CustomerID,Recency,Frequency,Monetary,RecencyScore,FrequencyScore,MonetaryScore,RFM_Score,Value Segment,RFM Customer Segments
1,84,7,"305,5",5,2,1,8,High-Value,Potential Loyalists
3,264,3,"172,2",5,1,1,7,Mid-Value,Potential Loyalists
4,1230,2,"179,0",2,1,1,4,Low-Value,Can't Lose
5,243,5,"272,8",5,1,1,7,Mid-Value,Potential Loyalists
6,192,3,"168,2",5,1,1,7,Mid-Value,Potential Loyalists
7,430,5,"233,75",4,1,1,6,Mid-Value,Potential Loyalists
9,183,4,"130,85000000000002",5,1,1,7,Mid-Value,Potential Loyalists
10,166,4,"115,85",5,1,1,7,Mid-Value,Potential Loyalists
12,1590,1,"44,099999999999994",1,1,1,3,Low-Value,Lost
13,788,3,"129,6",3,1,1,5,Low-Value,At Risk Customers
16,374,3,"313,25",4,1,1,6,Mid-Value,Potential Loyalists
18,1049,1,"84,9",3,1,1,5,Low-Value,At Risk Customers
19,431,5,"48,05",4,1,1,6,Mid-Value,Potential Loyalists
20,1601,2,"100,55000000000001",1,1,1,3,Low-Value,Lost
21,775,2,"29,75",3,1,1,5,Low-Value,At Risk Customers
23,922,2,"29,799999999999997",3,1,1,5,Low-Value,At Risk Customers
24,1043,1,"5,4",3,1,1,5,Low-Value,At Risk Customers
25,894,2,"721,9000000000001",3,1,2,6,Mid-Value,Potential Loyalists
26,22,4,"316,05",5,1,1,7,Mid-Value,Potential Loyalists
29,568,2,"37,599999999999994",4,1,1,6,Mid-Value,Potential Loyalists
30,409,1,"28,75",4,1,1,6,Mid-Value,Potential Loyalists
31,19,4,"536,9",5,1,1,7,Mid-Value,Potential Loyalists
33,526,2,"107,80000000000001",4,1,1,6,Mid-Value,Potential Loyalists
34,1173,4,"423,55",2,1,1,4,Low-Value,Can't Lose
36,743,5,"407,20000000000005",3,1,1,5,Low-Value,At Risk Customers
37,525,4,"496,8",4,1,1,6,Mid-Value,Potential Loyalists
39,636,1,"2,2",4,1,1,6,Mid-Value,Potential Loyalists
40,21,2,"39,599999999999994",5,1,1,7,Mid-Value,Potential Loyalists
41,165,3,"38,25",5,1,1,7,Mid-Value,Potential Loyalists
44,9,3,"187,2",5,1,1,7,Mid-Value,Potential Loyalists
45,25,3,"451,95",5,1,1,7,Mid-Value,Potential Loyalists
46,219,3,"87,65",5,1,1,7,Mid-Value,Potential Loyalists
47,444,5,"234,0",4,1,1,6,Mid-Value,Potential Loyalists
48,1585,1,"125,25",1,1,1,3,Low-Value,Lost
49,949,1,"11,6",3,1,1,5,Low-Value,At Risk Customers
50,568,3,"102,85000000000001",4,1,1,6,Mid-Value,Potential Loyalists
51,523,2,"1115,1999999999998",4,1,2,7,Mid-Value,Potential Loyalists
52,382,4,"128,70000000000002",4,1,1,6,Mid-Value,Potential Loyalists
53,142,3,"276,75",5,1,1,7,Mid-Value,Potential Loyalists
56,270,1,"8,9",5,1,1,7,Mid-Value,Potential Loyalists
58,64,3,"537,25",5,1,1,7,Mid-Value,Potential Loyalists
59,1140,3,"60,4",2,1,1,4,Low-Value,Can't Lose
61,360,5,"203,6",5,1,1,7,Mid-Value,Potential Loyalists
63,419,3,"80,65",4,1,1,6,Mid-Value,Potential Loyalists
65,150,2,"238,4",5,1,1,7,Mid-Value,Potential Loyalists
71,681,1,"18,15",4,1,1,6,Mid-Value,Potential Loyalists
72,351,2,"68,65",5,1,1,7,Mid-Value,Potential Loyalists
74,14,4,"196,2",5,1,1,7,Mid-Value,Potential Loyalists
75,1147,1,"3,1",2,1,1,4,Low-Value,Can't Lose
76,360,9,"575,25",5,2,1,8,High-Value,Potential Loyalists
77,24,7,"884,1",5,2,2,9,High-Value,Champions
78,148,6,"358,4",5,1,1,7,Mid-Value,Potential Loyalists
79,790,3,"140,15",3,1,1,5,Low-Value,At Risk Customers
81,558,4,"328,9",4,1,1,6,Mid-Value,Potential Loyalists
83,788,2,"110,55",3,1,1,5,Low-Value,At Risk Customers
84,47,6,"342,45",5,1,1,7,Mid-Value,Potential Loyalists
88,568,1,"118,1",4,1,1,6,Mid-Value,Potential Loyalists
89,631,5,"221,55",4,1,1,6,Mid-Value,Potential Loyalists
90,242,3,"144,6",5,1,1,7,Mid-Value,Potential Loyalists
91,129,3,"110,25",5,1,1,7,Mid-Value,Potential Loyalists
92,1116,2,"82,55",2,1,1,4,Low-Value,Can't Lose
94,386,4,"276,45",4,1,1,6,Mid-Value,Potential Loyalists
95,684,4,"105,45",4,1,1,6,Mid-Value,Potential Loyalists
96,288,2,"148,0",5,1,1,7,Mid-Value,Potential Loyalists
97,1529,2,"399,0",1,1,1,3,Low-Value,Lost
99,82,3,"94,55",5,1,1,7,Mid-Value,Potential Loyalists
101,780,2,"43,379999999999995",3,1,1,5,Low-Value,At Risk Customers
102,379,3,"263,20000000000005",4,1,1,6,Mid-Value,Potential Loyalists
105,1298,1,"30,299999999999997",2,1,1,4,Low-Value,Can't Lose
106,1221,3,"477,0",2,1,1,4,Low-Value,Can't Lose
108,13,5,"352,4",5,1,1,7,Mid-Value,Potential Loyalists
109,561,4,"137,1",4,1,1,6,Mid-Value,Potential Loyalists
111,1176,1,"51,9",2,1,1,4,Low-Value,Can't Lose
117,221,3,"82,5",5,1,1,7,Mid-Value,Potential Loyalists
121,413,8,"782,6",4,2,2,8,High-Value,Potential Loyalists
123,271,7,"259,3",5,2,1,8,High-Value,Potential Loyalists
125,1096,2,"92,0",2,1,1,4,Low-Value,Can't Lose
126,220,1,"159,95",5,1,1,7,Mid-Value,Potential Loyalists
128,11,4,"122,1",5,1,1,7,Mid-Value,Potential Loyalists
129,292,2,"190,05",5,1,1,7,Mid-Value,Potential Loyalists
130,181,4,"458,05",5,1,1,7,Mid-Value,Potential Loyalists
131,191,5,"162,2",5,1,1,7,Mid-Value,Potential Loyalists
132,531,1,"9,45",4,1,1,6,Mid-Value,Potential Loyalists
133,1087,1,"54,0",3,1,1,5,Low-Value,At Risk Customers
134,185,6,"250,4",5,1,1,7,Mid-Value,Potential Loyalists
137,1389,1,"30,95",2,1,1,4,Low-Value,Can't Lose
141,185,5,"182,75",5,1,1,7,Mid-Value,Potential Loyalists
142,78,13,"908,0",5,3,2,10,High-Value,Champions
143,516,8,"518,83",4,2,1,7,Mid-Value,Potential Loyalists
144,44,1,"9,2",5,1,1,7,Mid-Value,Potential Loyalists
147,333,15,"1439,0",5,3,3,11,High-Value,Champions
148,25,7,"513,05",5,2,1,8,High-Value,Potential Loyalists
149,1409,1,"23,5",2,1,1,4,Low-Value,Can't Lose
150,1462,1,"95,4",1,1,1,3,Low-Value,Lost
151,678,3,"54,900000000000006",4,1,1,6,Mid-Value,Potential Loyalists
152,1285,1,"44,5",2,1,1,4,Low-Value,Can't Lose
153,378,2,"368,04999999999995",4,1,1,6,Mid-Value,Potential Loyalists
157,305,3,"73,55",5,1,1,7,Mid-Value,Potential Loyalists
159,333,1,"114,1",5,1,1,7,Mid-Value,Potential Loyalists
161,922,9,"527,85",3,2,1,6,Mid-Value,Potential Loyalists
162,59,3,"64,95",5,1,1,7,Mid-Value,Potential Loyalists
163,38,3,"149,6",5,1,1,7,Mid-Value,Potential Loyalists
164,605,3,"107,35",4,1,1,6,Mid-Value,Potential Loyalists
165,11,1,"87,0",5,1,1,7,Mid-Value,Potential Loyalists
166,1706,1,"254,0",1,1,1,3,Low-Value,Lost
168,11,6,"814,65",5,1,2,8,High-Value,Potential Loyalists
170,1287,1,"60,599999999999994",2,1,1,4,Low-Value,Can't Lose
171,38,5,"169,7",5,1,1,7,Mid-Value,Potential Loyalists
173,943,1,"1216,5",3,1,2,6,Mid-Value,Potential Loyalists
174,541,1,"231,2",4,1,1,6,Mid-Value,Potential Loyalists
177,571,5,"357,5",4,1,1,6,Mid-Value,Potential Loyalists
180,71,4,"162,20000000000002",5,1,1,7,Mid-Value,Potential Loyalists
181,505,1,"55,9",4,1,1,6,Mid-Value,Potential Loyalists
183,862,5,"184,60000000000002",3,1,1,5,Low-Value,At Risk Customers
184,1631,1,"106,0",1,1,1,3,Low-Value,Lost
185,274,4,"81,8",5,1,1,7,Mid-Value,Potential Loyalists
186,1104,2,"64,89999999999999",2,1,1,4,Low-Value,Can't Lose
187,179,1,"53,699999999999996",5,1,1,7,Mid-Value,Potential Loyalists
188,68,6,"360,29999999999995",5,1,1,7,Mid-Value,Potential Loyalists
190,647,1,"10,25",4,1,1,6,Mid-Value,Potential Loyalists
191,906,3,"168,45",3,1,1,5,Low-Value,At Risk Customers
192,751,3,"202,35",3,1,1,5,Low-Value,At Risk Customers
194,1300,1,"22,3",2,1,1,4,Low-Value,Can't Lose
195,814,2,"176,8",3,1,1,5,Low-Value,At Risk Customers
196,647,1,"14,3",4,1,1,6,Mid-Value,Potential Loyalists
197,29,7,"375,83",5,2,1,8,High-Value,Potential Loyalists
198,448,4,"60,9",4,1,1,6,Mid-Value,Potential Loyalists
199,609,3,"63,60000000000001",4,1,1,6,Mid-Value,Potential Loyalists
201,591,2,"84,65",4,1,1,6,Mid-Value,Potential Loyalists
203,1638,1,"90,30000000000001",1,1,1,3,Low-Value,Lost
204,669,2,"161,45",4,1,1,6,Mid-Value,Potential Loyalists
205,756,4,"391,4",3,1,1,5,Low-Value,At Risk Customers
206,15,4,"432,45",5,1,1,7,Mid-Value,Potential Loyalists
209,8,8,"657,15",5,2,1,8,High-Value,Potential Loyalists
211,161,3,"130,55",5,1,1,7,Mid-Value,Potential Loyalists
213,263,3,"124,5",5,1,1,7,Mid-Value,Potential Loyalists
214,9,4,"698,3",5,1,2,8,High-Value,Potential Loyalists
215,1015,4,"255,09999999999997",3,1,1,5,Low-Value,At Risk Customers
216,22,13,"903,75",5,3,2,10,High-Value,Champions
220,762,5,"500,79999999999995",3,1,1,5,Low-Value,At Risk Customers
221,144,6,"410,0",5,1,1,7,Mid-Value,Potential Loyalists
222,1333,1,"30,25",2,1,1,4,Low-Value,Can't Lose
223,40,3,"115,35",5,1,1,7,Mid-Value,Potential Loyalists
224,179,2,"24,299999999999997",5,1,1,7,Mid-Value,Potential Loyalists
226,716,2,"162,75",4,1,1,6,Mid-Value,Potential Loyalists
227,1138,1,"8,6",2,1,1,4,Low-Value,Can't Lose
228,1582,1,"86,5",1,1,1,3,Low-Value,Lost
229,857,4,"300,25",3,1,1,5,Low-Value,At Risk Customers
231,57,4,"126,0",5,1,1,7,Mid-Value,Potential Loyalists
234,32,3,"60,35",5,1,1,7,Mid-Value,Potential Loyalists
235,304,1,"102,6",5,1,1,7,Mid-Value,Potential Loyalists
236,16,6,"1678,8999999999999",5,1,3,9,High-Value,Champions
238,255,7,"695,35",5,2,2,9,High-Value,Champions
239,40,9,"567,1",5,2,1,8,High-Value,Potential Loyalists
241,946,2,"52,2",3,1,1,5,Low-Value,At Risk Customers
243,100,6,"285,09999999999997",5,1,1,7,Mid-Value,Potential Loyalists
245,207,2,"57,3",5,1,1,7,Mid-Value,Potential Loyalists
248,46,3,"94,95",5,1,1,7,Mid-Value,Potential Loyalists
250,1584,1,"112,85",1,1,1,3,Low-Value,Lost
251,326,2,"134,2",5,1,1,7,Mid-Value,Potential Loyalists
252,62,2,"36,35",5,1,1,7,Mid-Value,Potential Loyalists
254,375,2,"72,05",4,1,1,6,Mid-Value,Potential Loyalists
255,54,3,"103,1",5,1,1,7,Mid-Value,Potential Loyalists
257,559,3,"187,6",4,1,1,6,Mid-Value,Potential Loyalists
259,19,2,"58,8",5,1,1,7,Mid-Value,Potential Loyalists
261,87,8,"453,75",5,2,1,8,High-Value,Potential Loyalists
262,171,5,"458,6",5,1,1,7,Mid-Value,Potential Loyalists
264,232,3,"50,95",5,1,1,7,Mid-Value,Potential Loyalists
265,82,8,"358,7",5,2,1,8,High-Value,Potential Loyalists
266,169,6,"317,83000000000004",5,1,1,7,Mid-Value,Potential Loyalists
267,494,1,"29,2",4,1,1,6,Mid-Value,Potential Loyalists
268,318,12,"768,75",5,3,2,10,High-Value,Champions
269,371,2,"217,35",4,1,1,6,Mid-Value,Potential Loyalists
271,773,4,"136,7",3,1,1,5,Low-Value,At Risk Customers
273,33,4,"596,2",5,1,1,7,Mid-Value,Potential Loyalists
275,47,8,"1240,85",5,2,2,9,High-Value,Champions
278,132,11,"507,15",5,2,1,8,High-Value,Potential Loyalists
279,759,1,"91,5",3,1,1,5,Low-Value,At Risk Customers
280,703,1,"21,3",4,1,1,6,Mid-Value,Potential Loyalists
282,167,3,"312,85",5,1,1,7,Mid-Value,Potential Loyalists
284,1014,2,"16,4",3,1,1,5,Low-Value,At Risk Customers
285,1452,2,"33,5",2,1,1,4,Low-Value,Can't Lose
286,514,3,"60,25",4,1,1,6,Mid-Value,Potential Loyalists
287,1256,3,"484,7",2,1,1,4,Low-Value,Can't Lose
288,190,1,"3,85",5,1,1,7,Mid-Value,Potential Loyalists
289,1715,1,"19,9",1,1,1,3,Low-Value,Lost
290,400,3,"91,95",4,1,1,6,Mid-Value,Potential Loyalists
291,256,7,"366,00000000000006",5,2,1,8,High-Value,Potential Loyalists
292,1294,1,"144,9",2,1,1,4,Low-Value,Can't Lose
295,429,1,"31,6",4,1,1,6,Mid-Value,Potential Loyalists
296,21,4,"121,0",5,1,1,7,Mid-Value,Potential Loyalists
297,1049,3,"331,7",3,1,1,5,Low-Value,At Risk Customers
300,21,4,"204,70000000000002",5,1,1,7,Mid-Value,Potential Loyalists
301,650,3,"83,0",4,1,1,6,Mid-Value,Potential Loyalists
302,345,3,"370,05",5,1,1,7,Mid-Value,Potential Loyalists
303,1200,2,"136,35",2,1,1,4,Low-Value,Can't Lose
305,1023,3,"229,5",3,1,1,5,Low-Value,At Risk Customers
308,343,4,"188,6",5,1,1,7,Mid-Value,Potential Loyalists
310,815,3,"254,15",3,1,1,5,Low-Value,At Risk Customers
311,80,4,"152,0",5,1,1,7,Mid-Value,Potential Loyalists
312,505,1,"4,4",4,1,1,6,Mid-Value,Potential Loyalists
313,689,5,"285,3",4,1,1,6,Mid-Value,Potential Loyalists
315,1625,2,"139,4",1,1,1,3,Low-Value,Lost
316,809,2,"10,55",3,1,1,5,Low-Value,At Risk Customers
317,1310,3,"511,15",2,1,1,4,Low-Value,Can't Lose
318,1652,2,"187,0",1,1,1,3,Low-Value,Lost
319,510,5,"162,8",4,1,1,6,Mid-Value,Potential Loyalists
323,123,2,"42,199999999999996",5,1,1,7,Mid-Value,Potential Loyalists
324,1315,1,"50,25",2,1,1,4,Low-Value,Can't Lose
326,711,4,"184,8",4,1,1,6,Mid-Value,Potential Loyalists
327,44,12,"467,1",5,3,1,9,High-Value,Champions
328,1436,1,"11,95",2,1,1,4,Low-Value,Can't Lose
329,916,1,"248,85000000000002",3,1,1,5,Low-Value,At Risk Customers
331,367,7,"534,65",4,2,1,7,Mid-Value,Potential Loyalists
332,835,5,"483,25",3,1,1,5,Low-Value,At Risk Customers
333,782,1,"13,4",3,1,1,5,Low-Value,At Risk Customers
334,886,2,"41,75",3,1,1,5,Low-Value,At Risk Customers
337,977,4,"100,85",3,1,1,5,Low-Value,At Risk Customers
338,153,6,"162,65",5,1,1,7,Mid-Value,Potential Loyalists
339,770,4,"148,55",3,1,1,5,Low-Value,At Risk Customers
340,946,3,"144,5",3,1,1,5,Low-Value,At Risk Customers
341,102,5,"220,25",5,1,1,7,Mid-Value,Potential Loyalists
343,127,2,"62,15",5,1,1,7,Mid-Value,Potential Loyalists
344,54,4,"166,35",5,1,1,7,Mid-Value,Potential Loyalists
345,169,1,"39,4",5,1,1,7,Mid-Value,Potential Loyalists
346,17,5,"329,45000000000005",5,1,1,7,Mid-Value,Potential Loyalists
348,1374,2,"68,5",2,1,1,4,Low-Value,Can't Lose
349,93,3,"115,41",5,1,1,7,Mid-Value,Potential Loyalists
351,62,4,"158,2",5,1,1,7,Mid-Value,Potential Loyalists
352,1506,1,"39,2",1,1,1,3,Low-Value,Lost
353,248,2,"8,65",5,1,1,7,Mid-Value,Potential Loyalists
355,647,1,"18,35",4,1,1,6,Mid-Value,Potential Loyalists
356,358,7,"301,0",5,2,1,8,High-Value,Potential Loyalists
357,28,6,"2388,1",5,1,4,10,High-Value,Champions
358,487,1,"270,0",4,1,1,6,Mid-Value,Potential Loyalists
359,305,2,"51,150000000000006",5,1,1,7,Mid-Value,Potential Loyalists
361,1041,1,"35,7",3,1,1,5,Low-Value,At Risk Customers
362,235,5,"478,3",5,1,1,7,Mid-Value,Potential Loyalists
363,387,1,"71,4",4,1,1,6,Mid-Value,Potential Loyalists
368,49,5,"923,35",5,1,2,8,High-Value,Potential Loyalists
374,815,2,"165,0",3,1,1,5,Low-Value,At Risk Customers
375,66,3,"207,60000000000002",5,1,1,7,Mid-Value,Potential Loyalists
377,660,1,"42,15",4,1,1,6,Mid-Value,Potential Loyalists
378,26,5,"203,45",5,1,1,7,Mid-Value,Potential Loyalists
379,332,4,"370,75",5,1,1,7,Mid-Value,Potential Loyalists
380,1493,1,"46,25",1,1,1,3,Low-Value,Lost
381,149,2,"107,1",5,1,1,7,Mid-Value,Potential Loyalists
383,301,3,"229,5",5,1,1,7,Mid-Value,Potential Loyalists
386,190,2,"242,55",5,1,1,7,Mid-Value,Potential Loyalists
388,1523,1,"7,4",1,1,1,3,Low-Value,Lost
390,193,4,"299,58",5,1,1,7,Mid-Value,Potential Loyalists
392,174,8,"545,3",5,2,1,8,High-Value,Potential Loyalists
393,76,4,"98,15",5,1,1,7,Mid-Value,Potential Loyalists
395,77,7,"538,65",5,2,1,8,High-Value,Potential Loyalists
398,119,2,"109,2",5,1,1,7,Mid-Value,Potential Loyalists
400,231,3,"30,400000000000002",5,1,1,7,Mid-Value,Potential Loyalists
401,17,2,"93,80000000000001",5,1,1,7,Mid-Value,Potential Loyalists
402,1754,1,"9,1",1,1,1,3,Low-Value,Lost
403,369,3,"140,2",4,1,1,6,Mid-Value,Potential Loyalists
404,480,2,"57,7",4,1,1,6,Mid-Value,Potential Loyalists
406,1503,1,"30,0",1,1,1,3,Low-Value,Lost
407,27,5,"356,95",5,1,1,7,Mid-Value,Potential Loyalists
408,117,3,"118,94999999999999",5,1,1,7,Mid-Value,Potential Loyalists
410,118,2,"9,5",5,1,1,7,Mid-Value,Potential Loyalists
411,537,2,"197,2",4,1,1,6,Mid-Value,Potential Loyalists
416,424,1,"30,5",4,1,1,6,Mid-Value,Potential Loyalists
418,253,1,"89,95",5,1,1,7,Mid-Value,Potential Loyalists
419,906,1,"16,7",3,1,1,5,Low-Value,At Risk Customers
420,22,6,"293,8",5,1,1,7,Mid-Value,Potential Loyalists
421,578,2,"77,4",4,1,1,6,Mid-Value,Potential Loyalists
422,745,4,"140,60000000000002",3,1,1,5,Low-Value,At Risk Customers
423,393,3,"194,8",4,1,1,6,Mid-Value,Potential Loyalists
424,126,6,"333,65000000000003",5,1,1,7,Mid-Value,Potential Loyalists
425,1237,3,"97,0",2,1,1,4,Low-Value,Can't Lose
426,1469,1,"42,15",1,1,1,3,Low-Value,Lost
427,859,1,"19,1",3,1,1,5,Low-Value,At Risk Customers
429,1050,2,"22,7",3,1,1,5,Low-Value,At Risk Customers
430,838,2,"50,9",3,1,1,5,Low-Value,At Risk Customers
433,1412,5,"227,9",2,1,1,4,Low-Value,Can't Lose
434,727,1,"168,0",4,1,1,6,Mid-Value,Potential Loyalists
435,546,3,"52,05",4,1,1,6,Mid-Value,Potential Loyalists
436,434,2,"38,4",4,1,1,6,Mid-Value,Potential Loyalists
437,534,1,"177,8",4,1,1,6,Mid-Value,Potential Loyalists
444,72,3,"102,2",5,1,1,7,Mid-Value,Potential Loyalists
445,385,2,"154,5",4,1,1,6,Mid-Value,Potential Loyalists
446,25,4,"70,7",5,1,1,7,Mid-Value,Potential Loyalists
447,593,1,"2,3",4,1,1,6,Mid-Value,Potential Loyalists
448,633,2,"45,7",4,1,1,6,Mid-Value,Potential Loyalists
452,290,1,"20,05",5,1,1,7,Mid-Value,Potential Loyalists
453,36,1,"64,1",5,1,1,7,Mid-Value,Potential Loyalists
454,361,3,"388,75",5,1,1,7,Mid-Value,Potential Loyalists
455,459,4,"80,55",4,1,1,6,Mid-Value,Potential Loyalists
458,1147,2,"97,45",2,1,1,4,Low-Value,Can't Lose
460,12,8,"233,15",5,2,1,8,High-Value,Potential Loyalists
463,949,4,"557,4499999999999",3,1,1,5,Low-Value,At Risk Customers
464,99,4,"270,85",5,1,1,7,Mid-Value,Potential Loyalists
467,549,3,"188,20000000000002",4,1,1,6,Mid-Value,Potential Loyalists
470,206,1,"60,85",5,1,1,7,Mid-Value,Potential Loyalists
471,743,2,"55,1",3,1,1,5,Low-Value,At Risk Customers
472,439,5,"128,1",4,1,1,6,Mid-Value,Potential Loyalists
473,369,9,"692,1",4,2,2,8,High-Value,Potential Loyalists
474,437,2,"211,55",4,1,1,6,Mid-Value,Potential Loyalists
476,783,4,"88,85",3,1,1,5,Low-Value,At Risk Customers
478,1439,1,"18,3",2,1,1,4,Low-Value,Can't Lose
480,49,6,"163,15",5,1,1,7,Mid-Value,Potential Loyalists
482,747,3,"242,55",3,1,1,5,Low-Value,At Risk Customers
483,141,10,"656,3",5,2,1,8,High-Value,Potential Loyalists
485,95,2,"682,75",5,1,2,8,High-Value,Potential Loyalists
486,1066,2,"33,7",3,1,1,5,Low-Value,At Risk Customers
487,183,5,"385,35",5,1,1,7,Mid-Value,Potential Loyalists
488,360,4,"159,85",5,1,1,7,Mid-Value,Potential Loyalists
492,577,1,"42,45",4,1,1,6,Mid-Value,Potential Loyalists
494,369,2,"50,1",4,1,1,6,Mid-Value,Potential Loyalists
495,91,5,"307,65",5,1,1,7,Mid-Value,Potential Loyalists
498,780,3,"117,35",3,1,1,5,Low-Value,At Risk Customers
499,191,3,"55,599999999999994",5,1,1,7,Mid-Value,Potential Loyalists
501,486,2,"178,1",4,1,1,6,Mid-Value,Potential Loyalists
502,43,2,"87,15",5,1,1,7,Mid-Value,Potential Loyalists
503,147,5,"172,6",5,1,1,7,Mid-Value,Potential Loyalists
504,1666,1,"16,7",1,1,1,3,Low-Value,Lost
506,304,1,"30,8",5,1,1,7,Mid-Value,Potential Loyalists
508,82,8,"348,5",5,2,1,8,High-Value,Potential Loyalists
509,603,3,"209,10000000000002",4,1,1,6,Mid-Value,Potential Loyalists
510,1057,1,"219,6",3,1,1,5,Low-Value,At Risk Customers
511,4,4,"123,35",5,1,1,7,Mid-Value,Potential Loyalists
512,1190,1,"150,7",2,1,1,4,Low-Value,Can't Lose
513,15,4,"205,0",5,1,1,7,Mid-Value,Potential Loyalists
514,1691,1,"34,35",1,1,1,3,Low-Value,Lost
517,1086,5,"373,35",3,1,1,5,Low-Value,At Risk Customers
518,679,1,"8,85",4,1,1,6,Mid-Value,Potential Loyalists
519,1283,1,"72,6",2,1,1,4,Low-Value,Can't Lose
520,820,3,"243,5",3,1,1,5,Low-Value,At Risk Customers
523,193,3,"87,7",5,1,1,7,Mid-Value,Potential Loyalists
524,36,3,"24,45",5,1,1,7,Mid-Value,Potential Loyalists
526,1370,1,"25,5",2,1,1,4,Low-Value,Can't Lose
528,380,4,"819,0999999999999",4,1,2,7,Mid-Value,Potential Loyalists
530,697,4,"441,45000000000005",4,1,1,6,Mid-Value,Potential Loyalists
531,1258,1,"74,95",2,1,1,4,Low-Value,Can't Lose
533,1006,3,"149,9",3,1,1,5,Low-Value,At Risk Customers
534,674,3,"119,4",4,1,1,6,Mid-Value,Potential Loyalists
536,655,2,"239,25",4,1,1,6,Mid-Value,Potential Loyalists
542,1153,1,"7,7",2,1,1,4,Low-Value,Can't Lose
544,388,1,"59,65",4,1,1,6,Mid-Value,Potential Loyalists
547,1326,1,"464,40000000000003",2,1,1,4,Low-Value,Can't Lose
548,45,2,"72,10000000000001",5,1,1,7,Mid-Value,Potential Loyalists
549,18,3,"115,85",5,1,1,7,Mid-Value,Potential Loyalists
551,1498,5,"473,05",1,1,1,3,Low-Value,Lost
555,96,3,"1204,3999999999999",5,1,2,8,High-Value,Potential Loyalists
556,45,2,"37,8",5,1,1,7,Mid-Value,Potential Loyalists
557,579,1,"113,55000000000001",4,1,1,6,Mid-Value,Potential Loyalists
559,509,6,"647,8499999999999",4,1,1,6,Mid-Value,Potential Loyalists
560,366,5,"241,35000000000002",4,1,1,6,Mid-Value,Potential Loyalists
561,1427,1,"564,25",2,1,1,4,Low-Value,Can't Lose
563,586,6,"425,1",4,1,1,6,Mid-Value,Potential Loyalists
564,156,2,"116,6",5,1,1,7,Mid-Value,Potential Loyalists
566,479,2,"223,55",4,1,1,6,Mid-Value,Potential Loyalists
570,280,6,"224,7",5,1,1,7,Mid-Value,Potential Loyalists
572,69,3,"89,2",5,1,1,7,Mid-Value,Potential Loyalists
574,12,4,"262,45",5,1,1,7,Mid-Value,Potential Loyalists
577,1387,2,"194,65",2,1,1,4,Low-Value,Can't Lose
579,98,4,"113,4",5,1,1,7,Mid-Value,Potential Loyalists
580,683,1,"24,2",4,1,1,6,Mid-Value,Potential Loyalists
581,82,1,"19,35",5,1,1,7,Mid-Value,Potential Loyalists
582,685,4,"295,9",4,1,1,6,Mid-Value,Potential Loyalists
583,1240,1,"147,60000000000002",2,1,1,4,Low-Value,Can't Lose
584,203,3,"120,35",5,1,1,7,Mid-Value,Potential Loyalists
585,1391,1,"16,85",2,1,1,4,Low-Value,Can't Lose
587,28,8,"292,65",5,2,1,8,High-Value,Potential Loyalists
588,356,8,"261,85",5,2,1,8,High-Value,Potential Loyalists
589,1133,8,"454,0",2,2,1,5,Low-Value,At Risk Customers
591,521,4,"363,3",4,1,1,6,Mid-Value,Potential Loyalists
593,106,2,"103,69999999999999",5,1,1,7,Mid-Value,Potential Loyalists
594,200,2,"72,7",5,1,1,7,Mid-Value,Potential Loyalists
595,148,2,"70,3",5,1,1,7,Mid-Value,Potential Loyalists
596,1607,2,"24,85",1,1,1,3,Low-Value,Lost
597,549,1,"290,0",4,1,1,6,Mid-Value,Potential Loyalists
598,236,4,"937,8499999999999",5,1,2,8,High-Value,Potential Loyalists
599,749,3,"555,9",3,1,1,5,Low-Value,At Risk Customers
603,1047,1,"17,5",3,1,1,5,Low-Value,At Risk Customers
604,1488,1,"132,2",1,1,1,3,Low-Value,Lost
606,988,2,"70,7",3,1,1,5,Low-Value,At Risk Customers
609,705,3,"33,9",4,1,1,6,Mid-Value,Potential Loyalists
610,353,2,"30,85",5,1,1,7,Mid-Value,Potential Loyalists
612,573,1,"53,2",4,1,1,6,Mid-Value,Potential Loyalists
613,500,4,"262,65",4,1,1,6,Mid-Value,Potential Loyalists
616,57,5,"262,55",5,1,1,7,Mid-Value,Potential Loyalists
617,1221,3,"113,1",2,1,1,4,Low-Value,Can't Lose
619,1193,1,"909,0",2,1,2,5,Low-Value,At Risk Customers
621,31,6,"167,55",5,1,1,7,Mid-Value,Potential Loyalists
622,1207,1,"53,6",2,1,1,4,Low-Value,Can't Lose
624,1411,2,"253,85",2,1,1,4,Low-Value,Can't Lose
625,154,1,"145,5",5,1,1,7,Mid-Value,Potential Loyalists
626,133,6,"1040,5",5,1,2,8,High-Value,Potential Loyalists
627,346,5,"205,85",5,1,1,7,Mid-Value,Potential Loyalists
629,29,2,"439,09999999999997",5,1,1,7,Mid-Value,Potential Loyalists
630,1537,1,"24,2",1,1,1,3,Low-Value,Lost
632,764,3,"217,85",3,1,1,5,Low-Value,At Risk Customers
633,486,8,"395,8",4,2,1,7,Mid-Value,Potential Loyalists
635,578,3,"87,8",4,1,1,6,Mid-Value,Potential Loyalists
636,4,4,"279,15",5,1,1,7,Mid-Value,Potential Loyalists
637,18,8,"409,65",5,2,1,8,High-Value,Potential Loyalists
638,456,9,"478,90000000000003",4,2,1,7,Mid-Value,Potential Loyalists
639,75,6,"383,15",5,1,1,7,Mid-Value,Potential Loyalists
640,110,2,"28,85",5,1,1,7,Mid-Value,Potential Loyalists
641,77,2,"37,95",5,1,1,7,Mid-Value,Potential Loyalists
643,672,2,"51,0",4,1,1,6,Mid-Value,Potential Loyalists
646,1813,1,"87,35",1,1,1,3,Low-Value,Lost
647,244,6,"242,25",5,1,1,7,Mid-Value,Potential Loyalists
648,341,2,"214,10000000000002",5,1,1,7,Mid-Value,Potential Loyalists
650,1592,1,"43,8",1,1,1,3,Low-Value,Lost
653,265,6,"282,09999999999997",5,1,1,7,Mid-Value,Potential Loyalists
654,356,1,"174,3",5,1,1,7,Mid-Value,Potential Loyalists
657,176,3,"173,95",5,1,1,7,Mid-Value,Potential Loyalists
659,52,10,"384,9",5,2,1,8,High-Value,Potential Loyalists
661,226,2,"63,300000000000004",5,1,1,7,Mid-Value,Potential Loyalists
662,1643,2,"244,1",1,1,1,3,Low-Value,Lost
665,1408,1,"1,9",2,1,1,4,Low-Value,Can't Lose
667,13,9,"588,8",5,2,1,8,High-Value,Potential Loyalists
668,10,4,"68,1",5,1,1,7,Mid-Value,Potential Loyalists
669,10,1,"28,4",5,1,1,7,Mid-Value,Potential Loyalists
670,59,10,"368,75",5,2,1,8,High-Value,Potential Loyalists
671,1256,2,"59,00000000000001",2,1,1,4,Low-Value,Can't Lose
672,1311,2,"127,5",2,1,1,4,Low-Value,Can't Lose
674,157,1,"32,25",5,1,1,7,Mid-Value,Potential Loyalists
676,970,2,"58,699999999999996",3,1,1,5,Low-Value,At Risk Customers
677,463,4,"325,8",4,1,1,6,Mid-Value,Potential Loyalists
679,903,2,"129,1",3,1,1,5,Low-Value,At Risk Customers
680,144,6,"252,9",5,1,1,7,Mid-Value,Potential Loyalists
681,321,2,"31,25",5,1,1,7,Mid-Value,Potential Loyalists
682,21,3,"103,3",5,1,1,7,Mid-Value,Potential Loyalists
683,10,5,"214,05",5,1,1,7,Mid-Value,Potential Loyalists
684,368,4,"131,10000000000002",4,1,1,6,Mid-Value,Potential Loyalists
685,236,2,"83,75",5,1,1,7,Mid-Value,Potential Loyalists
687,12,6,"580,5",5,1,1,7,Mid-Value,Potential Loyalists
688,147,7,"620,3",5,2,1,8,High-Value,Potential Loyalists
689,8,3,"44,45",5,1,1,7,Mid-Value,Potential Loyalists
690,205,2,"85,35",5,1,1,7,Mid-Value,Potential Loyalists
691,137,5,"172,05",5,1,1,7,Mid-Value,Potential Loyalists
692,627,1,"4,1",4,1,1,6,Mid-Value,Potential Loyalists
693,1228,2,"218,15",2,1,1,4,Low-Value,Can't Lose
694,42,2,"70,44999999999999",5,1,1,7,Mid-Value,Potential Loyalists
695,118,4,"229,65",5,1,1,7,Mid-Value,Potential Loyalists
696,95,4,"356,9",5,1,1,7,Mid-Value,Potential Loyalists
697,184,4,"288,2",5,1,1,7,Mid-Value,Potential Loyalists
699,183,1,"69,7",5,1,1,7,Mid-Value,Potential Loyalists
700,1244,2,"138,85",2,1,1,4,Low-Value,Can't Lose
701,11,7,"353,7",5,2,1,8,High-Value,Potential Loyalists
705,860,3,"247,1",3,1,1,5,Low-Value,At Risk Customers
709,382,2,"50,5",4,1,1,6,Mid-Value,Potential Loyalists
710,263,3,"74,85",5,1,1,7,Mid-Value,Potential Loyalists
711,808,4,"351,0",3,1,1,5,Low-Value,At Risk Customers
713,3,4,"224,74999999999997",5,1,1,7,Mid-Value,Potential Loyalists
715,37,1,"45,75",5,1,1,7,Mid-Value,Potential Loyalists
717,869,1,"97,3",3,1,1,5,Low-Value,At Risk Customers
718,623,2,"42,0",4,1,1,6,Mid-Value,Potential Loyalists
719,18,2,"26,299999999999997",5,1,1,7,Mid-Value,Potential Loyalists
720,563,2,"272,20000000000005",4,1,1,6,Mid-Value,Potential Loyalists
722,1153,3,"836,3500000000001",2,1,2,5,Low-Value,At Risk Customers
723,551,6,"1130,8",4,1,2,7,Mid-Value,Potential Loyalists
724,171,3,"124,05000000000001",5,1,1,7,Mid-Value,Potential Loyalists
725,158,4,"227,7",5,1,1,7,Mid-Value,Potential Loyalists
727,1601,1,"85,0",1,1,1,3,Low-Value,Lost
729,1198,1,"36,75",2,1,1,4,Low-Value,Can't Lose
732,1110,1,"48,6",2,1,1,4,Low-Value,Can't Lose
735,304,3,"43,400000000000006",5,1,1,7,Mid-Value,Potential Loyalists
738,1283,3,"413,3",2,1,1,4,Low-Value,Can't Lose
739,223,4,"613,8",5,1,1,7,Mid-Value,Potential Loyalists
743,674,6,"126,5",4,1,1,6,Mid-Value,Potential Loyalists
744,281,4,"127,44999999999999",5,1,1,7,Mid-Value,Potential Loyalists
745,402,2,"137,95",4,1,1,6,Mid-Value,Potential Loyalists
747,650,2,"230,55",4,1,1,6,Mid-Value,Potential Loyalists
750,1256,2,"186,45",2,1,1,4,Low-Value,Can't Lose
751,69,6,"256,9",5,1,1,7,Mid-Value,Potential Loyalists
752,551,2,"33,95",4,1,1,6,Mid-Value,Potential Loyalists
753,274,5,"135,85",5,1,1,7,Mid-Value,Potential Loyalists
754,694,1,"52,6",4,1,1,6,Mid-Value,Potential Loyalists
755,827,1,"15,2",3,1,1,5,Low-Value,At Risk Customers
757,1079,3,"180,14999999999998",3,1,1,5,Low-Value,At Risk Customers
758,189,6,"756,35",5,1,2,8,High-Value,Potential Loyalists
759,469,9,"978,8499999999999",4,2,2,8,High-Value,Potential Loyalists
760,496,1,"62,7",4,1,1,6,Mid-Value,Potential Loyalists
761,747,5,"131,95",3,1,1,5,Low-Value,At Risk Customers
763,180,4,"164,8",5,1,1,7,Mid-Value,Potential Loyalists
764,435,3,"171,05",4,1,1,6,Mid-Value,Potential Loyalists
768,143,2,"108,94999999999999",5,1,1,7,Mid-Value,Potential Loyalists
770,654,3,"414,55",4,1,1,6,Mid-Value,Potential Loyalists
771,1684,1,"30,95",1,1,1,3,Low-Value,Lost
773,42,5,"238,6",5,1,1,7,Mid-Value,Potential Loyalists
775,130,2,"125,7",5,1,1,7,Mid-Value,Potential Loyalists
776,838,1,"18,6",3,1,1,5,Low-Value,At Risk Customers
778,603,3,"306,45",4,1,1,6,Mid-Value,Potential Loyalists
780,682,1,"42,15",4,1,1,6,Mid-Value,Potential Loyalists
781,489,4,"215,25",4,1,1,6,Mid-Value,Potential Loyalists
782,1480,1,"106,2",1,1,1,3,Low-Value,Lost
783,46,5,"574,35",5,1,1,7,Mid-Value,Potential Loyalists
785,1121,5,"339,85",2,1,1,4,Low-Value,Can't Lose
786,556,1,"40,7",4,1,1,6,Mid-Value,Potential Loyalists
787,223,1,"177,60000000000002",5,1,1,7,Mid-Value,Potential Loyalists
788,758,8,"427,15000000000003",3,2,1,6,Mid-Value,Potential Loyalists
789,31,5,"128,14999999999998",5,1,1,7,Mid-Value,Potential Loyalists
791,30,1,"37,0",5,1,1,7,Mid-Value,Potential Loyalists
795,19,6,"314,45",5,1,1,7,Mid-Value,Potential Loyalists
796,323,4,"459,6",5,1,1,7,Mid-Value,Potential Loyalists
798,468,6,"485,95",4,1,1,6,Mid-Value,Potential Loyalists
799,666,1,"78,5",4,1,1,6,Mid-Value,Potential Loyalists
800,57,4,"167,8",5,1,1,7,Mid-Value,Potential Loyalists
801,596,1,"43,1",4,1,1,6,Mid-Value,Potential Loyalists
802,18,4,"708,35",5,1,2,8,High-Value,Potential Loyalists
803,1509,3,"138,1",1,1,1,3,Low-Value,Lost
806,67,1,"13,4",5,1,1,7,Mid-Value,Potential Loyalists
808,1623,1,"327,3",1,1,1,3,Low-Value,Lost
809,1279,3,"108,35",2,1,1,4,Low-Value,Can't Lose
811,497,5,"257,4",4,1,1,6,Mid-Value,Potential Loyalists
814,118,6,"453,25",5,1,1,7,Mid-Value,Potential Loyalists
816,260,2,"122,44999999999999",5,1,1,7,Mid-Value,Potential Loyalists
817,19,6,"276,15",5,1,1,7,Mid-Value,Potential Loyalists
818,400,11,"588,4",4,2,1,7,Mid-Value,Potential Loyalists
819,79,2,"135,05",5,1,1,7,Mid-Value,Potential Loyalists
822,1084,1,"10,35",3,1,1,5,Low-Value,At Risk Customers
826,1015,1,"93,1",3,1,1,5,Low-Value,At Risk Customers
827,562,3,"113,35",4,1,1,6,Mid-Value,Potential Loyalists
830,197,6,"332,40000000000003",5,1,1,7,Mid-Value,Potential Loyalists
838,742,3,"146,2",3,1,1,5,Low-Value,At Risk Customers
839,485,2,"50,0",4,1,1,6,Mid-Value,Potential Loyalists
840,424,4,"236,20000000000002",4,1,1,6,Mid-Value,Potential Loyalists
842,428,1,"30,3",4,1,1,6,Mid-Value,Potential Loyalists
843,1746,1,"7,9",1,1,1,3,Low-Value,Lost
844,15,7,"242,7",5,2,1,8,High-Value,Potential Loyalists
851,94,3,"76,05",5,1,1,7,Mid-Value,Potential Loyalists
852,1,7,"134,6",5,2,1,8,High-Value,Potential Loyalists
853,185,5,"149,60000000000002",5,1,1,7,Mid-Value,Potential Loyalists
854,1350,2,"239,79999999999998",2,1,1,4,Low-Value,Can't Lose
856,481,1,"17,7",4,1,1,6,Mid-Value,Potential Loyalists
857,522,1,"231,2",4,1,1,6,Mid-Value,Potential Loyalists
858,1509,2,"50,199999999999996",1,1,1,3,Low-Value,Lost
859,912,7,"466,45",3,2,1,6,Mid-Value,Potential Loyalists
860,368,6,"168,5",4,1,1,6,Mid-Value,Potential Loyalists
862,784,1,"37,0",3,1,1,5,Low-Value,At Risk Customers
863,11,5,"226,89999999999998",5,1,1,7,Mid-Value,Potential Loyalists
864,798,4,"94,8",3,1,1,5,Low-Value,At Risk Customers
866,804,3,"129,45",3,1,1,5,Low-Value,At Risk Customers
868,1098,4,"616,9",2,1,1,4,Low-Value,Can't Lose
869,449,4,"249,2",4,1,1,6,Mid-Value,Potential Loyalists
870,24,14,"728,6",5,3,2,10,High-Value,Champions
871,28,2,"151,1",5,1,1,7,Mid-Value,Potential Loyalists
872,1120,1,"26,6",2,1,1,4,Low-Value,Can't Lose
874,27,4,"224,39999999999998",5,1,1,7,Mid-Value,Potential Loyalists
876,740,1,"64,6",3,1,1,5,Low-Value,At Risk Customers
877,493,2,"122,19999999999999",4,1,1,6,Mid-Value,Potential Loyalists
878,405,2,"48,8",4,1,1,6,Mid-Value,Potential Loyalists
879,265,8,"702,9499999999999",5,2,2,9,High-Value,Champions
880,91,9,"630,35",5,2,1,8,High-Value,Potential Loyalists
881,862,6,"226,25",3,1,1,5,Low-Value,At Risk Customers
882,242,4,"172,14999999999998",5,1,1,7,Mid-Value,Potential Loyalists
883,94,11,"328,75",5,2,1,8,High-Value,Potential Loyalists
884,1799,1,"91,5",1,1,1,3,Low-Value,Lost
885,451,5,"195,75",4,1,1,6,Mid-Value,Potential Loyalists
886,888,3,"268,9",3,1,1,5,Low-Value,At Risk Customers
891,1143,1,"16,45",2,1,1,4,Low-Value,Can't Lose
895,609,2,"157,45",4,1,1,6,Mid-Value,Potential Loyalists
896,70,9,"504,84999999999997",5,2,1,8,High-Value,Potential Loyalists
900,762,1,"21,7",3,1,1,5,Low-Value,At Risk Customers
901,465,1,"20,2",4,1,1,6,Mid-Value,Potential Loyalists
902,1005,1,"16,5",3,1,1,5,Low-Value,At Risk Customers
904,1088,2,"87,85000000000001",3,1,1,5,Low-Value,At Risk Customers
905,315,2,"28,9",5,1,1,7,Mid-Value,Potential Loyalists
908,455,1,"48,45",4,1,1,6,Mid-Value,Potential Loyalists
910,521,2,"60,800000000000004",4,1,1,6,Mid-Value,Potential Loyalists
916,304,2,"199,14999999999998",5,1,1,7,Mid-Value,Potential Loyalists
917,632,6,"421,3",4,1,1,6,Mid-Value,Potential Loyalists
918,85,2,"110,9",5,1,1,7,Mid-Value,Potential Loyalists
922,587,3,"269,0",4,1,1,6,Mid-Value,Potential Loyalists
924,1104,3,"67,7",2,1,1,4,Low-Value,Can't Lose
926,393,5,"288,8",4,1,1,6,Mid-Value,Potential Loyalists
928,645,1,"352,1",4,1,1,6,Mid-Value,Potential Loyalists
929,380,3,"387,59999999999997",4,1,1,6,Mid-Value,Potential Loyalists
930,238,3,"658,3",5,1,1,7,Mid-Value,Potential Loyalists
933,678,7,"264,15",4,2,1,7,Mid-Value,Potential Loyalists
934,152,1,"71,4",5,1,1,7,Mid-Value,Potential Loyalists
937,315,2,"46,9",5,1,1,7,Mid-Value,Potential Loyalists
938,217,5,"410,95",5,1,1,7,Mid-Value,Potential Loyalists
939,283,2,"46,1",5,1,1,7,Mid-Value,Potential Loyalists
940,33,5,"281,1",5,1,1,7,Mid-Value,Potential Loyalists
942,408,1,"26,1",4,1,1,6,Mid-Value,Potential Loyalists
943,798,3,"171,93",3,1,1,5,Low-Value,At Risk Customers
944,726,3,"269,1",4,1,1,6,Mid-Value,Potential Loyalists
945,1454,1,"824,6",2,1,2,5,Low-Value,At Risk Customers
946,25,1,"51,8",5,1,1,7,Mid-Value,Potential Loyalists
948,1455,3,"179,15",2,1,1,4,Low-Value,Can't Lose
949,167,4,"281,15",5,1,1,7,Mid-Value,Potential Loyalists
951,47,2,"65,35",5,1,1,7,Mid-Value,Potential Loyalists
952,11,7,"408,5",5,2,1,8,High-Value,Potential Loyalists
953,1645,1,"94,8",1,1,1,3,Low-Value,Lost
955,25,4,"357,34999999999997",5,1,1,7,Mid-Value,Potential Loyalists
956,705,1,"129,1",4,1,1,6,Mid-Value,Potential Loyalists
957,429,4,"209,29999999999998",4,1,1,6,Mid-Value,Potential Loyalists
958,138,1,"27,6",5,1,1,7,Mid-Value,Potential Loyalists
959,211,3,"42,45",5,1,1,7,Mid-Value,Potential Loyalists
960,1179,1,"42,6",2,1,1,4,Low-Value,Can't Lose
962,163,3,"174,85",5,1,1,7,Mid-Value,Potential Loyalists
964,682,1,"22,25",4,1,1,6,Mid-Value,Potential Loyalists
965,127,3,"110,5",5,1,1,7,Mid-Value,Potential Loyalists
968,1242,2,"258,90000000000003",2,1,1,4,Low-Value,Can't Lose
969,1385,3,"386,3",2,1,1,4,Low-Value,Can't Lose
970,1680,1,"35,7",1,1,1,3,Low-Value,Lost
971,144,2,"401,70000000000005",5,1,1,7,Mid-Value,Potential Loyalists
973,80,10,"564,7",5,2,1,8,High-Value,Potential Loyalists
974,1138,2,"89,35",2,1,1,4,Low-Value,Can't Lose
975,883,2,"201,0",3,1,1,5,Low-Value,At Risk Customers
976,741,1,"30,9",3,1,1,5,Low-Value,At Risk Customers
977,1130,2,"77,55",2,1,1,4,Low-Value,Can't Lose
978,36,1,"63,2",5,1,1,7,Mid-Value,Potential Loyalists
979,391,1,"149,85000000000002",4,1,1,6,Mid-Value,Potential Loyalists
980,173,3,"218,4",5,1,1,7,Mid-Value,Potential Loyalists
981,1199,1,"15,45",2,1,1,4,Low-Value,Can't Lose
983,255,4,"112,3",5,1,1,7,Mid-Value,Potential Loyalists
985,741,2,"84,9",3,1,1,5,Low-Value,At Risk Customers
986,735,5,"239,7",3,1,1,5,Low-Value,At Risk Customers
987,402,2,"104,55000000000001",4,1,1,6,Mid-Value,Potential Loyalists
990,1223,1,"49,6",2,1,1,4,Low-Value,Can't Lose
991,1639,1,"32,5",1,1,1,3,Low-Value,Lost
994,1498,2,"57,0",1,1,1,3,Low-Value,Lost
995,802,2,"129,2",3,1,1,5,Low-Value,At Risk Customers
996,1416,2,"37,95",2,1,1,4,Low-Value,Can't Lose
997,405,3,"340,90000000000003",4,1,1,6,Mid-Value,Potential Loyalists
998,544,2,"235,65",4,1,1,6,Mid-Value,Potential Loyalists
1004,437,3,"123,95",4,1,1,6,Mid-Value,Potential Loyalists
1006,763,4,"1234,1",3,1,2,6,Mid-Value,Potential Loyalists
1007,1142,2,"125,65",2,1,1,4,Low-Value,Can't Lose
1008,152,3,"105,45",5,1,1,7,Mid-Value,Potential Loyalists
1011,878,2,"166,4",3,1,1,5,Low-Value,At Risk Customers
1012,1297,1,"197,7",2,1,1,4,Low-Value,Can't Lose
1014,1697,1,"86,25",1,1,1,3,Low-Value,Lost
1015,1124,2,"90,0",2,1,1,4,Low-Value,Can't Lose
1016,334,1,"15,9",5,1,1,7,Mid-Value,Potential Loyalists
1017,398,2,"133,2",4,1,1,6,Mid-Value,Potential Loyalists
1018,1397,2,"61,9",2,1,1,4,Low-Value,Can't Lose
1019,212,2,"40,35",5,1,1,7,Mid-Value,Potential Loyalists
1020,243,10,"406,55",5,2,1,8,High-Value,Potential Loyalists
1021,183,3,"290,0",5,1,1,7,Mid-Value,Potential Loyalists
1023,1033,3,"101,75",3,1,1,5,Low-Value,At Risk Customers
1024,576,9,"673,0",4,2,2,8,High-Value,Potential Loyalists
1025,789,2,"165,60000000000002",3,1,1,5,Low-Value,At Risk Customers
1027,22,2,"145,3",5,1,1,7,Mid-Value,Potential Loyalists
1028,363,2,"39,15",5,1,1,7,Mid-Value,Potential Loyalists
1030,202,6,"410,04999999999995",5,1,1,7,Mid-Value,Potential Loyalists
1031,697,1,"29,45",4,1,1,6,Mid-Value,Potential Loyalists
1033,239,1,"178,2",5,1,1,7,Mid-Value,Potential Loyalists
1034,669,2,"86,10000000000001",4,1,1,6,Mid-Value,Potential Loyalists
1035,641,1,"15,6",4,1,1,6,Mid-Value,Potential Loyalists
1036,153,2,"34,800000000000004",5,1,1,7,Mid-Value,Potential Loyalists
1037,255,7,"394,0",5,2,1,8,High-Value,Potential Loyalists
1038,1502,3,"79,9",1,1,1,3,Low-Value,Lost
1040,374,7,"452,45000000000005",4,2,1,7,Mid-Value,Potential Loyalists
1041,17,4,"305,35",5,1,1,7,Mid-Value,Potential Loyalists
1042,672,4,"838,55",4,1,2,7,Mid-Value,Potential Loyalists
1047,735,1,"158,0",3,1,1,5,Low-Value,At Risk Customers
1048,13,2,"85,25",5,1,1,7,Mid-Value,Potential Loyalists
1052,550,2,"40,0",4,1,1,6,Mid-Value,Potential Loyalists
1053,1232,7,"858,8000000000001",2,2,2,6,Mid-Value,Potential Loyalists
1054,542,3,"95,5",4,1,1,6,Mid-Value,Potential Loyalists
1055,1056,1,"8,5",3,1,1,5,Low-Value,At Risk Customers
1056,38,6,"193,15",5,1,1,7,Mid-Value,Potential Loyalists
1058,200,2,"51,4",5,1,1,7,Mid-Value,Potential Loyalists
1060,289,2,"203,5",5,1,1,7,Mid-Value,Potential Loyalists
1061,451,6,"608,2",4,1,1,6,Mid-Value,Potential Loyalists
1062,444,3,"58,949999999999996",4,1,1,6,Mid-Value,Potential Loyalists
1063,16,4,"167,39999999999998",5,1,1,7,Mid-Value,Potential Loyalists
1064,1545,2,"114,15",1,1,1,3,Low-Value,Lost
1065,261,5,"234,95",5,1,1,7,Mid-Value,Potential Loyalists
1066,826,2,"120,25",3,1,1,5,Low-Value,At Risk Customers
1067,28,4,"305,6",5,1,1,7,Mid-Value,Potential Loyalists
1070,1248,1,"166,8",2,1,1,4,Low-Value,Can't Lose
1073,1469,2,"245,2",1,1,1,3,Low-Value,Lost
1075,29,3,"101,75",5,1,1,7,Mid-Value,Potential Loyalists
1077,522,6,"152,35",4,1,1,6,Mid-Value,Potential Loyalists
1079,569,2,"46,7",4,1,1,6,Mid-Value,Potential Loyalists
1080,388,2,"136,65",4,1,1,6,Mid-Value,Potential Loyalists
1083,463,3,"29,7",4,1,1,6,Mid-Value,Potential Loyalists
1086,1341,2,"140,3",2,1,1,4,Low-Value,Can't Lose
1087,35,7,"268,25",5,2,1,8,High-Value,Potential Loyalists
1088,19,5,"344,55",5,1,1,7,Mid-Value,Potential Loyalists
1091,1380,4,"270,35",2,1,1,4,Low-Value,Can't Lose
1092,454,1,"38,6",4,1,1,6,Mid-Value,Potential Loyalists
1096,476,5,"343,74999999999994",4,1,1,6,Mid-Value,Potential Loyalists
1097,280,1,"37,6",5,1,1,7,Mid-Value,Potential Loyalists
1098,503,4,"250,55",4,1,1,6,Mid-Value,Potential Loyalists
1099,365,6,"336,15000000000003",5,1,1,7,Mid-Value,Potential Loyalists
1102,258,2,"84,45",5,1,1,7,Mid-Value,Potential Loyalists
1105,454,1,"36,45",4,1,1,6,Mid-Value,Potential Loyalists
1106,187,2,"127,39999999999999",5,1,1,7,Mid-Value,Potential Loyalists
1108,583,2,"73,85",4,1,1,6,Mid-Value,Potential Loyalists
1110,46,6,"584,6",5,1,1,7,Mid-Value,Potential Loyalists
1113,784,1,"86,1",3,1,1,5,Low-Value,At Risk Customers
1115,937,2,"116,2",3,1,1,5,Low-Value,At Risk Customers
1116,38,13,"713,36",5,3,2,10,High-Value,Champions
1118,1791,1,"10,4",1,1,1,3,Low-Value,Lost
1120,822,2,"73,4",3,1,1,5,Low-Value,At Risk Customers
1123,66,3,"106,5",5,1,1,7,Mid-Value,Potential Loyalists
1125,582,1,"72,8",4,1,1,6,Mid-Value,Potential Loyalists
1128,107,3,"142,0",5,1,1,7,Mid-Value,Potential Loyalists
1129,45,3,"454,35",5,1,1,7,Mid-Value,Potential Loyalists
1131,1586,2,"260,8",1,1,1,3,Low-Value,Lost
1133,393,5,"381,6",4,1,1,6,Mid-Value,Potential Loyalists
1134,781,4,"291,65",3,1,1,5,Low-Value,At Risk Customers
1135,1453,1,"26,1",2,1,1,4,Low-Value,Can't Lose
1136,1298,1,"84,3",2,1,1,4,Low-Value,Can't Lose
1138,119,2,"88,05000000000001",5,1,1,7,Mid-Value,Potential Loyalists
1141,450,7,"341,3",4,2,1,7,Mid-Value,Potential Loyalists
1142,406,2,"180,75",4,1,1,6,Mid-Value,Potential Loyalists
1143,796,2,"115,6",3,1,1,5,Low-Value,At Risk Customers
1148,418,6,"199,64999999999998",4,1,1,6,Mid-Value,Potential Loyalists
1149,28,4,"322,0",5,1,1,7,Mid-Value,Potential Loyalists
1151,1215,4,"140,1",2,1,1,4,Low-Value,Can't Lose
1153,498,3,"795,25",4,1,2,7,Mid-Value,Potential Loyalists
1154,18,4,"242,75",5,1,1,7,Mid-Value,Potential Loyalists
1155,112,3,"182,0",5,1,1,7,Mid-Value,Potential Loyalists
1157,1126,3,"99,35",2,1,1,4,Low-Value,Can't Lose
1162,7,6,"356,85",5,1,1,7,Mid-Value,Potential Loyalists
1163,1308,2,"103,7",2,1,1,4,Low-Value,Can't Lose
1164,94,9,"340,6",5,2,1,8,High-Value,Potential Loyalists
1165,188,2,"46,75",5,1,1,7,Mid-Value,Potential Loyalists
1166,290,2,"201,55",5,1,1,7,Mid-Value,Potential Loyalists
1168,1323,2,"119,39999999999999",2,1,1,4,Low-Value,Can't Lose
1173,608,2,"29,15",4,1,1,6,Mid-Value,Potential Loyalists
1174,1513,1,"8,25",1,1,1,3,Low-Value,Lost
1175,1074,1,"159,6",3,1,1,5,Low-Value,At Risk Customers
1177,1710,1,"18,75",1,1,1,3,Low-Value,Lost
1178,291,1,"45,9",5,1,1,7,Mid-Value,Potential Loyalists
1181,104,4,"354,35",5,1,1,7,Mid-Value,Potential Loyalists
1182,53,2,"68,05",5,1,1,7,Mid-Value,Potential Loyalists
1184,261,1,"17,25",5,1,1,7,Mid-Value,Potential Loyalists
1185,785,2,"96,65",3,1,1,5,Low-Value,At Risk Customers
1186,227,2,"49,85",5,1,1,7,Mid-Value,Potential Loyalists
1187,722,1,"52,4",4,1,1,6,Mid-Value,Potential Loyalists
1188,771,1,"23,65",3,1,1,5,Low-Value,At Risk Customers
1190,393,3,"156,7",4,1,1,6,Mid-Value,Potential Loyalists
1191,637,5,"79,9",4,1,1,6,Mid-Value,Potential Loyalists
1192,31,6,"94,7",5,1,1,7,Mid-Value,Potential Loyalists
1193,215,2,"66,55",5,1,1,7,Mid-Value,Potential Loyalists
1194,630,1,"23,3",4,1,1,6,Mid-Value,Potential Loyalists
1195,692,1,"182,75",4,1,1,6,Mid-Value,Potential Loyalists
1196,1307,2,"207,2",2,1,1,4,Low-Value,Can't Lose
1197,1447,2,"501,1",2,1,1,4,Low-Value,Can't Lose
1198,994,3,"35,9",3,1,1,5,Low-Value,At Risk Customers
1199,21,3,"146,75",5,1,1,7,Mid-Value,Potential Loyalists
1201,1268,1,"57,0",2,1,1,4,Low-Value,Can't Lose
1203,663,1,"9,05",4,1,1,6,Mid-Value,Potential Loyalists
1205,85,6,"215,6",5,1,1,7,Mid-Value,Potential Loyalists
1206,5,14,"1001,5999999999999",5,3,2,10,High-Value,Champions
1207,11,4,"696,25",5,1,2,8,High-Value,Potential Loyalists
1210,1116,1,"14,5",2,1,1,4,Low-Value,Can't Lose
1211,160,1,"108,4",5,1,1,7,Mid-Value,Potential Loyalists
1212,193,3,"81,55",5,1,1,7,Mid-Value,Potential Loyalists
1213,340,4,"138,45",5,1,1,7,Mid-Value,Potential Loyalists
1218,129,1,"81,6",5,1,1,7,Mid-Value,Potential Loyalists
1219,502,12,"479,15",4,3,1,8,High-Value,Potential Loyalists
1222,665,5,"191,55",4,1,1,6,Mid-Value,Potential Loyalists
1223,608,1,"10,0",4,1,1,6,Mid-Value,Potential Loyalists
1224,3,5,"697,35",5,1,2,8,High-Value,Potential Loyalists
1225,1593,2,"122,35000000000001",1,1,1,3,Low-Value,Lost
1226,168,3,"421,5",5,1,1,7,Mid-Value,Potential Loyalists
1228,1041,2,"398,0",3,1,1,5,Low-Value,At Risk Customers
1229,1166,2,"95,6",2,1,1,4,Low-Value,Can't Lose
1230,442,3,"121,4",4,1,1,6,Mid-Value,Potential Loyalists
1232,1683,1,"167,85000000000002",1,1,1,3,Low-Value,Lost
1233,516,2,"31,4",4,1,1,6,Mid-Value,Potential Loyalists
1235,1679,2,"73,25",1,1,1,3,Low-Value,Lost
1236,1243,1,"135,4",2,1,1,4,Low-Value,Can't Lose
1238,885,3,"217,05",3,1,1,5,Low-Value,At Risk Customers
1239,457,1,"11,5",4,1,1,6,Mid-Value,Potential Loyalists
1242,209,5,"328,95",5,1,1,7,Mid-Value,Potential Loyalists
1243,873,2,"98,85",3,1,1,5,Low-Value,At Risk Customers
1244,5,10,"481,5",5,2,1,8,High-Value,Potential Loyalists
1245,407,1,"13,4",4,1,1,6,Mid-Value,Potential Loyalists
1248,1189,1,"56,7",2,1,1,4,Low-Value,Can't Lose
1249,1531,1,"7,85",1,1,1,3,Low-Value,Lost
1250,377,2,"273,6",4,1,1,6,Mid-Value,Potential Loyalists
1251,626,3,"597,15",4,1,1,6,Mid-Value,Potential Loyalists
1252,483,3,"115,7",4,1,1,6,Mid-Value,Potential Loyalists
1253,252,4,"155,35",5,1,1,7,Mid-Value,Potential Loyalists
1255,1399,1,"22,75",2,1,1,4,Low-Value,Can't Lose
1259,616,4,"633,35",4,1,1,6,Mid-Value,Potential Loyalists
1260,485,5,"205,4",4,1,1,6,Mid-Value,Potential Loyalists
1263,60,7,"216,05",5,2,1,8,High-Value,Potential Loyalists
1264,23,5,"303,29999999999995",5,1,1,7,Mid-Value,Potential Loyalists
1265,452,3,"50,8",4,1,1,6,Mid-Value,Potential Loyalists
1267,714,5,"270,5",4,1,1,6,Mid-Value,Potential Loyalists
1268,1045,3,"92,1",3,1,1,5,Low-Value,At Risk Customers
1269,858,2,"65,6",3,1,1,5,Low-Value,At Risk Customers
1270,80,8,"619,85",5,2,1,8,High-Value,Potential Loyalists
1272,365,2,"24,9",5,1,1,7,Mid-Value,Potential Loyalists
1274,562,3,"185,5",4,1,1,6,Mid-Value,Potential Loyalists
1278,515,4,"310,0",4,1,1,6,Mid-Value,Potential Loyalists
1281,407,1,"42,75",4,1,1,6,Mid-Value,Potential Loyalists
1286,1133,1,"32,05",2,1,1,4,Low-Value,Can't Lose
1287,43,8,"309,4",5,2,1,8,High-Value,Potential Loyalists
1288,1433,1,"199,0",2,1,1,4,Low-Value,Can't Lose
1289,27,2,"29,5",5,1,1,7,Mid-Value,Potential Loyalists
1290,1519,1,"52,25",1,1,1,3,Low-Value,Lost
1291,64,4,"295,7",5,1,1,7,Mid-Value,Potential Loyalists
1294,893,1,"88,05000000000001",3,1,1,5,Low-Value,At Risk Customers
1295,633,3,"119,85",4,1,1,6,Mid-Value,Potential Loyalists
1297,1158,1,"105,5",2,1,1,4,Low-Value,Can't Lose
1298,39,2,"119,7",5,1,1,7,Mid-Value,Potential Loyalists
1299,1468,2,"165,2",1,1,1,3,Low-Value,Lost
1300,370,6,"230,25000000000003",4,1,1,6,Mid-Value,Potential Loyalists
1302,25,3,"133,0",5,1,1,7,Mid-Value,Potential Loyalists
1303,18,5,"221,0",5,1,1,7,Mid-Value,Potential Loyalists
1304,893,1,"42,9",3,1,1,5,Low-Value,At Risk Customers
1305,1231,2,"156,9",2,1,1,4,Low-Value,Can't Lose
1309,421,4,"279,85",4,1,1,6,Mid-Value,Potential Loyalists
1311,329,4,"194,05",5,1,1,7,Mid-Value,Potential Loyalists
1312,4,7,"468,85",5,2,1,8,High-Value,Potential Loyalists
1314,8,5,"315,85",5,1,1,7,Mid-Value,Potential Loyalists
1315,1277,1,"45,5",2,1,1,4,Low-Value,Can't Lose
1316,45,7,"838,75",5,2,2,9,High-Value,Champions
1320,384,7,"656,0",4,2,1,7,Mid-Value,Potential Loyalists
1321,1221,1,"43,4",2,1,1,4,Low-Value,Can't Lose
1323,365,1,"31,8",5,1,1,7,Mid-Value,Potential Loyalists
1325,220,3,"113,15",5,1,1,7,Mid-Value,Potential Loyalists
1326,1157,1,"17,8",2,1,1,4,Low-Value,Can't Lose
1327,684,3,"64,25",4,1,1,6,Mid-Value,Potential Loyalists
1329,1076,1,"15,4",3,1,1,5,Low-Value,At Risk Customers
1331,29,3,"78,6",5,1,1,7,Mid-Value,Potential Loyalists
1334,67,4,"169,2",5,1,1,7,Mid-Value,Potential Loyalists
1336,1204,1,"31,8",2,1,1,4,Low-Value,Can't Lose
1337,314,3,"712,2",5,1,2,8,High-Value,Potential Loyalists
1339,147,4,"180,76",5,1,1,7,Mid-Value,Potential Loyalists
1342,26,7,"574,7",5,2,1,8,High-Value,Potential Loyalists
1343,420,7,"480,45",4,2,1,7,Mid-Value,Potential Loyalists
1345,805,2,"159,6",3,1,1,5,Low-Value,At Risk Customers
1347,162,2,"278,5",5,1,1,7,Mid-Value,Potential Loyalists
1349,900,3,"156,9",3,1,1,5,Low-Value,At Risk Customers
1350,945,2,"581,0500000000001",3,1,1,5,Low-Value,At Risk Customers
1351,10,2,"95,7",5,1,1,7,Mid-Value,Potential Loyalists
1354,180,2,"347,4",5,1,1,7,Mid-Value,Potential Loyalists
1355,514,2,"108,9",4,1,1,6,Mid-Value,Potential Loyalists
1356,206,1,"22,8",5,1,1,7,Mid-Value,Potential Loyalists
1357,1139,5,"775,1",2,1,2,5,Low-Value,At Risk Customers
1360,123,1,"34,2",5,1,1,7,Mid-Value,Potential Loyalists
1361,13,2,"344,04999999999995",5,1,1,7,Mid-Value,Potential Loyalists
1364,880,1,"11,9",3,1,1,5,Low-Value,At Risk Customers
1365,189,3,"230,5",5,1,1,7,Mid-Value,Potential Loyalists
1366,872,2,"138,4",3,1,1,5,Low-Value,At Risk Customers
1367,17,8,"445,2",5,2,1,8,High-Value,Potential Loyalists
1369,348,6,"295,45",5,1,1,7,Mid-Value,Potential Loyalists
1370,1271,1,"28,4",2,1,1,4,Low-Value,Can't Lose
1371,1673,1,"17,7",1,1,1,3,Low-Value,Lost
1372,1501,1,"102,45",1,1,1,3,Low-Value,Lost
1373,1566,1,"13,4",1,1,1,3,Low-Value,Lost
1374,69,2,"72,0",5,1,1,7,Mid-Value,Potential Loyalists
1375,31,3,"171,1",5,1,1,7,Mid-Value,Potential Loyalists
1376,383,4,"72,2",4,1,1,6,Mid-Value,Potential Loyalists
1377,18,1,"13,5",5,1,1,7,Mid-Value,Potential Loyalists
1378,40,6,"353,35",5,1,1,7,Mid-Value,Potential Loyalists
1379,1578,2,"109,7",1,1,1,3,Low-Value,Lost
1380,416,2,"49,1",4,1,1,6,Mid-Value,Potential Loyalists
1381,80,5,"157,7",5,1,1,7,Mid-Value,Potential Loyalists
1383,857,4,"360,95000000000005",3,1,1,5,Low-Value,At Risk Customers
1384,384,5,"100,4",4,1,1,6,Mid-Value,Potential Loyalists
1385,273,1,"25,7",5,1,1,7,Mid-Value,Potential Loyalists
1386,36,2,"212,85000000000002",5,1,1,7,Mid-Value,Potential Loyalists
1387,534,4,"159,70000000000002",4,1,1,6,Mid-Value,Potential Loyalists
1388,213,6,"767,85",5,1,2,8,High-Value,Potential Loyalists
1389,30,4,"55,55",5,1,1,7,Mid-Value,Potential Loyalists
1391,4,9,"1123,5",5,2,2,9,High-Value,Champions
1393,242,5,"518,6999999999999",5,1,1,7,Mid-Value,Potential Loyalists
1394,254,4,"244,35",5,1,1,7,Mid-Value,Potential Loyalists
1395,11,4,"252,89999999999998",5,1,1,7,Mid-Value,Potential Loyalists
1396,874,1,"33,3",3,1,1,5,Low-Value,At Risk Customers
1397,129,3,"196,65",5,1,1,7,Mid-Value,Potential Loyalists
1399,208,2,"197,64999999999998",5,1,1,7,Mid-Value,Potential Loyalists
1401,565,2,"122,69999999999999",4,1,1,6,Mid-Value,Potential Loyalists
1402,1,1,"60,7",5,1,1,7,Mid-Value,Potential Loyalists
1404,728,2,"65,05000000000001",4,1,1,6,Mid-Value,Potential Loyalists
1405,876,1,"10,2",3,1,1,5,Low-Value,At Risk Customers
1406,1151,2,"92,9",2,1,1,4,Low-Value,Can't Lose
1408,327,4,"184,65",5,1,1,7,Mid-Value,Potential Loyalists
1410,1340,2,"106,7",2,1,1,4,Low-Value,Can't Lose
1411,396,4,"436,2",4,1,1,6,Mid-Value,Potential Loyalists
1412,1224,3,"271,0",2,1,1,4,Low-Value,Can't Lose
1413,9,6,"153,55",5,1,1,7,Mid-Value,Potential Loyalists
1414,133,5,"552,8",5,1,1,7,Mid-Value,Potential Loyalists
1417,1698,1,"70,05",1,1,1,3,Low-Value,Lost
1419,670,6,"485,7",4,1,1,6,Mid-Value,Potential Loyalists
1421,766,5,"302,0",3,1,1,5,Low-Value,At Risk Customers
1422,358,5,"207,75",5,1,1,7,Mid-Value,Potential Loyalists
1424,255,3,"265,6",5,1,1,7,Mid-Value,Potential Loyalists
1425,192,4,"147,15",5,1,1,7,Mid-Value,Potential Loyalists
1426,369,3,"193,6",4,1,1,6,Mid-Value,Potential Loyalists
1428,105,20,"1060,85",5,4,2,11,High-Value,Champions
1430,208,3,"122,85000000000001",5,1,1,7,Mid-Value,Potential Loyalists
1432,569,2,"175,65",4,1,1,6,Mid-Value,Potential Loyalists
1434,353,3,"122,3",5,1,1,7,Mid-Value,Potential Loyalists
1435,374,2,"64,35",4,1,1,6,Mid-Value,Potential Loyalists
1436,15,12,"463,8",5,3,1,9,High-Value,Champions
1437,796,5,"920,85",3,1,2,6,Mid-Value,Potential Loyalists
1438,99,2,"147,6",5,1,1,7,Mid-Value,Potential Loyalists
1439,452,3,"148,79999999999998",4,1,1,6,Mid-Value,Potential Loyalists
1440,14,4,"492,3",5,1,1,7,Mid-Value,Potential Loyalists
1442,1237,3,"84,8",2,1,1,4,Low-Value,Can't Lose
1443,273,1,"194,2",5,1,1,7,Mid-Value,Potential Loyalists
1444,558,4,"282,8",4,1,1,6,Mid-Value,Potential Loyalists
1445,122,3,"39,650000000000006",5,1,1,7,Mid-Value,Potential Loyalists
1447,1143,3,"186,4",2,1,1,4,Low-Value,Can't Lose
1448,647,2,"29,0",4,1,1,6,Mid-Value,Potential Loyalists
1451,130,1,"34,5",5,1,1,7,Mid-Value,Potential Loyalists
1452,659,3,"75,85",4,1,1,6,Mid-Value,Potential Loyalists
1453,515,3,"81,39999999999999",4,1,1,6,Mid-Value,Potential Loyalists
1455,235,10,"326,15000000000003",5,2,1,8,High-Value,Potential Loyalists
1457,326,9,"646,75",5,2,1,8,High-Value,Potential Loyalists
1458,199,2,"37,85",5,1,1,7,Mid-Value,Potential Loyalists
1459,1626,1,"46,3",1,1,1,3,Low-Value,Lost
1460,187,3,"457,9",5,1,1,7,Mid-Value,Potential Loyalists
1463,270,3,"403,2",5,1,1,7,Mid-Value,Potential Loyalists
1464,1233,4,"228,0",2,1,1,4,Low-Value,Can't Lose
1465,1169,4,"195,54999999999998",2,1,1,4,Low-Value,Can't Lose
1466,1111,6,"747,7",2,1,2,5,Low-Value,At Risk Customers
1467,484,4,"455,65000000000003",4,1,1,6,Mid-Value,Potential Loyalists
1468,1142,3,"134,10000000000002",2,1,1,4,Low-Value,Can't Lose
1470,29,7,"349,45",5,2,1,8,High-Value,Potential Loyalists
1471,420,3,"204,55",4,1,1,6,Mid-Value,Potential Loyalists
1472,963,1,"26,95",3,1,1,5,Low-Value,At Risk Customers
1475,1156,6,"142,8",2,1,1,4,Low-Value,Can't Lose
1476,718,1,"11,2",4,1,1,6,Mid-Value,Potential Loyalists
1477,846,1,"81,3",3,1,1,5,Low-Value,At Risk Customers
1478,1523,3,"135,3",1,1,1,3,Low-Value,Lost
1480,34,4,"106,55",5,1,1,7,Mid-Value,Potential Loyalists
1481,130,9,"413,95",5,2,1,8,High-Value,Potential Loyalists
1482,347,6,"358,15",5,1,1,7,Mid-Value,Potential Loyalists
1483,9,2,"58,800000000000004",5,1,1,7,Mid-Value,Potential Loyalists
1486,561,3,"174,1",4,1,1,6,Mid-Value,Potential Loyalists
1490,413,1,"16,75",4,1,1,6,Mid-Value,Potential Loyalists
1492,608,4,"147,10000000000002",4,1,1,6,Mid-Value,Potential Loyalists
1494,488,4,"1218,3",4,1,2,7,Mid-Value,Potential Loyalists
1495,943,4,"335,65",3,1,1,5,Low-Value,At Risk Customers
1496,1630,1,"112,85",1,1,1,3,Low-Value,Lost
1498,911,1,"7,0",3,1,1,5,Low-Value,At Risk Customers
1500,1035,3,"78,1",3,1,1,5,Low-Value,At Risk Customers
1501,547,5,"315,54999999999995",4,1,1,6,Mid-Value,Potential Loyalists
1502,812,1,"4,75",3,1,1,5,Low-Value,At Risk Customers
1503,1481,3,"251,34999999999997",1,1,1,3,Low-Value,Lost
1504,619,2,"32,3",4,1,1,6,Mid-Value,Potential Loyalists
1505,1144,3,"327,3",2,1,1,4,Low-Value,Can't Lose
1509,242,6,"187,39999999999998",5,1,1,7,Mid-Value,Potential Loyalists
1510,71,4,"109,30000000000001",5,1,1,7,Mid-Value,Potential Loyalists
1515,270,1,"47,0",5,1,1,7,Mid-Value,Potential Loyalists
1517,219,12,"754,95",5,3,2,10,High-Value,Champions
1518,1167,1,"36,7",2,1,1,4,Low-Value,Can't Lose
1520,752,5,"330,6",3,1,1,5,Low-Value,At Risk Customers
1521,255,2,"104,15",5,1,1,7,Mid-Value,Potential Loyalists
1522,101,7,"314,65",5,2,1,8,High-Value,Potential Loyalists
1523,1197,1,"60,4",2,1,1,4,Low-Value,Can't Lose
1524,565,7,"362,35",4,2,1,7,Mid-Value,Potential Loyalists
1525,804,7,"474,65000000000003",3,2,1,6,Mid-Value,Potential Loyalists
1526,577,7,"508,9",4,2,1,7,Mid-Value,Potential Loyalists
1527,705,4,"168,75",4,1,1,6,Mid-Value,Potential Loyalists
1529,331,3,"39,599999999999994",5,1,1,7,Mid-Value,Potential Loyalists
1530,7,11,"603,15",5,2,1,8,High-Value,Potential Loyalists
1531,1390,1,"18,0",2,1,1,4,Low-Value,Can't Lose
1532,354,1,"12,3",5,1,1,7,Mid-Value,Potential Loyalists
1535,110,2,"28,599999999999998",5,1,1,7,Mid-Value,Potential Loyalists
1536,526,7,"381,45",4,2,1,7,Mid-Value,Potential Loyalists
1537,1538,1,"48,45",1,1,1,3,Low-Value,Lost
1538,1063,2,"42,849999999999994",3,1,1,5,Low-Value,At Risk Customers
1539,363,5,"251,1",5,1,1,7,Mid-Value,Potential Loyalists
1540,117,5,"212,1",5,1,1,7,Mid-Value,Potential Loyalists
1541,1173,2,"69,35",2,1,1,4,Low-Value,Can't Lose
1542,1004,1,"36,5",3,1,1,5,Low-Value,At Risk Customers
1543,487,10,"804,3000000000001",4,2,2,8,High-Value,Potential Loyalists
1544,220,3,"85,0",5,1,1,7,Mid-Value,Potential Loyalists
1545,417,4,"31,85",4,1,1,6,Mid-Value,Potential Loyalists
1547,420,1,"170,7",4,1,1,6,Mid-Value,Potential Loyalists
1548,416,1,"76,3",4,1,1,6,Mid-Value,Potential Loyalists
1549,1119,1,"36,9",2,1,1,4,Low-Value,Can't Lose
1553,549,4,"156,60000000000002",4,1,1,6,Mid-Value,Potential Loyalists
1554,1245,2,"107,6",2,1,1,4,Low-Value,Can't Lose
1557,15,18,"921,9",5,4,2,11,High-Value,Champions
1558,1450,1,"2,9",2,1,1,4,Low-Value,Can't Lose
1562,124,4,"151,45",5,1,1,7,Mid-Value,Potential Loyalists
1563,1278,1,"55,9",2,1,1,4,Low-Value,Can't Lose
1564,159,2,"99,3",5,1,1,7,Mid-Value,Potential Loyalists
1568,1410,1,"63,8",2,1,1,4,Low-Value,Can't Lose
1570,782,1,"34,1",3,1,1,5,Low-Value,At Risk Customers
1574,277,2,"177,7",5,1,1,7,Mid-Value,Potential Loyalists
1575,102,7,"328,95000000000005",5,2,1,8,High-Value,Potential Loyalists
1577,10,6,"288,95",5,1,1,7,Mid-Value,Potential Loyalists
1580,19,6,"468,75",5,1,1,7,Mid-Value,Potential Loyalists
1581,14,4,"211,9",5,1,1,7,Mid-Value,Potential Loyalists
1582,108,6,"752,0",5,1,2,8,High-Value,Potential Loyalists
1584,634,3,"69,0",4,1,1,6,Mid-Value,Potential Loyalists
1585,216,6,"355,6",5,1,1,7,Mid-Value,Potential Loyalists
1587,426,6,"314,25",4,1,1,6,Mid-Value,Potential Loyalists
1588,186,3,"173,20000000000002",5,1,1,7,Mid-Value,Potential Loyalists
1589,204,2,"152,35000000000002",5,1,1,7,Mid-Value,Potential Loyalists
1590,1573,2,"114,6",1,1,1,3,Low-Value,Lost
1591,270,2,"38,9",5,1,1,7,Mid-Value,Potential Loyalists
1592,56,9,"1186,1499999999999",5,2,2,9,High-Value,Champions
1593,389,1,"53,2",4,1,1,6,Mid-Value,Potential Loyalists
1594,1374,3,"80,6",2,1,1,4,Low-Value,Can't Lose
1597,1132,2,"55,8",2,1,1,4,Low-Value,Can't Lose
1599,932,3,"197,8",3,1,1,5,Low-Value,At Risk Customers
1600,974,1,"40,75",3,1,1,5,Low-Value,At Risk Customers
1601,732,4,"162,6",3,1,1,5,Low-Value,At Risk Customers
1602,1100,1,"48,7",2,1,1,4,Low-Value,Can't Lose
1605,33,3,"457,8",5,1,1,7,Mid-Value,Potential Loyalists
1606,57,9,"840,2",5,2,2,9,High-Value,Champions
1607,97,1,"17,05",5,1,1,7,Mid-Value,Potential Loyalists
1608,778,2,"771,65",3,1,2,6,Mid-Value,Potential Loyalists
1609,482,2,"121,80000000000001",4,1,1,6,Mid-Value,Potential Loyalists
1610,173,6,"341,55",5,1,1,7,Mid-Value,Potential Loyalists
1612,437,2,"57,3",4,1,1,6,Mid-Value,Potential Loyalists
1614,718,1,"95,5",4,1,1,6,Mid-Value,Potential Loyalists
1617,274,2,"36,55",5,1,1,7,Mid-Value,Potential Loyalists
1619,575,4,"222,64999999999998",4,1,1,6,Mid-Value,Potential Loyalists
1620,812,1,"20,45",3,1,1,5,Low-Value,At Risk Customers
1622,459,2,"47,699999999999996",4,1,1,6,Mid-Value,Potential Loyalists
1623,1605,1,"111,5",1,1,1,3,Low-Value,Lost
1624,1300,2,"77,55000000000001",2,1,1,4,Low-Value,Can't Lose
1625,150,5,"194,95000000000002",5,1,1,7,Mid-Value,Potential Loyalists
1626,67,8,"517,05",5,2,1,8,High-Value,Potential Loyalists
1627,1636,1,"153,8",1,1,1,3,Low-Value,Lost
1628,13,4,"81,5",5,1,1,7,Mid-Value,Potential Loyalists
1629,52,8,"742,8",5,2,2,9,High-Value,Champions
1631,375,4,"259,9",4,1,1,6,Mid-Value,Potential Loyalists
1632,294,1,"39,25",5,1,1,7,Mid-Value,Potential Loyalists
1634,1224,5,"176,9",2,1,1,4,Low-Value,Can't Lose
1635,318,4,"311,8",5,1,1,7,Mid-Value,Potential Loyalists
1637,243,3,"143,0",5,1,1,7,Mid-Value,Potential Loyalists
1640,45,4,"140,15",5,1,1,7,Mid-Value,Potential Loyalists
1642,157,5,"185,55",5,1,1,7,Mid-Value,Potential Loyalists
1643,550,5,"590,65",4,1,1,6,Mid-Value,Potential Loyalists
1644,208,2,"126,75",5,1,1,7,Mid-Value,Potential Loyalists
1645,278,4,"286,7",5,1,1,7,Mid-Value,Potential Loyalists
1646,1665,1,"3,2",1,1,1,3,Low-Value,Lost
1647,142,3,"106,9",5,1,1,7,Mid-Value,Potential Loyalists
1648,455,2,"92,05000000000001",4,1,1,6,Mid-Value,Potential Loyalists
1649,829,3,"263,65",3,1,1,5,Low-Value,At Risk Customers
1650,1067,1,"18,4",3,1,1,5,Low-Value,At Risk Customers
1651,1093,1,"42,3",3,1,1,5,Low-Value,At Risk Customers
1652,1791,1,"26,8",1,1,1,3,Low-Value,Lost
1653,1804,2,"25,0",1,1,1,3,Low-Value,Lost
1656,488,2,"32,95",4,1,1,6,Mid-Value,Potential Loyalists
1657,594,1,"107,85000000000001",4,1,1,6,Mid-Value,Potential Loyalists
1658,1139,5,"164,75",2,1,1,4,Low-Value,Can't Lose
1659,468,3,"132,1",4,1,1,6,Mid-Value,Potential Loyalists
1665,966,1,"58,55",3,1,1,5,Low-Value,At Risk Customers
1667,1028,2,"96,1",3,1,1,5,Low-Value,At Risk Customers
1669,266,7,"384,95",5,2,1,8,High-Value,Potential Loyalists
1670,11,5,"244,9",5,1,1,7,Mid-Value,Potential Loyalists
1671,635,1,"57,05",4,1,1,6,Mid-Value,Potential Loyalists
1672,1642,2,"29,6",1,1,1,3,Low-Value,Lost
1675,789,2,"45,6",3,1,1,5,Low-Value,At Risk Customers
1678,377,3,"114,55",4,1,1,6,Mid-Value,Potential Loyalists
1680,338,4,"53,4",5,1,1,7,Mid-Value,Potential Loyalists
1686,1628,1,"52,0",1,1,1,3,Low-Value,Lost
1687,192,1,"42,9",5,1,1,7,Mid-Value,Potential Loyalists
1691,15,3,"159,1",5,1,1,7,Mid-Value,Potential Loyalists
1692,1295,1,"125,2",2,1,1,4,Low-Value,Can't Lose
1693,55,3,"152,65",5,1,1,7,Mid-Value,Potential Loyalists
1694,38,7,"949,65",5,2,2,9,High-Value,Champions
1698,303,4,"593,6999999999999",5,1,1,7,Mid-Value,Potential Loyalists
1700,284,3,"1031,25",5,1,2,8,High-Value,Potential Loyalists
1702,215,7,"432,35",5,2,1,8,High-Value,Potential Loyalists
1703,712,4,"182,3",4,1,1,6,Mid-Value,Potential Loyalists
1704,91,4,"372,59999999999997",5,1,1,7,Mid-Value,Potential Loyalists
1707,806,2,"68,7",3,1,1,5,Low-Value,At Risk Customers
1708,861,3,"195,3",3,1,1,5,Low-Value,At Risk Customers
1710,1307,1,"305,2",2,1,1,4,Low-Value,Can't Lose
1713,52,4,"285,5",5,1,1,7,Mid-Value,Potential Loyalists
1715,1083,1,"15,35",3,1,1,5,Low-Value,At Risk Customers
1718,725,1,"44,9",4,1,1,6,Mid-Value,Potential Loyalists
1719,983,2,"212,55",3,1,1,5,Low-Value,At Risk Customers
1723,786,3,"182,75",3,1,1,5,Low-Value,At Risk Customers
1724,165,4,"141,55",5,1,1,7,Mid-Value,Potential Loyalists
1726,295,3,"44,95",5,1,1,7,Mid-Value,Potential Loyalists
1727,606,1,"628,3499999999999",4,1,1,6,Mid-Value,Potential Loyalists
1728,4,4,"264,25",5,1,1,7,Mid-Value,Potential Loyalists
1729,1152,3,"379,20000000000005",2,1,1,4,Low-Value,Can't Lose
1731,822,3,"109,1",3,1,1,5,Low-Value,At Risk Customers
1735,3,4,"115,1",5,1,1,7,Mid-Value,Potential Loyalists
1737,3,2,"174,05",5,1,1,7,Mid-Value,Potential Loyalists
1739,755,2,"93,15",3,1,1,5,Low-Value,At Risk Customers
1740,252,4,"238,40000000000003",5,1,1,7,Mid-Value,Potential Loyalists
1743,608,1,"84,6",4,1,1,6,Mid-Value,Potential Loyalists
1744,1222,2,"107,55",2,1,1,4,Low-Value,Can't Lose
1745,34,3,"131,6",5,1,1,7,Mid-Value,Potential Loyalists
1746,322,3,"203,65",5,1,1,7,Mid-Value,Potential Loyalists
1747,144,2,"140,25",5,1,1,7,Mid-Value,Potential Loyalists
1748,735,6,"167,29999999999998",3,1,1,5,Low-Value,At Risk Customers
1749,773,5,"724,6",3,1,2,6,Mid-Value,Potential Loyalists
1750,363,10,"607,0",5,2,1,8,High-Value,Potential Loyalists
1751,3,7,"151,1",5,2,1,8,High-Value,Potential Loyalists
1754,806,4,"196,05",3,1,1,5,Low-Value,At Risk Customers
1756,315,4,"338,25",5,1,1,7,Mid-Value,Potential Loyalists
1758,339,2,"62,550000000000004",5,1,1,7,Mid-Value,Potential Loyalists
1759,406,3,"801,15",4,1,2,7,Mid-Value,Potential Loyalists
1762,951,1,"14,95",3,1,1,5,Low-Value,At Risk Customers
1763,249,4,"164,65",5,1,1,7,Mid-Value,Potential Loyalists
1767,98,8,"1396,75",5,2,3,10,High-Value,Champions
1768,268,3,"257,29999999999995",5,1,1,7,Mid-Value,Potential Loyalists
1769,59,3,"49,95",5,1,1,7,Mid-Value,Potential Loyalists
1770,95,11,"475,95",5,2,1,8,High-Value,Potential Loyalists
1772,1064,4,"83,95",3,1,1,5,Low-Value,At Risk Customers
1774,1438,1,"33,25",2,1,1,4,Low-Value,Can't Lose
1775,1072,1,"47,65",3,1,1,5,Low-Value,At Risk Customers
1776,7,7,"861,45",5,2,2,9,High-Value,Champions
1777,223,3,"111,4",5,1,1,7,Mid-Value,Potential Loyalists
1778,386,5,"337,25",4,1,1,6,Mid-Value,Potential Loyalists
1781,46,8,"450,9",5,2,1,8,High-Value,Potential Loyalists
1782,77,5,"148,95",5,1,1,7,Mid-Value,Potential Loyalists
1785,712,1,"5,75",4,1,1,6,Mid-Value,Potential Loyalists
1787,442,1,"50,25",4,1,1,6,Mid-Value,Potential Loyalists
1788,1637,1,"221,25",1,1,1,3,Low-Value,Lost
1791,448,12,"698,9499999999999",4,3,2,9,High-Value,Champions
1792,43,5,"226,25",5,1,1,7,Mid-Value,Potential Loyalists
1795,382,2,"220,05",4,1,1,6,Mid-Value,Potential Loyalists
1796,241,5,"206,09999999999997",5,1,1,7,Mid-Value,Potential Loyalists
1800,47,3,"60,15",5,1,1,7,Mid-Value,Potential Loyalists
1801,873,1,"71,1",3,1,1,5,Low-Value,At Risk Customers
1803,23,4,"113,85",5,1,1,7,Mid-Value,Potential Loyalists
1805,106,3,"137,95",5,1,1,7,Mid-Value,Potential Loyalists
1806,369,4,"101,2",4,1,1,6,Mid-Value,Potential Loyalists
1808,165,4,"457,04999999999995",5,1,1,7,Mid-Value,Potential Loyalists
1809,1799,1,"95,1",1,1,1,3,Low-Value,Lost
1810,915,2,"398,9",3,1,1,5,Low-Value,At Risk Customers
1811,1750,1,"2,85",1,1,1,3,Low-Value,Lost
1813,1100,2,"222,7",2,1,1,4,Low-Value,Can't Lose
1815,123,6,"782,8",5,1,2,8,High-Value,Potential Loyalists
1816,146,2,"74,5",5,1,1,7,Mid-Value,Potential Loyalists
1817,211,2,"165,0",5,1,1,7,Mid-Value,Potential Loyalists
1818,131,2,"262,5",5,1,1,7,Mid-Value,Potential Loyalists
1819,1350,1,"49,6",2,1,1,4,Low-Value,Can't Lose
1823,172,3,"76,45",5,1,1,7,Mid-Value,Potential Loyalists
1824,444,7,"250,7",4,2,1,7,Mid-Value,Potential Loyalists
1825,1703,1,"20,1",1,1,1,3,Low-Value,Lost
1827,269,3,"86,55",5,1,1,7,Mid-Value,Potential Loyalists
1829,695,2,"23,3",4,1,1,6,Mid-Value,Potential Loyalists
1831,672,4,"196,60000000000002",4,1,1,6,Mid-Value,Potential Loyalists
1832,713,1,"15,6",4,1,1,6,Mid-Value,Potential Loyalists
1833,391,3,"111,0",4,1,1,6,Mid-Value,Potential Loyalists
1834,142,7,"234,25",5,2,1,8,High-Value,Potential Loyalists
1835,1390,2,"282,1",2,1,1,4,Low-Value,Can't Lose
1838,374,7,"946,45",4,2,2,8,High-Value,Potential Loyalists
1839,199,1,"22,7",5,1,1,7,Mid-Value,Potential Loyalists
1840,1589,2,"89,5",1,1,1,3,Low-Value,Lost
1842,29,1,"22,8",5,1,1,7,Mid-Value,Potential Loyalists
1844,395,6,"175,9",4,1,1,6,Mid-Value,Potential Loyalists
1845,743,2,"46,9",3,1,1,5,Low-Value,At Risk Customers
1848,771,2,"13,85",3,1,1,5,Low-Value,At Risk Customers
1849,266,2,"68,4",5,1,1,7,Mid-Value,Potential Loyalists
1850,410,6,"251,25",4,1,1,6,Mid-Value,Potential Loyalists
1852,96,5,"371,04999999999995",5,1,1,7,Mid-Value,Potential Loyalists
1853,48,4,"164,8",5,1,1,7,Mid-Value,Potential Loyalists
1854,1594,1,"14,5",1,1,1,3,Low-Value,Lost
1855,403,3,"569,6999999999999",4,1,1,6,Mid-Value,Potential Loyalists
1858,737,1,"58,9",3,1,1,5,Low-Value,At Risk Customers
1859,502,2,"196,95",4,1,1,6,Mid-Value,Potential Loyalists
1861,26,5,"619,25",5,1,1,7,Mid-Value,Potential Loyalists
1862,728,3,"144,9",4,1,1,6,Mid-Value,Potential Loyalists
1863,235,2,"84,80000000000001",5,1,1,7,Mid-Value,Potential Loyalists
1864,524,4,"295,25",4,1,1,6,Mid-Value,Potential Loyalists
1869,1114,1,"149,1",2,1,1,4,Low-Value,Can't Lose
1870,85,7,"348,9",5,2,1,8,High-Value,Potential Loyalists
1871,472,6,"243,15",4,1,1,6,Mid-Value,Potential Loyalists
1872,123,2,"156,64999999999998",5,1,1,7,Mid-Value,Potential Loyalists
1873,368,2,"152,05",4,1,1,6,Mid-Value,Potential Loyalists
1876,526,2,"224,3",4,1,1,6,Mid-Value,Potential Loyalists
1877,407,6,"241,15",4,1,1,6,Mid-Value,Potential Loyalists
1878,845,2,"50,599999999999994",3,1,1,5,Low-Value,At Risk Customers
1879,108,2,"154,35",5,1,1,7,Mid-Value,Potential Loyalists
1881,223,4,"219,4",5,1,1,7,Mid-Value,Potential Loyalists
1883,1258,3,"166,35",2,1,1,4,Low-Value,Can't Lose
1884,741,1,"170,2",3,1,1,5,Low-Value,At Risk Customers
1885,1055,3,"59,45",3,1,1,5,Low-Value,At Risk Customers
1886,629,3,"171,05",4,1,1,6,Mid-Value,Potential Loyalists
1888,48,1,"10,55",5,1,1,7,Mid-Value,Potential Loyalists
1889,825,4,"215,8",3,1,1,5,Low-Value,At Risk Customers
1891,551,4,"186,29999999999998",4,1,1,6,Mid-Value,Potential Loyalists
1892,615,2,"50,0",4,1,1,6,Mid-Value,Potential Loyalists
1893,399,4,"163,05",4,1,1,6,Mid-Value,Potential Loyalists
1894,1328,1,"78,30000000000001",2,1,1,4,Low-Value,Can't Lose
1895,592,1,"58,9",4,1,1,6,Mid-Value,Potential Loyalists
1896,1250,2,"53,150000000000006",2,1,1,4,Low-Value,Can't Lose
1897,38,5,"165,29999999999998",5,1,1,7,Mid-Value,Potential Loyalists
1900,25,3,"147,1",5,1,1,7,Mid-Value,Potential Loyalists
1901,150,2,"74,39999999999999",5,1,1,7,Mid-Value,Potential Loyalists
1904,186,5,"494,55",5,1,1,7,Mid-Value,Potential Loyalists
1905,1032,3,"158,75000000000003",3,1,1,5,Low-Value,At Risk Customers
1906,489,2,"57,5",4,1,1,6,Mid-Value,Potential Loyalists
1907,1276,4,"249,3",2,1,1,4,Low-Value,Can't Lose
1908,517,2,"104,15",4,1,1,6,Mid-Value,Potential Loyalists
1909,85,2,"82,6",5,1,1,7,Mid-Value,Potential Loyalists
1910,1312,3,"155,8",2,1,1,4,Low-Value,Can't Lose
1912,135,4,"235,35",5,1,1,7,Mid-Value,Potential Loyalists
1915,31,2,"84,65",5,1,1,7,Mid-Value,Potential Loyalists
1917,190,6,"816,55",5,1,2,8,High-Value,Potential Loyalists
1918,52,3,"148,8",5,1,1,7,Mid-Value,Potential Loyalists
1919,423,4,"435,55000000000007",4,1,1,6,Mid-Value,Potential Loyalists
1922,5,9,"623,55",5,2,1,8,High-Value,Potential Loyalists
1924,179,2,"106,64999999999999",5,1,1,7,Mid-Value,Potential Loyalists
1925,781,2,"105,19999999999999",3,1,1,5,Low-Value,At Risk Customers
1926,447,6,"227,45",4,1,1,6,Mid-Value,Potential Loyalists
1927,456,3,"159,8",4,1,1,6,Mid-Value,Potential Loyalists
1929,63,2,"517,6",5,1,1,7,Mid-Value,Potential Loyalists
1930,365,6,"1007,25",5,1,2,8,High-Value,Potential Loyalists
1933,189,3,"1300,3",5,1,2,8,High-Value,Potential Loyalists
1934,566,1,"26,6",4,1,1,6,Mid-Value,Potential Loyalists
1935,15,5,"542,8499999999999",5,1,1,7,Mid-Value,Potential Loyalists
1936,61,4,"148,1",5,1,1,7,Mid-Value,Potential Loyalists
1937,419,2,"55,3",4,1,1,6,Mid-Value,Potential Loyalists
1938,446,3,"1310,65",4,1,2,7,Mid-Value,Potential Loyalists
1939,376,5,"595,0999999999999",4,1,1,6,Mid-Value,Potential Loyalists
1940,90,2,"25,15",5,1,1,7,Mid-Value,Potential Loyalists
1942,14,5,"510,29999999999995",5,1,1,7,Mid-Value,Potential Loyalists
1943,1715,2,"92,0",1,1,1,3,Low-Value,Lost
1944,1323,2,"175,15",2,1,1,4,Low-Value,Can't Lose
1945,549,6,"841,85",4,1,2,7,Mid-Value,Potential Loyalists
1946,348,1,"52,3",5,1,1,7,Mid-Value,Potential Loyalists
1947,1604,1,"100,9",1,1,1,3,Low-Value,Lost
1948,482,3,"104,2",4,1,1,6,Mid-Value,Potential Loyalists
1949,18,5,"365,15",5,1,1,7,Mid-Value,Potential Loyalists
1951,49,16,"527,65",5,3,1,9,High-Value,Champions
1953,1425,1,"11,35",2,1,1,4,Low-Value,Can't Lose
1954,439,2,"15,8",4,1,1,6,Mid-Value,Potential Loyalists
1956,1415,1,"38,0",2,1,1,4,Low-Value,Can't Lose
1960,496,4,"95,4",4,1,1,6,Mid-Value,Potential Loyalists
1962,621,3,"184,55",4,1,1,6,Mid-Value,Potential Loyalists
1965,203,6,"463,2",5,1,1,7,Mid-Value,Potential Loyalists
1966,546,4,"1117,15",4,1,2,7,Mid-Value,Potential Loyalists
1967,187,5,"261,65",5,1,1,7,Mid-Value,Potential Loyalists
1969,1480,1,"61,8",1,1,1,3,Low-Value,Lost
1971,55,3,"91,15",5,1,1,7,Mid-Value,Potential Loyalists
1974,153,8,"421,5",5,2,1,8,High-Value,Potential Loyalists
1975,1566,1,"19,75",1,1,1,3,Low-Value,Lost
1976,738,2,"63,15",3,1,1,5,Low-Value,At Risk Customers
1980,271,9,"1327,3",5,2,3,10,High-Value,Champions
1982,810,1,"113,45",3,1,1,5,Low-Value,At Risk Customers
1983,778,5,"360,2",3,1,1,5,Low-Value,At Risk Customers
1984,384,1,"63,9",4,1,1,6,Mid-Value,Potential Loyalists
1985,393,4,"573,65",4,1,1,6,Mid-Value,Potential Loyalists
1986,480,2,"75,5",4,1,1,6,Mid-Value,Potential Loyalists
1989,429,4,"165,05",4,1,1,6,Mid-Value,Potential Loyalists
1990,487,1,"46,9",4,1,1,6,Mid-Value,Potential Loyalists
1991,1100,1,"42,0",2,1,1,4,Low-Value,Can't Lose
1992,560,1,"148,35000000000002",4,1,1,6,Mid-Value,Potential Loyalists
1993,36,7,"431,35",5,2,1,8,High-Value,Potential Loyalists
1994,1748,1,"8,75",1,1,1,3,Low-Value,Lost
1997,784,6,"173,45",3,1,1,5,Low-Value,At Risk Customers
1998,780,4,"87,65",3,1,1,5,Low-Value,At Risk Customers
1999,521,2,"208,60000000000002",4,1,1,6,Mid-Value,Potential Loyalists
2004,76,6,"535,85",5,1,1,7,Mid-Value,Potential Loyalists
2006,59,9,"529,9",5,2,1,8,High-Value,Potential Loyalists
2007,361,3,"29,450000000000003",5,1,1,7,Mid-Value,Potential Loyalists
2012,110,2,"80,9",5,1,1,7,Mid-Value,Potential Loyalists
2013,319,5,"189,25",5,1,1,7,Mid-Value,Potential Loyalists
2014,367,3,"552,65",4,1,1,6,Mid-Value,Potential Loyalists
2015,1560,2,"145,65",1,1,1,3,Low-Value,Lost
2017,663,2,"92,85",4,1,1,6,Mid-Value,Potential Loyalists
2019,495,4,"164,8",4,1,1,6,Mid-Value,Potential Loyalists
2020,1120,3,"206,85",2,1,1,4,Low-Value,Can't Lose
2021,522,2,"59,65",4,1,1,6,Mid-Value,Potential Loyalists
2022,55,3,"138,5",5,1,1,7,Mid-Value,Potential Loyalists
2024,38,1,"17,25",5,1,1,7,Mid-Value,Potential Loyalists
2025,355,2,"52,4",5,1,1,7,Mid-Value,Potential Loyalists
2026,88,4,"290,95",5,1,1,7,Mid-Value,Potential Loyalists
2027,147,2,"120,1",5,1,1,7,Mid-Value,Potential Loyalists
2028,382,5,"403,29999999999995",4,1,1,6,Mid-Value,Potential Loyalists
2029,588,3,"243,64999999999998",4,1,1,6,Mid-Value,Potential Loyalists
2031,5,10,"1073,6000000000001",5,2,2,9,High-Value,Champions
2033,1692,2,"67,15",1,1,1,3,Low-Value,Lost
2034,1483,2,"296,3",1,1,1,3,Low-Value,Lost
2036,8,5,"334,45",5,1,1,7,Mid-Value,Potential Loyalists
2037,801,9,"652,9499999999999",3,2,1,6,Mid-Value,Potential Loyalists
2038,449,5,"287,65",4,1,1,6,Mid-Value,Potential Loyalists
2040,266,3,"47,75",5,1,1,7,Mid-Value,Potential Loyalists
2041,712,6,"345,25",4,1,1,6,Mid-Value,Potential Loyalists
2042,672,4,"285,7",4,1,1,6,Mid-Value,Potential Loyalists
2044,1721,1,"49,55",1,1,1,3,Low-Value,Lost
2045,329,4,"340,15",5,1,1,7,Mid-Value,Potential Loyalists
2047,498,6,"592,3499999999999",4,1,1,6,Mid-Value,Potential Loyalists
2049,4,2,"166,7",5,1,1,7,Mid-Value,Potential Loyalists
2050,12,7,"473,8",5,2,1,8,High-Value,Potential Loyalists
2051,529,6,"345,0",4,1,1,6,Mid-Value,Potential Loyalists
2055,1256,2,"71,95",2,1,1,4,Low-Value,Can't Lose
2057,999,1,"169,7",3,1,1,5,Low-Value,At Risk Customers
2060,138,8,"592,8",5,2,1,8,High-Value,Potential Loyalists
2063,81,8,"374,15",5,2,1,8,High-Value,Potential Loyalists
2064,994,6,"397,4",3,1,1,5,Low-Value,At Risk Customers
2065,24,5,"714,25",5,1,2,8,High-Value,Potential Loyalists
2070,793,8,"566,4",3,2,1,6,Mid-Value,Potential Loyalists
2071,399,4,"229,1",4,1,1,6,Mid-Value,Potential Loyalists
2073,604,2,"260,70000000000005",4,1,1,6,Mid-Value,Potential Loyalists
2075,1565,2,"114,9",1,1,1,3,Low-Value,Lost
2076,1135,1,"2,9",2,1,1,4,Low-Value,Can't Lose
2078,143,2,"312,9",5,1,1,7,Mid-Value,Potential Loyalists
2079,1455,1,"0,6",2,1,1,4,Low-Value,Can't Lose
2081,171,9,"743,35",5,2,2,9,High-Value,Champions
2083,1050,1,"17,3",3,1,1,5,Low-Value,At Risk Customers
2084,611,1,"9,35",4,1,1,6,Mid-Value,Potential Loyalists
2085,55,5,"185,35",5,1,1,7,Mid-Value,Potential Loyalists
2086,11,7,"437,4",5,2,1,8,High-Value,Potential Loyalists
2088,772,1,"18,9",3,1,1,5,Low-Value,At Risk Customers
2089,1223,4,"924,25",2,1,2,5,Low-Value,At Risk Customers
2090,239,6,"176,55",5,1,1,7,Mid-Value,Potential Loyalists
2091,182,3,"53,0",5,1,1,7,Mid-Value,Potential Loyalists
2092,1619,1,"31,4",1,1,1,3,Low-Value,Lost
2093,7,4,"407,3",5,1,1,7,Mid-Value,Potential Loyalists
2094,766,4,"134,1",3,1,1,5,Low-Value,At Risk Customers
2096,1247,1,"94,9",2,1,1,4,Low-Value,Can't Lose
2099,805,4,"214,15",3,1,1,5,Low-Value,At Risk Customers
2101,1703,1,"91,5",1,1,1,3,Low-Value,Lost
2103,20,2,"83,66",5,1,1,7,Mid-Value,Potential Loyalists
2105,609,3,"140,1",4,1,1,6,Mid-Value,Potential Loyalists
2106,214,4,"270,2",5,1,1,7,Mid-Value,Potential Loyalists
2107,3,9,"1270,75",5,2,2,9,High-Value,Champions
2108,1504,2,"74,1",1,1,1,3,Low-Value,Lost
2109,46,8,"266,7",5,2,1,8,High-Value,Potential Loyalists
2111,495,4,"200,8",4,1,1,6,Mid-Value,Potential Loyalists
2113,324,2,"56,75",5,1,1,7,Mid-Value,Potential Loyalists
2115,30,4,"128,35",5,1,1,7,Mid-Value,Potential Loyalists
2116,430,2,"2,4",4,1,1,6,Mid-Value,Potential Loyalists
2117,158,6,"624,55",5,1,1,7,Mid-Value,Potential Loyalists
2118,1747,1,"19,85",1,1,1,3,Low-Value,Lost
2122,1519,2,"107,3",1,1,1,3,Low-Value,Lost
2123,94,2,"116,4",5,1,1,7,Mid-Value,Potential Loyalists
2124,36,5,"98,35",5,1,1,7,Mid-Value,Potential Loyalists
2125,809,4,"242,85",3,1,1,5,Low-Value,At Risk Customers
2126,970,1,"16,049999999999997",3,1,1,5,Low-Value,At Risk Customers
2128,1152,2,"56,9",2,1,1,4,Low-Value,Can't Lose
2129,869,1,"383,85",3,1,1,5,Low-Value,At Risk Customers
2131,185,3,"274,9",5,1,1,7,Mid-Value,Potential Loyalists
2134,582,4,"108,1",4,1,1,6,Mid-Value,Potential Loyalists
2135,129,5,"212,05",5,1,1,7,Mid-Value,Potential Loyalists
2137,28,5,"255,89999999999998",5,1,1,7,Mid-Value,Potential Loyalists
2138,94,4,"346,25",5,1,1,7,Mid-Value,Potential Loyalists
2139,536,1,"103,64999999999999",4,1,1,6,Mid-Value,Potential Loyalists
2140,738,1,"25,8",3,1,1,5,Low-Value,At Risk Customers
2146,215,4,"200,1",5,1,1,7,Mid-Value,Potential Loyalists
2147,217,2,"32,6",5,1,1,7,Mid-Value,Potential Loyalists
2148,435,8,"477,7",4,2,1,7,Mid-Value,Potential Loyalists
2153,579,5,"194,75",4,1,1,6,Mid-Value,Potential Loyalists
2154,889,1,"20,5",3,1,1,5,Low-Value,At Risk Customers
2155,1289,2,"38,25",2,1,1,4,Low-Value,Can't Lose
2156,803,4,"287,1",3,1,1,5,Low-Value,At Risk Customers
2157,762,3,"160,85",3,1,1,5,Low-Value,At Risk Customers
2158,125,6,"189,85000000000002",5,1,1,7,Mid-Value,Potential Loyalists
2161,74,7,"395,4",5,2,1,8,High-Value,Potential Loyalists
2162,357,1,"11,9",5,1,1,7,Mid-Value,Potential Loyalists
2165,441,1,"26,9",4,1,1,6,Mid-Value,Potential Loyalists
2166,1379,1,"90,45",2,1,1,4,Low-Value,Can't Lose
2167,1380,1,"31,05",2,1,1,4,Low-Value,Can't Lose
2168,1030,1,"12,1",3,1,1,5,Low-Value,At Risk Customers
2172,386,3,"145,4",4,1,1,6,Mid-Value,Potential Loyalists
2173,880,2,"45,8",3,1,1,5,Low-Value,At Risk Customers
2174,332,4,"96,95",5,1,1,7,Mid-Value,Potential Loyalists
2175,1208,4,"488,05",2,1,1,4,Low-Value,Can't Lose
2177,366,2,"231,45",4,1,1,6,Mid-Value,Potential Loyalists
2179,418,2,"42,85",4,1,1,6,Mid-Value,Potential Loyalists
2180,26,2,"166,55",5,1,1,7,Mid-Value,Potential Loyalists
2181,676,1,"32,65",4,1,1,6,Mid-Value,Potential Loyalists
2183,84,1,"27,5",5,1,1,7,Mid-Value,Potential Loyalists
2184,77,2,"42,1",5,1,1,7,Mid-Value,Potential Loyalists
2187,1103,2,"61,599999999999994",2,1,1,4,Low-Value,Can't Lose
2190,203,5,"218,1",5,1,1,7,Mid-Value,Potential Loyalists
2191,133,2,"88,1",5,1,1,7,Mid-Value,Potential Loyalists
2193,873,1,"23,2",3,1,1,5,Low-Value,At Risk Customers
2194,417,2,"55,9",4,1,1,6,Mid-Value,Potential Loyalists
2195,441,2,"276,85",4,1,1,6,Mid-Value,Potential Loyalists
2196,1680,1,"147,2",1,1,1,3,Low-Value,Lost
2197,446,1,"49,6",4,1,1,6,Mid-Value,Potential Loyalists
2198,372,6,"839,1",4,1,2,7,Mid-Value,Potential Loyalists
2200,794,1,"43,15",3,1,1,5,Low-Value,At Risk Customers
2201,936,6,"219,2",3,1,1,5,Low-Value,At Risk Customers
2203,11,7,"355,5",5,2,1,8,High-Value,Potential Loyalists
2204,173,8,"216,55",5,2,1,8,High-Value,Potential Loyalists
2205,161,2,"166,65",5,1,1,7,Mid-Value,Potential Loyalists
2206,614,5,"118,39999999999999",4,1,1,6,Mid-Value,Potential Loyalists
2208,766,2,"70,15",3,1,1,5,Low-Value,At Risk Customers
2209,538,6,"213,95",4,1,1,6,Mid-Value,Potential Loyalists
2211,683,1,"42,15",4,1,1,6,Mid-Value,Potential Loyalists
2212,344,8,"748,1",5,2,2,9,High-Value,Champions
2213,740,5,"164,45",3,1,1,5,Low-Value,At Risk Customers
2216,403,6,"138,0",4,1,1,6,Mid-Value,Potential Loyalists
2218,287,2,"195,4",5,1,1,7,Mid-Value,Potential Loyalists
2219,1797,1,"57,9",1,1,1,3,Low-Value,Lost
2220,21,4,"96,0",5,1,1,7,Mid-Value,Potential Loyalists
2221,472,3,"127,85",4,1,1,6,Mid-Value,Potential Loyalists
2223,62,1,"128,3",5,1,1,7,Mid-Value,Potential Loyalists
2224,509,1,"100,0",4,1,1,6,Mid-Value,Potential Loyalists
2227,321,6,"266,0",5,1,1,7,Mid-Value,Potential Loyalists
2229,563,1,"71,9",4,1,1,6,Mid-Value,Potential Loyalists
2230,1231,1,"34,2",2,1,1,4,Low-Value,Can't Lose
2231,622,3,"72,9",4,1,1,6,Mid-Value,Potential Loyalists
2232,69,2,"194,3",5,1,1,7,Mid-Value,Potential Loyalists
2234,571,3,"103,2",4,1,1,6,Mid-Value,Potential Loyalists
2235,904,2,"268,5",3,1,1,5,Low-Value,At Risk Customers
2237,139,10,"491,40000000000003",5,2,1,8,High-Value,Potential Loyalists
2238,113,6,"897,1",5,1,2,8,High-Value,Potential Loyalists
2240,978,1,"54,599999999999994",3,1,1,5,Low-Value,At Risk Customers
2241,1456,1,"30,35",2,1,1,4,Low-Value,Can't Lose
2242,218,18,"1064,0",5,4,2,11,High-Value,Champions
2243,53,2,"78,95",5,1,1,7,Mid-Value,Potential Loyalists
2244,752,2,"95,45000000000002",3,1,1,5,Low-Value,At Risk Customers
2246,347,9,"696,15",5,2,2,9,High-Value,Champions
2247,89,7,"516,05",5,2,1,8,High-Value,Potential Loyalists
2248,1762,1,"135,0",1,1,1,3,Low-Value,Lost
2250,314,4,"172,9",5,1,1,7,Mid-Value,Potential Loyalists
2251,395,2,"210,65",4,1,1,6,Mid-Value,Potential Loyalists
2252,1377,1,"54,9",2,1,1,4,Low-Value,Can't Lose
2253,830,1,"11,8",3,1,1,5,Low-Value,At Risk Customers
2254,460,2,"27,4",4,1,1,6,Mid-Value,Potential Loyalists
2255,545,2,"49,3",4,1,1,6,Mid-Value,Potential Loyalists
2256,2,2,"104,85",5,1,1,7,Mid-Value,Potential Loyalists
2257,540,1,"55,25",4,1,1,6,Mid-Value,Potential Loyalists
2258,256,1,"141,3",5,1,1,7,Mid-Value,Potential Loyalists
2259,221,2,"214,24999999999997",5,1,1,7,Mid-Value,Potential Loyalists
2260,374,8,"731,2",4,2,2,8,High-Value,Potential Loyalists
2261,22,2,"424,5",5,1,1,7,Mid-Value,Potential Loyalists
2262,757,4,"192,3",3,1,1,5,Low-Value,At Risk Customers
2264,520,5,"247,2",4,1,1,6,Mid-Value,Potential Loyalists
2266,628,3,"251,10000000000002",4,1,1,6,Mid-Value,Potential Loyalists
2267,964,1,"3,75",3,1,1,5,Low-Value,At Risk Customers
2268,91,1,"39,95",5,1,1,7,Mid-Value,Potential Loyalists
2269,998,4,"305,4",3,1,1,5,Low-Value,At Risk Customers
2270,1320,1,"96,6",2,1,1,4,Low-Value,Can't Lose
2271,5,9,"412,6",5,2,1,8,High-Value,Potential Loyalists
2272,903,3,"347,1",3,1,1,5,Low-Value,At Risk Customers
2273,1496,1,"4,9",1,1,1,3,Low-Value,Lost
2274,57,4,"250,8",5,1,1,7,Mid-Value,Potential Loyalists
2276,190,7,"510,34999999999997",5,2,1,8,High-Value,Potential Loyalists
2277,801,1,"135,0",3,1,1,5,Low-Value,At Risk Customers
2278,303,2,"110,4",5,1,1,7,Mid-Value,Potential Loyalists
2281,123,4,"234,88",5,1,1,7,Mid-Value,Potential Loyalists
2282,426,2,"157,95",4,1,1,6,Mid-Value,Potential Loyalists
2283,1638,1,"57,05",1,1,1,3,Low-Value,Lost
2284,1083,1,"30,45",3,1,1,5,Low-Value,At Risk Customers
2285,83,6,"673,85",5,1,2,8,High-Value,Potential Loyalists
2286,609,1,"40,75",4,1,1,6,Mid-Value,Potential Loyalists
2287,1713,4,"188,39999999999998",1,1,1,3,Low-Value,Lost
2288,888,4,"494,8",3,1,1,5,Low-Value,At Risk Customers
2289,967,1,"147,14999999999998",3,1,1,5,Low-Value,At Risk Customers
2290,635,8,"938,6",4,2,2,8,High-Value,Potential Loyalists
2291,1315,1,"34,7",2,1,1,4,Low-Value,Can't Lose
2292,13,2,"31,05",5,1,1,7,Mid-Value,Potential Loyalists
2294,1249,1,"5,35",2,1,1,4,Low-Value,Can't Lose
2295,42,8,"308,15",5,2,1,8,High-Value,Potential Loyalists
2296,906,5,"132,85",3,1,1,5,Low-Value,At Risk Customers
2298,1,13,"1331,45",5,3,3,11,High-Value,Champions
2299,438,2,"85,85",4,1,1,6,Mid-Value,Potential Loyalists
2302,1699,1,"71,95",1,1,1,3,Low-Value,Lost
2303,49,2,"305,9",5,1,1,7,Mid-Value,Potential Loyalists
2304,159,12,"588,55",5,3,1,9,High-Value,Champions
2306,1060,2,"46,199999999999996",3,1,1,5,Low-Value,At Risk Customers
2307,330,6,"367,2",5,1,1,7,Mid-Value,Potential Loyalists
2310,64,10,"454,55",5,2,1,8,High-Value,Potential Loyalists
2313,1391,2,"80,0",2,1,1,4,Low-Value,Can't Lose
2314,49,7,"563,1999999999999",5,2,1,8,High-Value,Potential Loyalists
2315,20,3,"78,3",5,1,1,7,Mid-Value,Potential Loyalists
2316,551,3,"68,19999999999999",4,1,1,6,Mid-Value,Potential Loyalists
2318,910,2,"192,95",3,1,1,5,Low-Value,At Risk Customers
2319,809,5,"200,15",3,1,1,5,Low-Value,At Risk Customers
2320,8,5,"131,89999999999998",5,1,1,7,Mid-Value,Potential Loyalists
2321,1414,1,"63,2",2,1,1,4,Low-Value,Can't Lose
2323,81,6,"350,63",5,1,1,7,Mid-Value,Potential Loyalists
2324,299,1,"72,55",5,1,1,7,Mid-Value,Potential Loyalists
2327,453,9,"201,8",4,2,1,7,Mid-Value,Potential Loyalists
2330,113,12,"525,5500000000001",5,3,1,9,High-Value,Champions
2331,287,1,"19,4",5,1,1,7,Mid-Value,Potential Loyalists
2332,316,5,"116,75",5,1,1,7,Mid-Value,Potential Loyalists
2333,341,6,"573,4",5,1,1,7,Mid-Value,Potential Loyalists
2335,28,2,"88,25",5,1,1,7,Mid-Value,Potential Loyalists
2337,447,7,"285,65000000000003",4,2,1,7,Mid-Value,Potential Loyalists
2339,1160,6,"241,25",2,1,1,4,Low-Value,Can't Lose
2341,1034,1,"146,2",3,1,1,5,Low-Value,At Risk Customers
2344,1149,2,"142,35",2,1,1,4,Low-Value,Can't Lose
2345,1653,2,"42,45",1,1,1,3,Low-Value,Lost
2346,438,3,"106,75",4,1,1,6,Mid-Value,Potential Loyalists
2347,217,3,"247,5",5,1,1,7,Mid-Value,Potential Loyalists
2348,680,1,"19,35",4,1,1,6,Mid-Value,Potential Loyalists
2350,795,2,"31,9",3,1,1,5,Low-Value,At Risk Customers
2351,1824,1,"18,2",1,1,1,3,Low-Value,Lost
2353,899,4,"224,8",3,1,1,5,Low-Value,At Risk Customers
2354,229,2,"29,400000000000002",5,1,1,7,Mid-Value,Potential Loyalists
2355,1114,6,"302,75",2,1,1,4,Low-Value,Can't Lose
2356,4,2,"55,099999999999994",5,1,1,7,Mid-Value,Potential Loyalists
2357,119,1,"6,55",5,1,1,7,Mid-Value,Potential Loyalists
2358,391,3,"126,65",4,1,1,6,Mid-Value,Potential Loyalists
2359,386,14,"678,75",4,3,2,9,High-Value,Champions
2360,1181,2,"269,2",2,1,1,4,Low-Value,Can't Lose
2362,522,2,"127,1",4,1,1,6,Mid-Value,Potential Loyalists
2363,1391,1,"130,55",2,1,1,4,Low-Value,Can't Lose
2364,66,7,"539,2",5,2,1,8,High-Value,Potential Loyalists
2365,711,3,"254,9",4,1,1,6,Mid-Value,Potential Loyalists
2366,750,5,"173,15",3,1,1,5,Low-Value,At Risk Customers
2367,1008,3,"371,5",3,1,1,5,Low-Value,At Risk Customers
2369,53,5,"221,10000000000002",5,1,1,7,Mid-Value,Potential Loyalists
2370,511,1,"48,6",4,1,1,6,Mid-Value,Potential Loyalists
2372,550,5,"257,15",4,1,1,6,Mid-Value,Potential Loyalists
2373,34,4,"343,95",5,1,1,7,Mid-Value,Potential Loyalists
2374,146,4,"293,05",5,1,1,7,Mid-Value,Potential Loyalists
2375,1466,1,"41,4",1,1,1,3,Low-Value,Lost
2376,292,6,"689,55",5,1,2,8,High-Value,Potential Loyalists
2377,169,1,"85,5",5,1,1,7,Mid-Value,Potential Loyalists
2378,859,5,"244,6",3,1,1,5,Low-Value,At Risk Customers
2379,1459,1,"72,0",2,1,1,4,Low-Value,Can't Lose
2381,132,5,"239,75",5,1,1,7,Mid-Value,Potential Loyalists
2383,306,7,"477,34999999999997",5,2,1,8,High-Value,Potential Loyalists
2387,109,1,"8,5",5,1,1,7,Mid-Value,Potential Loyalists
2388,1466,3,"48,9",1,1,1,3,Low-Value,Lost
2389,809,2,"72,05000000000001",3,1,1,5,Low-Value,At Risk Customers
2391,578,2,"42,45",4,1,1,6,Mid-Value,Potential Loyalists
2393,425,4,"429,59999999999997",4,1,1,6,Mid-Value,Potential Loyalists
2394,594,4,"263,3",4,1,1,6,Mid-Value,Potential Loyalists
2395,528,5,"461,7",4,1,1,6,Mid-Value,Potential Loyalists
2396,1156,2,"91,95",2,1,1,4,Low-Value,Can't Lose
2397,1734,1,"97,64999999999999",1,1,1,3,Low-Value,Lost
2398,760,1,"10,8",3,1,1,5,Low-Value,At Risk Customers
2399,230,3,"85,19999999999999",5,1,1,7,Mid-Value,Potential Loyalists
2400,262,5,"264,15000000000003",5,1,1,7,Mid-Value,Potential Loyalists
2402,33,5,"168,9",5,1,1,7,Mid-Value,Potential Loyalists
2404,238,3,"117,15",5,1,1,7,Mid-Value,Potential Loyalists
2406,1777,1,"23,75",1,1,1,3,Low-Value,Lost
2410,34,2,"149,04999999999998",5,1,1,7,Mid-Value,Potential Loyalists
2411,571,2,"170,0",4,1,1,6,Mid-Value,Potential Loyalists
2414,330,3,"806,6",5,1,2,8,High-Value,Potential Loyalists
2415,1108,9,"275,5",2,2,1,5,Low-Value,At Risk Customers
2416,30,3,"112,05",5,1,1,7,Mid-Value,Potential Loyalists
2418,561,2,"55,15",4,1,1,6,Mid-Value,Potential Loyalists
2420,882,4,"370,1",3,1,1,5,Low-Value,At Risk Customers
2421,787,4,"296,35",3,1,1,5,Low-Value,At Risk Customers
2423,504,4,"289,1",4,1,1,6,Mid-Value,Potential Loyalists
2425,557,3,"155,7",4,1,1,6,Mid-Value,Potential Loyalists
2427,855,1,"79,0",3,1,1,5,Low-Value,At Risk Customers
2428,1365,5,"278,95",2,1,1,4,Low-Value,Can't Lose
2430,215,15,"864,45",5,3,2,10,High-Value,Champions
2432,1200,1,"113,6",2,1,1,4,Low-Value,Can't Lose
2433,1538,1,"69,6",1,1,1,3,Low-Value,Lost
2434,236,5,"622,85",5,1,1,7,Mid-Value,Potential Loyalists
2435,1194,1,"37,2",2,1,1,4,Low-Value,Can't Lose
2436,1279,3,"131,7",2,1,1,4,Low-Value,Can't Lose
2437,1029,1,"47,25",3,1,1,5,Low-Value,At Risk Customers
2438,1700,1,"130,35000000000002",1,1,1,3,Low-Value,Lost
2439,80,8,"222,25",5,2,1,8,High-Value,Potential Loyalists
2440,1174,3,"134,35",2,1,1,4,Low-Value,Can't Lose
2442,281,4,"166,79999999999998",5,1,1,7,Mid-Value,Potential Loyalists
2444,401,4,"184,89999999999998",4,1,1,6,Mid-Value,Potential Loyalists
2445,241,4,"122,85",5,1,1,7,Mid-Value,Potential Loyalists
2447,1153,2,"235,65",2,1,1,4,Low-Value,Can't Lose
2448,8,3,"83,5",5,1,1,7,Mid-Value,Potential Loyalists
2449,469,3,"206,4",4,1,1,6,Mid-Value,Potential Loyalists
2450,1092,1,"35,95",3,1,1,5,Low-Value,At Risk Customers
2451,1322,1,"17,7",2,1,1,4,Low-Value,Can't Lose
2452,19,7,"211,10000000000002",5,2,1,8,High-Value,Potential Loyalists
2453,176,3,"111,25",5,1,1,7,Mid-Value,Potential Loyalists
2454,1236,6,"511,2",2,1,1,4,Low-Value,Can't Lose
2455,694,4,"248,3",4,1,1,6,Mid-Value,Potential Loyalists
2456,657,2,"69,35",4,1,1,6,Mid-Value,Potential Loyalists
2458,873,4,"590,26",3,1,1,5,Low-Value,At Risk Customers
2459,924,2,"169,05",3,1,1,5,Low-Value,At Risk Customers
2460,187,1,"21,1",5,1,1,7,Mid-Value,Potential Loyalists
2461,480,4,"650,35",4,1,1,6,Mid-Value,Potential Loyalists
2463,297,9,"339,25",5,2,1,8,High-Value,Potential Loyalists
2464,955,2,"15,45",3,1,1,5,Low-Value,At Risk Customers
2465,242,3,"98,95",5,1,1,7,Mid-Value,Potential Loyalists
2466,230,3,"111,35",5,1,1,7,Mid-Value,Potential Loyalists
2467,1710,2,"84,85",1,1,1,3,Low-Value,Lost
2468,769,3,"86,69999999999999",3,1,1,5,Low-Value,At Risk Customers
2469,1463,1,"85,1",1,1,1,3,Low-Value,Lost
2470,1462,1,"39,4",1,1,1,3,Low-Value,Lost
2471,89,2,"74,1",5,1,1,7,Mid-Value,Potential Loyalists
2474,93,1,"58,3",5,1,1,7,Mid-Value,Potential Loyalists
2475,160,2,"594,9",5,1,1,7,Mid-Value,Potential Loyalists
2476,192,8,"538,15",5,2,1,8,High-Value,Potential Loyalists
2478,113,2,"82,25",5,1,1,7,Mid-Value,Potential Loyalists
2480,1610,2,"142,0",1,1,1,3,Low-Value,Lost
2481,143,5,"386,20000000000005",5,1,1,7,Mid-Value,Potential Loyalists
2484,36,2,"116,19999999999999",5,1,1,7,Mid-Value,Potential Loyalists
2485,52,3,"233,85",5,1,1,7,Mid-Value,Potential Loyalists
2486,3,7,"578,9",5,2,1,8,High-Value,Potential Loyalists
2487,265,2,"206,2",5,1,1,7,Mid-Value,Potential Loyalists
2489,71,9,"657,35",5,2,1,8,High-Value,Potential Loyalists
2490,164,9,"451,75",5,2,1,8,High-Value,Potential Loyalists
2492,13,1,"88,6",5,1,1,7,Mid-Value,Potential Loyalists
2493,188,1,"19,0",5,1,1,7,Mid-Value,Potential Loyalists
2495,1166,4,"177,79999999999998",2,1,1,4,Low-Value,Can't Lose
2497,80,3,"310,9",5,1,1,7,Mid-Value,Potential Loyalists
2499,1806,1,"5,8",1,1,1,3,Low-Value,Lost
2500,900,5,"458,85",3,1,1,5,Low-Value,At Risk Customers
2501,402,6,"581,9",4,1,1,6,Mid-Value,Potential Loyalists
2502,365,6,"356,55",5,1,1,7,Mid-Value,Potential Loyalists
2503,523,2,"100,25",4,1,1,6,Mid-Value,Potential Loyalists
2504,169,3,"169,3",5,1,1,7,Mid-Value,Potential Loyalists
2505,646,3,"80,35000000000001",4,1,1,6,Mid-Value,Potential Loyalists
2506,806,3,"458,05",3,1,1,5,Low-Value,At Risk Customers
2508,393,1,"94,9",4,1,1,6,Mid-Value,Potential Loyalists
2509,0,11,"660,0",5,2,1,8,High-Value,Potential Loyalists
2510,265,3,"184,4",5,1,1,7,Mid-Value,Potential Loyalists
2511,1121,6,"470,6",2,1,1,4,Low-Value,Can't Lose
2513,309,1,"57,45",5,1,1,7,Mid-Value,Potential Loyalists
2514,1708,1,"13,55",1,1,1,3,Low-Value,Lost
2515,647,2,"161,9",4,1,1,6,Mid-Value,Potential Loyalists
2516,935,1,"28,650000000000002",3,1,1,5,Low-Value,At Risk Customers
2519,122,4,"309,85",5,1,1,7,Mid-Value,Potential Loyalists
2520,368,8,"547,75",4,2,1,7,Mid-Value,Potential Loyalists
2522,1285,1,"31,7",2,1,1,4,Low-Value,Can't Lose
2523,509,4,"581,95",4,1,1,6,Mid-Value,Potential Loyalists
2524,598,8,"291,79999999999995",4,2,1,7,Mid-Value,Potential Loyalists
2526,1302,3,"293,1",2,1,1,4,Low-Value,Can't Lose
2527,60,3,"226,29999999999998",5,1,1,7,Mid-Value,Potential Loyalists
2529,124,3,"125,75",5,1,1,7,Mid-Value,Potential Loyalists
2530,67,6,"552,1999999999999",5,1,1,7,Mid-Value,Potential Loyalists
2532,1520,5,"278,4",1,1,1,3,Low-Value,Lost
2533,1196,1,"118,9",2,1,1,4,Low-Value,Can't Lose
2534,938,4,"142,15",3,1,1,5,Low-Value,At Risk Customers
2537,166,9,"683,3",5,2,2,9,High-Value,Champions
2538,18,4,"182,05",5,1,1,7,Mid-Value,Potential Loyalists
2539,39,7,"331,15",5,2,1,8,High-Value,Potential Loyalists
2540,746,3,"331,45000000000005",3,1,1,5,Low-Value,At Risk Customers
2542,106,6,"212,7",5,1,1,7,Mid-Value,Potential Loyalists
2543,1474,1,"199,0",1,1,1,3,Low-Value,Lost
2545,989,2,"120,85000000000001",3,1,1,5,Low-Value,At Risk Customers
2546,231,10,"900,6",5,2,2,9,High-Value,Champions
2547,990,2,"30,6",3,1,1,5,Low-Value,At Risk Customers
2548,792,2,"38,1",3,1,1,5,Low-Value,At Risk Customers
2552,304,7,"256,75",5,2,1,8,High-Value,Potential Loyalists
2554,25,4,"72,7",5,1,1,7,Mid-Value,Potential Loyalists
2555,333,10,"563,6",5,2,1,8,High-Value,Potential Loyalists
2558,1230,5,"327,3",2,1,1,4,Low-Value,Can't Lose
2559,636,2,"37,85",4,1,1,6,Mid-Value,Potential Loyalists
2561,17,2,"467,1",5,1,1,7,Mid-Value,Potential Loyalists
2562,94,4,"209,75",5,1,1,7,Mid-Value,Potential Loyalists
2564,915,2,"126,89999999999999",3,1,1,5,Low-Value,At Risk Customers
2565,153,1,"138,60000000000002",5,1,1,7,Mid-Value,Potential Loyalists
2566,440,1,"5,3",4,1,1,6,Mid-Value,Potential Loyalists
2568,157,4,"355,4",5,1,1,7,Mid-Value,Potential Loyalists
2569,1199,3,"70,15",2,1,1,4,Low-Value,Can't Lose
2570,893,1,"121,4",3,1,1,5,Low-Value,At Risk Customers
2573,463,4,"200,5",4,1,1,6,Mid-Value,Potential Loyalists
2574,455,6,"262,75",4,1,1,6,Mid-Value,Potential Loyalists
2577,257,3,"99,55",5,1,1,7,Mid-Value,Potential Loyalists
2578,747,2,"215,9",3,1,1,5,Low-Value,At Risk Customers
2579,57,15,"608,6",5,3,1,9,High-Value,Champions
2580,67,5,"213,05",5,1,1,7,Mid-Value,Potential Loyalists
2581,358,3,"183,85",5,1,1,7,Mid-Value,Potential Loyalists
2582,1288,2,"105,6",2,1,1,4,Low-Value,Can't Lose
2584,747,5,"378,66",3,1,1,5,Low-Value,At Risk Customers
2585,542,2,"153,25",4,1,1,6,Mid-Value,Potential Loyalists
2586,1360,1,"99,2",2,1,1,4,Low-Value,Can't Lose
2587,1098,2,"197,35000000000002",2,1,1,4,Low-Value,Can't Lose
2589,796,2,"66,9",3,1,1,5,Low-Value,At Risk Customers
2590,245,9,"322,75",5,2,1,8,High-Value,Potential Loyalists
2591,617,6,"412,79999999999995",4,1,1,6,Mid-Value,Potential Loyalists
2593,920,4,"253,8",3,1,1,5,Low-Value,At Risk Customers
2595,17,6,"217,0",5,1,1,7,Mid-Value,Potential Loyalists
2597,4,6,"280,8",5,1,1,7,Mid-Value,Potential Loyalists
2598,28,3,"104,95",5,1,1,7,Mid-Value,Potential Loyalists
2601,706,1,"6,05",4,1,1,6,Mid-Value,Potential Loyalists
2602,733,3,"297,84999999999997",3,1,1,5,Low-Value,At Risk Customers
2604,1265,2,"197,10000000000002",2,1,1,4,Low-Value,Can't Lose
2605,1175,3,"46,75",2,1,1,4,Low-Value,Can't Lose
2606,169,2,"169,8",5,1,1,7,Mid-Value,Potential Loyalists
2607,283,1,"79,0",5,1,1,7,Mid-Value,Potential Loyalists
2608,861,3,"483,49999999999994",3,1,1,5,Low-Value,At Risk Customers
2609,649,9,"336,3",4,2,1,7,Mid-Value,Potential Loyalists
2610,1371,2,"60,5",2,1,1,4,Low-Value,Can't Lose
2613,487,1,"65,6",4,1,1,6,Mid-Value,Potential Loyalists
2614,332,5,"360,45",5,1,1,7,Mid-Value,Potential Loyalists
2615,1424,3,"110,6",2,1,1,4,Low-Value,Can't Lose
2616,34,5,"220,65",5,1,1,7,Mid-Value,Potential Loyalists
2617,228,3,"54,1",5,1,1,7,Mid-Value,Potential Loyalists
2620,323,3,"63,55",5,1,1,7,Mid-Value,Potential Loyalists
2621,299,5,"441,45000000000005",5,1,1,7,Mid-Value,Potential Loyalists
2622,342,3,"118,2",5,1,1,7,Mid-Value,Potential Loyalists
2623,1609,1,"98,0",1,1,1,3,Low-Value,Lost
2624,137,2,"227,6",5,1,1,7,Mid-Value,Potential Loyalists
2625,19,1,"23,9",5,1,1,7,Mid-Value,Potential Loyalists
2626,328,3,"371,15000000000003",5,1,1,7,Mid-Value,Potential Loyalists
2627,623,1,"16,4",4,1,1,6,Mid-Value,Potential Loyalists
2629,615,1,"58,050000000000004",4,1,1,6,Mid-Value,Potential Loyalists
2630,1358,3,"301,25",2,1,1,4,Low-Value,Can't Lose
2631,503,1,"57,9",4,1,1,6,Mid-Value,Potential Loyalists
2632,746,1,"19,3",3,1,1,5,Low-Value,At Risk Customers
2633,112,5,"134,25",5,1,1,7,Mid-Value,Potential Loyalists
2634,15,6,"382,05",5,1,1,7,Mid-Value,Potential Loyalists
2635,818,4,"131,3",3,1,1,5,Low-Value,At Risk Customers
2638,382,2,"346,20000000000005",4,1,1,6,Mid-Value,Potential Loyalists
2640,402,1,"9,4",4,1,1,6,Mid-Value,Potential Loyalists
2642,56,11,"671,5",5,2,2,9,High-Value,Champions
2643,31,2,"126,1",5,1,1,7,Mid-Value,Potential Loyalists
2644,169,2,"104,69999999999999",5,1,1,7,Mid-Value,Potential Loyalists
2645,307,8,"313,8",5,2,1,8,High-Value,Potential Loyalists
2646,582,1,"68,69999999999999",4,1,1,6,Mid-Value,Potential Loyalists
2648,725,4,"101,35",4,1,1,6,Mid-Value,Potential Loyalists
2649,432,1,"7,4",4,1,1,6,Mid-Value,Potential Loyalists
2651,172,2,"183,05",5,1,1,7,Mid-Value,Potential Loyalists
2652,306,5,"501,90000000000003",5,1,1,7,Mid-Value,Potential Loyalists
2653,90,2,"130,9",5,1,1,7,Mid-Value,Potential Loyalists
2655,22,6,"628,8",5,1,1,7,Mid-Value,Potential Loyalists
2657,605,1,"46,8",4,1,1,6,Mid-Value,Potential Loyalists
2658,930,5,"218,55",3,1,1,5,Low-Value,At Risk Customers
2659,27,1,"22,1",5,1,1,7,Mid-Value,Potential Loyalists
2660,698,1,"10,8",4,1,1,6,Mid-Value,Potential Loyalists
2661,787,6,"121,1",3,1,1,5,Low-Value,At Risk Customers
2663,1607,1,"61,5",1,1,1,3,Low-Value,Lost
2665,43,1,"28,9",5,1,1,7,Mid-Value,Potential Loyalists
2668,35,3,"126,15",5,1,1,7,Mid-Value,Potential Loyalists
2669,568,5,"289,7",4,1,1,6,Mid-Value,Potential Loyalists
2672,51,1,"12,1",5,1,1,7,Mid-Value,Potential Loyalists
2674,61,3,"61,25",5,1,1,7,Mid-Value,Potential Loyalists
2676,821,2,"27,65",3,1,1,5,Low-Value,At Risk Customers
2678,229,7,"470,05",5,2,1,8,High-Value,Potential Loyalists
2681,889,2,"111,89999999999999",3,1,1,5,Low-Value,At Risk Customers
2682,130,4,"108,35",5,1,1,7,Mid-Value,Potential Loyalists
2689,19,3,"207,55",5,1,1,7,Mid-Value,Potential Loyalists
2690,1065,1,"39,0",3,1,1,5,Low-Value,At Risk Customers
2694,489,2,"53,8",4,1,1,6,Mid-Value,Potential Loyalists
2697,624,1,"4,75",4,1,1,6,Mid-Value,Potential Loyalists
2698,160,7,"344,5",5,2,1,8,High-Value,Potential Loyalists
2700,59,7,"775,25",5,2,2,9,High-Value,Champions
2703,563,3,"389,4",4,1,1,6,Mid-Value,Potential Loyalists
2704,138,7,"205,4",5,2,1,8,High-Value,Potential Loyalists
2706,339,1,"99,9",5,1,1,7,Mid-Value,Potential Loyalists
2707,519,2,"383,54999999999995",4,1,1,6,Mid-Value,Potential Loyalists
2708,1725,1,"47,35",1,1,1,3,Low-Value,Lost
2709,280,3,"158,6",5,1,1,7,Mid-Value,Potential Loyalists
2710,88,1,"61,0",5,1,1,7,Mid-Value,Potential Loyalists
2711,117,2,"80,5",5,1,1,7,Mid-Value,Potential Loyalists
2712,728,2,"61,7",4,1,1,6,Mid-Value,Potential Loyalists
2713,712,4,"227,75",4,1,1,6,Mid-Value,Potential Loyalists
2715,45,1,"21,2",5,1,1,7,Mid-Value,Potential Loyalists
2716,73,4,"535,4000000000001",5,1,1,7,Mid-Value,Potential Loyalists
2717,264,2,"139,0",5,1,1,7,Mid-Value,Potential Loyalists
2718,369,10,"425,4",4,2,1,7,Mid-Value,Potential Loyalists
2720,1805,1,"45,0",1,1,1,3,Low-Value,Lost
2722,853,2,"324,25000000000006",3,1,1,5,Low-Value,At Risk Customers
2723,109,6,"177,1",5,1,1,7,Mid-Value,Potential Loyalists
2724,21,4,"215,60000000000002",5,1,1,7,Mid-Value,Potential Loyalists
2726,556,3,"277,8",4,1,1,6,Mid-Value,Potential Loyalists
2727,352,4,"279,8",5,1,1,7,Mid-Value,Potential Loyalists
2729,1678,1,"18,25",1,1,1,3,Low-Value,Lost
2731,444,9,"377,04999999999995",4,2,1,7,Mid-Value,Potential Loyalists
2732,263,3,"270,5",5,1,1,7,Mid-Value,Potential Loyalists
2734,1369,1,"88,5",2,1,1,4,Low-Value,Can't Lose
2735,281,1,"18,95",5,1,1,7,Mid-Value,Potential Loyalists
2736,952,1,"31,1",3,1,1,5,Low-Value,At Risk Customers
2737,208,7,"408,1",5,2,1,8,High-Value,Potential Loyalists
2739,515,1,"145,5",4,1,1,6,Mid-Value,Potential Loyalists
2740,1106,2,"56,2",2,1,1,4,Low-Value,Can't Lose
2741,496,3,"168,85",4,1,1,6,Mid-Value,Potential Loyalists
2743,617,3,"55,25",4,1,1,6,Mid-Value,Potential Loyalists
2744,1419,3,"407,43",2,1,1,4,Low-Value,Can't Lose
2745,21,4,"45,849999999999994",5,1,1,7,Mid-Value,Potential Loyalists
2748,1069,2,"131,10000000000002",3,1,1,5,Low-Value,At Risk Customers
2749,258,5,"203,25",5,1,1,7,Mid-Value,Potential Loyalists
2755,929,1,"39,5",3,1,1,5,Low-Value,At Risk Customers
2756,927,3,"115,15",3,1,1,5,Low-Value,At Risk Customers
2757,197,1,"24,6",5,1,1,7,Mid-Value,Potential Loyalists
2758,306,1,"62,8",5,1,1,7,Mid-Value,Potential Loyalists
2759,1287,1,"20,0",2,1,1,4,Low-Value,Can't Lose
2764,320,2,"123,6",5,1,1,7,Mid-Value,Potential Loyalists
2765,363,3,"260,5",5,1,1,7,Mid-Value,Potential Loyalists
2767,987,1,"8,0",3,1,1,5,Low-Value,At Risk Customers
2769,870,4,"246,60000000000002",3,1,1,5,Low-Value,At Risk Customers
2770,23,2,"46,8",5,1,1,7,Mid-Value,Potential Loyalists
2772,576,5,"167,25",4,1,1,6,Mid-Value,Potential Loyalists
2773,31,4,"119,9",5,1,1,7,Mid-Value,Potential Loyalists
2776,1211,2,"48,45",2,1,1,4,Low-Value,Can't Lose
2777,168,4,"137,95",5,1,1,7,Mid-Value,Potential Loyalists
2778,53,8,"608,25",5,2,1,8,High-Value,Potential Loyalists
2783,319,3,"170,35",5,1,1,7,Mid-Value,Potential Loyalists
2784,34,10,"1103,6",5,2,2,9,High-Value,Champions
2789,158,1,"82,5",5,1,1,7,Mid-Value,Potential Loyalists
2791,1148,1,"86,55000000000001",2,1,1,4,Low-Value,Can't Lose
2794,30,3,"212,05",5,1,1,7,Mid-Value,Potential Loyalists
2796,381,3,"70,7",4,1,1,6,Mid-Value,Potential Loyalists
2797,1105,2,"79,95",2,1,1,4,Low-Value,Can't Lose
2798,207,3,"177,8",5,1,1,7,Mid-Value,Potential Loyalists
2799,27,7,"333,45000000000005",5,2,1,8,High-Value,Potential Loyalists
2800,609,1,"42,05",4,1,1,6,Mid-Value,Potential Loyalists
2802,113,2,"225,15",5,1,1,7,Mid-Value,Potential Loyalists
2803,696,6,"151,5",4,1,1,6,Mid-Value,Potential Loyalists
2804,113,2,"60,8",5,1,1,7,Mid-Value,Potential Loyalists
2806,31,7,"857,9",5,2,2,9,High-Value,Champions
2809,767,3,"226,1",3,1,1,5,Low-Value,At Risk Customers
2810,735,5,"356,85",3,1,1,5,Low-Value,At Risk Customers
2811,13,10,"289,95",5,2,1,8,High-Value,Potential Loyalists
2812,379,7,"420,70000000000005",4,2,1,7,Mid-Value,Potential Loyalists
2813,593,6,"330,3",4,1,1,6,Mid-Value,Potential Loyalists
2814,739,3,"112,0",3,1,1,5,Low-Value,At Risk Customers
2816,566,5,"186,70000000000002",4,1,1,6,Mid-Value,Potential Loyalists
2817,1522,1,"22,8",1,1,1,3,Low-Value,Lost
2818,37,2,"278,75",5,1,1,7,Mid-Value,Potential Loyalists
2819,763,1,"16,55",3,1,1,5,Low-Value,At Risk Customers
2820,434,2,"197,10000000000002",4,1,1,6,Mid-Value,Potential Loyalists
2821,1216,2,"143,25",2,1,1,4,Low-Value,Can't Lose
2822,689,1,"29,95",4,1,1,6,Mid-Value,Potential Loyalists
2824,23,3,"219,0",5,1,1,7,Mid-Value,Potential Loyalists
2828,709,1,"11,1",4,1,1,6,Mid-Value,Potential Loyalists
2829,46,3,"179,85000000000002",5,1,1,7,Mid-Value,Potential Loyalists
2830,64,2,"168,39999999999998",5,1,1,7,Mid-Value,Potential Loyalists
2831,126,4,"265,25",5,1,1,7,Mid-Value,Potential Loyalists
2832,473,2,"249,55",4,1,1,6,Mid-Value,Potential Loyalists
2833,280,1,"7,25",5,1,1,7,Mid-Value,Potential Loyalists
2834,1011,1,"27,2",3,1,1,5,Low-Value,At Risk Customers
2835,531,3,"271,25",4,1,1,6,Mid-Value,Potential Loyalists
2836,33,4,"175,15",5,1,1,7,Mid-Value,Potential Loyalists
2837,246,3,"250,1",5,1,1,7,Mid-Value,Potential Loyalists
2838,130,5,"382,25",5,1,1,7,Mid-Value,Potential Loyalists
2839,27,1,"24,6",5,1,1,7,Mid-Value,Potential Loyalists
2841,532,11,"642,0",4,2,1,7,Mid-Value,Potential Loyalists
2842,374,3,"253,45",4,1,1,6,Mid-Value,Potential Loyalists
2844,61,2,"79,60000000000001",5,1,1,7,Mid-Value,Potential Loyalists
2846,34,8,"882,65",5,2,2,9,High-Value,Champions
2848,150,1,"19,0",5,1,1,7,Mid-Value,Potential Loyalists
2849,498,7,"774,1999999999999",4,2,2,8,High-Value,Potential Loyalists
2850,227,6,"386,5",5,1,1,7,Mid-Value,Potential Loyalists
2851,868,2,"139,95",3,1,1,5,Low-Value,At Risk Customers
2852,411,7,"314,29999999999995",4,2,1,7,Mid-Value,Potential Loyalists
2854,996,3,"42,35",3,1,1,5,Low-Value,At Risk Customers
2855,869,2,"26,099999999999998",3,1,1,5,Low-Value,At Risk Customers
2856,118,1,"22,5",5,1,1,7,Mid-Value,Potential Loyalists
2857,850,2,"307,7",3,1,1,5,Low-Value,At Risk Customers
2859,27,1,"18,3",5,1,1,7,Mid-Value,Potential Loyalists
2861,716,4,"397,05",4,1,1,6,Mid-Value,Potential Loyalists
2862,860,1,"81,4",3,1,1,5,Low-Value,At Risk Customers
2863,1221,3,"20,25",2,1,1,4,Low-Value,Can't Lose
2864,1134,1,"53,3",2,1,1,4,Low-Value,Can't Lose
2865,585,4,"212,6",4,1,1,6,Mid-Value,Potential Loyalists
2866,33,2,"92,15",5,1,1,7,Mid-Value,Potential Loyalists
2868,1116,7,"461,25",2,2,1,5,Low-Value,At Risk Customers
2869,378,8,"297,75",4,2,1,7,Mid-Value,Potential Loyalists
2870,478,1,"23,35",4,1,1,6,Mid-Value,Potential Loyalists
2871,844,4,"266,45",3,1,1,5,Low-Value,At Risk Customers
2872,503,2,"196,45",4,1,1,6,Mid-Value,Potential Loyalists
2873,825,3,"151,79999999999998",3,1,1,5,Low-Value,At Risk Customers
2876,1269,2,"36,9",2,1,1,4,Low-Value,Can't Lose
2877,592,9,"377,3",4,2,1,7,Mid-Value,Potential Loyalists
2878,343,1,"36,85",5,1,1,7,Mid-Value,Potential Loyalists
2879,44,3,"142,45",5,1,1,7,Mid-Value,Potential Loyalists
2880,446,3,"80,05",4,1,1,6,Mid-Value,Potential Loyalists
2883,88,6,"361,20000000000005",5,1,1,7,Mid-Value,Potential Loyalists
2884,374,8,"421,95",4,2,1,7,Mid-Value,Potential Loyalists
2886,229,3,"191,20000000000002",5,1,1,7,Mid-Value,Potential Loyalists
2887,88,5,"166,4",5,1,1,7,Mid-Value,Potential Loyalists
2889,951,2,"353,45000000000005",3,1,1,5,Low-Value,At Risk Customers
2890,147,6,"373,55",5,1,1,7,Mid-Value,Potential Loyalists
2891,741,1,"1552,6",3,1,3,7,Mid-Value,Potential Loyalists
2892,176,3,"167,5",5,1,1,7,Mid-Value,Potential Loyalists
2893,89,7,"523,0500000000001",5,2,1,8,High-Value,Potential Loyalists
2894,9,9,"1037,95",5,2,2,9,High-Value,Champions
2896,1104,2,"158,39999999999998",2,1,1,4,Low-Value,Can't Lose
2899,552,6,"260,6",4,1,1,6,Mid-Value,Potential Loyalists
2901,414,3,"248,35",4,1,1,6,Mid-Value,Potential Loyalists
2902,126,1,"71,25",5,1,1,7,Mid-Value,Potential Loyalists
2905,976,7,"197,0",3,2,1,6,Mid-Value,Potential Loyalists
2907,653,2,"13,45",4,1,1,6,Mid-Value,Potential Loyalists
2908,647,1,"104,6",4,1,1,6,Mid-Value,Potential Loyalists
2909,733,5,"721,5500000000001",3,1,2,6,Mid-Value,Potential Loyalists
2910,312,3,"178,75",5,1,1,7,Mid-Value,Potential Loyalists
2911,187,4,"308,55",5,1,1,7,Mid-Value,Potential Loyalists
2912,717,4,"593,4",4,1,1,6,Mid-Value,Potential Loyalists
2913,179,4,"90,4",5,1,1,7,Mid-Value,Potential Loyalists
2914,111,4,"162,1",5,1,1,7,Mid-Value,Potential Loyalists
2915,401,4,"86,7",4,1,1,6,Mid-Value,Potential Loyalists
2918,32,5,"101,85",5,1,1,7,Mid-Value,Potential Loyalists
2919,225,1,"71,55",5,1,1,7,Mid-Value,Potential Loyalists
2923,1145,2,"359,55",2,1,1,4,Low-Value,Can't Lose
2926,106,4,"242,0",5,1,1,7,Mid-Value,Potential Loyalists
2927,167,2,"270,85",5,1,1,7,Mid-Value,Potential Loyalists
2928,410,8,"423,5",4,2,1,7,Mid-Value,Potential Loyalists
2929,832,2,"200,20000000000002",3,1,1,5,Low-Value,At Risk Customers
2931,518,4,"247,05",4,1,1,6,Mid-Value,Potential Loyalists
2932,343,1,"24,65",5,1,1,7,Mid-Value,Potential Loyalists
2933,384,2,"56,55",4,1,1,6,Mid-Value,Potential Loyalists
2936,533,6,"601,55",4,1,1,6,Mid-Value,Potential Loyalists
2939,745,5,"565,6999999999999",3,1,1,5,Low-Value,At Risk Customers
2940,192,6,"184,65",5,1,1,7,Mid-Value,Potential Loyalists
2941,183,4,"135,95",5,1,1,7,Mid-Value,Potential Loyalists
2945,271,5,"1239,55",5,1,2,8,High-Value,Potential Loyalists
2946,1719,1,"5,3",1,1,1,3,Low-Value,Lost
2947,518,2,"38,05",4,1,1,6,Mid-Value,Potential Loyalists
2949,1311,2,"239,65",2,1,1,4,Low-Value,Can't Lose
2950,917,2,"152,05",3,1,1,5,Low-Value,At Risk Customers
2952,151,4,"215,45",5,1,1,7,Mid-Value,Potential Loyalists
2953,592,3,"86,65",4,1,1,6,Mid-Value,Potential Loyalists
2955,384,4,"117,7",4,1,1,6,Mid-Value,Potential Loyalists
2956,74,7,"577,0",5,2,1,8,High-Value,Potential Loyalists
2957,1368,2,"110,85",2,1,1,4,Low-Value,Can't Lose
2959,666,2,"219,0",4,1,1,6,Mid-Value,Potential Loyalists
2961,465,3,"101,65",4,1,1,6,Mid-Value,Potential Loyalists
2962,433,9,"646,25",4,2,1,7,Mid-Value,Potential Loyalists
2963,1089,2,"125,95",3,1,1,5,Low-Value,At Risk Customers
2964,489,5,"192,85",4,1,1,6,Mid-Value,Potential Loyalists
2965,768,1,"42,45",3,1,1,5,Low-Value,At Risk Customers
2966,527,1,"90,1",4,1,1,6,Mid-Value,Potential Loyalists
2968,66,7,"238,39999999999998",5,2,1,8,High-Value,Potential Loyalists
2969,874,1,"66,44999999999999",3,1,1,5,Low-Value,At Risk Customers
2971,183,2,"95,05",5,1,1,7,Mid-Value,Potential Loyalists
2973,151,1,"17,25",5,1,1,7,Mid-Value,Potential Loyalists
2974,174,1,"56,9",5,1,1,7,Mid-Value,Potential Loyalists
2975,137,7,"321,9",5,2,1,8,High-Value,Potential Loyalists
2976,123,7,"740,25",5,2,2,9,High-Value,Champions
2977,794,4,"64,05",3,1,1,5,Low-Value,At Risk Customers
2979,930,4,"329,65",3,1,1,5,Low-Value,At Risk Customers
2980,309,2,"30,65",5,1,1,7,Mid-Value,Potential Loyalists
2981,30,4,"378,35",5,1,1,7,Mid-Value,Potential Loyalists
2982,1344,1,"4,6",2,1,1,4,Low-Value,Can't Lose
2984,983,2,"101,05",3,1,1,5,Low-Value,At Risk Customers
2985,1646,1,"7,0",1,1,1,3,Low-Value,Lost
2987,727,2,"96,05",4,1,1,6,Mid-Value,Potential Loyalists
2988,791,2,"38,05",3,1,1,5,Low-Value,At Risk Customers
2990,1260,2,"86,9",2,1,1,4,Low-Value,Can't Lose
2991,530,3,"231,3",4,1,1,6,Mid-Value,Potential Loyalists
2992,141,8,"535,2",5,2,1,8,High-Value,Potential Loyalists
2993,521,2,"36,15",4,1,1,6,Mid-Value,Potential Loyalists
2995,381,8,"383,45",4,2,1,7,Mid-Value,Potential Loyalists
2996,27,6,"328,85",5,1,1,7,Mid-Value,Potential Loyalists
2997,857,2,"236,2",3,1,1,5,Low-Value,At Risk Customers
2998,857,1,"50,400000000000006",3,1,1,5,Low-Value,At Risk Customers
3000,60,8,"1205,6",5,2,2,9,High-Value,Champions
3002,160,2,"64,2",5,1,1,7,Mid-Value,Potential Loyalists
3006,0,5,"495,4",5,1,1,7,Mid-Value,Potential Loyalists
3007,542,2,"125,9",4,1,1,6,Mid-Value,Potential Loyalists
3011,1483,4,"148,35",1,1,1,3,Low-Value,Lost
3013,68,2,"301,3",5,1,1,7,Mid-Value,Potential Loyalists
3015,740,3,"270,6",3,1,1,5,Low-Value,At Risk Customers
3016,738,2,"99,55",3,1,1,5,Low-Value,At Risk Customers
3017,631,2,"20,85",4,1,1,6,Mid-Value,Potential Loyalists
3018,36,7,"543,65",5,2,1,8,High-Value,Potential Loyalists
3019,139,2,"47,1",5,1,1,7,Mid-Value,Potential Loyalists
3021,1229,1,"20,0",2,1,1,4,Low-Value,Can't Lose
3024,547,1,"39,8",4,1,1,6,Mid-Value,Potential Loyalists
3026,311,7,"619,75",5,2,1,8,High-Value,Potential Loyalists
3027,257,3,"169,5",5,1,1,7,Mid-Value,Potential Loyalists
3028,1630,1,"47,4",1,1,1,3,Low-Value,Lost
3030,825,5,"397,85",3,1,1,5,Low-Value,At Risk Customers
3031,38,7,"673,2",5,2,2,9,High-Value,Champions
3032,1657,1,"493,1",1,1,1,3,Low-Value,Lost
3033,1295,2,"180,45",2,1,1,4,Low-Value,Can't Lose
3034,164,1,"29,25",5,1,1,7,Mid-Value,Potential Loyalists
3037,31,3,"38,8",5,1,1,7,Mid-Value,Potential Loyalists
3038,259,8,"460,2",5,2,1,8,High-Value,Potential Loyalists
3039,1355,3,"113,19999999999999",2,1,1,4,Low-Value,Can't Lose
3041,11,1,"24,4",5,1,1,7,Mid-Value,Potential Loyalists
3044,97,2,"45,099999999999994",5,1,1,7,Mid-Value,Potential Loyalists
3045,809,3,"121,85000000000001",3,1,1,5,Low-Value,At Risk Customers
3046,130,2,"289,5",5,1,1,7,Mid-Value,Potential Loyalists
3050,413,5,"455,95",4,1,1,6,Mid-Value,Potential Loyalists
3051,1307,1,"34,4",2,1,1,4,Low-Value,Can't Lose
3053,735,4,"169,0",3,1,1,5,Low-Value,At Risk Customers
3054,651,4,"211,75",4,1,1,6,Mid-Value,Potential Loyalists
3055,783,4,"163,15",3,1,1,5,Low-Value,At Risk Customers
3058,101,1,"63,1",5,1,1,7,Mid-Value,Potential Loyalists
3059,1010,1,"58,6",3,1,1,5,Low-Value,At Risk Customers
3060,1606,3,"120,1",1,1,1,3,Low-Value,Lost
3061,812,2,"30,150000000000002",3,1,1,5,Low-Value,At Risk Customers
3062,1151,1,"2,95",2,1,1,4,Low-Value,Can't Lose
3063,987,1,"65,55",3,1,1,5,Low-Value,At Risk Customers
3064,231,1,"74,95",5,1,1,7,Mid-Value,Potential Loyalists
3065,612,4,"130,75",4,1,1,6,Mid-Value,Potential Loyalists
3066,321,5,"472,45",5,1,1,7,Mid-Value,Potential Loyalists
3067,1210,1,"98,0",2,1,1,4,Low-Value,Can't Lose
3068,421,5,"608,45",4,1,1,6,Mid-Value,Potential Loyalists
3069,837,2,"105,6",3,1,1,5,Low-Value,At Risk Customers
3071,234,4,"829,2",5,1,2,8,High-Value,Potential Loyalists
3073,12,5,"197,6",5,1,1,7,Mid-Value,Potential Loyalists
3074,395,2,"63,55",4,1,1,6,Mid-Value,Potential Loyalists
3079,1784,1,"55,85",1,1,1,3,Low-Value,Lost
3080,934,3,"75,33",3,1,1,5,Low-Value,At Risk Customers
3083,80,4,"150,6",5,1,1,7,Mid-Value,Potential Loyalists
3084,22,1,"63,05",5,1,1,7,Mid-Value,Potential Loyalists
3085,516,2,"115,85",4,1,1,6,Mid-Value,Potential Loyalists
3087,283,8,"517,75",5,2,1,8,High-Value,Potential Loyalists
3088,1188,3,"90,25",2,1,1,4,Low-Value,Can't Lose
3089,497,6,"657,2",4,1,1,6,Mid-Value,Potential Loyalists
3091,431,2,"58,150000000000006",4,1,1,6,Mid-Value,Potential Loyalists
3095,813,4,"179,64999999999998",3,1,1,5,Low-Value,At Risk Customers
3096,549,1,"96,4",4,1,1,6,Mid-Value,Potential Loyalists
3098,864,1,"51,75",3,1,1,5,Low-Value,At Risk Customers
3099,737,9,"708,8",3,2,2,7,Mid-Value,Potential Loyalists
3100,904,1,"114,9",3,1,1,5,Low-Value,At Risk Customers
3101,1468,5,"197,0",1,1,1,3,Low-Value,Lost
3103,186,2,"146,75",5,1,1,7,Mid-Value,Potential Loyalists
3104,38,2,"319,15",5,1,1,7,Mid-Value,Potential Loyalists
3105,116,4,"142,45000000000002",5,1,1,7,Mid-Value,Potential Loyalists
3106,159,3,"197,75",5,1,1,7,Mid-Value,Potential Loyalists
3108,89,6,"136,05",5,1,1,7,Mid-Value,Potential Loyalists
3109,1355,2,"277,0",2,1,1,4,Low-Value,Can't Lose
3110,452,7,"1013,4",4,2,2,8,High-Value,Potential Loyalists
3111,99,7,"1067,3",5,2,2,9,High-Value,Champions
3112,244,4,"235,35",5,1,1,7,Mid-Value,Potential Loyalists
3116,461,4,"182,8",4,1,1,6,Mid-Value,Potential Loyalists
3117,1304,1,"140,0",2,1,1,4,Low-Value,Can't Lose
3119,1522,1,"10,0",1,1,1,3,Low-Value,Lost
3120,1271,1,"40,8",2,1,1,4,Low-Value,Can't Lose
3121,183,1,"25,3",5,1,1,7,Mid-Value,Potential Loyalists
3122,25,1,"29,6",5,1,1,7,Mid-Value,Potential Loyalists
3123,550,2,"147,3",4,1,1,6,Mid-Value,Potential Loyalists
3125,1029,1,"10,23",3,1,1,5,Low-Value,At Risk Customers
3126,734,6,"307,65",3,1,1,5,Low-Value,At Risk Customers
3127,967,1,"36,900000000000006",3,1,1,5,Low-Value,At Risk Customers
3130,4,6,"251,1",5,1,1,7,Mid-Value,Potential Loyalists
3131,487,6,"201,4",4,1,1,6,Mid-Value,Potential Loyalists
3132,101,1,"8,35",5,1,1,7,Mid-Value,Potential Loyalists
3134,403,1,"71,6",4,1,1,6,Mid-Value,Potential Loyalists
3135,59,10,"809,75",5,2,2,9,High-Value,Champions
3137,388,8,"530,5500000000001",4,2,1,7,Mid-Value,Potential Loyalists
3138,411,3,"98,9",4,1,1,6,Mid-Value,Potential Loyalists
3139,1188,2,"40,55",2,1,1,4,Low-Value,Can't Lose
3141,298,6,"338,55",5,1,1,7,Mid-Value,Potential Loyalists
3145,129,2,"153,29999999999998",5,1,1,7,Mid-Value,Potential Loyalists
3146,577,1,"18,3",4,1,1,6,Mid-Value,Potential Loyalists
3147,329,4,"127,65",5,1,1,7,Mid-Value,Potential Loyalists
3150,258,4,"1640,5",5,1,3,9,High-Value,Champions
3151,162,2,"113,30000000000001",5,1,1,7,Mid-Value,Potential Loyalists
3153,1004,2,"55,75",3,1,1,5,Low-Value,At Risk Customers
3156,1409,1,"120,55",2,1,1,4,Low-Value,Can't Lose
3157,643,2,"180,75",4,1,1,6,Mid-Value,Potential Loyalists
3158,863,3,"359,2",3,1,1,5,Low-Value,At Risk Customers
3159,56,7,"275,25",5,2,1,8,High-Value,Potential Loyalists
3160,133,6,"304,8",5,1,1,7,Mid-Value,Potential Loyalists
3162,563,2,"104,85",4,1,1,6,Mid-Value,Potential Loyalists
3164,201,1,"168,6",5,1,1,7,Mid-Value,Potential Loyalists
3165,1816,1,"39,7",1,1,1,3,Low-Value,Lost
3166,587,1,"7,35",4,1,1,6,Mid-Value,Potential Loyalists
3167,173,5,"899,6500000000001",5,1,2,8,High-Value,Potential Loyalists
3168,1154,1,"17,9",2,1,1,4,Low-Value,Can't Lose
3169,1088,1,"21,8",3,1,1,5,Low-Value,At Risk Customers
3171,1530,2,"59,65",1,1,1,3,Low-Value,Lost
3173,386,6,"352,75",4,1,1,6,Mid-Value,Potential Loyalists
3176,1411,3,"179,9",2,1,1,4,Low-Value,Can't Lose
3178,12,3,"120,1",5,1,1,7,Mid-Value,Potential Loyalists
3181,411,1,"38,95",4,1,1,6,Mid-Value,Potential Loyalists
3182,196,12,"482,8",5,3,1,9,High-Value,Champions
3186,885,4,"213,75",3,1,1,5,Low-Value,At Risk Customers
3187,1273,3,"180,8",2,1,1,4,Low-Value,Can't Lose
3189,20,9,"653,45",5,2,1,8,High-Value,Potential Loyalists
3190,132,5,"2373,7000000000003",5,1,4,10,High-Value,Champions
3191,54,10,"585,25",5,2,1,8,High-Value,Potential Loyalists
3193,1241,4,"233,5",2,1,1,4,Low-Value,Can't Lose
3194,1098,8,"606,45",2,2,1,5,Low-Value,At Risk Customers
3196,158,2,"135,55",5,1,1,7,Mid-Value,Potential Loyalists
3197,179,6,"303,8",5,1,1,7,Mid-Value,Potential Loyalists
3201,205,2,"30,599999999999998",5,1,1,7,Mid-Value,Potential Loyalists
3204,88,1,"32,15",5,1,1,7,Mid-Value,Potential Loyalists
3205,43,5,"211,2",5,1,1,7,Mid-Value,Potential Loyalists
3210,220,4,"99,0",5,1,1,7,Mid-Value,Potential Loyalists
3212,535,2,"60,6",4,1,1,6,Mid-Value,Potential Loyalists
3213,62,5,"357,4",5,1,1,7,Mid-Value,Potential Loyalists
3215,788,5,"181,39999999999998",3,1,1,5,Low-Value,At Risk Customers
3216,524,4,"216,60000000000002",4,1,1,6,Mid-Value,Potential Loyalists
3217,487,3,"272,1",4,1,1,6,Mid-Value,Potential Loyalists
3218,586,2,"60,05",4,1,1,6,Mid-Value,Potential Loyalists
3219,488,1,"46,9",4,1,1,6,Mid-Value,Potential Loyalists
3220,574,4,"102,65",4,1,1,6,Mid-Value,Potential Loyalists
3221,342,2,"77,95",5,1,1,7,Mid-Value,Potential Loyalists
3222,1645,2,"138,4",1,1,1,3,Low-Value,Lost
3223,1547,5,"132,9",1,1,1,3,Low-Value,Lost
3226,134,3,"208,0",5,1,1,7,Mid-Value,Potential Loyalists
3230,787,1,"97,85",3,1,1,5,Low-Value,At Risk Customers
3232,551,4,"863,2499999999999",4,1,2,7,Mid-Value,Potential Loyalists
3233,34,3,"271,8",5,1,1,7,Mid-Value,Potential Loyalists
3234,1655,1,"53,4",1,1,1,3,Low-Value,Lost
3235,1503,1,"5,75",1,1,1,3,Low-Value,Lost
3238,683,2,"26,45",4,1,1,6,Mid-Value,Potential Loyalists
3239,8,6,"511,59999999999997",5,1,1,7,Mid-Value,Potential Loyalists
3241,491,2,"352,3",4,1,1,6,Mid-Value,Potential Loyalists
3242,390,6,"277,75",4,1,1,6,Mid-Value,Potential Loyalists
3243,1215,4,"187,65",2,1,1,4,Low-Value,Can't Lose
3244,441,2,"91,9",4,1,1,6,Mid-Value,Potential Loyalists
3245,1247,3,"148,35",2,1,1,4,Low-Value,Can't Lose
3246,614,3,"191,45",4,1,1,6,Mid-Value,Potential Loyalists
3247,44,4,"92,0",5,1,1,7,Mid-Value,Potential Loyalists
3248,1509,3,"146,8",1,1,1,3,Low-Value,Lost
3251,33,4,"150,8",5,1,1,7,Mid-Value,Potential Loyalists
3252,195,1,"34,7",5,1,1,7,Mid-Value,Potential Loyalists
3254,918,2,"90,1",3,1,1,5,Low-Value,At Risk Customers
3255,1379,1,"27,4",2,1,1,4,Low-Value,Can't Lose
3258,599,3,"87,45",4,1,1,6,Mid-Value,Potential Loyalists
3260,203,2,"76,45",5,1,1,7,Mid-Value,Potential Loyalists
3261,966,3,"104,75",3,1,1,5,Low-Value,At Risk Customers
3262,532,4,"131,8",4,1,1,6,Mid-Value,Potential Loyalists
3264,167,1,"23,35",5,1,1,7,Mid-Value,Potential Loyalists
3265,1080,2,"42,55",3,1,1,5,Low-Value,At Risk Customers
3266,256,3,"110,0",5,1,1,7,Mid-Value,Potential Loyalists
3267,34,4,"198,65",5,1,1,7,Mid-Value,Potential Loyalists
3268,1170,4,"160,15",2,1,1,4,Low-Value,Can't Lose
3271,147,2,"219,65",5,1,1,7,Mid-Value,Potential Loyalists
3272,465,4,"196,4",4,1,1,6,Mid-Value,Potential Loyalists
3273,794,4,"170,14999999999998",3,1,1,5,Low-Value,At Risk Customers
3275,596,3,"114,80000000000001",4,1,1,6,Mid-Value,Potential Loyalists
3276,25,3,"67,85",5,1,1,7,Mid-Value,Potential Loyalists
3279,445,3,"161,95",4,1,1,6,Mid-Value,Potential Loyalists
3280,10,6,"387,0",5,1,1,7,Mid-Value,Potential Loyalists
3283,518,2,"45,8",4,1,1,6,Mid-Value,Potential Loyalists
3284,175,3,"189,7",5,1,1,7,Mid-Value,Potential Loyalists
3286,23,6,"249,7",5,1,1,7,Mid-Value,Potential Loyalists
3287,732,1,"86,4",3,1,1,5,Low-Value,At Risk Customers
3289,121,2,"21,85",5,1,1,7,Mid-Value,Potential Loyalists
3290,56,6,"118,45",5,1,1,7,Mid-Value,Potential Loyalists
3291,444,9,"655,75",4,2,1,7,Mid-Value,Potential Loyalists
3292,844,3,"114,5",3,1,1,5,Low-Value,At Risk Customers
3293,17,6,"254,1",5,1,1,7,Mid-Value,Potential Loyalists
3294,903,2,"54,349999999999994",3,1,1,5,Low-Value,At Risk Customers
3295,481,3,"38,7",4,1,1,6,Mid-Value,Potential Loyalists
3296,1190,1,"10,95",2,1,1,4,Low-Value,Can't Lose
3297,1812,1,"48,9",1,1,1,3,Low-Value,Lost
3298,260,6,"64,15",5,1,1,7,Mid-Value,Potential Loyalists
3299,825,3,"144,95000000000002",3,1,1,5,Low-Value,At Risk Customers
3300,337,1,"87,15",5,1,1,7,Mid-Value,Potential Loyalists
3301,984,1,"8,25",3,1,1,5,Low-Value,At Risk Customers
3302,162,3,"86,4",5,1,1,7,Mid-Value,Potential Loyalists
3303,128,2,"69,9",5,1,1,7,Mid-Value,Potential Loyalists
3304,90,4,"379,75",5,1,1,7,Mid-Value,Potential Loyalists
3307,1765,1,"103,95",1,1,1,3,Low-Value,Lost
3309,388,3,"334,4",4,1,1,6,Mid-Value,Potential Loyalists
3310,700,3,"176,60000000000002",4,1,1,6,Mid-Value,Potential Loyalists
3311,0,3,"145,0",5,1,1,7,Mid-Value,Potential Loyalists
3312,129,2,"64,8",5,1,1,7,Mid-Value,Potential Loyalists
3314,82,14,"804,4",5,3,2,10,High-Value,Champions
3315,1520,2,"50,2",1,1,1,3,Low-Value,Lost
3317,25,2,"28,85",5,1,1,7,Mid-Value,Potential Loyalists
3318,193,1,"31,9",5,1,1,7,Mid-Value,Potential Loyalists
3319,738,3,"215,29999999999998",3,1,1,5,Low-Value,At Risk Customers
3320,517,4,"104,85",4,1,1,6,Mid-Value,Potential Loyalists
3323,228,3,"356,75",5,1,1,7,Mid-Value,Potential Loyalists
3325,137,3,"142,0",5,1,1,7,Mid-Value,Potential Loyalists
3326,941,2,"20,049999999999997",3,1,1,5,Low-Value,At Risk Customers
3327,474,1,"24,5",4,1,1,6,Mid-Value,Potential Loyalists
3329,49,3,"271,25",5,1,1,7,Mid-Value,Potential Loyalists
3330,333,5,"1152,3999999999999",5,1,2,8,High-Value,Potential Loyalists
3331,950,2,"92,85",3,1,1,5,Low-Value,At Risk Customers
3332,131,4,"145,20000000000002",5,1,1,7,Mid-Value,Potential Loyalists
3333,459,1,"54,7",4,1,1,6,Mid-Value,Potential Loyalists
3334,38,9,"446,9",5,2,1,8,High-Value,Potential Loyalists
3336,1700,1,"15,6",1,1,1,3,Low-Value,Lost
3337,433,2,"161,20000000000002",4,1,1,6,Mid-Value,Potential Loyalists
3338,67,6,"512,75",5,1,1,7,Mid-Value,Potential Loyalists
3340,981,1,"28,9",3,1,1,5,Low-Value,At Risk Customers
3341,1006,3,"132,2",3,1,1,5,Low-Value,At Risk Customers
3343,917,4,"187,55",3,1,1,5,Low-Value,At Risk Customers
3345,1378,3,"148,45000000000002",2,1,1,4,Low-Value,Can't Lose
3346,210,2,"148,05",5,1,1,7,Mid-Value,Potential Loyalists
3347,68,4,"65,8",5,1,1,7,Mid-Value,Potential Loyalists
3349,377,1,"15,5",4,1,1,6,Mid-Value,Potential Loyalists
3350,831,1,"165,75",3,1,1,5,Low-Value,At Risk Customers
3351,368,1,"5,65",4,1,1,6,Mid-Value,Potential Loyalists
3355,91,5,"209,55",5,1,1,7,Mid-Value,Potential Loyalists
3357,75,9,"327,95",5,2,1,8,High-Value,Potential Loyalists
3359,420,1,"22,75",4,1,1,6,Mid-Value,Potential Loyalists
3360,392,5,"135,6",4,1,1,6,Mid-Value,Potential Loyalists
3361,33,2,"40,0",5,1,1,7,Mid-Value,Potential Loyalists
3362,579,4,"701,3",4,1,2,7,Mid-Value,Potential Loyalists
3363,31,12,"503,9",5,3,1,9,High-Value,Champions
3366,626,2,"57,95",4,1,1,6,Mid-Value,Potential Loyalists
3367,854,1,"21,95",3,1,1,5,Low-Value,At Risk Customers
3369,313,2,"82,7",5,1,1,7,Mid-Value,Potential Loyalists
3370,1361,1,"107,85000000000001",2,1,1,4,Low-Value,Can't Lose
3372,215,4,"135,15",5,1,1,7,Mid-Value,Potential Loyalists
3373,764,2,"81,9",3,1,1,5,Low-Value,At Risk Customers
3374,540,2,"89,6",4,1,1,6,Mid-Value,Potential Loyalists
3375,26,2,"65,4",5,1,1,7,Mid-Value,Potential Loyalists
3379,1054,1,"7,25",3,1,1,5,Low-Value,At Risk Customers
3380,1196,3,"168,15",2,1,1,4,Low-Value,Can't Lose
3383,1434,1,"8,35",2,1,1,4,Low-Value,Can't Lose
3386,1091,1,"38,3",3,1,1,5,Low-Value,At Risk Customers
3387,1133,1,"7,7",2,1,1,4,Low-Value,Can't Lose
3388,476,4,"229,0",4,1,1,6,Mid-Value,Potential Loyalists
3390,953,4,"251,85",3,1,1,5,Low-Value,At Risk Customers
3393,31,1,"40,7",5,1,1,7,Mid-Value,Potential Loyalists
3394,692,1,"66,5",4,1,1,6,Mid-Value,Potential Loyalists
3395,680,2,"43,55",4,1,1,6,Mid-Value,Potential Loyalists
3398,832,2,"239,15",3,1,1,5,Low-Value,At Risk Customers
3399,653,1,"22,8",4,1,1,6,Mid-Value,Potential Loyalists
3400,10,2,"613,6999999999999",5,1,1,7,Mid-Value,Potential Loyalists
3401,31,7,"260,9",5,2,1,8,High-Value,Potential Loyalists
3402,40,4,"259,7",5,1,1,7,Mid-Value,Potential Loyalists
3403,870,2,"142,5",3,1,1,5,Low-Value,At Risk Customers
3404,990,2,"31,75",3,1,1,5,Low-Value,At Risk Customers
3405,526,5,"161,7",4,1,1,6,Mid-Value,Potential Loyalists
3407,91,4,"89,65",5,1,1,7,Mid-Value,Potential Loyalists
3412,1272,2,"48,65",2,1,1,4,Low-Value,Can't Lose
3413,1154,1,"22,5",2,1,1,4,Low-Value,Can't Lose
3414,1657,1,"13,5",1,1,1,3,Low-Value,Lost
3415,333,5,"424,4",5,1,1,7,Mid-Value,Potential Loyalists
3416,56,7,"784,2",5,2,2,9,High-Value,Champions
3419,508,1,"48,4",4,1,1,6,Mid-Value,Potential Loyalists
3422,466,2,"167,05",4,1,1,6,Mid-Value,Potential Loyalists
3423,1071,1,"20,45",3,1,1,5,Low-Value,At Risk Customers
3425,595,3,"58,05",4,1,1,6,Mid-Value,Potential Loyalists
3426,1551,2,"206,4",1,1,1,3,Low-Value,Lost
3429,39,2,"84,19999999999999",5,1,1,7,Mid-Value,Potential Loyalists
3430,1187,2,"437,54999999999995",2,1,1,4,Low-Value,Can't Lose
3432,854,2,"175,5",3,1,1,5,Low-Value,At Risk Customers
3433,195,6,"174,70000000000002",5,1,1,7,Mid-Value,Potential Loyalists
3435,173,2,"30,6",5,1,1,7,Mid-Value,Potential Loyalists
3436,11,7,"315,45",5,2,1,8,High-Value,Potential Loyalists
3437,844,2,"515,85",3,1,1,5,Low-Value,At Risk Customers
3438,1452,2,"28,36",2,1,1,4,Low-Value,Can't Lose
3439,923,3,"531,1",3,1,1,5,Low-Value,At Risk Customers
3442,364,5,"373,3",5,1,1,7,Mid-Value,Potential Loyalists
3443,1722,1,"21,3",1,1,1,3,Low-Value,Lost
3444,873,1,"33,1",3,1,1,5,Low-Value,At Risk Customers
3445,93,2,"21,05",5,1,1,7,Mid-Value,Potential Loyalists
3446,1635,3,"157,39999999999998",1,1,1,3,Low-Value,Lost
3447,1152,1,"61,15",2,1,1,4,Low-Value,Can't Lose
3449,1136,1,"9,35",2,1,1,4,Low-Value,Can't Lose
3450,648,2,"141,7",4,1,1,6,Mid-Value,Potential Loyalists
3451,797,2,"60,1",3,1,1,5,Low-Value,At Risk Customers
3454,1574,3,"107,55",1,1,1,3,Low-Value,Lost
3456,383,4,"364,25",4,1,1,6,Mid-Value,Potential Loyalists
3457,792,2,"65,30000000000001",3,1,1,5,Low-Value,At Risk Customers
3458,778,1,"57,05",3,1,1,5,Low-Value,At Risk Customers
3461,1294,1,"8,95",2,1,1,4,Low-Value,Can't Lose
3462,1621,1,"124,3",1,1,1,3,Low-Value,Lost
3463,209,5,"322,01",5,1,1,7,Mid-Value,Potential Loyalists
3465,207,4,"264,6",5,1,1,7,Mid-Value,Potential Loyalists
3467,643,2,"67,35",4,1,1,6,Mid-Value,Potential Loyalists
3468,675,1,"26,5",4,1,1,6,Mid-Value,Potential Loyalists
3469,397,6,"241,4",4,1,1,6,Mid-Value,Potential Loyalists
3470,451,1,"122,8",4,1,1,6,Mid-Value,Potential Loyalists
3472,1229,1,"45,75",2,1,1,4,Low-Value,Can't Lose
3473,122,1,"75,6",5,1,1,7,Mid-Value,Potential Loyalists
3474,691,3,"101,95",4,1,1,6,Mid-Value,Potential Loyalists
3475,890,3,"202,9",3,1,1,5,Low-Value,At Risk Customers
3476,131,8,"557,8000000000001",5,2,1,8,High-Value,Potential Loyalists
3477,1242,1,"35,4",2,1,1,4,Low-Value,Can't Lose
3478,24,5,"353,34999999999997",5,1,1,7,Mid-Value,Potential Loyalists
3484,407,5,"368,95",4,1,1,6,Mid-Value,Potential Loyalists
3486,1014,1,"109,1",3,1,1,5,Low-Value,At Risk Customers
3487,190,8,"717,3000000000001",5,2,2,9,High-Value,Champions
3488,59,2,"135,35",5,1,1,7,Mid-Value,Potential Loyalists
3489,1024,2,"29,950000000000003",3,1,1,5,Low-Value,At Risk Customers
3490,204,2,"205,35",5,1,1,7,Mid-Value,Potential Loyalists
3491,657,1,"9,3",4,1,1,6,Mid-Value,Potential Loyalists
3492,565,4,"390,05",4,1,1,6,Mid-Value,Potential Loyalists
3493,1765,1,"76,3",1,1,1,3,Low-Value,Lost
3494,657,2,"130,8",4,1,1,6,Mid-Value,Potential Loyalists
3498,1370,2,"274,75",2,1,1,4,Low-Value,Can't Lose
3501,850,4,"283,15",3,1,1,5,Low-Value,At Risk Customers
3502,917,1,"14,8",3,1,1,5,Low-Value,At Risk Customers
3503,381,3,"154,55",4,1,1,6,Mid-Value,Potential Loyalists
3504,411,4,"286,05",4,1,1,6,Mid-Value,Potential Loyalists
3505,12,11,"635,0",5,2,1,8,High-Value,Potential Loyalists
3507,781,4,"182,45000000000002",3,1,1,5,Low-Value,At Risk Customers
3509,1242,1,"158,0",2,1,1,4,Low-Value,Can't Lose
3510,54,6,"231,8",5,1,1,7,Mid-Value,Potential Loyalists
3513,803,7,"604,4499999999999",3,2,1,6,Mid-Value,Potential Loyalists
3514,551,2,"118,0",4,1,1,6,Mid-Value,Potential Loyalists
3516,239,3,"127,44999999999999",5,1,1,7,Mid-Value,Potential Loyalists
3517,528,3,"113,45",4,1,1,6,Mid-Value,Potential Loyalists
3520,448,7,"1205,3",4,2,2,8,High-Value,Potential Loyalists
3521,64,9,"237,15",5,2,1,8,High-Value,Potential Loyalists
3522,806,4,"166,15",3,1,1,5,Low-Value,At Risk Customers
3523,295,3,"100,55",5,1,1,7,Mid-Value,Potential Loyalists
3524,713,1,"50,4",4,1,1,6,Mid-Value,Potential Loyalists
3525,292,1,"143,1",5,1,1,7,Mid-Value,Potential Loyalists
3526,731,4,"192,85000000000002",3,1,1,5,Low-Value,At Risk Customers
3527,963,2,"989,2500000000001",3,1,2,6,Mid-Value,Potential Loyalists
3528,402,7,"271,65",4,2,1,7,Mid-Value,Potential Loyalists
3529,1151,2,"112,4",2,1,1,4,Low-Value,Can't Lose
3531,56,5,"218,9",5,1,1,7,Mid-Value,Potential Loyalists
3532,935,2,"113,8",3,1,1,5,Low-Value,At Risk Customers
3533,1474,2,"36,3",1,1,1,3,Low-Value,Lost
3534,127,2,"87,05000000000001",5,1,1,7,Mid-Value,Potential Loyalists
3535,824,2,"139,35000000000002",3,1,1,5,Low-Value,At Risk Customers
3537,236,2,"182,75",5,1,1,7,Mid-Value,Potential Loyalists
3538,392,1,"85,05000000000001",4,1,1,6,Mid-Value,Potential Loyalists
3539,286,4,"147,55",5,1,1,7,Mid-Value,Potential Loyalists
3540,511,2,"128,9",4,1,1,6,Mid-Value,Potential Loyalists
3541,113,2,"79,19999999999999",5,1,1,7,Mid-Value,Potential Loyalists
3542,379,2,"224,54999999999998",4,1,1,6,Mid-Value,Potential Loyalists
3543,32,5,"180,7",5,1,1,7,Mid-Value,Potential Loyalists
3544,443,3,"191,05",4,1,1,6,Mid-Value,Potential Loyalists
3545,330,4,"463,75",5,1,1,7,Mid-Value,Potential Loyalists
3548,757,4,"403,2",3,1,1,5,Low-Value,At Risk Customers
3549,127,2,"107,35000000000001",5,1,1,7,Mid-Value,Potential Loyalists
3550,567,1,"71,1",4,1,1,6,Mid-Value,Potential Loyalists
3551,470,7,"433,35",4,2,1,7,Mid-Value,Potential Loyalists
3552,368,3,"136,45",4,1,1,6,Mid-Value,Potential Loyalists
3553,122,4,"252,55",5,1,1,7,Mid-Value,Potential Loyalists
3554,187,4,"130,5",5,1,1,7,Mid-Value,Potential Loyalists
3555,1048,2,"32,300000000000004",3,1,1,5,Low-Value,At Risk Customers
3556,193,3,"116,8",5,1,1,7,Mid-Value,Potential Loyalists
3557,82,1,"20,6",5,1,1,7,Mid-Value,Potential Loyalists
3558,534,1,"14,55",4,1,1,6,Mid-Value,Potential Loyalists
3560,408,3,"49,6",4,1,1,6,Mid-Value,Potential Loyalists
3561,570,2,"121,89999999999999",4,1,1,6,Mid-Value,Potential Loyalists
3562,285,6,"251,55",5,1,1,7,Mid-Value,Potential Loyalists
3564,1617,1,"84,3",1,1,1,3,Low-Value,Lost
3565,412,3,"45,95",4,1,1,6,Mid-Value,Potential Loyalists
3566,320,6,"173,8",5,1,1,7,Mid-Value,Potential Loyalists
3567,48,1,"20,4",5,1,1,7,Mid-Value,Potential Loyalists
3574,1039,4,"165,2",3,1,1,5,Low-Value,At Risk Customers
3575,822,3,"103,05",3,1,1,5,Low-Value,At Risk Customers
3581,395,2,"36,099999999999994",4,1,1,6,Mid-Value,Potential Loyalists
3583,523,2,"78,45",4,1,1,6,Mid-Value,Potential Loyalists
3585,164,5,"1046,25",5,1,2,8,High-Value,Potential Loyalists
3586,80,13,"770,9",5,3,2,10,High-Value,Champions
3587,1285,1,"42,9",2,1,1,4,Low-Value,Can't Lose
3589,1303,1,"22,5",2,1,1,4,Low-Value,Can't Lose
3590,721,2,"100,0",4,1,1,6,Mid-Value,Potential Loyalists
3591,126,5,"337,86",5,1,1,7,Mid-Value,Potential Loyalists
3592,1058,1,"16,75",3,1,1,5,Low-Value,At Risk Customers
3593,106,13,"759,5",5,3,2,10,High-Value,Champions
3594,444,3,"161,8",4,1,1,6,Mid-Value,Potential Loyalists
3595,348,1,"31,4",5,1,1,7,Mid-Value,Potential Loyalists
3596,343,5,"223,54999999999998",5,1,1,7,Mid-Value,Potential Loyalists
3597,306,3,"32,7",5,1,1,7,Mid-Value,Potential Loyalists
3598,914,3,"200,25",3,1,1,5,Low-Value,At Risk Customers
3599,1013,1,"19,95",3,1,1,5,Low-Value,At Risk Customers
3600,228,3,"150,3",5,1,1,7,Mid-Value,Potential Loyalists
3601,754,2,"857,1",3,1,2,6,Mid-Value,Potential Loyalists
3604,1611,1,"20,9",1,1,1,3,Low-Value,Lost
3605,321,3,"177,8",5,1,1,7,Mid-Value,Potential Loyalists
3606,71,3,"35,449999999999996",5,1,1,7,Mid-Value,Potential Loyalists
3607,2,6,"414,9",5,1,1,7,Mid-Value,Potential Loyalists
3608,539,2,"87,35000000000001",4,1,1,6,Mid-Value,Potential Loyalists
3609,1548,1,"43,95",1,1,1,3,Low-Value,Lost
3610,911,6,"404,45000000000005",3,1,1,5,Low-Value,At Risk Customers
3613,580,1,"54,0",4,1,1,6,Mid-Value,Potential Loyalists
3614,168,4,"138,4",5,1,1,7,Mid-Value,Potential Loyalists
3615,228,2,"45,150000000000006",5,1,1,7,Mid-Value,Potential Loyalists
3618,763,3,"126,1",3,1,1,5,Low-Value,At Risk Customers
3619,657,1,"7,3",4,1,1,6,Mid-Value,Potential Loyalists
3620,867,6,"290,15000000000003",3,1,1,5,Low-Value,At Risk Customers
3621,255,1,"32,25",5,1,1,7,Mid-Value,Potential Loyalists
3622,1281,2,"23,35",2,1,1,4,Low-Value,Can't Lose
3625,553,8,"516,55",4,2,1,7,Mid-Value,Potential Loyalists
3626,1275,3,"223,5",2,1,1,4,Low-Value,Can't Lose
3627,668,1,"14,55",4,1,1,6,Mid-Value,Potential Loyalists
3628,1590,1,"21,7",1,1,1,3,Low-Value,Lost
3629,206,2,"144,9",5,1,1,7,Mid-Value,Potential Loyalists
3632,256,8,"377,2",5,2,1,8,High-Value,Potential Loyalists
3633,179,5,"274,5",5,1,1,7,Mid-Value,Potential Loyalists
3634,152,5,"215,5",5,1,1,7,Mid-Value,Potential Loyalists
3635,1145,5,"253,7",2,1,1,4,Low-Value,Can't Lose
3636,52,4,"671,15",5,1,2,8,High-Value,Potential Loyalists
3638,263,1,"62,9",5,1,1,7,Mid-Value,Potential Loyalists
3640,473,3,"98,0",4,1,1,6,Mid-Value,Potential Loyalists
3641,1384,4,"142,85",2,1,1,4,Low-Value,Can't Lose
3643,339,1,"91,0",5,1,1,7,Mid-Value,Potential Loyalists
3644,1547,2,"46,7",1,1,1,3,Low-Value,Lost
3646,294,5,"239,45",5,1,1,7,Mid-Value,Potential Loyalists
3647,334,1,"115,05000000000001",5,1,1,7,Mid-Value,Potential Loyalists
3649,866,4,"91,88",3,1,1,5,Low-Value,At Risk Customers
3651,735,2,"62,35",3,1,1,5,Low-Value,At Risk Customers
3652,1327,1,"25,5",2,1,1,4,Low-Value,Can't Lose
3653,69,5,"125,2",5,1,1,7,Mid-Value,Potential Loyalists
3655,565,2,"70,05",4,1,1,6,Mid-Value,Potential Loyalists
3656,747,6,"310,75",3,1,1,5,Low-Value,At Risk Customers
3657,183,5,"278,29999999999995",5,1,1,7,Mid-Value,Potential Loyalists
3658,576,2,"119,3",4,1,1,6,Mid-Value,Potential Loyalists
3661,1315,5,"399,5",2,1,1,4,Low-Value,Can't Lose
3662,1157,3,"178,15",2,1,1,4,Low-Value,Can't Lose
3663,148,2,"66,0",5,1,1,7,Mid-Value,Potential Loyalists
3664,77,4,"118,60000000000001",5,1,1,7,Mid-Value,Potential Loyalists
3667,348,11,"456,0",5,2,1,8,High-Value,Potential Loyalists
3668,543,1,"20,0",4,1,1,6,Mid-Value,Potential Loyalists
3669,528,2,"182,7",4,1,1,6,Mid-Value,Potential Loyalists
3670,228,6,"404,0",5,1,1,7,Mid-Value,Potential Loyalists
3673,1296,1,"126,85",2,1,1,4,Low-Value,Can't Lose
3675,963,2,"75,1",3,1,1,5,Low-Value,At Risk Customers
3677,1151,1,"20,95",2,1,1,4,Low-Value,Can't Lose
3678,4,6,"484,75",5,1,1,7,Mid-Value,Potential Loyalists
3680,481,7,"501,15",4,2,1,7,Mid-Value,Potential Loyalists
3681,99,5,"388,15000000000003",5,1,1,7,Mid-Value,Potential Loyalists
3682,1022,3,"113,3",3,1,1,5,Low-Value,At Risk Customers
3683,251,1,"59,4",5,1,1,7,Mid-Value,Potential Loyalists
3686,1308,2,"69,69999999999999",2,1,1,4,Low-Value,Can't Lose
3692,703,5,"491,6",4,1,1,6,Mid-Value,Potential Loyalists
3696,747,5,"207,8",3,1,1,5,Low-Value,At Risk Customers
3699,561,2,"157,6",4,1,1,6,Mid-Value,Potential Loyalists
3700,8,8,"667,45",5,2,2,9,High-Value,Champions
3701,212,4,"92,0",5,1,1,7,Mid-Value,Potential Loyalists
3703,792,5,"971,0",3,1,2,6,Mid-Value,Potential Loyalists
3705,781,1,"60,65",3,1,1,5,Low-Value,At Risk Customers
3706,1447,1,"11,5",2,1,1,4,Low-Value,Can't Lose
3707,500,3,"250,2",4,1,1,6,Mid-Value,Potential Loyalists
3709,403,1,"17,9",4,1,1,6,Mid-Value,Potential Loyalists
3710,1194,1,"10,35",2,1,1,4,Low-Value,Can't Lose
3711,1789,1,"32,7",1,1,1,3,Low-Value,Lost
3712,1343,1,"47,4",2,1,1,4,Low-Value,Can't Lose
3713,273,2,"96,25",5,1,1,7,Mid-Value,Potential Loyalists
3714,1188,2,"49,7",2,1,1,4,Low-Value,Can't Lose
3715,1503,1,"6,1",1,1,1,3,Low-Value,Lost
3716,445,2,"46,85",4,1,1,6,Mid-Value,Potential Loyalists
3719,383,1,"1,35",4,1,1,6,Mid-Value,Potential Loyalists
3720,85,3,"74,75",5,1,1,7,Mid-Value,Potential Loyalists
3721,1467,1,"41,4",1,1,1,3,Low-Value,Lost
3724,874,3,"131,35",3,1,1,5,Low-Value,At Risk Customers
3727,5,4,"375,75",5,1,1,7,Mid-Value,Potential Loyalists
3730,644,1,"130,2",4,1,1,6,Mid-Value,Potential Loyalists
3731,416,1,"136,4",4,1,1,6,Mid-Value,Potential Loyalists
3732,74,1,"42,45",5,1,1,7,Mid-Value,Potential Loyalists
3733,361,3,"57,9",5,1,1,7,Mid-Value,Potential Loyalists
3735,228,4,"101,2",5,1,1,7,Mid-Value,Potential Loyalists
3736,228,7,"605,25",5,2,1,8,High-Value,Potential Loyalists
3738,36,3,"311,9",5,1,1,7,Mid-Value,Potential Loyalists
3739,145,6,"515,8",5,1,1,7,Mid-Value,Potential Loyalists
3741,9,2,"48,449999999999996",5,1,1,7,Mid-Value,Potential Loyalists
3743,971,3,"175,9",3,1,1,5,Low-Value,At Risk Customers
3744,498,4,"91,69999999999999",4,1,1,6,Mid-Value,Potential Loyalists
3745,759,3,"101,9",3,1,1,5,Low-Value,At Risk Customers
3746,52,3,"81,39999999999999",5,1,1,7,Mid-Value,Potential Loyalists
3748,899,3,"405,4",3,1,1,5,Low-Value,At Risk Customers
3749,802,5,"290,5",3,1,1,5,Low-Value,At Risk Customers
3751,78,4,"228,35",5,1,1,7,Mid-Value,Potential Loyalists
3753,1116,2,"96,5",2,1,1,4,Low-Value,Can't Lose
3755,1155,2,"100,15",2,1,1,4,Low-Value,Can't Lose
3761,25,2,"253,0",5,1,1,7,Mid-Value,Potential Loyalists
3762,614,1,"582,5999999999999",4,1,1,6,Mid-Value,Potential Loyalists
3764,53,2,"35,2",5,1,1,7,Mid-Value,Potential Loyalists
3766,851,3,"114,6",3,1,1,5,Low-Value,At Risk Customers
3769,553,3,"139,2",4,1,1,6,Mid-Value,Potential Loyalists
3770,381,11,"856,53",4,2,2,8,High-Value,Potential Loyalists
3771,566,1,"60,7",4,1,1,6,Mid-Value,Potential Loyalists
3772,1285,3,"333,04999999999995",2,1,1,4,Low-Value,Can't Lose
3773,280,1,"9,3",5,1,1,7,Mid-Value,Potential Loyalists
3774,316,3,"41,699999999999996",5,1,1,7,Mid-Value,Potential Loyalists
3775,1723,1,"3,8",1,1,1,3,Low-Value,Lost
3777,612,1,"18,2",4,1,1,6,Mid-Value,Potential Loyalists
3780,375,2,"128,85",4,1,1,6,Mid-Value,Potential Loyalists
3781,257,2,"13,5",5,1,1,7,Mid-Value,Potential Loyalists
3785,442,2,"52,45",4,1,1,6,Mid-Value,Potential Loyalists
3788,1606,1,"7,95",1,1,1,3,Low-Value,Lost
3789,679,5,"176,95",4,1,1,6,Mid-Value,Potential Loyalists
3792,542,3,"256,45",4,1,1,6,Mid-Value,Potential Loyalists
3793,309,1,"22,8",5,1,1,7,Mid-Value,Potential Loyalists
3794,550,3,"112,35",4,1,1,6,Mid-Value,Potential Loyalists
3795,161,9,"380,70000000000005",5,2,1,8,High-Value,Potential Loyalists
3798,402,5,"178,15",4,1,1,6,Mid-Value,Potential Loyalists
3800,994,2,"82,8",3,1,1,5,Low-Value,At Risk Customers
3801,291,4,"301,4",5,1,1,7,Mid-Value,Potential Loyalists
3802,1457,1,"127,2",2,1,1,4,Low-Value,Can't Lose
3803,291,3,"54,650000000000006",5,1,1,7,Mid-Value,Potential Loyalists
3804,33,2,"98,55000000000001",5,1,1,7,Mid-Value,Potential Loyalists
3805,9,3,"345,29999999999995",5,1,1,7,Mid-Value,Potential Loyalists
3806,2,5,"283,55",5,1,1,7,Mid-Value,Potential Loyalists
3808,344,3,"44,5",5,1,1,7,Mid-Value,Potential Loyalists
3809,269,2,"61,75",5,1,1,7,Mid-Value,Potential Loyalists
3810,508,3,"161,5",4,1,1,6,Mid-Value,Potential Loyalists
3811,152,7,"270,45",5,2,1,8,High-Value,Potential Loyalists
3815,724,3,"171,15",4,1,1,6,Mid-Value,Potential Loyalists
3816,267,4,"163,85",5,1,1,7,Mid-Value,Potential Loyalists
3819,215,6,"183,9",5,1,1,7,Mid-Value,Potential Loyalists
3821,36,4,"346,85",5,1,1,7,Mid-Value,Potential Loyalists
3823,176,6,"805,1",5,1,2,8,High-Value,Potential Loyalists
3825,49,3,"545,0",5,1,1,7,Mid-Value,Potential Loyalists
3826,734,5,"284,0",3,1,1,5,Low-Value,At Risk Customers
3827,440,6,"421,65",4,1,1,6,Mid-Value,Potential Loyalists
3828,35,8,"389,8",5,2,1,8,High-Value,Potential Loyalists
3829,1106,3,"96,4",2,1,1,4,Low-Value,Can't Lose
3830,921,4,"101,9",3,1,1,5,Low-Value,At Risk Customers
3831,340,1,"117,8",5,1,1,7,Mid-Value,Potential Loyalists
3832,326,2,"133,75",5,1,1,7,Mid-Value,Potential Loyalists
3833,417,2,"59,35",4,1,1,6,Mid-Value,Potential Loyalists
3834,133,2,"77,85000000000001",5,1,1,7,Mid-Value,Potential Loyalists
3836,197,2,"244,5",5,1,1,7,Mid-Value,Potential Loyalists
3841,1618,2,"265,7",1,1,1,3,Low-Value,Lost
3842,781,3,"271,3",3,1,1,5,Low-Value,At Risk Customers
3843,1342,1,"6,6000000000000005",2,1,1,4,Low-Value,Can't Lose
3844,264,11,"497,75",5,2,1,8,High-Value,Potential Loyalists
3845,22,10,"758,2",5,2,2,9,High-Value,Champions
3846,124,11,"359,6",5,2,1,8,High-Value,Potential Loyalists
3847,530,1,"59,3",4,1,1,6,Mid-Value,Potential Loyalists
3855,862,1,"61,9",3,1,1,5,Low-Value,At Risk Customers
3856,935,1,"98,69999999999999",3,1,1,5,Low-Value,At Risk Customers
3857,644,1,"38,15",4,1,1,6,Mid-Value,Potential Loyalists
3858,785,4,"141,7",3,1,1,5,Low-Value,At Risk Customers
3860,154,1,"8,7",5,1,1,7,Mid-Value,Potential Loyalists
3862,20,3,"355,15000000000003",5,1,1,7,Mid-Value,Potential Loyalists
3863,281,2,"211,10000000000002",5,1,1,7,Mid-Value,Potential Loyalists
3864,557,1,"13,4",4,1,1,6,Mid-Value,Potential Loyalists
3866,642,5,"438,2",4,1,1,6,Mid-Value,Potential Loyalists
3867,334,5,"244,25",5,1,1,7,Mid-Value,Potential Loyalists
3869,101,3,"49,05",5,1,1,7,Mid-Value,Potential Loyalists
3871,1556,1,"40,0",1,1,1,3,Low-Value,Lost
3872,710,3,"109,5",4,1,1,6,Mid-Value,Potential Loyalists
3873,1469,1,"400,65000000000003",1,1,1,3,Low-Value,Lost
3874,25,2,"170,25",5,1,1,7,Mid-Value,Potential Loyalists
3875,1371,1,"22,6",2,1,1,4,Low-Value,Can't Lose
3876,48,4,"242,70000000000002",5,1,1,7,Mid-Value,Potential Loyalists
3879,108,4,"112,2",5,1,1,7,Mid-Value,Potential Loyalists
3880,1350,3,"119,8",2,1,1,4,Low-Value,Can't Lose
3881,738,4,"208,2",3,1,1,5,Low-Value,At Risk Customers
3883,163,7,"259,15",5,2,1,8,High-Value,Potential Loyalists
3884,129,5,"579,9499999999999",5,1,1,7,Mid-Value,Potential Loyalists
3887,420,7,"172,65",4,2,1,7,Mid-Value,Potential Loyalists
3890,544,1,"93,75",4,1,1,6,Mid-Value,Potential Loyalists
3892,73,4,"145,95",5,1,1,7,Mid-Value,Potential Loyalists
3898,824,3,"244,5",3,1,1,5,Low-Value,At Risk Customers
3899,416,3,"203,8",4,1,1,6,Mid-Value,Potential Loyalists
3900,1469,1,"117,8",1,1,1,3,Low-Value,Lost
3901,1586,2,"37,6",1,1,1,3,Low-Value,Lost
3903,1560,1,"11,7",1,1,1,3,Low-Value,Lost
3904,549,3,"115,95",4,1,1,6,Mid-Value,Potential Loyalists
3905,186,9,"340,5",5,2,1,8,High-Value,Potential Loyalists
3907,561,1,"94,2",4,1,1,6,Mid-Value,Potential Loyalists
3908,876,1,"17,2",3,1,1,5,Low-Value,At Risk Customers
3909,52,6,"398,05",5,1,1,7,Mid-Value,Potential Loyalists
3910,242,4,"197,05",5,1,1,7,Mid-Value,Potential Loyalists
3911,162,5,"338,35",5,1,1,7,Mid-Value,Potential Loyalists
3913,262,1,"36,5",5,1,1,7,Mid-Value,Potential Loyalists
3920,180,8,"629,9499999999999",5,2,1,8,High-Value,Potential Loyalists
3921,70,3,"102,7",5,1,1,7,Mid-Value,Potential Loyalists
3923,24,8,"518,2",5,2,1,8,High-Value,Potential Loyalists
3925,297,7,"326,3",5,2,1,8,High-Value,Potential Loyalists
3927,1150,3,"121,35000000000001",2,1,1,4,Low-Value,Can't Lose
3929,781,3,"174,95",3,1,1,5,Low-Value,At Risk Customers
3930,161,4,"173,75",5,1,1,7,Mid-Value,Potential Loyalists
3931,11,6,"224,3",5,1,1,7,Mid-Value,Potential Loyalists
3933,798,1,"97,3",3,1,1,5,Low-Value,At Risk Customers
3935,47,7,"516,3",5,2,1,8,High-Value,Potential Loyalists
3936,461,1,"20,1",4,1,1,6,Mid-Value,Potential Loyalists
3937,65,1,"41,4",5,1,1,7,Mid-Value,Potential Loyalists
3938,941,1,"117,8",3,1,1,5,Low-Value,At Risk Customers
3939,1375,1,"77,7",2,1,1,4,Low-Value,Can't Lose
3940,1021,3,"159,6",3,1,1,5,Low-Value,At Risk Customers
3944,1054,2,"81,80000000000001",3,1,1,5,Low-Value,At Risk Customers
3951,745,5,"420,79999999999995",3,1,1,5,Low-Value,At Risk Customers
3952,390,4,"103,39999999999999",4,1,1,6,Mid-Value,Potential Loyalists
3954,1092,2,"90,4",3,1,1,5,Low-Value,At Risk Customers
3956,47,3,"320,55",5,1,1,7,Mid-Value,Potential Loyalists
3958,11,2,"239,2",5,1,1,7,Mid-Value,Potential Loyalists
3961,232,4,"120,55000000000001",5,1,1,7,Mid-Value,Potential Loyalists
3962,195,5,"220,04999999999998",5,1,1,7,Mid-Value,Potential Loyalists
3963,546,6,"234,75",4,1,1,6,Mid-Value,Potential Loyalists
3964,10,3,"106,55",5,1,1,7,Mid-Value,Potential Loyalists
3965,20,8,"370,15",5,2,1,8,High-Value,Potential Loyalists
3968,33,3,"105,7",5,1,1,7,Mid-Value,Potential Loyalists
3969,171,1,"58,9",5,1,1,7,Mid-Value,Potential Loyalists
3970,530,2,"100,25",4,1,1,6,Mid-Value,Potential Loyalists
3973,566,1,"76,9",4,1,1,6,Mid-Value,Potential Loyalists
3976,1160,5,"151,29999999999998",2,1,1,4,Low-Value,Can't Lose
3977,25,7,"436,59999999999997",5,2,1,8,High-Value,Potential Loyalists
3982,251,6,"595,5",5,1,1,7,Mid-Value,Potential Loyalists
3985,1082,1,"0,6",3,1,1,5,Low-Value,At Risk Customers
3986,483,1,"17,25",4,1,1,6,Mid-Value,Potential Loyalists
3987,1525,3,"280,25",1,1,1,3,Low-Value,Lost
3988,1513,2,"42,0",1,1,1,3,Low-Value,Lost
3989,3,6,"161,5",5,1,1,7,Mid-Value,Potential Loyalists
3990,18,2,"194,55",5,1,1,7,Mid-Value,Potential Loyalists
3994,384,3,"84,6",4,1,1,6,Mid-Value,Potential Loyalists
3997,1010,1,"9,7",3,1,1,5,Low-Value,At Risk Customers
3998,1014,3,"175,29999999999998",3,1,1,5,Low-Value,At Risk Customers
4001,775,2,"43,3",3,1,1,5,Low-Value,At Risk Customers
4004,785,3,"91,15",3,1,1,5,Low-Value,At Risk Customers
4006,1307,1,"174,8",2,1,1,4,Low-Value,Can't Lose
4007,393,3,"169,5",4,1,1,6,Mid-Value,Potential Loyalists
4008,433,9,"632,5",4,2,1,7,Mid-Value,Potential Loyalists
4009,15,5,"431,3",5,1,1,7,Mid-Value,Potential Loyalists
4010,433,7,"385,7",4,2,1,7,Mid-Value,Potential Loyalists
4011,771,4,"97,85000000000001",3,1,1,5,Low-Value,At Risk Customers
4012,17,4,"379,7",5,1,1,7,Mid-Value,Potential Loyalists
4014,1112,2,"160,15",2,1,1,4,Low-Value,Can't Lose
4016,12,10,"259,2",5,2,1,8,High-Value,Potential Loyalists
4018,492,5,"242,2",4,1,1,6,Mid-Value,Potential Loyalists
4019,1427,1,"63,8",2,1,1,4,Low-Value,Can't Lose
4021,10,10,"499,45",5,2,1,8,High-Value,Potential Loyalists
4022,399,2,"183,35",4,1,1,6,Mid-Value,Potential Loyalists
4023,216,1,"26,85",5,1,1,7,Mid-Value,Potential Loyalists
4024,120,2,"116,1",5,1,1,7,Mid-Value,Potential Loyalists
4026,136,8,"499,5",5,2,1,8,High-Value,Potential Loyalists
4027,123,2,"67,05000000000001",5,1,1,7,Mid-Value,Potential Loyalists
4028,318,3,"53,6",5,1,1,7,Mid-Value,Potential Loyalists
4030,962,5,"422,0",3,1,1,5,Low-Value,At Risk Customers
4032,128,1,"37,0",5,1,1,7,Mid-Value,Potential Loyalists
4033,15,5,"156,95",5,1,1,7,Mid-Value,Potential Loyalists
4034,60,4,"207,25000000000003",5,1,1,7,Mid-Value,Potential Loyalists
4037,386,7,"357,90999999999997",4,2,1,7,Mid-Value,Potential Loyalists
4040,304,2,"153,95",5,1,1,7,Mid-Value,Potential Loyalists
4041,124,1,"20,5",5,1,1,7,Mid-Value,Potential Loyalists
4042,134,3,"185,60000000000002",5,1,1,7,Mid-Value,Potential Loyalists
4043,447,2,"127,8",4,1,1,6,Mid-Value,Potential Loyalists
4044,397,4,"442,15",4,1,1,6,Mid-Value,Potential Loyalists
4045,654,3,"301,59999999999997",4,1,1,6,Mid-Value,Potential Loyalists
4046,1447,1,"30,25",2,1,1,4,Low-Value,Can't Lose
4047,1198,2,"141,4",2,1,1,4,Low-Value,Can't Lose
4048,59,5,"371,8",5,1,1,7,Mid-Value,Potential Loyalists
4050,1548,3,"84,05000000000001",1,1,1,3,Low-Value,Lost
4052,7,1,"33,1",5,1,1,7,Mid-Value,Potential Loyalists
4053,1456,1,"20,7",2,1,1,4,Low-Value,Can't Lose
4054,13,2,"229,5",5,1,1,7,Mid-Value,Potential Loyalists
4055,726,3,"258,1",4,1,1,6,Mid-Value,Potential Loyalists
4059,110,6,"200,3",5,1,1,7,Mid-Value,Potential Loyalists
4061,507,8,"155,05",4,2,1,7,Mid-Value,Potential Loyalists
4062,8,7,"421,35",5,2,1,8,High-Value,Potential Loyalists
4063,155,4,"292,75",5,1,1,7,Mid-Value,Potential Loyalists
4065,739,1,"64,1",3,1,1,5,Low-Value,At Risk Customers
4066,144,4,"271,1",5,1,1,7,Mid-Value,Potential Loyalists
4069,313,3,"90,25",5,1,1,7,Mid-Value,Potential Loyalists
4070,505,9,"531,6999999999999",4,2,1,7,Mid-Value,Potential Loyalists
4071,220,6,"374,35",5,1,1,7,Mid-Value,Potential Loyalists
4073,285,1,"41,0",5,1,1,7,Mid-Value,Potential Loyalists
4074,267,1,"243,95",5,1,1,7,Mid-Value,Potential Loyalists
4076,104,4,"164,79999999999998",5,1,1,7,Mid-Value,Potential Loyalists
4077,770,2,"212,95",3,1,1,5,Low-Value,At Risk Customers
4078,461,2,"95,69999999999999",4,1,1,6,Mid-Value,Potential Loyalists
4079,964,1,"16,2",3,1,1,5,Low-Value,At Risk Customers
4081,290,1,"42,15",5,1,1,7,Mid-Value,Potential Loyalists
4083,209,4,"677,0",5,1,2,8,High-Value,Potential Loyalists
4084,558,2,"122,0",4,1,1,6,Mid-Value,Potential Loyalists
4087,106,5,"248,85",5,1,1,7,Mid-Value,Potential Loyalists
4088,1282,3,"76,1",2,1,1,4,Low-Value,Can't Lose
4092,1630,1,"6,3",1,1,1,3,Low-Value,Lost
4093,995,1,"17,85",3,1,1,5,Low-Value,At Risk Customers
4094,339,1,"23,35",5,1,1,7,Mid-Value,Potential Loyalists
4096,257,2,"146,25",5,1,1,7,Mid-Value,Potential Loyalists
4097,571,2,"121,5",4,1,1,6,Mid-Value,Potential Loyalists
4101,596,2,"63,300000000000004",4,1,1,6,Mid-Value,Potential Loyalists
4103,130,3,"281,7",5,1,1,7,Mid-Value,Potential Loyalists
4107,298,10,"558,75",5,2,1,8,High-Value,Potential Loyalists
4108,334,4,"186,85000000000002",5,1,1,7,Mid-Value,Potential Loyalists
4112,827,2,"51,0",3,1,1,5,Low-Value,At Risk Customers
4114,936,5,"731,4",3,1,2,6,Mid-Value,Potential Loyalists
4117,104,8,"347,25",5,2,1,8,High-Value,Potential Loyalists
4118,582,3,"138,85",4,1,1,6,Mid-Value,Potential Loyalists
4122,983,2,"95,39999999999999",3,1,1,5,Low-Value,At Risk Customers
4123,792,3,"135,35",3,1,1,5,Low-Value,At Risk Customers
4125,1238,4,"754,1999999999999",2,1,2,5,Low-Value,At Risk Customers
4126,20,5,"237,65",5,1,1,7,Mid-Value,Potential Loyalists
4128,269,4,"505,59999999999997",5,1,1,7,Mid-Value,Potential Loyalists
4129,194,3,"109,5",5,1,1,7,Mid-Value,Potential Loyalists
4131,669,3,"149,3",4,1,1,6,Mid-Value,Potential Loyalists
4132,129,1,"49,75",5,1,1,7,Mid-Value,Potential Loyalists
4134,133,2,"172,4",5,1,1,7,Mid-Value,Potential Loyalists
4136,53,5,"107,05",5,1,1,7,Mid-Value,Potential Loyalists
4137,803,2,"32,0",3,1,1,5,Low-Value,At Risk Customers
4138,1022,4,"196,10000000000002",3,1,1,5,Low-Value,At Risk Customers
4139,323,4,"246,0",5,1,1,7,Mid-Value,Potential Loyalists
4140,1112,2,"41,7",2,1,1,4,Low-Value,Can't Lose
4142,460,3,"64,05",4,1,1,6,Mid-Value,Potential Loyalists
4143,536,2,"42,599999999999994",4,1,1,6,Mid-Value,Potential Loyalists
4144,441,4,"385,65",4,1,1,6,Mid-Value,Potential Loyalists
4148,997,1,"27,1",3,1,1,5,Low-Value,At Risk Customers
4149,129,8,"407,4",5,2,1,8,High-Value,Potential Loyalists
4153,1269,1,"22,3",2,1,1,4,Low-Value,Can't Lose
4156,367,2,"250,70000000000002",4,1,1,6,Mid-Value,Potential Loyalists
4157,164,2,"147,7",5,1,1,7,Mid-Value,Potential Loyalists
4159,143,2,"176,05",5,1,1,7,Mid-Value,Potential Loyalists
4162,787,4,"257,8",3,1,1,5,Low-Value,At Risk Customers
4164,265,5,"434,95000000000005",5,1,1,7,Mid-Value,Potential Loyalists
4165,67,6,"376,84999999999997",5,1,1,7,Mid-Value,Potential Loyalists
4166,731,3,"147,6",3,1,1,5,Low-Value,At Risk Customers
4168,754,6,"319,35",3,1,1,5,Low-Value,At Risk Customers
4169,1140,6,"396,55",2,1,1,4,Low-Value,Can't Lose
4172,1659,1,"125,8",1,1,1,3,Low-Value,Lost
4173,227,2,"69,9",5,1,1,7,Mid-Value,Potential Loyalists
4175,1503,1,"26,9",1,1,1,3,Low-Value,Lost
4176,482,5,"257,55",4,1,1,6,Mid-Value,Potential Loyalists
4177,32,5,"165,85",5,1,1,7,Mid-Value,Potential Loyalists
4178,88,6,"517,65",5,1,1,7,Mid-Value,Potential Loyalists
4179,286,2,"277,09999999999997",5,1,1,7,Mid-Value,Potential Loyalists
4180,177,2,"32,8",5,1,1,7,Mid-Value,Potential Loyalists
4182,1338,1,"27,3",2,1,1,4,Low-Value,Can't Lose
4183,654,2,"71,9",4,1,1,6,Mid-Value,Potential Loyalists
4184,490,3,"234,09999999999997",4,1,1,6,Mid-Value,Potential Loyalists
4185,108,7,"776,0",5,2,2,9,High-Value,Champions
4186,727,1,"42,45",4,1,1,6,Mid-Value,Potential Loyalists
4188,12,7,"367,65",5,2,1,8,High-Value,Potential Loyalists
4192,419,2,"144,4",4,1,1,6,Mid-Value,Potential Loyalists
4193,1249,1,"51,7",2,1,1,4,Low-Value,Can't Lose
4194,140,1,"85,9",5,1,1,7,Mid-Value,Potential Loyalists
4195,966,1,"29,35",3,1,1,5,Low-Value,At Risk Customers
4198,464,1,"30,0",4,1,1,6,Mid-Value,Potential Loyalists
4200,376,1,"42,6",4,1,1,6,Mid-Value,Potential Loyalists
4201,0,6,"378,1",5,1,1,7,Mid-Value,Potential Loyalists
4202,66,5,"378,5",5,1,1,7,Mid-Value,Potential Loyalists
4204,180,2,"85,2",5,1,1,7,Mid-Value,Potential Loyalists
4208,1452,1,"10,23",2,1,1,4,Low-Value,Can't Lose
4209,891,2,"264,85",3,1,1,5,Low-Value,At Risk Customers
4210,95,2,"13,8",5,1,1,7,Mid-Value,Potential Loyalists
4212,906,4,"229,7",3,1,1,5,Low-Value,At Risk Customers
4213,1261,2,"52,400000000000006",2,1,1,4,Low-Value,Can't Lose
4216,737,3,"71,55",3,1,1,5,Low-Value,At Risk Customers
4217,544,1,"65,6",4,1,1,6,Mid-Value,Potential Loyalists
4218,69,5,"479,85",5,1,1,7,Mid-Value,Potential Loyalists
4219,923,1,"86,1",3,1,1,5,Low-Value,At Risk Customers
4222,885,4,"357,85",3,1,1,5,Low-Value,At Risk Customers
4224,1115,2,"62,099999999999994",2,1,1,4,Low-Value,Can't Lose
4227,1648,2,"143,95",1,1,1,3,Low-Value,Lost
4228,160,5,"404,75",5,1,1,7,Mid-Value,Potential Loyalists
4230,481,3,"80,85",4,1,1,6,Mid-Value,Potential Loyalists
4231,176,3,"148,25",5,1,1,7,Mid-Value,Potential Loyalists
4232,41,4,"377,6",5,1,1,7,Mid-Value,Potential Loyalists
4234,6,1,"253,2",5,1,1,7,Mid-Value,Potential Loyalists
4235,739,3,"199,8",3,1,1,5,Low-Value,At Risk Customers
4238,72,3,"235,25",5,1,1,7,Mid-Value,Potential Loyalists
4239,1628,2,"82,65",1,1,1,3,Low-Value,Lost
4243,623,4,"188,2",4,1,1,6,Mid-Value,Potential Loyalists
4244,1401,2,"103,9",2,1,1,4,Low-Value,Can't Lose
4245,558,5,"335,5",4,1,1,6,Mid-Value,Potential Loyalists
4246,58,6,"483,1",5,1,1,7,Mid-Value,Potential Loyalists
4247,1521,3,"254,0",1,1,1,3,Low-Value,Lost
4248,246,2,"38,300000000000004",5,1,1,7,Mid-Value,Potential Loyalists
4249,505,7,"580,9",4,2,1,7,Mid-Value,Potential Loyalists
4256,139,4,"173,45",5,1,1,7,Mid-Value,Potential Loyalists
4258,479,4,"171,5",4,1,1,6,Mid-Value,Potential Loyalists
4261,909,7,"397,7",3,2,1,6,Mid-Value,Potential Loyalists
4264,445,7,"307,26",4,2,1,7,Mid-Value,Potential Loyalists
4266,55,4,"89,7",5,1,1,7,Mid-Value,Potential Loyalists
4268,725,1,"30,3",4,1,1,6,Mid-Value,Potential Loyalists
4269,1069,2,"15,2",3,1,1,5,Low-Value,At Risk Customers
4270,270,1,"97,7",5,1,1,7,Mid-Value,Potential Loyalists
4271,1244,2,"139,8",2,1,1,4,Low-Value,Can't Lose
4272,658,2,"157,5",4,1,1,6,Mid-Value,Potential Loyalists
4273,217,3,"221,2",5,1,1,7,Mid-Value,Potential Loyalists
4274,876,2,"37,3",3,1,1,5,Low-Value,At Risk Customers
4275,13,5,"295,15",5,1,1,7,Mid-Value,Potential Loyalists
4276,392,6,"254,45",4,1,1,6,Mid-Value,Potential Loyalists
4277,17,5,"277,55",5,1,1,7,Mid-Value,Potential Loyalists
4278,60,3,"179,6",5,1,1,7,Mid-Value,Potential Loyalists
4280,1014,4,"308,0",3,1,1,5,Low-Value,At Risk Customers
4282,702,2,"34,3",4,1,1,6,Mid-Value,Potential Loyalists
4283,92,2,"283,65",5,1,1,7,Mid-Value,Potential Loyalists
4284,75,5,"134,75",5,1,1,7,Mid-Value,Potential Loyalists
4285,17,6,"144,95",5,1,1,7,Mid-Value,Potential Loyalists
4286,189,2,"147,1",5,1,1,7,Mid-Value,Potential Loyalists
4287,139,3,"548,15",5,1,1,7,Mid-Value,Potential Loyalists
4289,153,3,"93,15",5,1,1,7,Mid-Value,Potential Loyalists
4290,1494,1,"55,85",1,1,1,3,Low-Value,Lost
4292,951,3,"166,0",3,1,1,5,Low-Value,At Risk Customers
4293,902,2,"59,5",3,1,1,5,Low-Value,At Risk Customers
4294,449,1,"10,3",4,1,1,6,Mid-Value,Potential Loyalists
4295,629,1,"328,20000000000005",4,1,1,6,Mid-Value,Potential Loyalists
4297,496,4,"528,6",4,1,1,6,Mid-Value,Potential Loyalists
4299,25,7,"251,10000000000002",5,2,1,8,High-Value,Potential Loyalists
4300,785,1,"12,05",3,1,1,5,Low-Value,At Risk Customers
4303,144,4,"910,5500000000001",5,1,2,8,High-Value,Potential Loyalists
4304,766,7,"558,3",3,2,1,6,Mid-Value,Potential Loyalists
4306,446,2,"99,85000000000001",4,1,1,6,Mid-Value,Potential Loyalists
4307,906,6,"379,8",3,1,1,5,Low-Value,At Risk Customers
4309,438,4,"204,79999999999998",4,1,1,6,Mid-Value,Potential Loyalists
4311,461,4,"218,70000000000002",4,1,1,6,Mid-Value,Potential Loyalists
4312,1278,1,"227,3",2,1,1,4,Low-Value,Can't Lose
4316,399,6,"561,6500000000001",4,1,1,6,Mid-Value,Potential Loyalists
4317,560,1,"188,1",4,1,1,6,Mid-Value,Potential Loyalists
4319,89,4,"209,35",5,1,1,7,Mid-Value,Potential Loyalists
4322,981,4,"104,60000000000001",3,1,1,5,Low-Value,At Risk Customers
4323,81,7,"556,55",5,2,1,8,High-Value,Potential Loyalists
4325,110,6,"781,75",5,1,2,8,High-Value,Potential Loyalists
4327,66,2,"249,39999999999998",5,1,1,7,Mid-Value,Potential Loyalists
4329,80,6,"369,0",5,1,1,7,Mid-Value,Potential Loyalists
4330,1607,1,"35,7",1,1,1,3,Low-Value,Lost
4331,655,1,"58,6",4,1,1,6,Mid-Value,Potential Loyalists
4332,115,2,"183,35",5,1,1,7,Mid-Value,Potential Loyalists
4333,13,5,"172,85",5,1,1,7,Mid-Value,Potential Loyalists
4334,721,3,"172,6",4,1,1,6,Mid-Value,Potential Loyalists
4337,483,2,"32,25",4,1,1,6,Mid-Value,Potential Loyalists
4340,782,3,"160,55",3,1,1,5,Low-Value,At Risk Customers
4342,1234,1,"53,3",2,1,1,4,Low-Value,Can't Lose
4343,798,1,"58,4",3,1,1,5,Low-Value,At Risk Customers
4344,1181,2,"36,7",2,1,1,4,Low-Value,Can't Lose
4345,891,2,"57,3",3,1,1,5,Low-Value,At Risk Customers
4346,88,3,"188,65",5,1,1,7,Mid-Value,Potential Loyalists
4347,1302,4,"202,7",2,1,1,4,Low-Value,Can't Lose
4348,1482,1,"41,4",1,1,1,3,Low-Value,Lost
4349,185,1,"41,8",5,1,1,7,Mid-Value,Potential Loyalists
4350,16,5,"160,35",5,1,1,7,Mid-Value,Potential Loyalists
4352,864,3,"162,7",3,1,1,5,Low-Value,At Risk Customers
4353,299,1,"11,7",5,1,1,7,Mid-Value,Potential Loyalists
4357,1524,2,"140,45",1,1,1,3,Low-Value,Lost
4360,770,1,"289,95",3,1,1,5,Low-Value,At Risk Customers
4362,863,3,"546,55",3,1,1,5,Low-Value,At Risk Customers
4364,50,1,"14,4",5,1,1,7,Mid-Value,Potential Loyalists
4365,396,1,"57,85",4,1,1,6,Mid-Value,Potential Loyalists
4366,598,1,"102,14999999999999",4,1,1,6,Mid-Value,Potential Loyalists
4368,62,2,"91,30000000000001",5,1,1,7,Mid-Value,Potential Loyalists
4370,1301,2,"211,25",2,1,1,4,Low-Value,Can't Lose
4371,126,2,"108,2",5,1,1,7,Mid-Value,Potential Loyalists
4372,55,6,"1013,9",5,1,2,8,High-Value,Potential Loyalists
4373,617,5,"322,20000000000005",4,1,1,6,Mid-Value,Potential Loyalists
4374,1089,2,"42,15",3,1,1,5,Low-Value,At Risk Customers
4375,40,6,"282,35",5,1,1,7,Mid-Value,Potential Loyalists
4376,1115,3,"226,5",2,1,1,4,Low-Value,Can't Lose
4377,343,6,"141,25",5,1,1,7,Mid-Value,Potential Loyalists
4378,1001,3,"322,85",3,1,1,5,Low-Value,At Risk Customers
4380,96,2,"145,0",5,1,1,7,Mid-Value,Potential Loyalists
4381,25,11,"320,95",5,2,1,8,High-Value,Potential Loyalists
4382,108,7,"727,9",5,2,2,9,High-Value,Champions
4390,357,6,"698,35",5,1,2,8,High-Value,Potential Loyalists
4392,122,2,"177,8",5,1,1,7,Mid-Value,Potential Loyalists
4393,152,4,"145,8",5,1,1,7,Mid-Value,Potential Loyalists
4396,280,1,"16,15",5,1,1,7,Mid-Value,Potential Loyalists
4397,30,7,"432,05",5,2,1,8,High-Value,Potential Loyalists
4400,523,2,"53,25",4,1,1,6,Mid-Value,Potential Loyalists
4401,85,8,"629,65",5,2,1,8,High-Value,Potential Loyalists
4405,334,5,"171,8",5,1,1,7,Mid-Value,Potential Loyalists
4406,419,2,"53,650000000000006",4,1,1,6,Mid-Value,Potential Loyalists
4408,1359,1,"23,25",2,1,1,4,Low-Value,Can't Lose
4409,110,3,"217,85",5,1,1,7,Mid-Value,Potential Loyalists
4410,259,1,"79,0",5,1,1,7,Mid-Value,Potential Loyalists
4413,819,2,"39,5",3,1,1,5,Low-Value,At Risk Customers
4414,616,2,"196,45",4,1,1,6,Mid-Value,Potential Loyalists
4415,82,5,"310,35",5,1,1,7,Mid-Value,Potential Loyalists
4416,386,1,"600,0",4,1,1,6,Mid-Value,Potential Loyalists
4418,178,2,"132,3",5,1,1,7,Mid-Value,Potential Loyalists
4420,405,2,"105,8",4,1,1,6,Mid-Value,Potential Loyalists
4421,1690,1,"27,65",1,1,1,3,Low-Value,Lost
4422,641,1,"21,3",4,1,1,6,Mid-Value,Potential Loyalists
4423,1133,3,"96,05",2,1,1,4,Low-Value,Can't Lose
4424,130,5,"93,55",5,1,1,7,Mid-Value,Potential Loyalists
4425,1801,1,"8,3",1,1,1,3,Low-Value,Lost
4432,578,3,"105,1",4,1,1,6,Mid-Value,Potential Loyalists
4434,865,3,"430,95000000000005",3,1,1,5,Low-Value,At Risk Customers
4435,273,6,"373,2",5,1,1,7,Mid-Value,Potential Loyalists
4436,147,3,"170,7",5,1,1,7,Mid-Value,Potential Loyalists
4437,599,2,"113,05",4,1,1,6,Mid-Value,Potential Loyalists
4438,16,3,"99,15",5,1,1,7,Mid-Value,Potential Loyalists
4440,580,3,"149,95",4,1,1,6,Mid-Value,Potential Loyalists
4441,1169,1,"9,85",2,1,1,4,Low-Value,Can't Lose
4442,767,4,"186,35000000000002",3,1,1,5,Low-Value,At Risk Customers
4445,18,6,"398,1",5,1,1,7,Mid-Value,Potential Loyalists
4446,491,2,"85,85000000000001",4,1,1,6,Mid-Value,Potential Loyalists
4447,46,4,"277,90000000000003",5,1,1,7,Mid-Value,Potential Loyalists
4448,248,7,"567,8",5,2,1,8,High-Value,Potential Loyalists
4450,323,6,"138,25",5,1,1,7,Mid-Value,Potential Loyalists
4454,325,1,"24,3",5,1,1,7,Mid-Value,Potential Loyalists
4455,118,4,"213,85",5,1,1,7,Mid-Value,Potential Loyalists
4456,1257,1,"109,1",2,1,1,4,Low-Value,Can't Lose
4459,14,4,"503,04999999999995",5,1,1,7,Mid-Value,Potential Loyalists
4460,1380,3,"100,45",2,1,1,4,Low-Value,Can't Lose
4463,1165,1,"127,95",2,1,1,4,Low-Value,Can't Lose
4464,314,2,"237,5",5,1,1,7,Mid-Value,Potential Loyalists
4465,126,7,"611,75",5,2,1,8,High-Value,Potential Loyalists
4466,133,1,"19,0",5,1,1,7,Mid-Value,Potential Loyalists
4468,1230,3,"111,0",2,1,1,4,Low-Value,Can't Lose
4469,1646,2,"293,7",1,1,1,3,Low-Value,Lost
4472,598,5,"168,85",4,1,1,6,Mid-Value,Potential Loyalists
4474,12,2,"144,64999999999998",5,1,1,7,Mid-Value,Potential Loyalists
4475,137,6,"379,79999999999995",5,1,1,7,Mid-Value,Potential Loyalists
4476,887,2,"81,65",3,1,1,5,Low-Value,At Risk Customers
4477,852,2,"62,75",3,1,1,5,Low-Value,At Risk Customers
4478,404,3,"167,2",4,1,1,6,Mid-Value,Potential Loyalists
4479,206,1,"55,0",5,1,1,7,Mid-Value,Potential Loyalists
4480,473,1,"27,05",4,1,1,6,Mid-Value,Potential Loyalists
4482,537,3,"106,00000000000001",4,1,1,6,Mid-Value,Potential Loyalists
4483,990,1,"42,2",3,1,1,5,Low-Value,At Risk Customers
4484,22,6,"352,25",5,1,1,7,Mid-Value,Potential Loyalists
4485,785,2,"139,35",3,1,1,5,Low-Value,At Risk Customers
4486,997,2,"781,5500000000001",3,1,2,6,Mid-Value,Potential Loyalists
4487,1473,2,"34,7",1,1,1,3,Low-Value,Lost
4490,85,5,"334,28000000000003",5,1,1,7,Mid-Value,Potential Loyalists
4491,67,7,"182,60000000000002",5,2,1,8,High-Value,Potential Loyalists
4492,790,4,"146,55",3,1,1,5,Low-Value,At Risk Customers
4494,1295,1,"133,4",2,1,1,4,Low-Value,Can't Lose
4497,1686,1,"27,4",1,1,1,3,Low-Value,Lost
4498,342,4,"395,49999999999994",5,1,1,7,Mid-Value,Potential Loyalists
4500,211,1,"100,6",5,1,1,7,Mid-Value,Potential Loyalists
4503,183,7,"297,55",5,2,1,8,High-Value,Potential Loyalists
4504,462,3,"140,85",4,1,1,6,Mid-Value,Potential Loyalists
4506,235,2,"128,95",5,1,1,7,Mid-Value,Potential Loyalists
4507,23,5,"517,45",5,1,1,7,Mid-Value,Potential Loyalists
4508,805,2,"74,44999999999999",3,1,1,5,Low-Value,At Risk Customers
4510,111,6,"449,0",5,1,1,7,Mid-Value,Potential Loyalists
4511,439,1,"16,9",4,1,1,6,Mid-Value,Potential Loyalists
4513,715,11,"676,55",4,2,2,8,High-Value,Potential Loyalists
4514,386,3,"283,54999999999995",4,1,1,6,Mid-Value,Potential Loyalists
4515,1027,2,"11,35",3,1,1,5,Low-Value,At Risk Customers
4516,290,1,"7,75",5,1,1,7,Mid-Value,Potential Loyalists
4517,491,2,"60,0",4,1,1,6,Mid-Value,Potential Loyalists
4518,1769,1,"9,1",1,1,1,3,Low-Value,Lost
4519,188,3,"267,90000000000003",5,1,1,7,Mid-Value,Potential Loyalists
4521,226,2,"70,35",5,1,1,7,Mid-Value,Potential Loyalists
4523,1012,1,"45,4",3,1,1,5,Low-Value,At Risk Customers
4524,871,1,"4,4",3,1,1,5,Low-Value,At Risk Customers
4525,305,1,"12,55",5,1,1,7,Mid-Value,Potential Loyalists
4526,378,4,"268,1",4,1,1,6,Mid-Value,Potential Loyalists
4531,1140,1,"18,55",2,1,1,4,Low-Value,Can't Lose
4533,101,2,"96,75",5,1,1,7,Mid-Value,Potential Loyalists
4534,730,3,"173,8",4,1,1,6,Mid-Value,Potential Loyalists
4535,94,9,"477,54999999999995",5,2,1,8,High-Value,Potential Loyalists
4539,287,7,"315,55",5,2,1,8,High-Value,Potential Loyalists
4540,23,9,"633,3",5,2,1,8,High-Value,Potential Loyalists
4541,1064,2,"58,5",3,1,1,5,Low-Value,At Risk Customers
4542,1739,1,"13,7",1,1,1,3,Low-Value,Lost
4544,503,3,"437,5",4,1,1,6,Mid-Value,Potential Loyalists
4548,137,3,"85,8",5,1,1,7,Mid-Value,Potential Loyalists
4549,438,4,"251,49999999999997",4,1,1,6,Mid-Value,Potential Loyalists
4550,46,4,"556,15",5,1,1,7,Mid-Value,Potential Loyalists
4551,385,1,"1,2",4,1,1,6,Mid-Value,Potential Loyalists
4553,966,1,"26,6",3,1,1,5,Low-Value,At Risk Customers
4555,393,4,"341,1",4,1,1,6,Mid-Value,Potential Loyalists
4557,213,1,"118,8",5,1,1,7,Mid-Value,Potential Loyalists
4559,1491,1,"103,80000000000001",1,1,1,3,Low-Value,Lost
4561,105,3,"139,3",5,1,1,7,Mid-Value,Potential Loyalists
4562,815,1,"20,65",3,1,1,5,Low-Value,At Risk Customers
4563,34,1,"32,05",5,1,1,7,Mid-Value,Potential Loyalists
4565,167,1,"398,0",5,1,1,7,Mid-Value,Potential Loyalists
4567,498,7,"236,4",4,2,1,7,Mid-Value,Potential Loyalists
4568,394,3,"188,25",4,1,1,6,Mid-Value,Potential Loyalists
4569,193,2,"91,8",5,1,1,7,Mid-Value,Potential Loyalists
4571,1187,1,"3,6",2,1,1,4,Low-Value,Can't Lose
4572,623,3,"448,75",4,1,1,6,Mid-Value,Potential Loyalists
4573,921,2,"75,50000000000001",3,1,1,5,Low-Value,At Risk Customers
4574,700,7,"558,4",4,2,1,7,Mid-Value,Potential Loyalists
4575,101,9,"517,75",5,2,1,8,High-Value,Potential Loyalists
4576,34,3,"195,65",5,1,1,7,Mid-Value,Potential Loyalists
4577,427,1,"83,4",4,1,1,6,Mid-Value,Potential Loyalists
4578,137,1,"148,7",5,1,1,7,Mid-Value,Potential Loyalists
4579,71,9,"394,5",5,2,1,8,High-Value,Potential Loyalists
4580,813,2,"66,65",3,1,1,5,Low-Value,At Risk Customers
4581,686,2,"43,0",4,1,1,6,Mid-Value,Potential Loyalists
4582,12,5,"294,9",5,1,1,7,Mid-Value,Potential Loyalists
4584,968,3,"93,4",3,1,1,5,Low-Value,At Risk Customers
4585,3,2,"243,0",5,1,1,7,Mid-Value,Potential Loyalists
4586,1373,1,"1,25",2,1,1,4,Low-Value,Can't Lose
4587,231,1,"65,4",5,1,1,7,Mid-Value,Potential Loyalists
4590,119,2,"239,75",5,1,1,7,Mid-Value,Potential Loyalists
4593,1333,1,"78,30000000000001",2,1,1,4,Low-Value,Can't Lose
4594,168,5,"630,55",5,1,1,7,Mid-Value,Potential Loyalists
4595,206,6,"459,0",5,1,1,7,Mid-Value,Potential Loyalists
4597,783,3,"568,6",3,1,1,5,Low-Value,At Risk Customers
4601,1404,1,"31,4",2,1,1,4,Low-Value,Can't Lose
4602,826,6,"645,3000000000001",3,1,1,5,Low-Value,At Risk Customers
4604,1103,3,"179,1",2,1,1,4,Low-Value,Can't Lose
4606,756,7,"579,95",3,2,1,6,Mid-Value,Potential Loyalists
4607,785,9,"261,1",3,2,1,6,Mid-Value,Potential Loyalists
4611,306,6,"222,3",5,1,1,7,Mid-Value,Potential Loyalists
4612,327,3,"823,95",5,1,2,8,High-Value,Potential Loyalists
4616,75,1,"120,3",5,1,1,7,Mid-Value,Potential Loyalists
4617,122,2,"442,85",5,1,1,7,Mid-Value,Potential Loyalists
4618,43,3,"182,89999999999998",5,1,1,7,Mid-Value,Potential Loyalists
4619,337,12,"935,85",5,3,2,10,High-Value,Champions
4621,414,9,"636,65",4,2,1,7,Mid-Value,Potential Loyalists
4622,348,3,"35,8",5,1,1,7,Mid-Value,Potential Loyalists
4627,1110,6,"660,2",2,1,1,4,Low-Value,Can't Lose
4629,752,1,"100,2",3,1,1,5,Low-Value,At Risk Customers
4630,376,1,"126,2",4,1,1,6,Mid-Value,Potential Loyalists
4631,339,1,"165,95",5,1,1,7,Mid-Value,Potential Loyalists
4633,1172,2,"41,25",2,1,1,4,Low-Value,Can't Lose
4634,96,2,"184,85",5,1,1,7,Mid-Value,Potential Loyalists
4635,1026,1,"45,75",3,1,1,5,Low-Value,At Risk Customers
4637,128,6,"386,0",5,1,1,7,Mid-Value,Potential Loyalists
4641,1343,1,"23,85",2,1,1,4,Low-Value,Can't Lose
4644,1813,1,"17,1",1,1,1,3,Low-Value,Lost
4645,769,4,"159,45",3,1,1,5,Low-Value,At Risk Customers
4646,761,4,"166,35000000000002",3,1,1,5,Low-Value,At Risk Customers
4647,263,4,"102,3",5,1,1,7,Mid-Value,Potential Loyalists
4648,601,6,"140,10000000000002",4,1,1,6,Mid-Value,Potential Loyalists
4650,31,5,"674,35",5,1,2,8,High-Value,Potential Loyalists
4653,345,4,"88,75",5,1,1,7,Mid-Value,Potential Loyalists
4656,90,5,"179,15",5,1,1,7,Mid-Value,Potential Loyalists
4657,23,2,"9,45",5,1,1,7,Mid-Value,Potential Loyalists
4658,277,4,"127,5",5,1,1,7,Mid-Value,Potential Loyalists
4659,1547,2,"134,05",1,1,1,3,Low-Value,Lost
4661,1655,1,"23,9",1,1,1,3,Low-Value,Lost
4662,222,2,"30,85",5,1,1,7,Mid-Value,Potential Loyalists
4663,20,3,"368,2",5,1,1,7,Mid-Value,Potential Loyalists
4666,11,3,"319,05",5,1,1,7,Mid-Value,Potential Loyalists
4667,81,6,"349,05",5,1,1,7,Mid-Value,Potential Loyalists
4668,822,2,"50,65",3,1,1,5,Low-Value,At Risk Customers
4670,361,7,"288,35",5,2,1,8,High-Value,Potential Loyalists
4672,23,4,"302,45",5,1,1,7,Mid-Value,Potential Loyalists
4675,1473,1,"3,6",1,1,1,3,Low-Value,Lost
4676,52,4,"195,10000000000002",5,1,1,7,Mid-Value,Potential Loyalists
4677,17,3,"154,0",5,1,1,7,Mid-Value,Potential Loyalists
4678,77,6,"413,40000000000003",5,1,1,7,Mid-Value,Potential Loyalists
4679,435,4,"173,1",4,1,1,6,Mid-Value,Potential Loyalists
4680,886,1,"398,0",3,1,1,5,Low-Value,At Risk Customers
4681,544,2,"278,4",4,1,1,6,Mid-Value,Potential Loyalists
4683,59,3,"285,7",5,1,1,7,Mid-Value,Potential Loyalists
4684,274,2,"124,15",5,1,1,7,Mid-Value,Potential Loyalists
4686,680,3,"92,7",4,1,1,6,Mid-Value,Potential Loyalists
4687,251,2,"206,89999999999998",5,1,1,7,Mid-Value,Potential Loyalists
4688,1254,1,"6,35",2,1,1,4,Low-Value,Can't Lose
4689,25,3,"218,75",5,1,1,7,Mid-Value,Potential Loyalists
4690,75,1,"72,0",5,1,1,7,Mid-Value,Potential Loyalists
4693,55,6,"127,69999999999999",5,1,1,7,Mid-Value,Potential Loyalists
4694,1412,2,"8,25",2,1,1,4,Low-Value,Can't Lose
4699,928,2,"225,1",3,1,1,5,Low-Value,At Risk Customers
4703,946,2,"154,25",3,1,1,5,Low-Value,At Risk Customers
4704,1304,1,"9,4",2,1,1,4,Low-Value,Can't Lose
4706,341,1,"8,1",5,1,1,7,Mid-Value,Potential Loyalists
4708,326,7,"158,6",5,2,1,8,High-Value,Potential Loyalists
4710,927,2,"104,5",3,1,1,5,Low-Value,At Risk Customers
4712,34,9,"685,6",5,2,2,9,High-Value,Champions
4713,1257,1,"90,8",2,1,1,4,Low-Value,Can't Lose
4717,153,3,"205,39999999999998",5,1,1,7,Mid-Value,Potential Loyalists
4720,490,8,"1292,75",4,2,2,8,High-Value,Potential Loyalists
4725,456,2,"126,0",4,1,1,6,Mid-Value,Potential Loyalists
4728,455,1,"253,2",4,1,1,6,Mid-Value,Potential Loyalists
4729,330,2,"582,85",5,1,1,7,Mid-Value,Potential Loyalists
4730,1253,2,"33,6",2,1,1,4,Low-Value,Can't Lose
4731,21,2,"132,1",5,1,1,7,Mid-Value,Potential Loyalists
4733,5,2,"200,6",5,1,1,7,Mid-Value,Potential Loyalists
4734,741,2,"106,3",3,1,1,5,Low-Value,At Risk Customers
4735,746,2,"163,04999999999998",3,1,1,5,Low-Value,At Risk Customers
4736,1131,4,"177,79999999999998",2,1,1,4,Low-Value,Can't Lose
4737,262,4,"216,05",5,1,1,7,Mid-Value,Potential Loyalists
4738,348,3,"214,95",5,1,1,7,Mid-Value,Potential Loyalists
4742,83,10,"579,0",5,2,1,8,High-Value,Potential Loyalists
4743,159,2,"237,15",5,1,1,7,Mid-Value,Potential Loyalists
4744,62,5,"481,25",5,1,1,7,Mid-Value,Potential Loyalists
4745,1665,1,"63,7",1,1,1,3,Low-Value,Lost
4746,42,5,"113,3",5,1,1,7,Mid-Value,Potential Loyalists
4748,1292,1,"48,7",2,1,1,4,Low-Value,Can't Lose
4749,511,5,"265,45",4,1,1,6,Mid-Value,Potential Loyalists
4750,1035,3,"170,35",3,1,1,5,Low-Value,At Risk Customers
4751,1018,1,"31,95",3,1,1,5,Low-Value,At Risk Customers
4752,1186,2,"96,1",2,1,1,4,Low-Value,Can't Lose
4754,570,3,"162,45",4,1,1,6,Mid-Value,Potential Loyalists
4755,636,1,"73,65",4,1,1,6,Mid-Value,Potential Loyalists
4756,171,1,"48,8",5,1,1,7,Mid-Value,Potential Loyalists
4758,622,1,"72,75",4,1,1,6,Mid-Value,Potential Loyalists
4760,264,5,"711,7",5,1,2,8,High-Value,Potential Loyalists
4763,347,3,"159,6",5,1,1,7,Mid-Value,Potential Loyalists
4766,1035,1,"113,65",3,1,1,5,Low-Value,At Risk Customers
4767,280,4,"210,65",5,1,1,7,Mid-Value,Potential Loyalists
4769,199,5,"555,25",5,1,1,7,Mid-Value,Potential Loyalists
4770,1207,1,"26,1",2,1,1,4,Low-Value,Can't Lose
4772,420,2,"114,39999999999999",4,1,1,6,Mid-Value,Potential Loyalists
4773,227,5,"232,3",5,1,1,7,Mid-Value,Potential Loyalists
4774,112,8,"442,95",5,2,1,8,High-Value,Potential Loyalists
4775,820,1,"3,6",3,1,1,5,Low-Value,At Risk Customers
4776,245,2,"49,7",5,1,1,7,Mid-Value,Potential Loyalists
4778,383,1,"63,2",4,1,1,6,Mid-Value,Potential Loyalists
4779,290,3,"129,65",5,1,1,7,Mid-Value,Potential Loyalists
4780,184,3,"317,7",5,1,1,7,Mid-Value,Potential Loyalists
4783,4,6,"249,6",5,1,1,7,Mid-Value,Potential Loyalists
4784,759,5,"221,45",3,1,1,5,Low-Value,At Risk Customers
4785,341,4,"397,65",5,1,1,7,Mid-Value,Potential Loyalists
4787,1816,1,"33,0",1,1,1,3,Low-Value,Lost
4788,291,2,"62,35",5,1,1,7,Mid-Value,Potential Loyalists
4792,83,5,"185,35000000000002",5,1,1,7,Mid-Value,Potential Loyalists
4793,1202,2,"263,3",2,1,1,4,Low-Value,Can't Lose
4795,83,2,"116,19999999999999",5,1,1,7,Mid-Value,Potential Loyalists
4797,954,3,"177,65",3,1,1,5,Low-Value,At Risk Customers
4798,1067,1,"21,25",3,1,1,5,Low-Value,At Risk Customers
4799,460,2,"44,150000000000006",4,1,1,6,Mid-Value,Potential Loyalists
4800,257,2,"188,45000000000002",5,1,1,7,Mid-Value,Potential Loyalists
4802,316,5,"315,4",5,1,1,7,Mid-Value,Potential Loyalists
4803,1145,2,"259,15",2,1,1,4,Low-Value,Can't Lose
4804,19,8,"580,8",5,2,1,8,High-Value,Potential Loyalists
4805,1026,2,"123,75",3,1,1,5,Low-Value,At Risk Customers
4806,841,3,"50,650000000000006",3,1,1,5,Low-Value,At Risk Customers
4807,1672,1,"118,7",1,1,1,3,Low-Value,Lost
4808,676,2,"393,4",4,1,1,6,Mid-Value,Potential Loyalists
4809,1071,2,"66,9",3,1,1,5,Low-Value,At Risk Customers
4811,65,5,"113,95",5,1,1,7,Mid-Value,Potential Loyalists
4812,9,9,"216,9",5,2,1,8,High-Value,Potential Loyalists
4813,1741,1,"25,25",1,1,1,3,Low-Value,Lost
4814,766,2,"46,0",3,1,1,5,Low-Value,At Risk Customers
4815,116,5,"254,75",5,1,1,7,Mid-Value,Potential Loyalists
4816,57,2,"58,45",5,1,1,7,Mid-Value,Potential Loyalists
4817,847,3,"130,9",3,1,1,5,Low-Value,At Risk Customers
4820,1464,1,"22,4",1,1,1,3,Low-Value,Lost
4822,247,11,"818,7",5,2,2,9,High-Value,Champions
4823,980,4,"107,55000000000001",3,1,1,5,Low-Value,At Risk Customers
4826,1120,5,"279,45",2,1,1,4,Low-Value,Can't Lose
4827,14,1,"89,8",5,1,1,7,Mid-Value,Potential Loyalists
4829,1144,1,"69,8",2,1,1,4,Low-Value,Can't Lose
4831,944,2,"66,2",3,1,1,5,Low-Value,At Risk Customers
4833,11,6,"387,9",5,1,1,7,Mid-Value,Potential Loyalists
4835,800,3,"80,65",3,1,1,5,Low-Value,At Risk Customers
4837,400,1,"50,7",4,1,1,6,Mid-Value,Potential Loyalists
4841,1126,1,"42,45",2,1,1,4,Low-Value,Can't Lose
4843,383,3,"151,3",4,1,1,6,Mid-Value,Potential Loyalists
4844,1079,1,"127,2",3,1,1,5,Low-Value,At Risk Customers
4845,188,4,"350,9",5,1,1,7,Mid-Value,Potential Loyalists
4847,228,1,"45,75",5,1,1,7,Mid-Value,Potential Loyalists
4849,22,8,"396,8",5,2,1,8,High-Value,Potential Loyalists
4850,192,5,"388,2",5,1,1,7,Mid-Value,Potential Loyalists
4852,309,5,"258,6",5,1,1,7,Mid-Value,Potential Loyalists
4853,133,2,"607,25",5,1,1,7,Mid-Value,Potential Loyalists
4854,948,1,"17,3",3,1,1,5,Low-Value,At Risk Customers
4856,375,2,"55,0",4,1,1,6,Mid-Value,Potential Loyalists
4862,561,5,"314,3",4,1,1,6,Mid-Value,Potential Loyalists
4863,206,3,"161,79999999999998",5,1,1,7,Mid-Value,Potential Loyalists
4864,3,8,"445,65000000000003",5,2,1,8,High-Value,Potential Loyalists
4865,666,1,"116,85",4,1,1,6,Mid-Value,Potential Loyalists
4866,499,1,"23,700000000000003",4,1,1,6,Mid-Value,Potential Loyalists
4868,405,3,"166,25",4,1,1,6,Mid-Value,Potential Loyalists
4870,1310,1,"23,2",2,1,1,4,Low-Value,Can't Lose
4871,1112,1,"48,6",2,1,1,4,Low-Value,Can't Lose
4872,715,3,"111,4",4,1,1,6,Mid-Value,Potential Loyalists
4873,1279,2,"346,7",2,1,1,4,Low-Value,Can't Lose
4874,423,5,"251,05",4,1,1,6,Mid-Value,Potential Loyalists
4875,1,8,"501,85",5,2,1,8,High-Value,Potential Loyalists
4876,84,7,"688,9499999999999",5,2,2,9,High-Value,Champions
4877,176,4,"290,79999999999995",5,1,1,7,Mid-Value,Potential Loyalists
4878,160,7,"566,45",5,2,1,8,High-Value,Potential Loyalists
4879,994,5,"362,55",3,1,1,5,Low-Value,At Risk Customers
4881,354,5,"287,45",5,1,1,7,Mid-Value,Potential Loyalists
4884,258,5,"156,95",5,1,1,7,Mid-Value,Potential Loyalists
4886,146,10,"632,25",5,2,1,8,High-Value,Potential Loyalists
4889,532,1,"219,1",4,1,1,6,Mid-Value,Potential Loyalists
4891,911,5,"111,75",3,1,1,5,Low-Value,At Risk Customers
4892,770,1,"14,45",3,1,1,5,Low-Value,At Risk Customers
4893,319,3,"536,75",5,1,1,7,Mid-Value,Potential Loyalists
4894,131,5,"527,6500000000001",5,1,1,7,Mid-Value,Potential Loyalists
4895,523,4,"176,8",4,1,1,6,Mid-Value,Potential Loyalists
4896,817,3,"569,5",3,1,1,5,Low-Value,At Risk Customers
4897,1694,1,"96,9",1,1,1,3,Low-Value,Lost
4900,1085,1,"32,4",3,1,1,5,Low-Value,At Risk Customers
4904,104,3,"59,75",5,1,1,7,Mid-Value,Potential Loyalists
4905,1143,3,"305,85",2,1,1,4,Low-Value,Can't Lose
4906,579,7,"775,9",4,2,2,8,High-Value,Potential Loyalists
4907,1432,4,"321,4",2,1,1,4,Low-Value,Can't Lose
4909,754,2,"155,9",3,1,1,5,Low-Value,At Risk Customers
4910,151,9,"662,6",5,2,1,8,High-Value,Potential Loyalists
4911,166,9,"472,15",5,2,1,8,High-Value,Potential Loyalists
4912,1247,2,"89,25",2,1,1,4,Low-Value,Can't Lose
4913,1239,2,"212,75",2,1,1,4,Low-Value,Can't Lose
4916,375,4,"135,45",4,1,1,6,Mid-Value,Potential Loyalists
4918,1361,1,"86,25",2,1,1,4,Low-Value,Can't Lose
4923,787,3,"65,7",3,1,1,5,Low-Value,At Risk Customers
4924,387,3,"115,39999999999999",4,1,1,6,Mid-Value,Potential Loyalists
4925,171,1,"59,3",5,1,1,7,Mid-Value,Potential Loyalists
4927,1592,2,"105,95",1,1,1,3,Low-Value,Lost
4928,1335,1,"78,5",2,1,1,4,Low-Value,Can't Lose
4930,617,4,"46,980000000000004",4,1,1,6,Mid-Value,Potential Loyalists
4931,91,2,"56,599999999999994",5,1,1,7,Mid-Value,Potential Loyalists
4932,298,1,"4,9",5,1,1,7,Mid-Value,Potential Loyalists
4933,601,1,"110,95",4,1,1,6,Mid-Value,Potential Loyalists
4934,158,3,"179,3",5,1,1,7,Mid-Value,Potential Loyalists
4935,52,9,"503,9",5,2,1,8,High-Value,Potential Loyalists
4936,755,3,"121,7",3,1,1,5,Low-Value,At Risk Customers
4940,199,6,"220,4",5,1,1,7,Mid-Value,Potential Loyalists
4941,388,2,"126,1",4,1,1,6,Mid-Value,Potential Loyalists
4944,199,3,"82,9",5,1,1,7,Mid-Value,Potential Loyalists
4946,594,9,"339,55",4,2,1,7,Mid-Value,Potential Loyalists
4948,152,5,"146,29999999999998",5,1,1,7,Mid-Value,Potential Loyalists
4949,243,1,"10,65",5,1,1,7,Mid-Value,Potential Loyalists
4951,747,1,"19,1",3,1,1,5,Low-Value,At Risk Customers
4952,146,1,"161,10000000000002",5,1,1,7,Mid-Value,Potential Loyalists
4953,1306,1,"150,89999999999998",2,1,1,4,Low-Value,Can't Lose
4955,651,2,"55,3",4,1,1,6,Mid-Value,Potential Loyalists
4957,213,3,"217,35",5,1,1,7,Mid-Value,Potential Loyalists
4958,346,4,"289,25",5,1,1,7,Mid-Value,Potential Loyalists
4960,525,2,"181,3",4,1,1,6,Mid-Value,Potential Loyalists
4961,197,7,"500,05",5,2,1,8,High-Value,Potential Loyalists
4965,1075,1,"147,3",3,1,1,5,Low-Value,At Risk Customers
4966,3,2,"212,8",5,1,1,7,Mid-Value,Potential Loyalists
4967,405,1,"33,1",4,1,1,6,Mid-Value,Potential Loyalists
4970,654,2,"87,3",4,1,1,6,Mid-Value,Potential Loyalists
4971,1120,1,"237,29999999999998",2,1,1,4,Low-Value,Can't Lose
4973,1231,1,"207,29999999999998",2,1,1,4,Low-Value,Can't Lose
4974,529,1,"5,6",4,1,1,6,Mid-Value,Potential Loyalists
4975,182,1,"199,15",5,1,1,7,Mid-Value,Potential Loyalists
4976,740,3,"235,9",3,1,1,5,Low-Value,At Risk Customers
4978,143,5,"272,65",5,1,1,7,Mid-Value,Potential Loyalists
4980,1261,1,"53,1",2,1,1,4,Low-Value,Can't Lose
4983,1804,1,"48,6",1,1,1,3,Low-Value,Lost
4986,237,4,"370,85",5,1,1,7,Mid-Value,Potential Loyalists
4987,712,1,"28,8",4,1,1,6,Mid-Value,Potential Loyalists
4988,65,5,"372,2",5,1,1,7,Mid-Value,Potential Loyalists
4989,285,5,"243,25",5,1,1,7,Mid-Value,Potential Loyalists
4990,187,5,"250,5",5,1,1,7,Mid-Value,Potential Loyalists
4991,172,4,"270,05",5,1,1,7,Mid-Value,Potential Loyalists
4993,195,2,"140,8",5,1,1,7,Mid-Value,Potential Loyalists
4994,732,2,"210,6",3,1,1,5,Low-Value,At Risk Customers
4995,926,3,"132,35",3,1,1,5,Low-Value,At Risk Customers
4997,61,11,"563,65",5,2,1,8,High-Value,Potential Loyalists
4998,1379,1,"58,9",2,1,1,4,Low-Value,Can't Lose
4999,59,5,"191,9",5,1,1,7,Mid-Value,Potential Loyalists
5001,7,2,"101,0",5,1,1,7,Mid-Value,Potential Loyalists
5003,1410,1,"564,25",2,1,1,4,Low-Value,Can't Lose
5004,1585,1,"58,199999999999996",1,1,1,3,Low-Value,Lost
5008,1365,1,"9,85",2,1,1,4,Low-Value,Can't Lose
5009,178,4,"48,35",5,1,1,7,Mid-Value,Potential Loyalists
5010,882,3,"165,15",3,1,1,5,Low-Value,At Risk Customers
5011,97,10,"879,0500000000001",5,2,2,9,High-Value,Champions
5012,569,2,"49,2",4,1,1,6,Mid-Value,Potential Loyalists
5013,8,8,"539,5",5,2,1,8,High-Value,Potential Loyalists
5015,886,2,"34,0",3,1,1,5,Low-Value,At Risk Customers
5017,34,5,"852,8",5,1,2,8,High-Value,Potential Loyalists
5018,1111,4,"85,2",2,1,1,4,Low-Value,Can't Lose
5019,526,4,"311,79999999999995",4,1,1,6,Mid-Value,Potential Loyalists
5020,89,2,"195,14999999999998",5,1,1,7,Mid-Value,Potential Loyalists
5021,587,1,"96,2",4,1,1,6,Mid-Value,Potential Loyalists
5022,372,4,"104,9",4,1,1,6,Mid-Value,Potential Loyalists
5026,254,2,"305,9",5,1,1,7,Mid-Value,Potential Loyalists
5030,953,1,"15,5",3,1,1,5,Low-Value,At Risk Customers
5031,245,8,"1090,75",5,2,2,9,High-Value,Champions
5036,515,5,"537,5",4,1,1,6,Mid-Value,Potential Loyalists
5040,866,2,"133,05",3,1,1,5,Low-Value,At Risk Customers
5046,471,2,"128,65",4,1,1,6,Mid-Value,Potential Loyalists
5047,105,13,"811,75",5,3,2,10,High-Value,Champions
5048,1404,1,"67,1",2,1,1,4,Low-Value,Can't Lose
5052,1658,2,"66,15",1,1,1,3,Low-Value,Lost
5053,1487,2,"72,19999999999999",1,1,1,3,Low-Value,Lost
5056,830,1,"40,1",3,1,1,5,Low-Value,At Risk Customers
5057,44,4,"446,4",5,1,1,7,Mid-Value,Potential Loyalists
5058,37,2,"14,5",5,1,1,7,Mid-Value,Potential Loyalists
5059,363,6,"398,65",5,1,1,7,Mid-Value,Potential Loyalists
5061,253,1,"21,7",5,1,1,7,Mid-Value,Potential Loyalists
5062,722,2,"85,15",4,1,1,6,Mid-Value,Potential Loyalists
5063,14,13,"1222,35",5,3,2,10,High-Value,Champions
5064,213,3,"95,64999999999999",5,1,1,7,Mid-Value,Potential Loyalists
5065,1036,1,"125,15",3,1,1,5,Low-Value,At Risk Customers
5066,525,4,"1020,7",4,1,2,7,Mid-Value,Potential Loyalists
5068,758,5,"106,05",3,1,1,5,Low-Value,At Risk Customers
5069,1152,3,"312,45",2,1,1,4,Low-Value,Can't Lose
5070,254,1,"16,950000000000003",5,1,1,7,Mid-Value,Potential Loyalists
5072,682,2,"191,55",4,1,1,6,Mid-Value,Potential Loyalists
5076,296,4,"361,4",5,1,1,7,Mid-Value,Potential Loyalists
5078,644,1,"113,85",4,1,1,6,Mid-Value,Potential Loyalists
5079,50,3,"171,1",5,1,1,7,Mid-Value,Potential Loyalists
5080,335,4,"248,39999999999998",5,1,1,7,Mid-Value,Potential Loyalists
5082,864,4,"386,25",3,1,1,5,Low-Value,At Risk Customers
5083,909,7,"1095,1000000000001",3,2,2,7,Mid-Value,Potential Loyalists
5084,760,2,"444,2",3,1,1,5,Low-Value,At Risk Customers
5087,557,2,"14,55",4,1,1,6,Mid-Value,Potential Loyalists
5089,224,3,"108,85",5,1,1,7,Mid-Value,Potential Loyalists
5090,1120,2,"94,89999999999999",2,1,1,4,Low-Value,Can't Lose
5091,651,4,"63,6",4,1,1,6,Mid-Value,Potential Loyalists
5092,1281,4,"181,95",2,1,1,4,Low-Value,Can't Lose
5094,1490,1,"61,4",1,1,1,3,Low-Value,Lost
5095,135,3,"274,15",5,1,1,7,Mid-Value,Potential Loyalists
5096,202,1,"19,6",5,1,1,7,Mid-Value,Potential Loyalists
5097,236,5,"737,4",5,1,2,8,High-Value,Potential Loyalists
5099,784,2,"86,85",3,1,1,5,Low-Value,At Risk Customers
5100,505,4,"244,60000000000002",4,1,1,6,Mid-Value,Potential Loyalists
5101,1068,1,"76,3",3,1,1,5,Low-Value,At Risk Customers
5102,834,5,"389,75",3,1,1,5,Low-Value,At Risk Customers
5104,573,4,"377,2",4,1,1,6,Mid-Value,Potential Loyalists
5107,1378,2,"106,0",2,1,1,4,Low-Value,Can't Lose
5109,976,1,"13,75",3,1,1,5,Low-Value,At Risk Customers
5110,132,3,"290,0",5,1,1,7,Mid-Value,Potential Loyalists
5111,1648,2,"70,2",1,1,1,3,Low-Value,Lost
5112,227,3,"42,4",5,1,1,7,Mid-Value,Potential Loyalists
5113,310,2,"125,0",5,1,1,7,Mid-Value,Potential Loyalists
5115,87,5,"611,45",5,1,1,7,Mid-Value,Potential Loyalists
5118,614,3,"149,45",4,1,1,6,Mid-Value,Potential Loyalists
5119,252,4,"74,95",5,1,1,7,Mid-Value,Potential Loyalists
5120,183,3,"160,65",5,1,1,7,Mid-Value,Potential Loyalists
5121,412,2,"86,9",4,1,1,6,Mid-Value,Potential Loyalists
5123,388,1,"20,6",4,1,1,6,Mid-Value,Potential Loyalists
5125,369,3,"392,49999999999994",4,1,1,6,Mid-Value,Potential Loyalists
5128,1388,1,"12,8",2,1,1,4,Low-Value,Can't Lose
5129,712,2,"53,650000000000006",4,1,1,6,Mid-Value,Potential Loyalists
5131,497,1,"50,5",4,1,1,6,Mid-Value,Potential Loyalists
5132,1334,4,"324,1",2,1,1,4,Low-Value,Can't Lose
5133,1277,1,"118,9",2,1,1,4,Low-Value,Can't Lose
5134,768,3,"57,55",3,1,1,5,Low-Value,At Risk Customers
5138,384,3,"101,45",4,1,1,6,Mid-Value,Potential Loyalists
5140,228,2,"72,9",5,1,1,7,Mid-Value,Potential Loyalists
5141,423,5,"258,5",4,1,1,6,Mid-Value,Potential Loyalists
5142,601,3,"302,9",4,1,1,6,Mid-Value,Potential Loyalists
5143,872,5,"478,79999999999995",3,1,1,5,Low-Value,At Risk Customers
5145,54,3,"107,35",5,1,1,7,Mid-Value,Potential Loyalists
5146,36,2,"63,25",5,1,1,7,Mid-Value,Potential Loyalists
5147,204,2,"313,4",5,1,1,7,Mid-Value,Potential Loyalists
5148,1350,2,"38,75",2,1,1,4,Low-Value,Can't Lose
5149,1819,1,"73,85",1,1,1,3,Low-Value,Lost
5150,59,9,"249,3",5,2,1,8,High-Value,Potential Loyalists
5151,541,4,"126,80000000000001",4,1,1,6,Mid-Value,Potential Loyalists
5152,762,2,"57,25",3,1,1,5,Low-Value,At Risk Customers
5155,8,9,"435,05",5,2,1,8,High-Value,Potential Loyalists
5156,760,4,"137,65",3,1,1,5,Low-Value,At Risk Customers
5158,41,9,"406,7",5,2,1,8,High-Value,Potential Loyalists
5159,684,11,"696,5",4,2,2,8,High-Value,Potential Loyalists
5160,54,1,"18,0",5,1,1,7,Mid-Value,Potential Loyalists
5162,974,2,"191,0",3,1,1,5,Low-Value,At Risk Customers
5163,1366,1,"45,6",2,1,1,4,Low-Value,Can't Lose
5166,1012,7,"719,45",3,2,2,7,Mid-Value,Potential Loyalists
5167,44,9,"850,48",5,2,2,9,High-Value,Champions
5170,613,2,"78,1",4,1,1,6,Mid-Value,Potential Loyalists
5171,4,6,"494,2",5,1,1,7,Mid-Value,Potential Loyalists
5172,404,2,"246,64999999999998",4,1,1,6,Mid-Value,Potential Loyalists
5173,108,4,"352,8",5,1,1,7,Mid-Value,Potential Loyalists
5174,32,2,"82,5",5,1,1,7,Mid-Value,Potential Loyalists
5175,289,5,"159,4",5,1,1,7,Mid-Value,Potential Loyalists
5177,1256,1,"27,3",2,1,1,4,Low-Value,Can't Lose
5178,133,4,"198,35",5,1,1,7,Mid-Value,Potential Loyalists
5179,1213,1,"7,5",2,1,1,4,Low-Value,Can't Lose
5180,573,3,"41,800000000000004",4,1,1,6,Mid-Value,Potential Loyalists
5181,35,11,"749,85",5,2,2,9,High-Value,Champions
5182,4,2,"28,15",5,1,1,7,Mid-Value,Potential Loyalists
5183,368,4,"279,95",4,1,1,6,Mid-Value,Potential Loyalists
5185,789,6,"365,8",3,1,1,5,Low-Value,At Risk Customers
5187,405,1,"19,55",4,1,1,6,Mid-Value,Potential Loyalists
5188,680,8,"320,35",4,2,1,7,Mid-Value,Potential Loyalists
5190,392,3,"202,39999999999998",4,1,1,6,Mid-Value,Potential Loyalists
5192,225,6,"604,9499999999999",5,1,1,7,Mid-Value,Potential Loyalists
5193,908,1,"226,5",3,1,1,5,Low-Value,At Risk Customers
5199,1400,3,"73,2",2,1,1,4,Low-Value,Can't Lose
5200,1119,1,"132,6",2,1,1,4,Low-Value,Can't Lose
5202,1,3,"388,5",5,1,1,7,Mid-Value,Potential Loyalists
5203,1695,1,"5,5",1,1,1,3,Low-Value,Lost
5206,955,1,"36,3",3,1,1,5,Low-Value,At Risk Customers
5210,529,5,"169,3",4,1,1,6,Mid-Value,Potential Loyalists
5212,360,3,"168,2",5,1,1,7,Mid-Value,Potential Loyalists
5214,14,6,"402,88",5,1,1,7,Mid-Value,Potential Loyalists
5216,1002,2,"55,0",3,1,1,5,Low-Value,At Risk Customers
5217,178,5,"322,8",5,1,1,7,Mid-Value,Potential Loyalists
5219,360,3,"133,0",5,1,1,7,Mid-Value,Potential Loyalists
5220,966,3,"81,9",3,1,1,5,Low-Value,At Risk Customers
5222,297,2,"235,7",5,1,1,7,Mid-Value,Potential Loyalists
5223,309,2,"210,35",5,1,1,7,Mid-Value,Potential Loyalists
5224,348,3,"320,5",5,1,1,7,Mid-Value,Potential Loyalists
5227,761,5,"294,9",3,1,1,5,Low-Value,At Risk Customers
5228,455,3,"79,10000000000001",4,1,1,6,Mid-Value,Potential Loyalists
5229,739,4,"263,0",3,1,1,5,Low-Value,At Risk Customers
5231,350,4,"216,25",5,1,1,7,Mid-Value,Potential Loyalists
5232,158,2,"75,44999999999999",5,1,1,7,Mid-Value,Potential Loyalists
5233,472,6,"315,4",4,1,1,6,Mid-Value,Potential Loyalists
5236,34,3,"199,95",5,1,1,7,Mid-Value,Potential Loyalists
5238,542,15,"798,15",4,3,2,9,High-Value,Champions
5240,536,3,"288,4",4,1,1,6,Mid-Value,Potential Loyalists
5242,180,14,"757,75",5,3,2,10,High-Value,Champions
5243,122,2,"86,55",5,1,1,7,Mid-Value,Potential Loyalists
5248,74,13,"629,75",5,3,1,9,High-Value,Champions
5249,266,2,"85,94999999999999",5,1,1,7,Mid-Value,Potential Loyalists
5250,223,3,"78,0",5,1,1,7,Mid-Value,Potential Loyalists
5251,1486,2,"41,55",1,1,1,3,Low-Value,Lost
5253,1,3,"122,8",5,1,1,7,Mid-Value,Potential Loyalists
5254,1770,1,"8,75",1,1,1,3,Low-Value,Lost
5255,28,8,"489,4",5,2,1,8,High-Value,Potential Loyalists
5256,373,6,"234,3",4,1,1,6,Mid-Value,Potential Loyalists
5257,212,1,"207,0",5,1,1,7,Mid-Value,Potential Loyalists
5259,631,3,"182,7",4,1,1,6,Mid-Value,Potential Loyalists
5260,1053,1,"412,3",3,1,1,5,Low-Value,At Risk Customers
5262,273,4,"207,2",5,1,1,7,Mid-Value,Potential Loyalists
5263,735,3,"121,44999999999999",3,1,1,5,Low-Value,At Risk Customers
5264,66,4,"323,4",5,1,1,7,Mid-Value,Potential Loyalists
5267,1513,1,"27,1",1,1,1,3,Low-Value,Lost
5269,1350,1,"6,3",2,1,1,4,Low-Value,Can't Lose
5271,1236,2,"147,8",2,1,1,4,Low-Value,Can't Lose
5273,20,6,"323,45",5,1,1,7,Mid-Value,Potential Loyalists
5274,81,5,"585,85",5,1,1,7,Mid-Value,Potential Loyalists
5275,167,2,"318,35",5,1,1,7,Mid-Value,Potential Loyalists
5276,400,2,"20,95",4,1,1,6,Mid-Value,Potential Loyalists
5278,350,3,"88,7",5,1,1,7,Mid-Value,Potential Loyalists
5280,574,1,"108,0",4,1,1,6,Mid-Value,Potential Loyalists
5281,301,1,"19,4",5,1,1,7,Mid-Value,Potential Loyalists
5283,793,1,"26,85",3,1,1,5,Low-Value,At Risk Customers
5286,136,9,"236,5",5,2,1,8,High-Value,Potential Loyalists
5287,399,8,"745,4",4,2,2,8,High-Value,Potential Loyalists
5288,38,4,"163,9",5,1,1,7,Mid-Value,Potential Loyalists
5289,415,1,"43,15",4,1,1,6,Mid-Value,Potential Loyalists
5290,1124,2,"28,6",2,1,1,4,Low-Value,Can't Lose
5291,1355,1,"10,35",2,1,1,4,Low-Value,Can't Lose
5292,593,3,"122,3",4,1,1,6,Mid-Value,Potential Loyalists
5293,182,5,"684,6500000000001",5,1,2,8,High-Value,Potential Loyalists
5294,735,1,"116,85",3,1,1,5,Low-Value,At Risk Customers
5296,594,1,"43,5",4,1,1,6,Mid-Value,Potential Loyalists
5298,983,3,"74,0",3,1,1,5,Low-Value,At Risk Customers
5301,97,7,"559,1",5,2,1,8,High-Value,Potential Loyalists
5302,388,6,"554,75",4,1,1,6,Mid-Value,Potential Loyalists
5303,424,8,"536,45",4,2,1,7,Mid-Value,Potential Loyalists
5304,334,1,"19,5",5,1,1,7,Mid-Value,Potential Loyalists
5307,1198,2,"359,5",2,1,1,4,Low-Value,Can't Lose
5308,990,1,"20,4",3,1,1,5,Low-Value,At Risk Customers
5309,862,2,"142,15",3,1,1,5,Low-Value,At Risk Customers
5312,501,3,"799,4",4,1,2,7,Mid-Value,Potential Loyalists
5313,865,1,"105,4",3,1,1,5,Low-Value,At Risk Customers
5314,1106,3,"127,0",2,1,1,4,Low-Value,Can't Lose
5315,1606,2,"25,1",1,1,1,3,Low-Value,Lost
5318,94,5,"457,8",5,1,1,7,Mid-Value,Potential Loyalists
5319,760,2,"280,55",3,1,1,5,Low-Value,At Risk Customers
5320,709,1,"113,25",4,1,1,6,Mid-Value,Potential Loyalists
5321,1720,1,"86,45",1,1,1,3,Low-Value,Lost
5322,1100,2,"92,75",2,1,1,4,Low-Value,Can't Lose
5323,1,3,"505,75",5,1,1,7,Mid-Value,Potential Loyalists
5324,264,3,"60,0",5,1,1,7,Mid-Value,Potential Loyalists
5325,1228,1,"31,2",2,1,1,4,Low-Value,Can't Lose
5326,798,16,"859,65",3,3,2,8,High-Value,Potential Loyalists
5327,1550,1,"28,65",1,1,1,3,Low-Value,Lost
5329,715,1,"112,3",4,1,1,6,Mid-Value,Potential Loyalists
5330,1265,3,"128,15",2,1,1,4,Low-Value,Can't Lose
5331,108,1,"96,5",5,1,1,7,Mid-Value,Potential Loyalists
5332,11,2,"187,85",5,1,1,7,Mid-Value,Potential Loyalists
5333,1680,1,"24,35",1,1,1,3,Low-Value,Lost
5334,70,5,"166,15",5,1,1,7,Mid-Value,Potential Loyalists
5336,1119,2,"29,650000000000002",2,1,1,4,Low-Value,Can't Lose
5337,1392,3,"32,25",2,1,1,4,Low-Value,Can't Lose
5338,1090,1,"22,45",3,1,1,5,Low-Value,At Risk Customers
5340,889,1,"5,5",3,1,1,5,Low-Value,At Risk Customers
5342,653,1,"42,8",4,1,1,6,Mid-Value,Potential Loyalists
5343,809,2,"41,89999999999999",3,1,1,5,Low-Value,At Risk Customers
5344,1385,1,"112,05000000000001",2,1,1,4,Low-Value,Can't Lose
5346,508,5,"280,0",4,1,1,6,Mid-Value,Potential Loyalists
5349,354,5,"555,7",5,1,1,7,Mid-Value,Potential Loyalists
5350,101,5,"178,4",5,1,1,7,Mid-Value,Potential Loyalists
5351,316,3,"359,85",5,1,1,7,Mid-Value,Potential Loyalists
5357,122,8,"187,4",5,2,1,8,High-Value,Potential Loyalists
5358,81,9,"634,6",5,2,1,8,High-Value,Potential Loyalists
5359,155,3,"325,6",5,1,1,7,Mid-Value,Potential Loyalists
5360,579,3,"127,7",4,1,1,6,Mid-Value,Potential Loyalists
5362,169,1,"81,5",5,1,1,7,Mid-Value,Potential Loyalists
5364,591,1,"30,900000000000002",4,1,1,6,Mid-Value,Potential Loyalists
5366,977,1,"25,25",3,1,1,5,Low-Value,At Risk Customers
5370,30,6,"288,1",5,1,1,7,Mid-Value,Potential Loyalists
5371,1645,2,"121,69999999999999",1,1,1,3,Low-Value,Lost
5373,60,11,"762,1",5,2,2,9,High-Value,Champions
5374,423,6,"144,5",4,1,1,6,Mid-Value,Potential Loyalists
5375,745,1,"22,4",3,1,1,5,Low-Value,At Risk Customers
5377,271,4,"99,9",5,1,1,7,Mid-Value,Potential Loyalists
5378,456,5,"383,75",4,1,1,6,Mid-Value,Potential Loyalists
5379,738,2,"54,2",3,1,1,5,Low-Value,At Risk Customers
5381,277,1,"15,95",5,1,1,7,Mid-Value,Potential Loyalists
5383,508,3,"83,15",4,1,1,6,Mid-Value,Potential Loyalists
5385,1116,2,"27,549999999999997",2,1,1,4,Low-Value,Can't Lose
5386,1158,1,"39,1",2,1,1,4,Low-Value,Can't Lose
5387,1478,1,"8,9",1,1,1,3,Low-Value,Lost
5388,214,5,"435,05",5,1,1,7,Mid-Value,Potential Loyalists
5389,1320,1,"85,35",2,1,1,4,Low-Value,Can't Lose
5390,92,6,"581,7",5,1,1,7,Mid-Value,Potential Loyalists
5391,1096,2,"346,6",2,1,1,4,Low-Value,Can't Lose
5393,565,3,"243,3",4,1,1,6,Mid-Value,Potential Loyalists
5394,1256,2,"92,35",2,1,1,4,Low-Value,Can't Lose
5395,957,1,"85,5",3,1,1,5,Low-Value,At Risk Customers
5398,402,6,"213,8",4,1,1,6,Mid-Value,Potential Loyalists
5399,80,4,"114,6",5,1,1,7,Mid-Value,Potential Loyalists
5400,232,5,"356,4",5,1,1,7,Mid-Value,Potential Loyalists
5401,733,7,"646,05",3,2,1,6,Mid-Value,Potential Loyalists
5402,630,2,"427,3",4,1,1,6,Mid-Value,Potential Loyalists
5404,553,1,"21,9",4,1,1,6,Mid-Value,Potential Loyalists
5406,1490,1,"11,3",1,1,1,3,Low-Value,Lost
5410,310,2,"277,9",5,1,1,7,Mid-Value,Potential Loyalists
5412,0,3,"83,15",5,1,1,7,Mid-Value,Potential Loyalists
5414,96,7,"371,35",5,2,1,8,High-Value,Potential Loyalists
5415,1270,2,"87,69999999999999",2,1,1,4,Low-Value,Can't Lose
5416,468,2,"75,1",4,1,1,6,Mid-Value,Potential Loyalists
5417,924,4,"181,60000000000002",3,1,1,5,Low-Value,At Risk Customers
5418,476,1,"56,0",4,1,1,6,Mid-Value,Potential Loyalists
5419,214,3,"249,0",5,1,1,7,Mid-Value,Potential Loyalists
5422,756,2,"76,1",3,1,1,5,Low-Value,At Risk Customers
5426,444,5,"160,35000000000002",4,1,1,6,Mid-Value,Potential Loyalists
5428,75,2,"91,5",5,1,1,7,Mid-Value,Potential Loyalists
5429,31,16,"1216,7",5,3,2,10,High-Value,Champions
5430,285,1,"2,8",5,1,1,7,Mid-Value,Potential Loyalists
5431,193,5,"329,05",5,1,1,7,Mid-Value,Potential Loyalists
5432,57,1,"57,8",5,1,1,7,Mid-Value,Potential Loyalists
5433,970,1,"196,0",3,1,1,5,Low-Value,At Risk Customers
5434,12,2,"51,9",5,1,1,7,Mid-Value,Potential Loyalists
5435,681,3,"346,75",4,1,1,6,Mid-Value,Potential Loyalists
5437,327,4,"173,14999999999998",5,1,1,7,Mid-Value,Potential Loyalists
5438,338,4,"367,75",5,1,1,7,Mid-Value,Potential Loyalists
5440,76,3,"69,8",5,1,1,7,Mid-Value,Potential Loyalists
5441,117,3,"238,5",5,1,1,7,Mid-Value,Potential Loyalists
5442,1254,2,"45,35",2,1,1,4,Low-Value,Can't Lose
5443,394,3,"68,8",4,1,1,6,Mid-Value,Potential Loyalists
5446,381,3,"134,3",4,1,1,6,Mid-Value,Potential Loyalists
5447,17,5,"499,09999999999997",5,1,1,7,Mid-Value,Potential Loyalists
5448,701,1,"46,7",4,1,1,6,Mid-Value,Potential Loyalists
5449,369,2,"210,45000000000002",4,1,1,6,Mid-Value,Potential Loyalists
5450,572,1,"19,85",4,1,1,6,Mid-Value,Potential Loyalists
5452,294,2,"65,25",5,1,1,7,Mid-Value,Potential Loyalists
5453,1267,2,"251,25",2,1,1,4,Low-Value,Can't Lose
5454,938,1,"68,9",3,1,1,5,Low-Value,At Risk Customers
5455,1105,1,"20,9",2,1,1,4,Low-Value,Can't Lose
5457,1422,1,"117,8",2,1,1,4,Low-Value,Can't Lose
5460,393,4,"177,1",4,1,1,6,Mid-Value,Potential Loyalists
5462,624,4,"348,3",4,1,1,6,Mid-Value,Potential Loyalists
5463,160,3,"140,8",5,1,1,7,Mid-Value,Potential Loyalists
5465,910,1,"91,5",3,1,1,5,Low-Value,At Risk Customers
5466,29,9,"362,0",5,2,1,8,High-Value,Potential Loyalists
5467,495,4,"392,4",4,1,1,6,Mid-Value,Potential Loyalists
5468,461,1,"10,6",4,1,1,6,Mid-Value,Potential Loyalists
5470,329,3,"339,65",5,1,1,7,Mid-Value,Potential Loyalists
5472,15,4,"263,85",5,1,1,7,Mid-Value,Potential Loyalists
5473,781,2,"109,4",3,1,1,5,Low-Value,At Risk Customers
5474,200,5,"122,0",5,1,1,7,Mid-Value,Potential Loyalists
5476,131,2,"221,2",5,1,1,7,Mid-Value,Potential Loyalists
5477,503,2,"110,9",4,1,1,6,Mid-Value,Potential Loyalists
5478,938,5,"417,6",3,1,1,5,Low-Value,At Risk Customers
5479,308,4,"303,65",5,1,1,7,Mid-Value,Potential Loyalists
5481,168,10,"933,85",5,2,2,9,High-Value,Champions
5482,129,7,"453,25",5,2,1,8,High-Value,Potential Loyalists
5483,1036,1,"39,5",3,1,1,5,Low-Value,At Risk Customers
5484,1312,1,"4,05",2,1,1,4,Low-Value,Can't Lose
5485,1435,1,"27,5",2,1,1,4,Low-Value,Can't Lose
5487,399,10,"347,4",4,2,1,7,Mid-Value,Potential Loyalists
5489,1316,1,"39,599999999999994",2,1,1,4,Low-Value,Can't Lose
5490,28,9,"432,2",5,2,1,8,High-Value,Potential Loyalists
5491,468,5,"605,3",4,1,1,6,Mid-Value,Potential Loyalists
5493,195,4,"137,85",5,1,1,7,Mid-Value,Potential Loyalists
5496,260,3,"79,5",5,1,1,7,Mid-Value,Potential Loyalists
5499,528,3,"192,10000000000002",4,1,1,6,Mid-Value,Potential Loyalists
5502,1072,1,"161,2",3,1,1,5,Low-Value,At Risk Customers
5503,161,2,"57,599999999999994",5,1,1,7,Mid-Value,Potential Loyalists
5504,621,2,"114,25",4,1,1,6,Mid-Value,Potential Loyalists
5506,230,5,"450,29999999999995",5,1,1,7,Mid-Value,Potential Loyalists
5507,61,10,"588,2",5,2,1,8,High-Value,Potential Loyalists
5508,350,1,"2,2",5,1,1,7,Mid-Value,Potential Loyalists
5509,852,1,"48,45",3,1,1,5,Low-Value,At Risk Customers
5512,227,1,"66,75",5,1,1,7,Mid-Value,Potential Loyalists
5516,223,1,"579,9",5,1,1,7,Mid-Value,Potential Loyalists
5517,14,6,"850,7",5,1,2,8,High-Value,Potential Loyalists
5518,94,4,"146,95",5,1,1,7,Mid-Value,Potential Loyalists
5519,138,7,"215,15",5,2,1,8,High-Value,Potential Loyalists
5520,1203,1,"31,1",2,1,1,4,Low-Value,Can't Lose
5521,1123,1,"89,7",2,1,1,4,Low-Value,Can't Lose
5523,613,4,"91,15",4,1,1,6,Mid-Value,Potential Loyalists
5524,732,5,"207,95",3,1,1,5,Low-Value,At Risk Customers
5525,419,8,"361,5",4,2,1,7,Mid-Value,Potential Loyalists
5526,16,6,"771,5",5,1,2,8,High-Value,Potential Loyalists
5527,699,4,"583,9",4,1,1,6,Mid-Value,Potential Loyalists
5528,343,4,"151,05",5,1,1,7,Mid-Value,Potential Loyalists
5529,1117,2,"69,85",2,1,1,4,Low-Value,Can't Lose
5530,959,4,"342,1",3,1,1,5,Low-Value,At Risk Customers
5531,955,2,"120,55000000000001",3,1,1,5,Low-Value,At Risk Customers
5532,166,4,"131,4",5,1,1,7,Mid-Value,Potential Loyalists
5533,57,7,"147,25",5,2,1,8,High-Value,Potential Loyalists
5538,1180,3,"114,65",2,1,1,4,Low-Value,Can't Lose
5540,136,2,"105,85",5,1,1,7,Mid-Value,Potential Loyalists
5541,29,5,"287,55",5,1,1,7,Mid-Value,Potential Loyalists
5542,899,1,"57,0",3,1,1,5,Low-Value,At Risk Customers
5543,584,10,"294,3",4,2,1,7,Mid-Value,Potential Loyalists
5544,1020,1,"9,95",3,1,1,5,Low-Value,At Risk Customers
5545,15,2,"25,450000000000003",5,1,1,7,Mid-Value,Potential Loyalists
5547,206,2,"31,85",5,1,1,7,Mid-Value,Potential Loyalists
5548,411,2,"100,50000000000001",4,1,1,6,Mid-Value,Potential Loyalists
5549,418,2,"64,75",4,1,1,6,Mid-Value,Potential Loyalists
5552,1722,1,"143,25",1,1,1,3,Low-Value,Lost
5553,31,13,"878,93",5,3,2,10,High-Value,Champions
5555,788,1,"116,0",3,1,1,5,Low-Value,At Risk Customers
5556,560,6,"1302,35",4,1,2,7,Mid-Value,Potential Loyalists
5557,25,7,"407,85",5,2,1,8,High-Value,Potential Loyalists
5558,228,4,"77,60000000000001",5,1,1,7,Mid-Value,Potential Loyalists
5559,741,4,"269,6",3,1,1,5,Low-Value,At Risk Customers
5561,654,1,"23,5",4,1,1,6,Mid-Value,Potential Loyalists
5562,109,4,"197,6",5,1,1,7,Mid-Value,Potential Loyalists
5563,193,3,"370,2",5,1,1,7,Mid-Value,Potential Loyalists
5565,152,4,"222,60000000000002",5,1,1,7,Mid-Value,Potential Loyalists
5567,1503,1,"9,85",1,1,1,3,Low-Value,Lost
5569,258,5,"88,0",5,1,1,7,Mid-Value,Potential Loyalists
5570,1250,2,"254,9",2,1,1,4,Low-Value,Can't Lose
5571,1686,2,"58,24999999999999",1,1,1,3,Low-Value,Lost
5573,181,4,"276,6",5,1,1,7,Mid-Value,Potential Loyalists
5574,404,1,"73,15",4,1,1,6,Mid-Value,Potential Loyalists
5575,28,5,"449,7",5,1,1,7,Mid-Value,Potential Loyalists
5580,295,2,"252,5",5,1,1,7,Mid-Value,Potential Loyalists
5581,247,2,"174,85",5,1,1,7,Mid-Value,Potential Loyalists
5583,25,7,"508,15000000000003",5,2,1,8,High-Value,Potential Loyalists
5584,500,4,"165,95",4,1,1,6,Mid-Value,Potential Loyalists
5586,126,7,"546,8",5,2,1,8,High-Value,Potential Loyalists
5589,333,5,"378,45",5,1,1,7,Mid-Value,Potential Loyalists
5590,54,8,"470,45",5,2,1,8,High-Value,Potential Loyalists
5593,1637,2,"75,55",1,1,1,3,Low-Value,Lost
5595,98,3,"50,55",5,1,1,7,Mid-Value,Potential Loyalists
5597,529,6,"503,16",4,1,1,6,Mid-Value,Potential Loyalists
5598,652,2,"37,849999999999994",4,1,1,6,Mid-Value,Potential Loyalists
5599,160,6,"178,89999999999998",5,1,1,7,Mid-Value,Potential Loyalists
5602,529,6,"444,25",4,1,1,6,Mid-Value,Potential Loyalists
5603,61,5,"121,45",5,1,1,7,Mid-Value,Potential Loyalists
5606,1674,1,"38,9",1,1,1,3,Low-Value,Lost
5607,1653,1,"65,3",1,1,1,3,Low-Value,Lost
5608,883,2,"131,7",3,1,1,5,Low-Value,At Risk Customers
5609,1100,3,"416,25000000000006",2,1,1,4,Low-Value,Can't Lose
5610,1572,1,"73,6",1,1,1,3,Low-Value,Lost
5612,203,9,"320,45000000000005",5,2,1,8,High-Value,Potential Loyalists
5613,824,5,"360,7",3,1,1,5,Low-Value,At Risk Customers
5615,1295,3,"662,15",2,1,1,4,Low-Value,Can't Lose
5616,562,1,"6,05",4,1,1,6,Mid-Value,Potential Loyalists
5618,94,9,"412,9",5,2,1,8,High-Value,Potential Loyalists
5619,696,3,"135,29999999999998",4,1,1,6,Mid-Value,Potential Loyalists
5620,176,1,"796,0",5,1,2,8,High-Value,Potential Loyalists
5621,67,2,"59,95",5,1,1,7,Mid-Value,Potential Loyalists
5622,147,6,"529,95",5,1,1,7,Mid-Value,Potential Loyalists
5625,159,1,"63,0",5,1,1,7,Mid-Value,Potential Loyalists
5628,573,1,"94,25",4,1,1,6,Mid-Value,Potential Loyalists
5629,1476,1,"618,45",1,1,1,3,Low-Value,Lost
5631,32,4,"420,75",5,1,1,7,Mid-Value,Potential Loyalists
5632,395,4,"228,14999999999998",4,1,1,6,Mid-Value,Potential Loyalists
5633,107,7,"423,05",5,2,1,8,High-Value,Potential Loyalists
5634,1546,1,"9,55",1,1,1,3,Low-Value,Lost
5636,906,6,"210,5",3,1,1,5,Low-Value,At Risk Customers
5637,483,2,"86,55",4,1,1,6,Mid-Value,Potential Loyalists
5640,732,2,"29,099999999999998",3,1,1,5,Low-Value,At Risk Customers
5645,553,2,"100,8",4,1,1,6,Mid-Value,Potential Loyalists
5646,1206,1,"19,35",2,1,1,4,Low-Value,Can't Lose
5648,386,5,"258,75",4,1,1,6,Mid-Value,Potential Loyalists
5649,946,1,"218,25",3,1,1,5,Low-Value,At Risk Customers
5652,412,1,"67,65",4,1,1,6,Mid-Value,Potential Loyalists
5653,33,5,"595,85",5,1,1,7,Mid-Value,Potential Loyalists
5654,76,9,"612,75",5,2,1,8,High-Value,Potential Loyalists
5656,118,11,"652,25",5,2,1,8,High-Value,Potential Loyalists
5662,28,2,"154,4",5,1,1,7,Mid-Value,Potential Loyalists
5663,1625,2,"55,8",1,1,1,3,Low-Value,Lost
5664,1142,7,"240,25",2,2,1,5,Low-Value,At Risk Customers
5665,172,4,"198,4",5,1,1,7,Mid-Value,Potential Loyalists
5666,1105,1,"139,4",2,1,1,4,Low-Value,Can't Lose
5672,24,3,"221,64999999999998",5,1,1,7,Mid-Value,Potential Loyalists
5673,1087,1,"24,8",3,1,1,5,Low-Value,At Risk Customers
5677,438,5,"304,1",4,1,1,6,Mid-Value,Potential Loyalists
5678,65,2,"74,19999999999999",5,1,1,7,Mid-Value,Potential Loyalists
5679,59,4,"96,05000000000001",5,1,1,7,Mid-Value,Potential Loyalists
5683,472,2,"117,95",4,1,1,6,Mid-Value,Potential Loyalists
5685,431,6,"352,35",4,1,1,6,Mid-Value,Potential Loyalists
5686,374,5,"308,5",4,1,1,6,Mid-Value,Potential Loyalists
5687,1403,1,"41,0",2,1,1,4,Low-Value,Can't Lose
5688,46,8,"554,65",5,2,1,8,High-Value,Potential Loyalists
5689,635,1,"27,05",4,1,1,6,Mid-Value,Potential Loyalists
5690,987,3,"92,45",3,1,1,5,Low-Value,At Risk Customers
5691,161,1,"99,5",5,1,1,7,Mid-Value,Potential Loyalists
5692,559,3,"136,5",4,1,1,6,Mid-Value,Potential Loyalists
5693,1142,1,"52,75",2,1,1,4,Low-Value,Can't Lose
5695,117,6,"914,5999999999999",5,1,2,8,High-Value,Potential Loyalists
5696,18,2,"272,59999999999997",5,1,1,7,Mid-Value,Potential Loyalists
5697,1579,1,"9,7",1,1,1,3,Low-Value,Lost
5698,14,5,"258,1",5,1,1,7,Mid-Value,Potential Loyalists
5699,1450,1,"17,4",2,1,1,4,Low-Value,Can't Lose
5700,533,4,"154,6",4,1,1,6,Mid-Value,Potential Loyalists
5702,38,14,"982,1",5,3,2,10,High-Value,Champions
5703,411,3,"350,24999999999994",4,1,1,6,Mid-Value,Potential Loyalists
5704,173,8,"642,4",5,2,1,8,High-Value,Potential Loyalists
5705,237,7,"319,25",5,2,1,8,High-Value,Potential Loyalists
5708,28,9,"760,6",5,2,2,9,High-Value,Champions
5709,598,3,"185,55",4,1,1,6,Mid-Value,Potential Loyalists
5710,133,3,"101,35",5,1,1,7,Mid-Value,Potential Loyalists
5711,354,3,"102,75",5,1,1,7,Mid-Value,Potential Loyalists
5712,854,2,"147,5",3,1,1,5,Low-Value,At Risk Customers
5713,1274,1,"169,8",2,1,1,4,Low-Value,Can't Lose
5716,447,1,"2,2",4,1,1,6,Mid-Value,Potential Loyalists
5718,157,3,"110,74999999999999",5,1,1,7,Mid-Value,Potential Loyalists
5719,739,3,"132,5",3,1,1,5,Low-Value,At Risk Customers
5723,1236,1,"218,25",2,1,1,4,Low-Value,Can't Lose
5724,441,6,"249,15",4,1,1,6,Mid-Value,Potential Loyalists
5728,97,3,"59,7",5,1,1,7,Mid-Value,Potential Loyalists
5729,1398,4,"165,65",2,1,1,4,Low-Value,Can't Lose
5730,1041,2,"43,2",3,1,1,5,Low-Value,At Risk Customers
5731,1676,1,"140,05",1,1,1,3,Low-Value,Lost
5734,417,12,"673,55",4,3,2,9,High-Value,Champions
5735,293,4,"195,6",5,1,1,7,Mid-Value,Potential Loyalists
5736,1540,1,"17,25",1,1,1,3,Low-Value,Lost
5739,295,2,"47,15",5,1,1,7,Mid-Value,Potential Loyalists
5742,12,6,"334,8",5,1,1,7,Mid-Value,Potential Loyalists
5743,451,4,"432,15",4,1,1,6,Mid-Value,Potential Loyalists
5744,1679,1,"207,9",1,1,1,3,Low-Value,Lost
5746,896,3,"37,95",3,1,1,5,Low-Value,At Risk Customers
5747,380,2,"58,75",4,1,1,6,Mid-Value,Potential Loyalists
5748,8,4,"213,05",5,1,1,7,Mid-Value,Potential Loyalists
5749,651,1,"17,6",4,1,1,6,Mid-Value,Potential Loyalists
5750,193,2,"124,9",5,1,1,7,Mid-Value,Potential Loyalists
5752,246,3,"1060,1499999999999",5,1,2,8,High-Value,Potential Loyalists
5755,1347,2,"25,4",2,1,1,4,Low-Value,Can't Lose
5756,741,1,"114,4",3,1,1,5,Low-Value,At Risk Customers
5758,17,6,"259,95",5,1,1,7,Mid-Value,Potential Loyalists
5760,650,2,"25,05",4,1,1,6,Mid-Value,Potential Loyalists
5761,553,5,"496,15000000000003",4,1,1,6,Mid-Value,Potential Loyalists
5762,629,3,"362,0",4,1,1,6,Mid-Value,Potential Loyalists
5763,232,2,"185,35000000000002",5,1,1,7,Mid-Value,Potential Loyalists
5764,1543,1,"227,4",1,1,1,3,Low-Value,Lost
5766,827,1,"73,85",3,1,1,5,Low-Value,At Risk Customers
5767,1663,1,"94,5",1,1,1,3,Low-Value,Lost
5768,329,4,"207,6",5,1,1,7,Mid-Value,Potential Loyalists
5770,514,2,"133,9",4,1,1,6,Mid-Value,Potential Loyalists
5771,1407,1,"63,8",2,1,1,4,Low-Value,Can't Lose
5772,22,3,"206,60000000000002",5,1,1,7,Mid-Value,Potential Loyalists
5774,22,8,"744,65",5,2,2,9,High-Value,Champions
5776,938,1,"17,15",3,1,1,5,Low-Value,At Risk Customers
5777,1639,1,"35,1",1,1,1,3,Low-Value,Lost
5778,326,1,"11,4",5,1,1,7,Mid-Value,Potential Loyalists
5779,106,6,"141,15",5,1,1,7,Mid-Value,Potential Loyalists
5781,1368,1,"65,8",2,1,1,4,Low-Value,Can't Lose
5782,1246,1,"6,1",2,1,1,4,Low-Value,Can't Lose
5783,605,1,"66,85",4,1,1,6,Mid-Value,Potential Loyalists
5784,24,9,"272,3",5,2,1,8,High-Value,Potential Loyalists
5785,1520,1,"118,05",1,1,1,3,Low-Value,Lost
5786,606,2,"29,4",4,1,1,6,Mid-Value,Potential Loyalists
5787,147,2,"57,199999999999996",5,1,1,7,Mid-Value,Potential Loyalists
5789,530,4,"200,35",4,1,1,6,Mid-Value,Potential Loyalists
5793,393,6,"177,4",4,1,1,6,Mid-Value,Potential Loyalists
5794,885,3,"620,3",3,1,1,5,Low-Value,At Risk Customers
5796,1646,3,"174,0",1,1,1,3,Low-Value,Lost
5797,437,1,"55,2",4,1,1,6,Mid-Value,Potential Loyalists
5800,329,4,"311,54999999999995",5,1,1,7,Mid-Value,Potential Loyalists
5801,131,4,"285,25",5,1,1,7,Mid-Value,Potential Loyalists
5802,17,7,"509,25",5,2,1,8,High-Value,Potential Loyalists
5803,794,2,"107,3",3,1,1,5,Low-Value,At Risk Customers
5804,22,2,"200,9",5,1,1,7,Mid-Value,Potential Loyalists
5805,1595,2,"102,4",1,1,1,3,Low-Value,Lost
5806,61,5,"359,45000000000005",5,1,1,7,Mid-Value,Potential Loyalists
5808,1003,2,"48,75",3,1,1,5,Low-Value,At Risk Customers
5809,427,6,"597,9",4,1,1,6,Mid-Value,Potential Loyalists
5811,95,6,"260,5",5,1,1,7,Mid-Value,Potential Loyalists
5815,1653,1,"86,25",1,1,1,3,Low-Value,Lost
5819,154,2,"47,05",5,1,1,7,Mid-Value,Potential Loyalists
5820,7,3,"300,45",5,1,1,7,Mid-Value,Potential Loyalists
5821,742,5,"420,15",3,1,1,5,Low-Value,At Risk Customers
5822,627,2,"21,349999999999998",4,1,1,6,Mid-Value,Potential Loyalists
5823,109,6,"243,35",5,1,1,7,Mid-Value,Potential Loyalists
5824,942,1,"39,5",3,1,1,5,Low-Value,At Risk Customers
5826,1584,3,"205,15",1,1,1,3,Low-Value,Lost
5827,455,3,"136,95000000000002",4,1,1,6,Mid-Value,Potential Loyalists
5828,1692,1,"30,0",1,1,1,3,Low-Value,Lost
5829,17,4,"76,65",5,1,1,7,Mid-Value,Potential Loyalists
5830,150,6,"673,05",5,1,2,8,High-Value,Potential Loyalists
5831,318,5,"154,9",5,1,1,7,Mid-Value,Potential Loyalists
5832,614,3,"285,90000000000003",4,1,1,6,Mid-Value,Potential Loyalists
5833,381,4,"352,3",4,1,1,6,Mid-Value,Potential Loyalists
5835,11,5,"503,35",5,1,1,7,Mid-Value,Potential Loyalists
5836,214,4,"215,55",5,1,1,7,Mid-Value,Potential Loyalists
5837,953,1,"123,2",3,1,1,5,Low-Value,At Risk Customers
5838,92,8,"504,85",5,2,1,8,High-Value,Potential Loyalists
5839,554,2,"66,1",4,1,1,6,Mid-Value,Potential Loyalists
5840,965,3,"384,25",3,1,1,5,Low-Value,At Risk Customers
5841,102,1,"18,2",5,1,1,7,Mid-Value,Potential Loyalists
5844,1108,1,"294,6",2,1,1,4,Low-Value,Can't Lose
5848,137,4,"1042,65",5,1,2,8,High-Value,Potential Loyalists
5849,480,4,"128,95",4,1,1,6,Mid-Value,Potential Loyalists
5850,350,1,"91,65",5,1,1,7,Mid-Value,Potential Loyalists
5851,901,1,"6,1",3,1,1,5,Low-Value,At Risk Customers
5852,171,5,"251,2",5,1,1,7,Mid-Value,Potential Loyalists
5853,637,1,"58,0",4,1,1,6,Mid-Value,Potential Loyalists
5856,73,5,"104,9",5,1,1,7,Mid-Value,Potential Loyalists
5857,50,6,"991,3",5,1,2,8,High-Value,Potential Loyalists
5858,4,7,"272,9",5,2,1,8,High-Value,Potential Loyalists
5860,573,2,"263,95",4,1,1,6,Mid-Value,Potential Loyalists
5861,1004,1,"58,6",3,1,1,5,Low-Value,At Risk Customers
5862,28,3,"369,95",5,1,1,7,Mid-Value,Potential Loyalists
5864,890,6,"324,3",3,1,1,5,Low-Value,At Risk Customers
5866,28,1,"30,35",5,1,1,7,Mid-Value,Potential Loyalists
5867,789,3,"97,75",3,1,1,5,Low-Value,At Risk Customers
5868,1279,2,"76,9",2,1,1,4,Low-Value,Can't Lose
5869,661,1,"110,15",4,1,1,6,Mid-Value,Potential Loyalists
5872,768,6,"454,5",3,1,1,5,Low-Value,At Risk Customers
5874,773,3,"72,3",3,1,1,5,Low-Value,At Risk Customers
5875,149,2,"50,900000000000006",5,1,1,7,Mid-Value,Potential Loyalists
5876,1333,2,"227,2",2,1,1,4,Low-Value,Can't Lose
5878,24,3,"309,45000000000005",5,1,1,7,Mid-Value,Potential Loyalists
5879,5,14,"402,2",5,3,1,9,High-Value,Champions
5880,87,4,"75,75",5,1,1,7,Mid-Value,Potential Loyalists
5881,621,1,"20,0",4,1,1,6,Mid-Value,Potential Loyalists
5882,99,4,"108,55000000000001",5,1,1,7,Mid-Value,Potential Loyalists
5883,218,5,"293,4",5,1,1,7,Mid-Value,Potential Loyalists
5886,8,7,"376,0",5,2,1,8,High-Value,Potential Loyalists
5888,548,3,"110,75",4,1,1,6,Mid-Value,Potential Loyalists
5889,389,2,"113,89999999999999",4,1,1,6,Mid-Value,Potential Loyalists
5890,141,7,"586,4499999999999",5,2,1,8,High-Value,Potential Loyalists
5891,673,3,"96,55000000000001",4,1,1,6,Mid-Value,Potential Loyalists
5892,182,5,"251,64999999999998",5,1,1,7,Mid-Value,Potential Loyalists
5893,996,1,"227,3",3,1,1,5,Low-Value,At Risk Customers
5895,335,2,"90,25",5,1,1,7,Mid-Value,Potential Loyalists
5899,756,3,"173,2",3,1,1,5,Low-Value,At Risk Customers
5900,776,2,"121,0",3,1,1,5,Low-Value,At Risk Customers
5901,32,6,"291,75",5,1,1,7,Mid-Value,Potential Loyalists
5903,261,2,"18,1",5,1,1,7,Mid-Value,Potential Loyalists
5905,390,3,"135,85",4,1,1,6,Mid-Value,Potential Loyalists
5906,27,7,"488,59999999999997",5,2,1,8,High-Value,Potential Loyalists
5907,71,5,"378,25",5,1,1,7,Mid-Value,Potential Loyalists
5909,99,4,"136,9",5,1,1,7,Mid-Value,Potential Loyalists
5911,136,6,"383,5",5,1,1,7,Mid-Value,Potential Loyalists
5912,45,2,"51,15",5,1,1,7,Mid-Value,Potential Loyalists
5913,253,1,"39,9",5,1,1,7,Mid-Value,Potential Loyalists
5914,447,3,"69,6",4,1,1,6,Mid-Value,Potential Loyalists
5915,356,6,"305,0",5,1,1,7,Mid-Value,Potential Loyalists
5916,1166,2,"27,75",2,1,1,4,Low-Value,Can't Lose
5917,896,2,"120,4",3,1,1,5,Low-Value,At Risk Customers
5918,1637,2,"119,25",1,1,1,3,Low-Value,Lost
5919,916,2,"220,2",3,1,1,5,Low-Value,At Risk Customers
5920,31,5,"402,9",5,1,1,7,Mid-Value,Potential Loyalists
5921,762,3,"339,4",3,1,1,5,Low-Value,At Risk Customers
5922,81,2,"48,1",5,1,1,7,Mid-Value,Potential Loyalists
5926,1431,2,"48,95",2,1,1,4,Low-Value,Can't Lose
5927,25,2,"109,69999999999999",5,1,1,7,Mid-Value,Potential Loyalists
5928,58,3,"159,8",5,1,1,7,Mid-Value,Potential Loyalists
5929,40,1,"78,15",5,1,1,7,Mid-Value,Potential Loyalists
5930,225,3,"106,25",5,1,1,7,Mid-Value,Potential Loyalists
5932,192,1,"20,0",5,1,1,7,Mid-Value,Potential Loyalists
5934,405,6,"276,2",4,1,1,6,Mid-Value,Potential Loyalists
5938,133,8,"587,0",5,2,1,8,High-Value,Potential Loyalists
5939,756,1,"122,6",3,1,1,5,Low-Value,At Risk Customers
5940,471,2,"92,25",4,1,1,6,Mid-Value,Potential Loyalists
5942,159,1,"27,5",5,1,1,7,Mid-Value,Potential Loyalists
5943,577,2,"32,55",4,1,1,6,Mid-Value,Potential Loyalists
5944,387,4,"154,4",4,1,1,6,Mid-Value,Potential Loyalists
5945,401,7,"324,4",4,2,1,7,Mid-Value,Potential Loyalists
5946,593,1,"13,35",4,1,1,6,Mid-Value,Potential Loyalists
5951,834,2,"70,65",3,1,1,5,Low-Value,At Risk Customers
5952,303,3,"241,2",5,1,1,7,Mid-Value,Potential Loyalists
5953,1429,2,"250,5",2,1,1,4,Low-Value,Can't Lose
5954,353,2,"160,0",5,1,1,7,Mid-Value,Potential Loyalists
5955,22,1,"51,6",5,1,1,7,Mid-Value,Potential Loyalists
5956,1434,1,"53,85",2,1,1,4,Low-Value,Can't Lose
5957,15,2,"580,05",5,1,1,7,Mid-Value,Potential Loyalists
5959,58,2,"17,0",5,1,1,7,Mid-Value,Potential Loyalists
5960,441,2,"183,1",4,1,1,6,Mid-Value,Potential Loyalists
5961,165,7,"486,05",5,2,1,8,High-Value,Potential Loyalists
5964,404,2,"18,5",4,1,1,6,Mid-Value,Potential Loyalists
5965,89,9,"665,6",5,2,2,9,High-Value,Champions
5966,213,2,"108,9",5,1,1,7,Mid-Value,Potential Loyalists
5967,993,2,"485,6",3,1,1,5,Low-Value,At Risk Customers
5968,25,3,"132,6",5,1,1,7,Mid-Value,Potential Loyalists
5970,192,5,"137,75",5,1,1,7,Mid-Value,Potential Loyalists
5971,1542,1,"22,8",1,1,1,3,Low-Value,Lost
5972,36,4,"131,25",5,1,1,7,Mid-Value,Potential Loyalists
5973,13,1,"21,1",5,1,1,7,Mid-Value,Potential Loyalists
5974,164,4,"268,8",5,1,1,7,Mid-Value,Potential Loyalists
5975,791,3,"285,05",3,1,1,5,Low-Value,At Risk Customers
5976,408,6,"1335,65",4,1,3,8,High-Value,Potential Loyalists
5979,859,3,"134,2",3,1,1,5,Low-Value,At Risk Customers
5981,166,3,"302,0",5,1,1,7,Mid-Value,Potential Loyalists
5982,353,5,"388,65",5,1,1,7,Mid-Value,Potential Loyalists
5983,90,3,"71,91",5,1,1,7,Mid-Value,Potential Loyalists
5985,199,4,"122,3",5,1,1,7,Mid-Value,Potential Loyalists
5986,342,7,"337,9",5,2,1,8,High-Value,Potential Loyalists
5987,870,5,"226,60000000000002",3,1,1,5,Low-Value,At Risk Customers
5988,993,1,"14,8",3,1,1,5,Low-Value,At Risk Customers
5990,864,7,"748,1",3,2,2,7,Mid-Value,Potential Loyalists
5991,109,1,"29,3",5,1,1,7,Mid-Value,Potential Loyalists
5993,187,4,"93,4",5,1,1,7,Mid-Value,Potential Loyalists
5994,1496,1,"36,65",1,1,1,3,Low-Value,Lost
5995,1089,1,"10,2",3,1,1,5,Low-Value,At Risk Customers
5997,475,1,"66,5",4,1,1,6,Mid-Value,Potential Loyalists
5999,1469,3,"239,7",1,1,1,3,Low-Value,Lost
6000,544,1,"94,5",4,1,1,6,Mid-Value,Potential Loyalists
6002,172,3,"130,5",5,1,1,7,Mid-Value,Potential Loyalists
6008,76,3,"141,75",5,1,1,7,Mid-Value,Potential Loyalists
6010,313,5,"1486,85",5,1,3,9,High-Value,Champions
6012,515,1,"15,7",4,1,1,6,Mid-Value,Potential Loyalists
6018,957,1,"30,25",3,1,1,5,Low-Value,At Risk Customers
6019,740,1,"40,9",3,1,1,5,Low-Value,At Risk Customers
6020,746,1,"227,2",3,1,1,5,Low-Value,At Risk Customers
6021,116,5,"101,65",5,1,1,7,Mid-Value,Potential Loyalists
6022,527,2,"155,9",4,1,1,6,Mid-Value,Potential Loyalists
6026,27,2,"18,4",5,1,1,7,Mid-Value,Potential Loyalists
6027,977,2,"55,85",3,1,1,5,Low-Value,At Risk Customers
6028,35,1,"5,5",5,1,1,7,Mid-Value,Potential Loyalists
6029,468,5,"540,8",4,1,1,6,Mid-Value,Potential Loyalists
6030,115,9,"279,85",5,2,1,8,High-Value,Potential Loyalists
6031,107,2,"47,1",5,1,1,7,Mid-Value,Potential Loyalists
6032,908,1,"96,9",3,1,1,5,Low-Value,At Risk Customers
6033,43,5,"101,25",5,1,1,7,Mid-Value,Potential Loyalists
6034,977,4,"422,1",3,1,1,5,Low-Value,At Risk Customers
6035,501,9,"363,45",4,2,1,7,Mid-Value,Potential Loyalists
6036,547,1,"59,849999999999994",4,1,1,6,Mid-Value,Potential Loyalists
6038,763,3,"122,64999999999999",3,1,1,5,Low-Value,At Risk Customers
6039,8,2,"103,4",5,1,1,7,Mid-Value,Potential Loyalists
6040,435,6,"192,8",4,1,1,6,Mid-Value,Potential Loyalists
6041,89,2,"100,0",5,1,1,7,Mid-Value,Potential Loyalists
6044,1218,5,"218,1",2,1,1,4,Low-Value,Can't Lose
6045,430,7,"1272,5",4,2,2,8,High-Value,Potential Loyalists
6046,1352,1,"48,1",2,1,1,4,Low-Value,Can't Lose
6047,570,4,"196,1",4,1,1,6,Mid-Value,Potential Loyalists
6048,379,6,"1365,4",4,1,3,8,High-Value,Potential Loyalists
6049,314,3,"251,14999999999998",5,1,1,7,Mid-Value,Potential Loyalists
6050,230,1,"23,4",5,1,1,7,Mid-Value,Potential Loyalists
6051,103,1,"36,5",5,1,1,7,Mid-Value,Potential Loyalists
6053,1274,2,"154,5",2,1,1,4,Low-Value,Can't Lose
6054,620,5,"287,15",4,1,1,6,Mid-Value,Potential Loyalists
6055,257,2,"78,7",5,1,1,7,Mid-Value,Potential Loyalists
6056,705,4,"605,55",4,1,1,6,Mid-Value,Potential Loyalists
6057,193,7,"867,1",5,2,2,9,High-Value,Champions
6058,260,1,"17,8",5,1,1,7,Mid-Value,Potential Loyalists
6059,344,1,"3,5",5,1,1,7,Mid-Value,Potential Loyalists
6060,267,19,"716,15",5,4,2,11,High-Value,Champions
6062,796,8,"443,05",3,2,1,6,Mid-Value,Potential Loyalists
6063,1691,2,"69,19999999999999",1,1,1,3,Low-Value,Lost
6066,397,2,"39,0",4,1,1,6,Mid-Value,Potential Loyalists
6067,295,4,"357,05000000000007",5,1,1,7,Mid-Value,Potential Loyalists
6068,728,3,"213,45",4,1,1,6,Mid-Value,Potential Loyalists
6069,988,1,"46,9",3,1,1,5,Low-Value,At Risk Customers
6072,882,3,"397,79999999999995",3,1,1,5,Low-Value,At Risk Customers
6073,1179,2,"31,700000000000003",2,1,1,4,Low-Value,Can't Lose
6074,801,4,"266,1",3,1,1,5,Low-Value,At Risk Customers
6075,404,7,"725,8",4,2,2,8,High-Value,Potential Loyalists
6078,28,2,"145,5",5,1,1,7,Mid-Value,Potential Loyalists
6080,23,5,"230,8",5,1,1,7,Mid-Value,Potential Loyalists
6081,531,2,"17,45",4,1,1,6,Mid-Value,Potential Loyalists
6082,50,1,"22,85",5,1,1,7,Mid-Value,Potential Loyalists
6085,238,2,"30,9",5,1,1,7,Mid-Value,Potential Loyalists
6086,16,6,"439,20000000000005",5,1,1,7,Mid-Value,Potential Loyalists
6088,516,3,"187,9",4,1,1,6,Mid-Value,Potential Loyalists
6094,235,5,"147,1",5,1,1,7,Mid-Value,Potential Loyalists
6096,570,2,"78,4",4,1,1,6,Mid-Value,Potential Loyalists
6097,1498,2,"140,9",1,1,1,3,Low-Value,Lost
6099,238,3,"165,24999999999997",5,1,1,7,Mid-Value,Potential Loyalists
6101,360,4,"266,95",5,1,1,7,Mid-Value,Potential Loyalists
6102,281,2,"39,050000000000004",5,1,1,7,Mid-Value,Potential Loyalists
6103,645,1,"28,7",4,1,1,6,Mid-Value,Potential Loyalists
6104,475,3,"240,8",4,1,1,6,Mid-Value,Potential Loyalists
6106,176,3,"182,95",5,1,1,7,Mid-Value,Potential Loyalists
6107,465,6,"964,55",4,1,2,7,Mid-Value,Potential Loyalists
6113,1057,2,"295,5",3,1,1,5,Low-Value,At Risk Customers
6116,1240,1,"352,20000000000005",2,1,1,4,Low-Value,Can't Lose
6118,24,4,"207,95",5,1,1,7,Mid-Value,Potential Loyalists
6119,1105,3,"77,4",2,1,1,4,Low-Value,Can't Lose
6120,60,2,"25,8",5,1,1,7,Mid-Value,Potential Loyalists
6121,556,11,"444,40000000000003",4,2,1,7,Mid-Value,Potential Loyalists
6124,133,4,"105,75",5,1,1,7,Mid-Value,Potential Loyalists
6125,73,2,"64,8",5,1,1,7,Mid-Value,Potential Loyalists
6126,1107,4,"117,2",2,1,1,4,Low-Value,Can't Lose
6127,1179,2,"84,0",2,1,1,4,Low-Value,Can't Lose
6128,745,1,"20,6",3,1,1,5,Low-Value,At Risk Customers
6129,1382,2,"72,4",2,1,1,4,Low-Value,Can't Lose
6130,1040,1,"15,75",3,1,1,5,Low-Value,At Risk Customers
6131,205,7,"878,25",5,2,2,9,High-Value,Champions
6133,613,1,"86,1",4,1,1,6,Mid-Value,Potential Loyalists
6135,442,4,"397,95",4,1,1,6,Mid-Value,Potential Loyalists
6138,826,2,"104,35000000000001",3,1,1,5,Low-Value,At Risk Customers
6140,610,5,"390,05",4,1,1,6,Mid-Value,Potential Loyalists
6141,47,7,"388,29999999999995",5,2,1,8,High-Value,Potential Loyalists
6142,40,19,"914,75",5,4,2,11,High-Value,Champions
6144,377,7,"885,85",4,2,2,8,High-Value,Potential Loyalists
6145,473,6,"300,85",4,1,1,6,Mid-Value,Potential Loyalists
6146,134,3,"139,7",5,1,1,7,Mid-Value,Potential Loyalists
6148,360,3,"58,25",5,1,1,7,Mid-Value,Potential Loyalists
6150,544,4,"331,3",4,1,1,6,Mid-Value,Potential Loyalists
6152,79,2,"65,6",5,1,1,7,Mid-Value,Potential Loyalists
6153,770,5,"238,7",3,1,1,5,Low-Value,At Risk Customers
6154,497,3,"226,45",4,1,1,6,Mid-Value,Potential Loyalists
6155,1278,2,"177,73",2,1,1,4,Low-Value,Can't Lose
6156,745,3,"530,55",3,1,1,5,Low-Value,At Risk Customers
6157,886,1,"33,6",3,1,1,5,Low-Value,At Risk Customers
6158,909,3,"389,09999999999997",3,1,1,5,Low-Value,At Risk Customers
6159,471,3,"244,04999999999998",4,1,1,6,Mid-Value,Potential Loyalists
6161,605,1,"51,0",4,1,1,6,Mid-Value,Potential Loyalists
6162,50,2,"25,2",5,1,1,7,Mid-Value,Potential Loyalists
6163,1164,2,"116,60000000000001",2,1,1,4,Low-Value,Can't Lose
6164,1501,1,"19,8",1,1,1,3,Low-Value,Lost
6167,568,8,"618,0",4,2,1,7,Mid-Value,Potential Loyalists
6168,1370,3,"92,14999999999999",2,1,1,4,Low-Value,Can't Lose
6169,746,2,"16,0",3,1,1,5,Low-Value,At Risk Customers
6170,210,4,"324,75",5,1,1,7,Mid-Value,Potential Loyalists
6171,1435,1,"11,25",2,1,1,4,Low-Value,Can't Lose
6175,1010,3,"147,4",3,1,1,5,Low-Value,At Risk Customers
6177,439,4,"187,95",4,1,1,6,Mid-Value,Potential Loyalists
6178,1532,1,"64,5",1,1,1,3,Low-Value,Lost
6179,675,4,"139,2",4,1,1,6,Mid-Value,Potential Loyalists
6181,759,3,"409,1",3,1,1,5,Low-Value,At Risk Customers
6183,209,3,"697,3",5,1,2,8,High-Value,Potential Loyalists
6185,761,5,"162,1",3,1,1,5,Low-Value,At Risk Customers
6186,1288,3,"62,7",2,1,1,4,Low-Value,Can't Lose
6187,1580,1,"29,7",1,1,1,3,Low-Value,Lost
6188,28,6,"316,85",5,1,1,7,Mid-Value,Potential Loyalists
6189,1627,1,"15,4",1,1,1,3,Low-Value,Lost
6190,1687,1,"44,25",1,1,1,3,Low-Value,Lost
6191,299,1,"1,6",5,1,1,7,Mid-Value,Potential Loyalists
6194,615,3,"53,8",4,1,1,6,Mid-Value,Potential Loyalists
6195,98,3,"194,3",5,1,1,7,Mid-Value,Potential Loyalists
6197,617,2,"73,65",4,1,1,6,Mid-Value,Potential Loyalists
6198,1471,1,"6,65",1,1,1,3,Low-Value,Lost
6200,14,2,"208,0",5,1,1,7,Mid-Value,Potential Loyalists
6201,790,2,"50,45",3,1,1,5,Low-Value,At Risk Customers
6202,10,12,"652,9",5,3,1,9,High-Value,Champions
6203,244,5,"228,05",5,1,1,7,Mid-Value,Potential Loyalists
6205,1273,1,"204,9",2,1,1,4,Low-Value,Can't Lose
6208,1181,3,"93,5",2,1,1,4,Low-Value,Can't Lose
6209,216,1,"43,55",5,1,1,7,Mid-Value,Potential Loyalists
6211,601,1,"51,3",4,1,1,6,Mid-Value,Potential Loyalists
6213,864,3,"135,75",3,1,1,5,Low-Value,At Risk Customers
6214,767,4,"90,0",3,1,1,5,Low-Value,At Risk Customers
6215,685,5,"125,25",4,1,1,6,Mid-Value,Potential Loyalists
6216,1180,3,"420,15",2,1,1,4,Low-Value,Can't Lose
6218,274,2,"98,6",5,1,1,7,Mid-Value,Potential Loyalists
6221,234,1,"17,0",5,1,1,7,Mid-Value,Potential Loyalists
6222,492,1,"165,95",4,1,1,6,Mid-Value,Potential Loyalists
6224,225,1,"68,69999999999999",5,1,1,7,Mid-Value,Potential Loyalists
6227,169,3,"158,9",5,1,1,7,Mid-Value,Potential Loyalists
6228,887,2,"121,8",3,1,1,5,Low-Value,At Risk Customers
6229,1292,3,"239,85",2,1,1,4,Low-Value,Can't Lose
6230,1051,1,"19,3",3,1,1,5,Low-Value,At Risk Customers
6231,213,1,"158,39999999999998",5,1,1,7,Mid-Value,Potential Loyalists
6233,822,2,"93,75",3,1,1,5,Low-Value,At Risk Customers
6234,214,4,"315,25",5,1,1,7,Mid-Value,Potential Loyalists
6236,435,2,"275,75",4,1,1,6,Mid-Value,Potential Loyalists
6237,1105,2,"136,6",2,1,1,4,Low-Value,Can't Lose
6238,94,5,"148,85",5,1,1,7,Mid-Value,Potential Loyalists
6239,573,2,"85,35000000000001",4,1,1,6,Mid-Value,Potential Loyalists
6244,765,1,"49,75",3,1,1,5,Low-Value,At Risk Customers
6245,768,1,"10,0",3,1,1,5,Low-Value,At Risk Customers
6246,1594,1,"100,5",1,1,1,3,Low-Value,Lost
6247,379,2,"139,5",4,1,1,6,Mid-Value,Potential Loyalists
6248,259,4,"548,65",5,1,1,7,Mid-Value,Potential Loyalists
6249,991,1,"47,4",3,1,1,5,Low-Value,At Risk Customers
6250,248,5,"215,65",5,1,1,7,Mid-Value,Potential Loyalists
6251,78,8,"425,34999999999997",5,2,1,8,High-Value,Potential Loyalists
6252,24,5,"310,45",5,1,1,7,Mid-Value,Potential Loyalists
6253,328,3,"113,9",5,1,1,7,Mid-Value,Potential Loyalists
6254,511,1,"47,5",4,1,1,6,Mid-Value,Potential Loyalists
6255,1,1,"26,8",5,1,1,7,Mid-Value,Potential Loyalists
6256,758,7,"464,3",3,2,1,6,Mid-Value,Potential Loyalists
6258,1196,3,"161,35",2,1,1,4,Low-Value,Can't Lose
6259,437,4,"114,75",4,1,1,6,Mid-Value,Potential Loyalists
6260,712,2,"157,95",4,1,1,6,Mid-Value,Potential Loyalists
6261,208,12,"695,9",5,3,2,10,High-Value,Champions
6262,35,3,"52,15",5,1,1,7,Mid-Value,Potential Loyalists
6263,39,1,"159,8",5,1,1,7,Mid-Value,Potential Loyalists
6264,1546,1,"14,0",1,1,1,3,Low-Value,Lost
6265,24,2,"91,10000000000001",5,1,1,7,Mid-Value,Potential Loyalists
6266,228,3,"251,25",5,1,1,7,Mid-Value,Potential Loyalists
6267,665,1,"35,9",4,1,1,6,Mid-Value,Potential Loyalists
6268,190,9,"291,25",5,2,1,8,High-Value,Potential Loyalists
6269,24,5,"447,84999999999997",5,1,1,7,Mid-Value,Potential Loyalists
6272,420,1,"13,4",4,1,1,6,Mid-Value,Potential Loyalists
6273,478,1,"3,5",4,1,1,6,Mid-Value,Potential Loyalists
6274,802,3,"63,25",3,1,1,5,Low-Value,At Risk Customers
6275,165,3,"105,95",5,1,1,7,Mid-Value,Potential Loyalists
6276,1113,1,"3,5",2,1,1,4,Low-Value,Can't Lose
6277,334,6,"271,45",5,1,1,7,Mid-Value,Potential Loyalists
6279,642,5,"199,1",4,1,1,6,Mid-Value,Potential Loyalists
6282,303,7,"115,44999999999999",5,2,1,8,High-Value,Potential Loyalists
6283,273,3,"138,35",5,1,1,7,Mid-Value,Potential Loyalists
6285,669,1,"2,9",4,1,1,6,Mid-Value,Potential Loyalists
6290,152,7,"517,6",5,2,1,8,High-Value,Potential Loyalists
6291,237,6,"152,45",5,1,1,7,Mid-Value,Potential Loyalists
6292,379,6,"482,15",4,1,1,6,Mid-Value,Potential Loyalists
6294,38,6,"536,7",5,1,1,7,Mid-Value,Potential Loyalists
6295,167,14,"935,75",5,3,2,10,High-Value,Champions
6296,19,2,"152,5",5,1,1,7,Mid-Value,Potential Loyalists
6297,34,3,"108,45",5,1,1,7,Mid-Value,Potential Loyalists
6298,1057,3,"65,95",3,1,1,5,Low-Value,At Risk Customers
6300,223,2,"72,49",5,1,1,7,Mid-Value,Potential Loyalists
6301,858,1,"280,0",3,1,1,5,Low-Value,At Risk Customers
6302,850,2,"160,9",3,1,1,5,Low-Value,At Risk Customers
6303,999,1,"18,2",3,1,1,5,Low-Value,At Risk Customers
6304,1437,1,"44,6",2,1,1,4,Low-Value,Can't Lose
6306,381,5,"250,60000000000002",4,1,1,6,Mid-Value,Potential Loyalists
6308,398,8,"333,2",4,2,1,7,Mid-Value,Potential Loyalists
6309,25,13,"824,7",5,3,2,10,High-Value,Champions
6312,245,3,"143,2",5,1,1,7,Mid-Value,Potential Loyalists
6314,26,2,"23,65",5,1,1,7,Mid-Value,Potential Loyalists
6317,384,4,"89,95",4,1,1,6,Mid-Value,Potential Loyalists
6318,837,9,"464,05",3,2,1,6,Mid-Value,Potential Loyalists
6320,1527,1,"128,3",1,1,1,3,Low-Value,Lost
6323,901,1,"92,0",3,1,1,5,Low-Value,At Risk Customers
6325,1018,1,"8,0",3,1,1,5,Low-Value,At Risk Customers
6326,79,4,"369,15000000000003",5,1,1,7,Mid-Value,Potential Loyalists
6327,423,4,"237,4",4,1,1,6,Mid-Value,Potential Loyalists
6328,969,4,"326,0",3,1,1,5,Low-Value,At Risk Customers
6329,95,4,"102,75",5,1,1,7,Mid-Value,Potential Loyalists
6330,204,6,"521,15",5,1,1,7,Mid-Value,Potential Loyalists
6331,303,2,"69,5",5,1,1,7,Mid-Value,Potential Loyalists
6332,255,1,"278,9",5,1,1,7,Mid-Value,Potential Loyalists
6333,1100,3,"97,45",2,1,1,4,Low-Value,Can't Lose
6334,914,1,"331,9",3,1,1,5,Low-Value,At Risk Customers
6336,119,6,"244,25",5,1,1,7,Mid-Value,Potential Loyalists
6338,980,1,"44,4",3,1,1,5,Low-Value,At Risk Customers
6339,255,2,"91,1",5,1,1,7,Mid-Value,Potential Loyalists
6340,654,1,"49,6",4,1,1,6,Mid-Value,Potential Loyalists
6343,87,1,"15,9",5,1,1,7,Mid-Value,Potential Loyalists
6346,29,3,"132,5",5,1,1,7,Mid-Value,Potential Loyalists
6348,144,2,"96,4",5,1,1,7,Mid-Value,Potential Loyalists
6350,734,3,"445,5",3,1,1,5,Low-Value,At Risk Customers
6351,944,1,"46,8",3,1,1,5,Low-Value,At Risk Customers
6352,4,3,"183,95",5,1,1,7,Mid-Value,Potential Loyalists
6353,1200,1,"57,0",2,1,1,4,Low-Value,Can't Lose
6356,545,2,"95,95",4,1,1,6,Mid-Value,Potential Loyalists
6358,536,1,"12,7",4,1,1,6,Mid-Value,Potential Loyalists
6359,271,3,"48,85",5,1,1,7,Mid-Value,Potential Loyalists
6360,64,7,"702,15",5,2,2,9,High-Value,Champions
6361,108,3,"166,05",5,1,1,7,Mid-Value,Potential Loyalists
6362,741,5,"329,3",3,1,1,5,Low-Value,At Risk Customers
6363,248,6,"216,55",5,1,1,7,Mid-Value,Potential Loyalists
6367,206,3,"652,8499999999999",5,1,1,7,Mid-Value,Potential Loyalists
6370,501,5,"280,59999999999997",4,1,1,6,Mid-Value,Potential Loyalists
6372,60,4,"237,1",5,1,1,7,Mid-Value,Potential Loyalists
6373,822,1,"23,45",3,1,1,5,Low-Value,At Risk Customers
6374,159,2,"73,9",5,1,1,7,Mid-Value,Potential Loyalists
6375,1440,1,"26,35",2,1,1,4,Low-Value,Can't Lose
6377,546,3,"13,5",4,1,1,6,Mid-Value,Potential Loyalists
6378,1221,2,"46,1",2,1,1,4,Low-Value,Can't Lose
6379,682,1,"21,65",4,1,1,6,Mid-Value,Potential Loyalists
6380,1628,4,"327,9",1,1,1,3,Low-Value,Lost
6382,237,8,"389,9",5,2,1,8,High-Value,Potential Loyalists
6385,15,9,"369,45",5,2,1,8,High-Value,Potential Loyalists
6386,1391,1,"58,35",2,1,1,4,Low-Value,Can't Lose
6389,484,4,"82,1",4,1,1,6,Mid-Value,Potential Loyalists
6390,963,3,"141,85000000000002",3,1,1,5,Low-Value,At Risk Customers
6391,164,11,"495,94999999999993",5,2,1,8,High-Value,Potential Loyalists
6392,1256,1,"16,1",2,1,1,4,Low-Value,Can't Lose
6395,189,3,"654,05",5,1,1,7,Mid-Value,Potential Loyalists
6396,869,1,"132,75",3,1,1,5,Low-Value,At Risk Customers
6398,148,3,"281,29999999999995",5,1,1,7,Mid-Value,Potential Loyalists
6399,528,1,"113,10000000000001",4,1,1,6,Mid-Value,Potential Loyalists
6400,486,1,"26,7",4,1,1,6,Mid-Value,Potential Loyalists
6401,1060,3,"104,05",3,1,1,5,Low-Value,At Risk Customers
6404,444,7,"165,85",4,2,1,7,Mid-Value,Potential Loyalists
6405,186,1,"20,9",5,1,1,7,Mid-Value,Potential Loyalists
6407,1065,1,"131,2",3,1,1,5,Low-Value,At Risk Customers
6410,277,5,"285,05",5,1,1,7,Mid-Value,Potential Loyalists
6412,1642,1,"58,9",1,1,1,3,Low-Value,Lost
6413,474,2,"381,4",4,1,1,6,Mid-Value,Potential Loyalists
6414,404,2,"42,6",4,1,1,6,Mid-Value,Potential Loyalists
6415,264,5,"72,33",5,1,1,7,Mid-Value,Potential Loyalists
6416,74,3,"468,2",5,1,1,7,Mid-Value,Potential Loyalists
6417,914,1,"118,8",3,1,1,5,Low-Value,At Risk Customers
6418,1541,1,"12,85",1,1,1,3,Low-Value,Lost
6423,722,1,"225,7",4,1,1,6,Mid-Value,Potential Loyalists
6424,453,9,"593,05",4,2,1,7,Mid-Value,Potential Loyalists
6425,31,4,"166,85",5,1,1,7,Mid-Value,Potential Loyalists
6427,169,1,"39,8",5,1,1,7,Mid-Value,Potential Loyalists
6429,1795,1,"28,5",1,1,1,3,Low-Value,Lost
6430,830,3,"236,10000000000002",3,1,1,5,Low-Value,At Risk Customers
6432,1187,4,"141,1",2,1,1,4,Low-Value,Can't Lose
6433,97,1,"59,9",5,1,1,7,Mid-Value,Potential Loyalists
6435,563,7,"228,45",4,2,1,7,Mid-Value,Potential Loyalists
6436,1784,1,"24,5",1,1,1,3,Low-Value,Lost
6437,766,4,"284,4",3,1,1,5,Low-Value,At Risk Customers
6438,17,7,"435,65",5,2,1,8,High-Value,Potential Loyalists
6440,971,1,"5,15",3,1,1,5,Low-Value,At Risk Customers
6442,1268,2,"584,6",2,1,1,4,Low-Value,Can't Lose
6444,554,2,"99,89999999999999",4,1,1,6,Mid-Value,Potential Loyalists
6445,14,7,"430,5",5,2,1,8,High-Value,Potential Loyalists
6446,1531,1,"36,4",1,1,1,3,Low-Value,Lost
6449,516,5,"407,54999999999995",4,1,1,6,Mid-Value,Potential Loyalists
6450,388,3,"160,25",4,1,1,6,Mid-Value,Potential Loyalists
6452,846,3,"71,6",3,1,1,5,Low-Value,At Risk Customers
6453,296,5,"222,25",5,1,1,7,Mid-Value,Potential Loyalists
6455,84,5,"114,68",5,1,1,7,Mid-Value,Potential Loyalists
6456,68,2,"17,65",5,1,1,7,Mid-Value,Potential Loyalists
6457,542,2,"134,75",4,1,1,6,Mid-Value,Potential Loyalists
6458,1076,1,"109,35",3,1,1,5,Low-Value,At Risk Customers
6461,1509,2,"126,83",1,1,1,3,Low-Value,Lost
6462,507,2,"529,8",4,1,1,6,Mid-Value,Potential Loyalists
6464,5,2,"234,4",5,1,1,7,Mid-Value,Potential Loyalists
6466,1132,2,"40,9",2,1,1,4,Low-Value,Can't Lose
6467,170,2,"209,6",5,1,1,7,Mid-Value,Potential Loyalists
6468,329,3,"75,4",5,1,1,7,Mid-Value,Potential Loyalists
6470,1101,2,"196,4",2,1,1,4,Low-Value,Can't Lose
6471,1090,1,"39,8",3,1,1,5,Low-Value,At Risk Customers
6472,560,1,"57,5",4,1,1,6,Mid-Value,Potential Loyalists
6473,154,3,"106,35",5,1,1,7,Mid-Value,Potential Loyalists
6474,667,2,"74,4",4,1,1,6,Mid-Value,Potential Loyalists
6477,97,4,"186,25",5,1,1,7,Mid-Value,Potential Loyalists
6478,181,6,"510,7",5,1,1,7,Mid-Value,Potential Loyalists
6480,1067,1,"9,1",3,1,1,5,Low-Value,At Risk Customers
6482,229,7,"301,05",5,2,1,8,High-Value,Potential Loyalists
6483,371,2,"138,45",4,1,1,6,Mid-Value,Potential Loyalists
6485,900,1,"227,2",3,1,1,5,Low-Value,At Risk Customers
6486,270,4,"88,9",5,1,1,7,Mid-Value,Potential Loyalists
6487,556,2,"58,75",4,1,1,6,Mid-Value,Potential Loyalists
6488,872,3,"60,8",3,1,1,5,Low-Value,At Risk Customers
6490,474,5,"108,60000000000001",4,1,1,6,Mid-Value,Potential Loyalists
6492,906,1,"5,2",3,1,1,5,Low-Value,At Risk Customers
6493,690,4,"157,65",4,1,1,6,Mid-Value,Potential Loyalists
6494,241,2,"16,8",5,1,1,7,Mid-Value,Potential Loyalists
6495,575,6,"326,15",4,1,1,6,Mid-Value,Potential Loyalists
6497,118,3,"230,6",5,1,1,7,Mid-Value,Potential Loyalists
6500,755,5,"228,0",3,1,1,5,Low-Value,At Risk Customers
6501,218,4,"237,09999999999997",5,1,1,7,Mid-Value,Potential Loyalists
6503,453,3,"107,44999999999999",4,1,1,6,Mid-Value,Potential Loyalists
6506,186,3,"51,3",5,1,1,7,Mid-Value,Potential Loyalists
6508,1479,2,"15,8",1,1,1,3,Low-Value,Lost
6509,125,4,"95,69999999999999",5,1,1,7,Mid-Value,Potential Loyalists
6510,162,6,"340,29999999999995",5,1,1,7,Mid-Value,Potential Loyalists
6513,763,2,"163,55",3,1,1,5,Low-Value,At Risk Customers
6514,1638,1,"79,65",1,1,1,3,Low-Value,Lost
6515,214,2,"181,0",5,1,1,7,Mid-Value,Potential Loyalists
6516,264,1,"24,05",5,1,1,7,Mid-Value,Potential Loyalists
6517,378,2,"118,65",4,1,1,6,Mid-Value,Potential Loyalists
6519,1461,1,"10,4",1,1,1,3,Low-Value,Lost
6520,189,5,"152,89999999999998",5,1,1,7,Mid-Value,Potential Loyalists
6522,111,10,"541,2",5,2,1,8,High-Value,Potential Loyalists
6524,280,4,"314,9",5,1,1,7,Mid-Value,Potential Loyalists
6526,1803,1,"323,6",1,1,1,3,Low-Value,Lost
6527,559,2,"86,0",4,1,1,6,Mid-Value,Potential Loyalists
6528,1487,1,"68,4",1,1,1,3,Low-Value,Lost
6529,374,6,"350,2",4,1,1,6,Mid-Value,Potential Loyalists
6531,486,1,"61,0",4,1,1,6,Mid-Value,Potential Loyalists
6532,683,3,"145,5",4,1,1,6,Mid-Value,Potential Loyalists
6533,562,9,"489,4",4,2,1,7,Mid-Value,Potential Loyalists
6535,425,3,"340,54999999999995",4,1,1,6,Mid-Value,Potential Loyalists
6536,83,8,"416,3",5,2,1,8,High-Value,Potential Loyalists
6538,1103,4,"283,55",2,1,1,4,Low-Value,Can't Lose
6539,1377,1,"30,35",2,1,1,4,Low-Value,Can't Lose
6541,22,2,"323,3",5,1,1,7,Mid-Value,Potential Loyalists
6542,216,4,"261,0",5,1,1,7,Mid-Value,Potential Loyalists
6545,269,1,"21,15",5,1,1,7,Mid-Value,Potential Loyalists
6546,395,1,"42,6",4,1,1,6,Mid-Value,Potential Loyalists
6548,19,11,"491,25",5,2,1,8,High-Value,Potential Loyalists
6551,893,2,"710,75",3,1,2,6,Mid-Value,Potential Loyalists
6553,1474,4,"181,8",1,1,1,3,Low-Value,Lost
6554,183,12,"614,3",5,3,1,9,High-Value,Champions
6557,932,5,"139,4",3,1,1,5,Low-Value,At Risk Customers
6558,118,2,"22,65",5,1,1,7,Mid-Value,Potential Loyalists
6560,100,4,"178,3",5,1,1,7,Mid-Value,Potential Loyalists
6562,145,9,"756,4",5,2,2,9,High-Value,Champions
6563,671,2,"188,5",4,1,1,6,Mid-Value,Potential Loyalists
6564,149,6,"232,93",5,1,1,7,Mid-Value,Potential Loyalists
6565,1604,2,"133,4",1,1,1,3,Low-Value,Lost
6566,436,4,"268,15000000000003",4,1,1,6,Mid-Value,Potential Loyalists
6567,45,6,"504,09999999999997",5,1,1,7,Mid-Value,Potential Loyalists
6568,164,3,"295,84999999999997",5,1,1,7,Mid-Value,Potential Loyalists
6569,68,1,"29,8",5,1,1,7,Mid-Value,Potential Loyalists
6572,638,4,"323,35",4,1,1,6,Mid-Value,Potential Loyalists
6573,193,4,"288,7",5,1,1,7,Mid-Value,Potential Loyalists
6574,574,6,"544,55",4,1,1,6,Mid-Value,Potential Loyalists
6576,1041,1,"47,4",3,1,1,5,Low-Value,At Risk Customers
6577,777,1,"10,2",3,1,1,5,Low-Value,At Risk Customers
6580,1287,1,"17,6",2,1,1,4,Low-Value,Can't Lose
6581,109,4,"181,95",5,1,1,7,Mid-Value,Potential Loyalists
6582,368,2,"100,44999999999999",4,1,1,6,Mid-Value,Potential Loyalists
6583,1329,1,"43,4",2,1,1,4,Low-Value,Can't Lose
6584,971,2,"40,5",3,1,1,5,Low-Value,At Risk Customers
6585,7,5,"278,45",5,1,1,7,Mid-Value,Potential Loyalists
6586,497,2,"104,65",4,1,1,6,Mid-Value,Potential Loyalists
6588,316,3,"125,55000000000001",5,1,1,7,Mid-Value,Potential Loyalists
6589,742,2,"119,9",3,1,1,5,Low-Value,At Risk Customers
6592,1735,1,"60,05",1,1,1,3,Low-Value,Lost
6593,733,1,"120,1",3,1,1,5,Low-Value,At Risk Customers
6594,318,1,"34,85",5,1,1,7,Mid-Value,Potential Loyalists
6596,876,3,"168,4",3,1,1,5,Low-Value,At Risk Customers
6597,478,1,"141,75",4,1,1,6,Mid-Value,Potential Loyalists
6598,638,1,"3,5",4,1,1,6,Mid-Value,Potential Loyalists
6599,732,2,"278,9",3,1,1,5,Low-Value,At Risk Customers
6600,750,3,"402,45",3,1,1,5,Low-Value,At Risk Customers
6602,754,2,"129,65",3,1,1,5,Low-Value,At Risk Customers
6609,143,9,"190,7",5,2,1,8,High-Value,Potential Loyalists
6610,1279,1,"98,39999999999999",2,1,1,4,Low-Value,Can't Lose
6612,39,7,"397,85",5,2,1,8,High-Value,Potential Loyalists
6614,395,2,"158,89999999999998",4,1,1,6,Mid-Value,Potential Loyalists
6615,715,4,"274,0",4,1,1,6,Mid-Value,Potential Loyalists
6617,9,5,"371,70000000000005",5,1,1,7,Mid-Value,Potential Loyalists
6622,25,5,"280,3",5,1,1,7,Mid-Value,Potential Loyalists
6623,397,2,"50,9",4,1,1,6,Mid-Value,Potential Loyalists
6624,1442,2,"70,75",2,1,1,4,Low-Value,Can't Lose
6626,743,2,"136,25",3,1,1,5,Low-Value,At Risk Customers
6627,198,6,"235,95",5,1,1,7,Mid-Value,Potential Loyalists
6628,1296,1,"171,2",2,1,1,4,Low-Value,Can't Lose
6629,54,5,"159,9",5,1,1,7,Mid-Value,Potential Loyalists
6630,439,2,"51,35",4,1,1,6,Mid-Value,Potential Loyalists
6631,169,2,"224,3",5,1,1,7,Mid-Value,Potential Loyalists
6633,155,1,"20,46",5,1,1,7,Mid-Value,Potential Loyalists
6635,469,1,"29,1",4,1,1,6,Mid-Value,Potential Loyalists
6636,690,2,"25,15",4,1,1,6,Mid-Value,Potential Loyalists
6639,196,2,"41,35",5,1,1,7,Mid-Value,Potential Loyalists
6640,1307,2,"10,350000000000001",2,1,1,4,Low-Value,Can't Lose
6641,904,6,"197,4",3,1,1,5,Low-Value,At Risk Customers
6642,1488,1,"61,6",1,1,1,3,Low-Value,Lost
6644,493,2,"382,25",4,1,1,6,Mid-Value,Potential Loyalists
6645,427,3,"198,5",4,1,1,6,Mid-Value,Potential Loyalists
6646,589,1,"33,9",4,1,1,6,Mid-Value,Potential Loyalists
6648,377,13,"686,85",4,3,2,9,High-Value,Champions
6649,227,2,"276,55",5,1,1,7,Mid-Value,Potential Loyalists
6650,353,1,"82,25",5,1,1,7,Mid-Value,Potential Loyalists
6651,69,3,"490,1",5,1,1,7,Mid-Value,Potential Loyalists
6652,72,1,"72,55",5,1,1,7,Mid-Value,Potential Loyalists
6656,254,2,"77,4",5,1,1,7,Mid-Value,Potential Loyalists
6657,666,3,"90,75",4,1,1,6,Mid-Value,Potential Loyalists
6660,869,2,"256,2",3,1,1,5,Low-Value,At Risk Customers
6661,715,2,"141,5",4,1,1,6,Mid-Value,Potential Loyalists
6662,60,3,"199,14999999999998",5,1,1,7,Mid-Value,Potential Loyalists
6663,756,1,"60,1",3,1,1,5,Low-Value,At Risk Customers
6665,211,2,"114,4",5,1,1,7,Mid-Value,Potential Loyalists
6667,175,4,"454,25",5,1,1,7,Mid-Value,Potential Loyalists
6668,395,10,"1005,95",4,2,2,8,High-Value,Potential Loyalists
6669,410,2,"72,15",4,1,1,6,Mid-Value,Potential Loyalists
6670,1415,1,"19,95",2,1,1,4,Low-Value,Can't Lose
6671,202,1,"355,65",5,1,1,7,Mid-Value,Potential Loyalists
6672,582,3,"77,6",4,1,1,6,Mid-Value,Potential Loyalists
6673,1757,1,"13,0",1,1,1,3,Low-Value,Lost
6675,427,2,"97,9",4,1,1,6,Mid-Value,Potential Loyalists
6676,1209,1,"37,95",2,1,1,4,Low-Value,Can't Lose
6679,12,3,"348,70000000000005",5,1,1,7,Mid-Value,Potential Loyalists
6680,766,1,"50,3",3,1,1,5,Low-Value,At Risk Customers
6681,90,12,"822,85",5,3,2,10,High-Value,Champions
6683,760,2,"42,45",3,1,1,5,Low-Value,At Risk Customers
6685,1241,2,"80,7",2,1,1,4,Low-Value,Can't Lose
6688,368,3,"187,0",4,1,1,6,Mid-Value,Potential Loyalists
6689,890,4,"251,5",3,1,1,5,Low-Value,At Risk Customers
6691,511,6,"854,75",4,1,2,7,Mid-Value,Potential Loyalists
6693,21,4,"175,25",5,1,1,7,Mid-Value,Potential Loyalists
6694,277,6,"308,65",5,1,1,7,Mid-Value,Potential Loyalists
6695,1286,3,"206,4",2,1,1,4,Low-Value,Can't Lose
6696,1511,1,"18,2",1,1,1,3,Low-Value,Lost
6697,759,4,"196,9",3,1,1,5,Low-Value,At Risk Customers
6699,3,2,"79,35",5,1,1,7,Mid-Value,Potential Loyalists
6700,941,2,"95,0",3,1,1,5,Low-Value,At Risk Customers
6701,1354,2,"34,400000000000006",2,1,1,4,Low-Value,Can't Lose
6702,337,3,"530,0",5,1,1,7,Mid-Value,Potential Loyalists
6703,623,9,"303,25",4,2,1,7,Mid-Value,Potential Loyalists
6704,1165,1,"292,3",2,1,1,4,Low-Value,Can't Lose
6705,1514,1,"19,15",1,1,1,3,Low-Value,Lost
6706,5,6,"629,45",5,1,1,7,Mid-Value,Potential Loyalists
6707,274,6,"162,85",5,1,1,7,Mid-Value,Potential Loyalists
6708,372,2,"224,85",4,1,1,6,Mid-Value,Potential Loyalists
6709,1189,1,"65,6",2,1,1,4,Low-Value,Can't Lose
6711,502,3,"76,85",4,1,1,6,Mid-Value,Potential Loyalists
6712,1016,1,"15,5",3,1,1,5,Low-Value,At Risk Customers
6715,620,4,"199,2",4,1,1,6,Mid-Value,Potential Loyalists
6716,421,8,"464,65",4,2,1,7,Mid-Value,Potential Loyalists
6717,1219,1,"42,3",2,1,1,4,Low-Value,Can't Lose
6719,753,2,"160,00000000000003",3,1,1,5,Low-Value,At Risk Customers
6722,458,1,"8,0",4,1,1,6,Mid-Value,Potential Loyalists
6723,372,9,"928,2",4,2,2,8,High-Value,Potential Loyalists
6724,310,1,"36,5",5,1,1,7,Mid-Value,Potential Loyalists
6725,416,3,"129,0",4,1,1,6,Mid-Value,Potential Loyalists
6728,609,2,"182,89999999999998",4,1,1,6,Mid-Value,Potential Loyalists
6730,1130,2,"170,75",2,1,1,4,Low-Value,Can't Lose
6732,816,5,"490,1",3,1,1,5,Low-Value,At Risk Customers
6735,1039,1,"14,8",3,1,1,5,Low-Value,At Risk Customers
6736,381,4,"215,5",4,1,1,6,Mid-Value,Potential Loyalists
6737,164,5,"398,0",5,1,1,7,Mid-Value,Potential Loyalists
6738,1403,4,"108,1",2,1,1,4,Low-Value,Can't Lose
6740,1122,2,"112,39999999999999",2,1,1,4,Low-Value,Can't Lose
6741,105,8,"577,05",5,2,1,8,High-Value,Potential Loyalists
6742,19,1,"61,0",5,1,1,7,Mid-Value,Potential Loyalists
6743,1104,2,"144,45",2,1,1,4,Low-Value,Can't Lose
6744,1748,1,"133,0",1,1,1,3,Low-Value,Lost
6747,883,6,"270,45",3,1,1,5,Low-Value,At Risk Customers
6748,69,4,"259,25",5,1,1,7,Mid-Value,Potential Loyalists
6749,398,3,"61,1",4,1,1,6,Mid-Value,Potential Loyalists
6751,1051,3,"150,55",3,1,1,5,Low-Value,At Risk Customers
6752,332,5,"390,5",5,1,1,7,Mid-Value,Potential Loyalists
6753,98,1,"18,5",5,1,1,7,Mid-Value,Potential Loyalists
6755,972,5,"256,45",3,1,1,5,Low-Value,At Risk Customers
6757,52,6,"398,5",5,1,1,7,Mid-Value,Potential Loyalists
6758,1529,3,"76,75",1,1,1,3,Low-Value,Lost
6759,154,1,"121,7",5,1,1,7,Mid-Value,Potential Loyalists
6760,112,3,"222,0",5,1,1,7,Mid-Value,Potential Loyalists
6763,190,4,"125,05",5,1,1,7,Mid-Value,Potential Loyalists
6764,99,13,"593,5",5,3,1,9,High-Value,Champions
6765,1143,2,"167,55",2,1,1,4,Low-Value,Can't Lose
6767,200,4,"258,4",5,1,1,7,Mid-Value,Potential Loyalists
6769,7,5,"237,39999999999998",5,1,1,7,Mid-Value,Potential Loyalists
6773,46,4,"204,9",5,1,1,7,Mid-Value,Potential Loyalists
6774,1242,2,"91,0",2,1,1,4,Low-Value,Can't Lose
6776,17,4,"82,0",5,1,1,7,Mid-Value,Potential Loyalists
6777,781,2,"295,85",3,1,1,5,Low-Value,At Risk Customers
6778,587,2,"144,65",4,1,1,6,Mid-Value,Potential Loyalists
6780,967,4,"404,7",3,1,1,5,Low-Value,At Risk Customers
6782,85,2,"83,94999999999999",5,1,1,7,Mid-Value,Potential Loyalists
6783,232,1,"100,8",5,1,1,7,Mid-Value,Potential Loyalists
6786,187,15,"587,55",5,3,1,9,High-Value,Champions
6787,372,1,"38,6",4,1,1,6,Mid-Value,Potential Loyalists
6788,770,3,"225,29999999999998",3,1,1,5,Low-Value,At Risk Customers
6789,97,4,"311,65",5,1,1,7,Mid-Value,Potential Loyalists
6790,422,4,"120,18",4,1,1,6,Mid-Value,Potential Loyalists
6791,1462,3,"83,2",1,1,1,3,Low-Value,Lost
6793,388,2,"50,650000000000006",4,1,1,6,Mid-Value,Potential Loyalists
6794,10,3,"315,05",5,1,1,7,Mid-Value,Potential Loyalists
6795,391,2,"175,64999999999998",4,1,1,6,Mid-Value,Potential Loyalists
6797,887,1,"15,4",3,1,1,5,Low-Value,At Risk Customers
6800,1345,2,"129,45",2,1,1,4,Low-Value,Can't Lose
6801,661,3,"563,4",4,1,1,6,Mid-Value,Potential Loyalists
6802,242,6,"269,8",5,1,1,7,Mid-Value,Potential Loyalists
6803,787,3,"248,25",3,1,1,5,Low-Value,At Risk Customers
6805,416,4,"194,55",4,1,1,6,Mid-Value,Potential Loyalists
6806,235,6,"402,6",5,1,1,7,Mid-Value,Potential Loyalists
6807,670,2,"56,75",4,1,1,6,Mid-Value,Potential Loyalists
6808,740,4,"549,2",3,1,1,5,Low-Value,At Risk Customers
6811,417,1,"11,45",4,1,1,6,Mid-Value,Potential Loyalists
6812,462,4,"159,3",4,1,1,6,Mid-Value,Potential Loyalists
6813,1279,2,"186,40000000000003",2,1,1,4,Low-Value,Can't Lose
6814,540,2,"67,7",4,1,1,6,Mid-Value,Potential Loyalists
6815,752,7,"502,4",3,2,1,6,Mid-Value,Potential Loyalists
6817,15,8,"731,05",5,2,2,9,High-Value,Champions
6818,216,1,"26,65",5,1,1,7,Mid-Value,Potential Loyalists
6820,753,3,"206,1",3,1,1,5,Low-Value,At Risk Customers
6821,482,3,"119,10000000000001",4,1,1,6,Mid-Value,Potential Loyalists
6822,224,4,"540,8",5,1,1,7,Mid-Value,Potential Loyalists
6823,1103,2,"118,25",2,1,1,4,Low-Value,Can't Lose
6824,600,2,"170,1",4,1,1,6,Mid-Value,Potential Loyalists
6825,18,7,"475,09999999999997",5,2,1,8,High-Value,Potential Loyalists
6826,430,3,"175,75",4,1,1,6,Mid-Value,Potential Loyalists
6827,901,3,"181,25",3,1,1,5,Low-Value,At Risk Customers
6828,381,6,"237,0",4,1,1,6,Mid-Value,Potential Loyalists
6830,299,3,"132,35",5,1,1,7,Mid-Value,Potential Loyalists
6831,1194,3,"596,5500000000001",2,1,1,4,Low-Value,Can't Lose
6833,449,6,"134,9",4,1,1,6,Mid-Value,Potential Loyalists
6834,947,2,"97,44999999999999",3,1,1,5,Low-Value,At Risk Customers
6835,209,3,"181,25",5,1,1,7,Mid-Value,Potential Loyalists
6837,151,1,"30,8",5,1,1,7,Mid-Value,Potential Loyalists
6838,542,2,"54,1",4,1,1,6,Mid-Value,Potential Loyalists
6839,680,1,"14,45",4,1,1,6,Mid-Value,Potential Loyalists
6840,833,1,"20,46",3,1,1,5,Low-Value,At Risk Customers
6841,821,2,"93,73",3,1,1,5,Low-Value,At Risk Customers
6842,913,3,"136,95",3,1,1,5,Low-Value,At Risk Customers
6843,1,2,"46,0",5,1,1,7,Mid-Value,Potential Loyalists
6844,1651,1,"19,0",1,1,1,3,Low-Value,Lost
6845,879,4,"265,1",3,1,1,5,Low-Value,At Risk Customers
6847,19,4,"107,85",5,1,1,7,Mid-Value,Potential Loyalists
6853,418,1,"70,0",4,1,1,6,Mid-Value,Potential Loyalists
6854,834,3,"155,05",3,1,1,5,Low-Value,At Risk Customers
6855,689,4,"578,8",4,1,1,6,Mid-Value,Potential Loyalists
6856,1381,1,"13,75",2,1,1,4,Low-Value,Can't Lose
6858,26,7,"316,75",5,2,1,8,High-Value,Potential Loyalists
6860,318,1,"6,8",5,1,1,7,Mid-Value,Potential Loyalists
6861,39,5,"304,35",5,1,1,7,Mid-Value,Potential Loyalists
6862,63,2,"41,05",5,1,1,7,Mid-Value,Potential Loyalists
6866,641,2,"117,2",4,1,1,6,Mid-Value,Potential Loyalists
6868,11,8,"614,5500000000001",5,2,1,8,High-Value,Potential Loyalists
6870,1516,1,"112,80000000000001",1,1,1,3,Low-Value,Lost
6872,90,4,"172,60000000000002",5,1,1,7,Mid-Value,Potential Loyalists
6873,1425,1,"16,05",2,1,1,4,Low-Value,Can't Lose
6874,1052,1,"412,3",3,1,1,5,Low-Value,At Risk Customers
6875,175,5,"453,29999999999995",5,1,1,7,Mid-Value,Potential Loyalists
6877,497,2,"154,2",4,1,1,6,Mid-Value,Potential Loyalists
6878,428,8,"429,15",4,2,1,7,Mid-Value,Potential Loyalists
6879,43,9,"1178,6999999999998",5,2,2,9,High-Value,Champions
6880,1677,2,"66,55000000000001",1,1,1,3,Low-Value,Lost
6881,521,2,"158,2",4,1,1,6,Mid-Value,Potential Loyalists
6882,1690,3,"94,8",1,1,1,3,Low-Value,Lost
6883,849,1,"63,6",3,1,1,5,Low-Value,At Risk Customers
6884,53,8,"672,3000000000001",5,2,2,9,High-Value,Champions
6885,1448,1,"195,14999999999998",2,1,1,4,Low-Value,Can't Lose
6888,509,7,"612,3",4,2,1,7,Mid-Value,Potential Loyalists
6889,902,1,"76,35",3,1,1,5,Low-Value,At Risk Customers
6890,12,5,"321,7",5,1,1,7,Mid-Value,Potential Loyalists
6891,1379,1,"8,1",2,1,1,4,Low-Value,Can't Lose
6892,162,1,"19,9",5,1,1,7,Mid-Value,Potential Loyalists
6894,1638,2,"168,75",1,1,1,3,Low-Value,Lost
6895,1365,2,"98,30000000000001",2,1,1,4,Low-Value,Can't Lose
6896,976,1,"37,75",3,1,1,5,Low-Value,At Risk Customers
6897,63,11,"661,3",5,2,1,8,High-Value,Potential Loyalists
6898,17,6,"232,55",5,1,1,7,Mid-Value,Potential Loyalists
6900,564,5,"246,7",4,1,1,6,Mid-Value,Potential Loyalists
6901,1657,1,"20,46",1,1,1,3,Low-Value,Lost
6902,685,1,"44,25",4,1,1,6,Mid-Value,Potential Loyalists
6904,142,8,"275,55",5,2,1,8,High-Value,Potential Loyalists
6905,70,6,"98,5",5,1,1,7,Mid-Value,Potential Loyalists
6906,227,8,"742,35",5,2,2,9,High-Value,Champions
6908,66,6,"497,20000000000005",5,1,1,7,Mid-Value,Potential Loyalists
6909,203,5,"496,6",5,1,1,7,Mid-Value,Potential Loyalists
6911,981,1,"7,5",3,1,1,5,Low-Value,At Risk Customers
6912,47,2,"105,7",5,1,1,7,Mid-Value,Potential Loyalists
6914,1004,2,"81,19999999999999",3,1,1,5,Low-Value,At Risk Customers
6915,252,6,"286,2",5,1,1,7,Mid-Value,Potential Loyalists
6916,378,6,"548,35",4,1,1,6,Mid-Value,Potential Loyalists
6918,374,3,"117,1",4,1,1,6,Mid-Value,Potential Loyalists
6919,626,1,"43,0",4,1,1,6,Mid-Value,Potential Loyalists
6920,647,2,"205,6",4,1,1,6,Mid-Value,Potential Loyalists
6922,43,5,"266,05",5,1,1,7,Mid-Value,Potential Loyalists
6923,51,3,"69,55",5,1,1,7,Mid-Value,Potential Loyalists
6925,951,3,"159,35",3,1,1,5,Low-Value,At Risk Customers
6927,401,4,"332,95",4,1,1,6,Mid-Value,Potential Loyalists
6928,924,2,"194,15000000000003",3,1,1,5,Low-Value,At Risk Customers
6929,274,3,"308,2",5,1,1,7,Mid-Value,Potential Loyalists
6930,1613,2,"27,849999999999998",1,1,1,3,Low-Value,Lost
6931,541,2,"77,75",4,1,1,6,Mid-Value,Potential Loyalists
6932,520,5,"520,7",4,1,1,6,Mid-Value,Potential Loyalists
6936,1215,1,"13,6",2,1,1,4,Low-Value,Can't Lose
6937,77,3,"397,55",5,1,1,7,Mid-Value,Potential Loyalists
6938,862,3,"83,1",3,1,1,5,Low-Value,At Risk Customers
6939,381,6,"413,29999999999995",4,1,1,6,Mid-Value,Potential Loyalists
6941,196,3,"147,75",5,1,1,7,Mid-Value,Potential Loyalists
6943,512,4,"163,6",4,1,1,6,Mid-Value,Potential Loyalists
6945,335,6,"501,1",5,1,1,7,Mid-Value,Potential Loyalists
6946,26,2,"302,9",5,1,1,7,Mid-Value,Potential Loyalists
6948,263,1,"42,0",5,1,1,7,Mid-Value,Potential Loyalists
6951,1473,3,"247,3",1,1,1,3,Low-Value,Lost
6952,5,8,"708,85",5,2,2,9,High-Value,Champions
6953,875,1,"30,4",3,1,1,5,Low-Value,At Risk Customers
6955,348,2,"39,2",5,1,1,7,Mid-Value,Potential Loyalists
6956,379,10,"1059,75",4,2,2,8,High-Value,Potential Loyalists
6958,45,6,"637,7",5,1,1,7,Mid-Value,Potential Loyalists
6959,41,1,"12,9",5,1,1,7,Mid-Value,Potential Loyalists
6960,1336,2,"136,5",2,1,1,4,Low-Value,Can't Lose
6961,1185,1,"24,2",2,1,1,4,Low-Value,Can't Lose
6962,26,1,"51,3",5,1,1,7,Mid-Value,Potential Loyalists
6963,188,3,"236,5",5,1,1,7,Mid-Value,Potential Loyalists
6965,89,1,"5,1",5,1,1,7,Mid-Value,Potential Loyalists
6967,182,7,"321,84999999999997",5,2,1,8,High-Value,Potential Loyalists
6968,609,6,"684,1",4,1,2,7,Mid-Value,Potential Loyalists
6970,134,8,"418,55",5,2,1,8,High-Value,Potential Loyalists
6971,1657,1,"56,0",1,1,1,3,Low-Value,Lost
6973,774,4,"288,7",3,1,1,5,Low-Value,At Risk Customers
6974,327,4,"145,15",5,1,1,7,Mid-Value,Potential Loyalists
6976,1639,1,"17,1",1,1,1,3,Low-Value,Lost
6977,1466,3,"113,9",1,1,1,3,Low-Value,Lost
6978,1061,1,"17,2",3,1,1,5,Low-Value,At Risk Customers
6979,1513,2,"211,7",1,1,1,3,Low-Value,Lost
6983,253,9,"454,35",5,2,1,8,High-Value,Potential Loyalists
6985,857,1,"87,1",3,1,1,5,Low-Value,At Risk Customers
6986,1244,2,"61,4",2,1,1,4,Low-Value,Can't Lose
6987,1480,1,"35,8",1,1,1,3,Low-Value,Lost
6988,1044,3,"47,3",3,1,1,5,Low-Value,At Risk Customers
6989,372,2,"420,7",4,1,1,6,Mid-Value,Potential Loyalists
6990,300,2,"84,3",5,1,1,7,Mid-Value,Potential Loyalists
6991,1027,1,"56,5",3,1,1,5,Low-Value,At Risk Customers
6992,1771,1,"42,75",1,1,1,3,Low-Value,Lost
6995,441,5,"292,4",4,1,1,6,Mid-Value,Potential Loyalists
6998,1203,2,"212,3",2,1,1,4,Low-Value,Can't Lose
7000,415,4,"102,0",4,1,1,6,Mid-Value,Potential Loyalists
7001,104,7,"479,70000000000005",5,2,1,8,High-Value,Potential Loyalists
7002,757,3,"30,2",3,1,1,5,Low-Value,At Risk Customers
7003,351,8,"326,65",5,2,1,8,High-Value,Potential Loyalists
7004,484,4,"161,55",4,1,1,6,Mid-Value,Potential Loyalists
7006,874,2,"241,6",3,1,1,5,Low-Value,At Risk Customers
7007,46,5,"286,75",5,1,1,7,Mid-Value,Potential Loyalists
7009,459,2,"94,15",4,1,1,6,Mid-Value,Potential Loyalists
7011,85,13,"730,8",5,3,2,10,High-Value,Champions
7012,453,7,"174,2",4,2,1,7,Mid-Value,Potential Loyalists
7015,892,1,"114,9",3,1,1,5,Low-Value,At Risk Customers
7017,932,5,"120,35000000000001",3,1,1,5,Low-Value,At Risk Customers
7020,438,1,"8,9",4,1,1,6,Mid-Value,Potential Loyalists
7021,590,1,"91,7",4,1,1,6,Mid-Value,Potential Loyalists
7022,889,1,"7,2",3,1,1,5,Low-Value,At Risk Customers
7023,24,3,"181,1",5,1,1,7,Mid-Value,Potential Loyalists
7024,98,7,"342,40000000000003",5,2,1,8,High-Value,Potential Loyalists
7025,876,1,"21,7",3,1,1,5,Low-Value,At Risk Customers
7026,67,5,"194,45",5,1,1,7,Mid-Value,Potential Loyalists
7027,769,5,"283,0",3,1,1,5,Low-Value,At Risk Customers
7028,1288,2,"110,25",2,1,1,4,Low-Value,Can't Lose
7029,1,1,"127,19999999999999",5,1,1,7,Mid-Value,Potential Loyalists
7034,1172,1,"13,95",2,1,1,4,Low-Value,Can't Lose
7035,501,2,"602,85",4,1,1,6,Mid-Value,Potential Loyalists
7036,479,4,"1066,8999999999999",4,1,2,7,Mid-Value,Potential Loyalists
7037,395,2,"98,80000000000001",4,1,1,6,Mid-Value,Potential Loyalists
7038,324,2,"89,4",5,1,1,7,Mid-Value,Potential Loyalists
7039,752,3,"199,9",3,1,1,5,Low-Value,At Risk Customers
7041,738,2,"263,1",3,1,1,5,Low-Value,At Risk Customers
7043,60,4,"501,8",5,1,1,7,Mid-Value,Potential Loyalists
7044,13,8,"413,5",5,2,1,8,High-Value,Potential Loyalists
7045,469,5,"120,35000000000001",4,1,1,6,Mid-Value,Potential Loyalists
7047,637,4,"112,85",4,1,1,6,Mid-Value,Potential Loyalists
7048,1076,3,"113,0",3,1,1,5,Low-Value,At Risk Customers
7052,27,5,"527,35",5,1,1,7,Mid-Value,Potential Loyalists
7057,1320,1,"49,15",2,1,1,4,Low-Value,Can't Lose
7059,394,3,"498,0",4,1,1,6,Mid-Value,Potential Loyalists
7062,123,3,"376,15000000000003",5,1,1,7,Mid-Value,Potential Loyalists
7063,61,7,"563,1",5,2,1,8,High-Value,Potential Loyalists
7064,944,1,"228,2",3,1,1,5,Low-Value,At Risk Customers
7065,21,8,"751,0500000000001",5,2,2,9,High-Value,Champions
7066,680,2,"71,45",4,1,1,6,Mid-Value,Potential Loyalists
7067,190,7,"315,25",5,2,1,8,High-Value,Potential Loyalists
7068,201,3,"81,1",5,1,1,7,Mid-Value,Potential Loyalists
7069,49,4,"220,40000000000003",5,1,1,7,Mid-Value,Potential Loyalists
7070,1237,1,"41,849999999999994",2,1,1,4,Low-Value,Can't Lose
7072,738,1,"3,5",3,1,1,5,Low-Value,At Risk Customers
7073,501,4,"160,55",4,1,1,6,Mid-Value,Potential Loyalists
7075,392,1,"12,2",4,1,1,6,Mid-Value,Potential Loyalists
7076,1806,1,"6,1",1,1,1,3,Low-Value,Lost
7080,67,7,"903,3",5,2,2,9,High-Value,Champions
7084,894,4,"128,2",3,1,1,5,Low-Value,At Risk Customers
7085,720,1,"54,0",4,1,1,6,Mid-Value,Potential Loyalists
7086,537,2,"646,9",4,1,1,6,Mid-Value,Potential Loyalists
7087,80,3,"110,6",5,1,1,7,Mid-Value,Potential Loyalists
7088,68,9,"679,75",5,2,2,9,High-Value,Champions
7089,143,8,"526,6",5,2,1,8,High-Value,Potential Loyalists
7092,1759,1,"68,15",1,1,1,3,Low-Value,Lost
7095,426,2,"23,7",4,1,1,6,Mid-Value,Potential Loyalists
7096,554,1,"21,6",4,1,1,6,Mid-Value,Potential Loyalists
7097,334,2,"108,2",5,1,1,7,Mid-Value,Potential Loyalists
7098,379,3,"42,400000000000006",4,1,1,6,Mid-Value,Potential Loyalists
7100,558,3,"92,3",4,1,1,6,Mid-Value,Potential Loyalists
7101,1284,1,"35,6",2,1,1,4,Low-Value,Can't Lose
7102,636,2,"35,8",4,1,1,6,Mid-Value,Potential Loyalists
7104,1338,2,"47,25000000000001",2,1,1,4,Low-Value,Can't Lose
7105,385,7,"764,3",4,2,2,8,High-Value,Potential Loyalists
7107,640,4,"399,55",4,1,1,6,Mid-Value,Potential Loyalists
7108,1706,1,"32,9",1,1,1,3,Low-Value,Lost
7109,449,1,"41,4",4,1,1,6,Mid-Value,Potential Loyalists
7110,122,4,"264,2",5,1,1,7,Mid-Value,Potential Loyalists
7112,732,1,"12,25",3,1,1,5,Low-Value,At Risk Customers
7115,829,2,"77,75",3,1,1,5,Low-Value,At Risk Customers
7116,1015,2,"156,65",3,1,1,5,Low-Value,At Risk Customers
7118,339,1,"11,5",5,1,1,7,Mid-Value,Potential Loyalists
7122,1624,1,"15,2",1,1,1,3,Low-Value,Lost
7123,38,3,"155,45",5,1,1,7,Mid-Value,Potential Loyalists
7127,26,7,"514,25",5,2,1,8,High-Value,Potential Loyalists
7129,1219,4,"216,65",2,1,1,4,Low-Value,Can't Lose
7130,742,3,"199,65",3,1,1,5,Low-Value,At Risk Customers
7131,61,2,"96,15",5,1,1,7,Mid-Value,Potential Loyalists
7132,1601,1,"19,200000000000003",1,1,1,3,Low-Value,Lost
7133,8,6,"471,1",5,1,1,7,Mid-Value,Potential Loyalists
7134,445,3,"232,9",4,1,1,6,Mid-Value,Potential Loyalists
7135,224,4,"336,28",5,1,1,7,Mid-Value,Potential Loyalists
7138,399,2,"78,89999999999999",4,1,1,6,Mid-Value,Potential Loyalists
7139,1510,1,"10,9",1,1,1,3,Low-Value,Lost
7140,197,5,"1020,0",5,1,2,8,High-Value,Potential Loyalists
7142,1055,2,"197,55",3,1,1,5,Low-Value,At Risk Customers
7143,3,4,"565,95",5,1,1,7,Mid-Value,Potential Loyalists
7144,1620,1,"48,4",1,1,1,3,Low-Value,Lost
7145,19,7,"399,8",5,2,1,8,High-Value,Potential Loyalists
7146,742,1,"172,8",3,1,1,5,Low-Value,At Risk Customers
7149,979,2,"418,0",3,1,1,5,Low-Value,At Risk Customers
7151,619,3,"231,65",4,1,1,6,Mid-Value,Potential Loyalists
7153,496,3,"272,1",4,1,1,6,Mid-Value,Potential Loyalists
7154,52,3,"89,5",5,1,1,7,Mid-Value,Potential Loyalists
7155,1356,1,"607,4",2,1,1,4,Low-Value,Can't Lose
7156,176,7,"429,1",5,2,1,8,High-Value,Potential Loyalists
7157,283,4,"167,29999999999998",5,1,1,7,Mid-Value,Potential Loyalists
7158,13,10,"594,4",5,2,1,8,High-Value,Potential Loyalists
7159,640,2,"98,85",4,1,1,6,Mid-Value,Potential Loyalists
7160,123,3,"231,95",5,1,1,7,Mid-Value,Potential Loyalists
7161,103,2,"341,35",5,1,1,7,Mid-Value,Potential Loyalists
7162,231,2,"120,69999999999999",5,1,1,7,Mid-Value,Potential Loyalists
7164,52,6,"562,0",5,1,1,7,Mid-Value,Potential Loyalists
7165,400,3,"52,650000000000006",4,1,1,6,Mid-Value,Potential Loyalists
7168,1057,1,"34,45",3,1,1,5,Low-Value,At Risk Customers
7169,403,8,"476,9",4,2,1,7,Mid-Value,Potential Loyalists
7170,360,3,"152,3",5,1,1,7,Mid-Value,Potential Loyalists
7171,370,2,"107,15",4,1,1,6,Mid-Value,Potential Loyalists
7172,1344,1,"16,15",2,1,1,4,Low-Value,Can't Lose
7174,427,4,"72,45",4,1,1,6,Mid-Value,Potential Loyalists
7177,1531,2,"53,9",1,1,1,3,Low-Value,Lost
7179,1272,2,"30,2",2,1,1,4,Low-Value,Can't Lose
7180,177,1,"160,9",5,1,1,7,Mid-Value,Potential Loyalists
7181,1551,1,"28,95",1,1,1,3,Low-Value,Lost
7184,105,1,"47,8",5,1,1,7,Mid-Value,Potential Loyalists
7185,964,5,"411,84999999999997",3,1,1,5,Low-Value,At Risk Customers
7188,96,4,"310,45",5,1,1,7,Mid-Value,Potential Loyalists
7189,72,4,"201,8",5,1,1,7,Mid-Value,Potential Loyalists
7190,1718,1,"33,599999999999994",1,1,1,3,Low-Value,Lost
7191,194,3,"70,15",5,1,1,7,Mid-Value,Potential Loyalists
7192,459,7,"375,84999999999997",4,2,1,7,Mid-Value,Potential Loyalists
7193,571,2,"63,9",4,1,1,6,Mid-Value,Potential Loyalists
7195,957,1,"11,45",3,1,1,5,Low-Value,At Risk Customers
7196,605,5,"193,7",4,1,1,6,Mid-Value,Potential Loyalists
7197,1516,1,"85,25",1,1,1,3,Low-Value,Lost
7200,448,1,"29,65",4,1,1,6,Mid-Value,Potential Loyalists
7202,741,3,"141,15",3,1,1,5,Low-Value,At Risk Customers
7203,97,7,"460,55",5,2,1,8,High-Value,Potential Loyalists
7207,71,9,"650,4",5,2,1,8,High-Value,Potential Loyalists
7210,24,5,"242,55",5,1,1,7,Mid-Value,Potential Loyalists
7211,676,2,"73,75",4,1,1,6,Mid-Value,Potential Loyalists
7213,1199,2,"119,35",2,1,1,4,Low-Value,Can't Lose
7215,399,2,"195,1",4,1,1,6,Mid-Value,Potential Loyalists
7216,967,2,"125,0",3,1,1,5,Low-Value,At Risk Customers
7217,1487,1,"299,8",1,1,1,3,Low-Value,Lost
7218,897,3,"351,05",3,1,1,5,Low-Value,At Risk Customers
7222,79,3,"53,5",5,1,1,7,Mid-Value,Potential Loyalists
7223,150,1,"81,3",5,1,1,7,Mid-Value,Potential Loyalists
7224,1243,1,"5,5",2,1,1,4,Low-Value,Can't Lose
7226,1111,3,"114,5",2,1,1,4,Low-Value,Can't Lose
7227,703,2,"361,8",4,1,1,6,Mid-Value,Potential Loyalists
7229,1684,1,"34,95",1,1,1,3,Low-Value,Lost
7232,129,3,"91,85",5,1,1,7,Mid-Value,Potential Loyalists
7233,10,7,"303,4",5,2,1,8,High-Value,Potential Loyalists
7234,77,11,"490,0",5,2,1,8,High-Value,Potential Loyalists
7235,20,1,"177,89999999999998",5,1,1,7,Mid-Value,Potential Loyalists
7237,1333,3,"243,25",2,1,1,4,Low-Value,Can't Lose
7238,68,5,"601,4",5,1,1,7,Mid-Value,Potential Loyalists
7239,1624,2,"210,0",1,1,1,3,Low-Value,Lost
7240,584,1,"31,2",4,1,1,6,Mid-Value,Potential Loyalists
7241,1482,2,"71,4",1,1,1,3,Low-Value,Lost
7242,915,4,"215,35000000000002",3,1,1,5,Low-Value,At Risk Customers
7243,15,3,"348,45000000000005",5,1,1,7,Mid-Value,Potential Loyalists
7245,361,2,"46,6",5,1,1,7,Mid-Value,Potential Loyalists
7246,165,1,"57,4",5,1,1,7,Mid-Value,Potential Loyalists
7247,85,4,"100,55",5,1,1,7,Mid-Value,Potential Loyalists
7248,855,5,"436,0",3,1,1,5,Low-Value,At Risk Customers
7252,148,8,"694,1",5,2,2,9,High-Value,Champions
7253,680,5,"975,3000000000001",4,1,2,7,Mid-Value,Potential Loyalists
7256,179,4,"175,35",5,1,1,7,Mid-Value,Potential Loyalists
7257,141,6,"436,0",5,1,1,7,Mid-Value,Potential Loyalists
7261,844,3,"328,85",3,1,1,5,Low-Value,At Risk Customers
7262,4,4,"55,55",5,1,1,7,Mid-Value,Potential Loyalists
7263,893,2,"232,05",3,1,1,5,Low-Value,At Risk Customers
7264,813,3,"203,5",3,1,1,5,Low-Value,At Risk Customers
7265,44,2,"70,95",5,1,1,7,Mid-Value,Potential Loyalists
7268,263,3,"99,45",5,1,1,7,Mid-Value,Potential Loyalists
7270,1468,2,"124,69999999999999",1,1,1,3,Low-Value,Lost
7272,1144,1,"30,35",2,1,1,4,Low-Value,Can't Lose
7274,62,4,"110,8",5,1,1,7,Mid-Value,Potential Loyalists
7276,928,1,"77,69999999999999",3,1,1,5,Low-Value,At Risk Customers
7279,617,3,"294,6",4,1,1,6,Mid-Value,Potential Loyalists
7280,413,5,"588,95",4,1,1,6,Mid-Value,Potential Loyalists
7282,647,1,"7,7",4,1,1,6,Mid-Value,Potential Loyalists
7283,798,2,"128,0",3,1,1,5,Low-Value,At Risk Customers
7285,1104,2,"185,79999999999998",2,1,1,4,Low-Value,Can't Lose
7287,434,1,"58,0",4,1,1,6,Mid-Value,Potential Loyalists
7288,645,1,"3,15",4,1,1,6,Mid-Value,Potential Loyalists
7290,264,4,"189,4",5,1,1,7,Mid-Value,Potential Loyalists
7291,48,3,"217,65",5,1,1,7,Mid-Value,Potential Loyalists
7292,196,7,"435,09999999999997",5,2,1,8,High-Value,Potential Loyalists
7296,5,3,"193,0",5,1,1,7,Mid-Value,Potential Loyalists
7297,622,6,"258,45",4,1,1,6,Mid-Value,Potential Loyalists
7299,45,4,"82,4",5,1,1,7,Mid-Value,Potential Loyalists
7300,105,3,"645,1",5,1,1,7,Mid-Value,Potential Loyalists
7301,242,4,"199,05",5,1,1,7,Mid-Value,Potential Loyalists
7302,121,4,"228,85",5,1,1,7,Mid-Value,Potential Loyalists
7305,631,2,"272,3",4,1,1,6,Mid-Value,Potential Loyalists
7306,82,6,"351,7",5,1,1,7,Mid-Value,Potential Loyalists
7308,1255,2,"150,25",2,1,1,4,Low-Value,Can't Lose
7309,1084,2,"80,25",3,1,1,5,Low-Value,At Risk Customers
7310,1040,1,"58,0",3,1,1,5,Low-Value,At Risk Customers
7311,984,1,"104,0",3,1,1,5,Low-Value,At Risk Customers
7312,231,1,"51,55",5,1,1,7,Mid-Value,Potential Loyalists
7313,1,5,"375,28999999999996",5,1,1,7,Mid-Value,Potential Loyalists
7314,1168,2,"102,35",2,1,1,4,Low-Value,Can't Lose
7316,1034,1,"51,85",3,1,1,5,Low-Value,At Risk Customers
7318,377,5,"552,0",4,1,1,6,Mid-Value,Potential Loyalists
7319,375,1,"12,2",4,1,1,6,Mid-Value,Potential Loyalists
7320,6,8,"395,55",5,2,1,8,High-Value,Potential Loyalists
7323,99,18,"1891,6999999999998",5,4,3,12,High-Value,Champions
7327,519,2,"29,2",4,1,1,6,Mid-Value,Potential Loyalists
7328,1115,3,"53,85",2,1,1,4,Low-Value,Can't Lose
7329,836,2,"35,55",3,1,1,5,Low-Value,At Risk Customers
7331,38,8,"746,85",5,2,2,9,High-Value,Champions
7332,207,5,"217,70000000000002",5,1,1,7,Mid-Value,Potential Loyalists
7333,148,5,"389,0",5,1,1,7,Mid-Value,Potential Loyalists
7334,445,2,"95,5",4,1,1,6,Mid-Value,Potential Loyalists
7336,923,2,"157,7",3,1,1,5,Low-Value,At Risk Customers
7339,210,5,"128,65",5,1,1,7,Mid-Value,Potential Loyalists
7340,993,1,"8,1",3,1,1,5,Low-Value,At Risk Customers
7343,698,3,"90,55",4,1,1,6,Mid-Value,Potential Loyalists
7344,52,6,"1180,75",5,1,2,8,High-Value,Potential Loyalists
7346,1008,1,"32,15",3,1,1,5,Low-Value,At Risk Customers
7347,190,4,"267,35",5,1,1,7,Mid-Value,Potential Loyalists
7348,13,3,"58,3",5,1,1,7,Mid-Value,Potential Loyalists
7350,34,3,"198,6",5,1,1,7,Mid-Value,Potential Loyalists
7351,1202,1,"5,4",2,1,1,4,Low-Value,Can't Lose
7352,624,4,"46,3",4,1,1,6,Mid-Value,Potential Loyalists
7353,125,5,"288,85",5,1,1,7,Mid-Value,Potential Loyalists
7355,1761,1,"7,45",1,1,1,3,Low-Value,Lost
7356,60,5,"636,45",5,1,1,7,Mid-Value,Potential Loyalists
7357,214,4,"337,6",5,1,1,7,Mid-Value,Potential Loyalists
7358,210,3,"181,9",5,1,1,7,Mid-Value,Potential Loyalists
7359,21,4,"163,3",5,1,1,7,Mid-Value,Potential Loyalists
7360,218,2,"34,5",5,1,1,7,Mid-Value,Potential Loyalists
7362,376,9,"323,25",4,2,1,7,Mid-Value,Potential Loyalists
7363,945,3,"43,8",3,1,1,5,Low-Value,At Risk Customers
7365,1196,2,"77,44999999999999",2,1,1,4,Low-Value,Can't Lose
7369,474,3,"227,6",4,1,1,6,Mid-Value,Potential Loyalists
7371,832,1,"178,4",3,1,1,5,Low-Value,At Risk Customers
7372,112,3,"98,0",5,1,1,7,Mid-Value,Potential Loyalists
7373,8,14,"885,25",5,3,2,10,High-Value,Champions
7375,195,3,"256,05",5,1,1,7,Mid-Value,Potential Loyalists
7376,102,4,"157,75",5,1,1,7,Mid-Value,Potential Loyalists
7378,830,4,"133,35",3,1,1,5,Low-Value,At Risk Customers
7379,1013,1,"25,25",3,1,1,5,Low-Value,At Risk Customers
7381,634,2,"175,8",4,1,1,6,Mid-Value,Potential Loyalists
7386,885,2,"57,05",3,1,1,5,Low-Value,At Risk Customers
7387,935,4,"502,00000000000006",3,1,1,5,Low-Value,At Risk Customers
7388,484,2,"223,2",4,1,1,6,Mid-Value,Potential Loyalists
7389,219,4,"65,7",5,1,1,7,Mid-Value,Potential Loyalists
7390,1176,1,"109,1",2,1,1,4,Low-Value,Can't Lose
7391,1700,1,"170,39999999999998",1,1,1,3,Low-Value,Lost
7395,36,4,"200,20000000000002",5,1,1,7,Mid-Value,Potential Loyalists
7398,12,9,"1262,0",5,2,2,9,High-Value,Champions
7399,977,1,"73,3",3,1,1,5,Low-Value,At Risk Customers
7400,41,5,"214,75000000000003",5,1,1,7,Mid-Value,Potential Loyalists
7401,813,1,"62,4",3,1,1,5,Low-Value,At Risk Customers
7402,272,1,"107,69999999999999",5,1,1,7,Mid-Value,Potential Loyalists
7403,776,3,"63,1",3,1,1,5,Low-Value,At Risk Customers
7405,339,9,"507,0",5,2,1,8,High-Value,Potential Loyalists
7406,673,4,"442,29999999999995",4,1,1,6,Mid-Value,Potential Loyalists
7407,158,5,"118,05",5,1,1,7,Mid-Value,Potential Loyalists
7408,18,4,"126,8",5,1,1,7,Mid-Value,Potential Loyalists
7410,383,1,"20,6",4,1,1,6,Mid-Value,Potential Loyalists
7411,1058,4,"291,2",3,1,1,5,Low-Value,At Risk Customers
7412,741,3,"463,9",3,1,1,5,Low-Value,At Risk Customers
7413,1261,2,"354,40000000000003",2,1,1,4,Low-Value,Can't Lose
7414,139,1,"20,46",5,1,1,7,Mid-Value,Potential Loyalists
7415,775,3,"153,75",3,1,1,5,Low-Value,At Risk Customers
7416,333,4,"424,29999999999995",5,1,1,7,Mid-Value,Potential Loyalists
7417,583,1,"34,5",4,1,1,6,Mid-Value,Potential Loyalists
7418,36,2,"22,7",5,1,1,7,Mid-Value,Potential Loyalists
7419,550,2,"161,05",4,1,1,6,Mid-Value,Potential Loyalists
7420,904,3,"207,25",3,1,1,5,Low-Value,At Risk Customers
7421,1656,1,"109,0",1,1,1,3,Low-Value,Lost
7423,29,1,"120,1",5,1,1,7,Mid-Value,Potential Loyalists
7425,920,2,"323,2",3,1,1,5,Low-Value,At Risk Customers
7426,1,6,"412,65",5,1,1,7,Mid-Value,Potential Loyalists
7428,48,4,"229,85000000000002",5,1,1,7,Mid-Value,Potential Loyalists
7429,817,4,"165,95",3,1,1,5,Low-Value,At Risk Customers
7432,22,1,"20,0",5,1,1,7,Mid-Value,Potential Loyalists
7433,167,1,"26,0",5,1,1,7,Mid-Value,Potential Loyalists
7434,118,2,"61,199999999999996",5,1,1,7,Mid-Value,Potential Loyalists
7437,10,4,"163,45",5,1,1,7,Mid-Value,Potential Loyalists
7438,1330,1,"124,0",2,1,1,4,Low-Value,Can't Lose
7442,46,9,"265,4",5,2,1,8,High-Value,Potential Loyalists
7444,717,1,"172,2",4,1,1,6,Mid-Value,Potential Loyalists
7446,508,3,"330,2",4,1,1,6,Mid-Value,Potential Loyalists
7447,47,2,"84,6",5,1,1,7,Mid-Value,Potential Loyalists
7448,1134,4,"80,80000000000001",2,1,1,4,Low-Value,Can't Lose
7449,86,2,"79,05",5,1,1,7,Mid-Value,Potential Loyalists
7451,1320,2,"60,6",2,1,1,4,Low-Value,Can't Lose
7452,130,1,"15,15",5,1,1,7,Mid-Value,Potential Loyalists
7454,1001,3,"205,20000000000002",3,1,1,5,Low-Value,At Risk Customers
7455,13,10,"418,8",5,2,1,8,High-Value,Potential Loyalists
7456,734,4,"402,4",3,1,1,5,Low-Value,At Risk Customers
7458,823,3,"92,0",3,1,1,5,Low-Value,At Risk Customers
7459,1417,1,"5,05",2,1,1,4,Low-Value,Can't Lose
7460,535,2,"28,2",4,1,1,6,Mid-Value,Potential Loyalists
7461,378,2,"100,0",4,1,1,6,Mid-Value,Potential Loyalists
7462,1020,4,"75,7",3,1,1,5,Low-Value,At Risk Customers
7463,1453,1,"99,2",2,1,1,4,Low-Value,Can't Lose
7464,828,1,"12,3",3,1,1,5,Low-Value,At Risk Customers
7467,1154,9,"451,95000000000005",2,2,1,5,Low-Value,At Risk Customers
7469,960,2,"124,75",3,1,1,5,Low-Value,At Risk Customers
7470,530,6,"709,8499999999999",4,1,2,7,Mid-Value,Potential Loyalists
7471,1300,1,"18,8",2,1,1,4,Low-Value,Can't Lose
7472,14,2,"192,85",5,1,1,7,Mid-Value,Potential Loyalists
7474,46,4,"128,75",5,1,1,7,Mid-Value,Potential Loyalists
7477,941,3,"93,55000000000001",3,1,1,5,Low-Value,At Risk Customers
7478,692,5,"142,35",4,1,1,6,Mid-Value,Potential Loyalists
7479,534,1,"16,0",4,1,1,6,Mid-Value,Potential Loyalists
7480,548,2,"107,7",4,1,1,6,Mid-Value,Potential Loyalists
7481,420,5,"55,4",4,1,1,6,Mid-Value,Potential Loyalists
7482,1619,1,"17,5",1,1,1,3,Low-Value,Lost
7483,201,3,"180,7",5,1,1,7,Mid-Value,Potential Loyalists
7484,115,2,"226,45",5,1,1,7,Mid-Value,Potential Loyalists
7485,154,5,"340,1",5,1,1,7,Mid-Value,Potential Loyalists
7486,283,6,"267,75",5,1,1,7,Mid-Value,Potential Loyalists
7487,743,5,"378,85",3,1,1,5,Low-Value,At Risk Customers
7489,1558,1,"8,3",1,1,1,3,Low-Value,Lost
7490,863,2,"104,15",3,1,1,5,Low-Value,At Risk Customers
7491,395,5,"140,8",4,1,1,6,Mid-Value,Potential Loyalists
7492,506,2,"73,9",4,1,1,6,Mid-Value,Potential Loyalists
7493,1361,2,"116,80000000000001",2,1,1,4,Low-Value,Can't Lose
7496,383,9,"537,65",4,2,1,7,Mid-Value,Potential Loyalists
7497,213,3,"207,0",5,1,1,7,Mid-Value,Potential Loyalists
7498,405,1,"105,5",4,1,1,6,Mid-Value,Potential Loyalists
7500,26,7,"530,4",5,2,1,8,High-Value,Potential Loyalists
7501,866,2,"135,6",3,1,1,5,Low-Value,At Risk Customers
7503,17,10,"556,3",5,2,1,8,High-Value,Potential Loyalists
7506,1398,2,"475,15",2,1,1,4,Low-Value,Can't Lose
7507,804,1,"302,4",3,1,1,5,Low-Value,At Risk Customers
7508,568,2,"32,2",4,1,1,6,Mid-Value,Potential Loyalists
7511,980,4,"298,8",3,1,1,5,Low-Value,At Risk Customers
7512,833,4,"269,15",3,1,1,5,Low-Value,At Risk Customers
7515,52,3,"384,5",5,1,1,7,Mid-Value,Potential Loyalists
7516,473,4,"110,85",4,1,1,6,Mid-Value,Potential Loyalists
7517,206,1,"67,0",5,1,1,7,Mid-Value,Potential Loyalists
7519,499,1,"39,2",4,1,1,6,Mid-Value,Potential Loyalists
7521,810,3,"193,6",3,1,1,5,Low-Value,At Risk Customers
7522,872,1,"22,9",3,1,1,5,Low-Value,At Risk Customers
7523,997,2,"139,0",3,1,1,5,Low-Value,At Risk Customers
7525,1230,2,"474,6",2,1,1,4,Low-Value,Can't Lose
7527,564,1,"94,65",4,1,1,6,Mid-Value,Potential Loyalists
7530,1442,1,"74,1",2,1,1,4,Low-Value,Can't Lose
7531,618,2,"103,8",4,1,1,6,Mid-Value,Potential Loyalists
7532,1364,1,"12,25",2,1,1,4,Low-Value,Can't Lose
7534,190,2,"64,65",5,1,1,7,Mid-Value,Potential Loyalists
7537,464,5,"419,9",4,1,1,6,Mid-Value,Potential Loyalists
7538,942,1,"74,1",3,1,1,5,Low-Value,At Risk Customers
7539,1127,1,"13,15",2,1,1,4,Low-Value,Can't Lose
7541,227,1,"85,15",5,1,1,7,Mid-Value,Potential Loyalists
7543,743,4,"599,3499999999999",3,1,1,5,Low-Value,At Risk Customers
7544,893,2,"54,15",3,1,1,5,Low-Value,At Risk Customers
7545,20,3,"32,7",5,1,1,7,Mid-Value,Potential Loyalists
7546,574,2,"119,30000000000001",4,1,1,6,Mid-Value,Potential Loyalists
7547,1586,2,"46,2",1,1,1,3,Low-Value,Lost
7548,267,4,"427,0",5,1,1,7,Mid-Value,Potential Loyalists
7549,1068,3,"435,65000000000003",3,1,1,5,Low-Value,At Risk Customers
7550,136,1,"238,3",5,1,1,7,Mid-Value,Potential Loyalists
7551,927,1,"46,9",3,1,1,5,Low-Value,At Risk Customers
7552,25,7,"507,9",5,2,1,8,High-Value,Potential Loyalists
7554,762,1,"41,65",3,1,1,5,Low-Value,At Risk Customers
7555,155,6,"734,95",5,1,2,8,High-Value,Potential Loyalists
7556,121,5,"480,3",5,1,1,7,Mid-Value,Potential Loyalists
7557,262,5,"388,35",5,1,1,7,Mid-Value,Potential Loyalists
7558,373,3,"550,85",4,1,1,6,Mid-Value,Potential Loyalists
7560,290,5,"182,45",5,1,1,7,Mid-Value,Potential Loyalists
7561,874,2,"124,15",3,1,1,5,Low-Value,At Risk Customers
7562,127,3,"212,55",5,1,1,7,Mid-Value,Potential Loyalists
7563,55,3,"92,65",5,1,1,7,Mid-Value,Potential Loyalists
7564,827,2,"116,8",3,1,1,5,Low-Value,At Risk Customers
7565,48,1,"100,2",5,1,1,7,Mid-Value,Potential Loyalists
7566,1067,2,"106,39999999999999",3,1,1,5,Low-Value,At Risk Customers
7567,50,3,"247,3",5,1,1,7,Mid-Value,Potential Loyalists
7572,569,3,"386,45",4,1,1,6,Mid-Value,Potential Loyalists
7573,1786,1,"42,15",1,1,1,3,Low-Value,Lost
7574,1825,1,"9,95",1,1,1,3,Low-Value,Lost
7575,399,2,"17,049999999999997",4,1,1,6,Mid-Value,Potential Loyalists
7577,204,2,"122,74999999999999",5,1,1,7,Mid-Value,Potential Loyalists
7580,1256,1,"8,25",2,1,1,4,Low-Value,Can't Lose
7581,1069,2,"62,4",3,1,1,5,Low-Value,At Risk Customers
7582,720,2,"67,55",4,1,1,6,Mid-Value,Potential Loyalists
7583,1046,5,"397,35",3,1,1,5,Low-Value,At Risk Customers
7584,242,3,"91,25",5,1,1,7,Mid-Value,Potential Loyalists
7585,788,2,"56,5",3,1,1,5,Low-Value,At Risk Customers
7586,563,2,"58,300000000000004",4,1,1,6,Mid-Value,Potential Loyalists
7589,795,8,"233,7",3,2,1,6,Mid-Value,Potential Loyalists
7590,231,4,"424,7",5,1,1,7,Mid-Value,Potential Loyalists
7591,342,4,"108,9",5,1,1,7,Mid-Value,Potential Loyalists
7593,265,2,"101,0",5,1,1,7,Mid-Value,Potential Loyalists
7594,136,1,"57,5",5,1,1,7,Mid-Value,Potential Loyalists
7595,647,3,"42,099999999999994",4,1,1,6,Mid-Value,Potential Loyalists
7596,102,7,"541,75",5,2,1,8,High-Value,Potential Loyalists
7598,140,6,"719,05",5,1,2,8,High-Value,Potential Loyalists
7599,1238,3,"127,4",2,1,1,4,Low-Value,Can't Lose
7605,92,4,"718,6999999999999",5,1,2,8,High-Value,Potential Loyalists
7606,82,2,"41,5",5,1,1,7,Mid-Value,Potential Loyalists
7607,1719,1,"27,25",1,1,1,3,Low-Value,Lost
7608,1375,1,"44,9",2,1,1,4,Low-Value,Can't Lose
7609,25,13,"402,75",5,3,1,9,High-Value,Champions
7612,17,7,"410,0",5,2,1,8,High-Value,Potential Loyalists
7616,365,2,"666,6500000000001",5,1,2,8,High-Value,Potential Loyalists
7622,3,7,"422,15",5,2,1,8,High-Value,Potential Loyalists
7623,398,5,"216,5",4,1,1,6,Mid-Value,Potential Loyalists
7624,237,2,"71,8",5,1,1,7,Mid-Value,Potential Loyalists
7627,39,13,"384,9",5,3,1,9,High-Value,Champions
7628,986,1,"30,0",3,1,1,5,Low-Value,At Risk Customers
7629,152,2,"116,5",5,1,1,7,Mid-Value,Potential Loyalists
7631,1277,2,"5,75",2,1,1,4,Low-Value,Can't Lose
7632,36,2,"74,85",5,1,1,7,Mid-Value,Potential Loyalists
7633,164,9,"616,05",5,2,1,8,High-Value,Potential Loyalists
7636,59,2,"145,1",5,1,1,7,Mid-Value,Potential Loyalists
7637,1091,1,"196,15",3,1,1,5,Low-Value,At Risk Customers
7638,388,3,"269,35",4,1,1,6,Mid-Value,Potential Loyalists
7640,515,3,"150,9",4,1,1,6,Mid-Value,Potential Loyalists
7641,66,6,"288,05",5,1,1,7,Mid-Value,Potential Loyalists
7642,911,1,"26,4",3,1,1,5,Low-Value,At Risk Customers
7643,447,1,"116,85",4,1,1,6,Mid-Value,Potential Loyalists
7644,55,5,"361,45",5,1,1,7,Mid-Value,Potential Loyalists
7645,185,5,"187,3",5,1,1,7,Mid-Value,Potential Loyalists
7646,892,2,"76,75",3,1,1,5,Low-Value,At Risk Customers
7647,493,2,"187,60000000000002",4,1,1,6,Mid-Value,Potential Loyalists
7648,1172,5,"107,55",2,1,1,4,Low-Value,Can't Lose
7649,177,1,"89,8",5,1,1,7,Mid-Value,Potential Loyalists
7650,1287,2,"83,35",2,1,1,4,Low-Value,Can't Lose
7651,762,4,"222,54999999999998",3,1,1,5,Low-Value,At Risk Customers
7652,68,5,"334,25",5,1,1,7,Mid-Value,Potential Loyalists
7653,467,2,"105,44999999999999",4,1,1,6,Mid-Value,Potential Loyalists
7654,1181,2,"50,900000000000006",2,1,1,4,Low-Value,Can't Lose
7655,255,4,"191,5",5,1,1,7,Mid-Value,Potential Loyalists
7657,1658,2,"352,8",1,1,1,3,Low-Value,Lost
7658,195,3,"343,40000000000003",5,1,1,7,Mid-Value,Potential Loyalists
7659,381,3,"215,85000000000002",4,1,1,6,Mid-Value,Potential Loyalists
7660,1343,4,"146,1",2,1,1,4,Low-Value,Can't Lose
7661,246,1,"15,8",5,1,1,7,Mid-Value,Potential Loyalists
7666,189,1,"87,1",5,1,1,7,Mid-Value,Potential Loyalists
7667,1651,1,"102,8",1,1,1,3,Low-Value,Lost
7668,405,4,"677,85",4,1,2,7,Mid-Value,Potential Loyalists
7670,542,4,"112,3",4,1,1,6,Mid-Value,Potential Loyalists
7671,15,1,"85,4",5,1,1,7,Mid-Value,Potential Loyalists
7672,1207,1,"70,9",2,1,1,4,Low-Value,Can't Lose
7673,454,4,"261,3",4,1,1,6,Mid-Value,Potential Loyalists
7674,439,2,"176,7",4,1,1,6,Mid-Value,Potential Loyalists
7675,606,1,"17,0",4,1,1,6,Mid-Value,Potential Loyalists
7676,560,1,"232,0",4,1,1,6,Mid-Value,Potential Loyalists
7678,542,4,"246,3",4,1,1,6,Mid-Value,Potential Loyalists
7679,421,3,"61,35",4,1,1,6,Mid-Value,Potential Loyalists
7680,1031,1,"16,4",3,1,1,5,Low-Value,At Risk Customers
7682,976,2,"21,55",3,1,1,5,Low-Value,At Risk Customers
7683,802,1,"9,65",3,1,1,5,Low-Value,At Risk Customers
7686,613,4,"193,4",4,1,1,6,Mid-Value,Potential Loyalists
7688,186,3,"185,0",5,1,1,7,Mid-Value,Potential Loyalists
7690,1298,1,"6,55",2,1,1,4,Low-Value,Can't Lose
7692,599,3,"287,6",4,1,1,6,Mid-Value,Potential Loyalists
7693,74,3,"107,15",5,1,1,7,Mid-Value,Potential Loyalists
7694,330,3,"66,35",5,1,1,7,Mid-Value,Potential Loyalists
7697,313,1,"18,45",5,1,1,7,Mid-Value,Potential Loyalists
7698,1331,1,"118,94999999999999",2,1,1,4,Low-Value,Can't Lose
7699,39,7,"1282,4",5,2,2,9,High-Value,Champions
7700,222,2,"46,65",5,1,1,7,Mid-Value,Potential Loyalists
7702,363,2,"98,45",5,1,1,7,Mid-Value,Potential Loyalists
7704,1195,1,"5,95",2,1,1,4,Low-Value,Can't Lose
7705,787,5,"247,45000000000002",3,1,1,5,Low-Value,At Risk Customers
7706,1019,1,"17,95",3,1,1,5,Low-Value,At Risk Customers
7709,3,3,"46,5",5,1,1,7,Mid-Value,Potential Loyalists
7710,169,5,"274,5",5,1,1,7,Mid-Value,Potential Loyalists
7711,206,4,"88,4",5,1,1,7,Mid-Value,Potential Loyalists
7712,1418,1,"34,1",2,1,1,4,Low-Value,Can't Lose
7714,628,2,"95,9",4,1,1,6,Mid-Value,Potential Loyalists
7717,305,3,"47,2",5,1,1,7,Mid-Value,Potential Loyalists
7720,1336,3,"224,0",2,1,1,4,Low-Value,Can't Lose
7721,1461,2,"45,2",1,1,1,3,Low-Value,Lost
7722,414,10,"572,1",4,2,1,7,Mid-Value,Potential Loyalists
7725,1297,5,"727,4",2,1,2,5,Low-Value,At Risk Customers
7726,1016,2,"50,65",3,1,1,5,Low-Value,At Risk Customers
7727,920,1,"144,6",3,1,1,5,Low-Value,At Risk Customers
7730,98,2,"156,3",5,1,1,7,Mid-Value,Potential Loyalists
7731,1201,3,"564,9",2,1,1,4,Low-Value,Can't Lose
7732,479,1,"99,6",4,1,1,6,Mid-Value,Potential Loyalists
7733,396,5,"353,0",4,1,1,6,Mid-Value,Potential Loyalists
7734,178,4,"141,4",5,1,1,7,Mid-Value,Potential Loyalists
7736,923,1,"36,0",3,1,1,5,Low-Value,At Risk Customers
7737,307,1,"21,95",5,1,1,7,Mid-Value,Potential Loyalists
7738,54,2,"108,75",5,1,1,7,Mid-Value,Potential Loyalists
7740,124,1,"50,2",5,1,1,7,Mid-Value,Potential Loyalists
7745,530,2,"164,10000000000002",4,1,1,6,Mid-Value,Potential Loyalists
7746,937,1,"14,15",3,1,1,5,Low-Value,At Risk Customers
7748,425,6,"552,7",4,1,1,6,Mid-Value,Potential Loyalists
7751,47,4,"189,85",5,1,1,7,Mid-Value,Potential Loyalists
7752,911,2,"195,3",3,1,1,5,Low-Value,At Risk Customers
7753,45,9,"389,65",5,2,1,8,High-Value,Potential Loyalists
7754,857,1,"35,7",3,1,1,5,Low-Value,At Risk Customers
7755,928,3,"214,7",3,1,1,5,Low-Value,At Risk Customers
7757,134,3,"109,4",5,1,1,7,Mid-Value,Potential Loyalists
7758,11,4,"425,8",5,1,1,7,Mid-Value,Potential Loyalists
7759,1809,1,"89,69999999999999",1,1,1,3,Low-Value,Lost
7762,172,13,"601,6",5,3,1,9,High-Value,Champions
7763,440,2,"36,45",4,1,1,6,Mid-Value,Potential Loyalists
7764,1223,2,"144,2",2,1,1,4,Low-Value,Can't Lose
7766,327,12,"3315,5999999999995",5,3,5,13,High-Value,Champions
7767,143,3,"236,64999999999998",5,1,1,7,Mid-Value,Potential Loyalists
7768,1742,1,"25,85",1,1,1,3,Low-Value,Lost
7769,1728,1,"49,0",1,1,1,3,Low-Value,Lost
7770,1669,1,"74,3",1,1,1,3,Low-Value,Lost
7773,901,1,"64,4",3,1,1,5,Low-Value,At Risk Customers
7775,130,3,"164,5",5,1,1,7,Mid-Value,Potential Loyalists
7776,53,2,"12,2",5,1,1,7,Mid-Value,Potential Loyalists
7777,981,2,"586,1",3,1,1,5,Low-Value,At Risk Customers
7778,47,4,"196,35",5,1,1,7,Mid-Value,Potential Loyalists
7779,1004,1,"16,85",3,1,1,5,Low-Value,At Risk Customers
7783,427,3,"131,1",4,1,1,6,Mid-Value,Potential Loyalists
7784,712,2,"53,25",4,1,1,6,Mid-Value,Potential Loyalists
7785,800,5,"223,35000000000002",3,1,1,5,Low-Value,At Risk Customers
7788,962,5,"282,15",3,1,1,5,Low-Value,At Risk Customers
7790,442,1,"10,1",4,1,1,6,Mid-Value,Potential Loyalists
7791,106,4,"85,65",5,1,1,7,Mid-Value,Potential Loyalists
7793,59,2,"51,45",5,1,1,7,Mid-Value,Potential Loyalists
7795,584,2,"120,0",4,1,1,6,Mid-Value,Potential Loyalists
7797,159,1,"180,35",5,1,1,7,Mid-Value,Potential Loyalists
7801,621,1,"59,25",4,1,1,6,Mid-Value,Potential Loyalists
7802,85,5,"141,8",5,1,1,7,Mid-Value,Potential Loyalists
7803,291,1,"36,45",5,1,1,7,Mid-Value,Potential Loyalists
7806,270,6,"194,46",5,1,1,7,Mid-Value,Potential Loyalists
7808,12,10,"771,05",5,2,2,9,High-Value,Champions
7809,36,8,"644,0500000000001",5,2,1,8,High-Value,Potential Loyalists
7812,740,3,"105,7",3,1,1,5,Low-Value,At Risk Customers
7813,759,5,"410,1",3,1,1,5,Low-Value,At Risk Customers
7814,185,3,"218,3",5,1,1,7,Mid-Value,Potential Loyalists
7815,380,7,"828,8",4,2,2,8,High-Value,Potential Loyalists
7816,564,1,"0,75",4,1,1,6,Mid-Value,Potential Loyalists
7817,650,6,"404,1",4,1,1,6,Mid-Value,Potential Loyalists
7818,798,3,"132,15",3,1,1,5,Low-Value,At Risk Customers
7819,160,1,"21,95",5,1,1,7,Mid-Value,Potential Loyalists
7820,775,4,"199,65",3,1,1,5,Low-Value,At Risk Customers
7821,88,1,"253,2",5,1,1,7,Mid-Value,Potential Loyalists
7824,147,1,"35,7",5,1,1,7,Mid-Value,Potential Loyalists
7825,416,2,"38,7",4,1,1,6,Mid-Value,Potential Loyalists
7826,381,2,"163,7",4,1,1,6,Mid-Value,Potential Loyalists
7827,398,6,"1151,55",4,1,2,7,Mid-Value,Potential Loyalists
7828,150,4,"313,7",5,1,1,7,Mid-Value,Potential Loyalists
7829,1644,1,"29,25",1,1,1,3,Low-Value,Lost
7830,20,1,"24,8",5,1,1,7,Mid-Value,Potential Loyalists
7831,1113,2,"208,0",2,1,1,4,Low-Value,Can't Lose
7832,832,2,"164,4",3,1,1,5,Low-Value,At Risk Customers
7836,167,3,"345,40000000000003",5,1,1,7,Mid-Value,Potential Loyalists
7837,388,7,"146,7",4,2,1,7,Mid-Value,Potential Loyalists
7838,250,6,"208,8",5,1,1,7,Mid-Value,Potential Loyalists
7842,96,3,"169,5",5,1,1,7,Mid-Value,Potential Loyalists
7843,224,5,"251,35000000000002",5,1,1,7,Mid-Value,Potential Loyalists
7846,531,2,"108,30000000000001",4,1,1,6,Mid-Value,Potential Loyalists
7847,242,3,"285,9",5,1,1,7,Mid-Value,Potential Loyalists
7849,499,1,"25,7",4,1,1,6,Mid-Value,Potential Loyalists
7851,540,1,"23,9",4,1,1,6,Mid-Value,Potential Loyalists
7852,59,1,"18,05",5,1,1,7,Mid-Value,Potential Loyalists
7853,635,2,"15,149999999999999",4,1,1,6,Mid-Value,Potential Loyalists
7854,1132,5,"462,25",2,1,1,4,Low-Value,Can't Lose
7855,236,2,"118,2",5,1,1,7,Mid-Value,Potential Loyalists
7856,909,1,"128,8",3,1,1,5,Low-Value,At Risk Customers
7862,1817,1,"27,65",1,1,1,3,Low-Value,Lost
7863,11,2,"70,3",5,1,1,7,Mid-Value,Potential Loyalists
7865,537,3,"244,89999999999998",4,1,1,6,Mid-Value,Potential Loyalists
7866,537,3,"137,10000000000002",4,1,1,6,Mid-Value,Potential Loyalists
7868,963,1,"21,15",3,1,1,5,Low-Value,At Risk Customers
7869,29,5,"801,7",5,1,2,8,High-Value,Potential Loyalists
7871,862,6,"583,95",3,1,1,5,Low-Value,At Risk Customers
7872,32,6,"96,65",5,1,1,7,Mid-Value,Potential Loyalists
7878,1671,1,"49,4",1,1,1,3,Low-Value,Lost
7880,462,3,"187,55",4,1,1,6,Mid-Value,Potential Loyalists
7884,1284,1,"59,8",2,1,1,4,Low-Value,Can't Lose
7885,91,4,"323,15",5,1,1,7,Mid-Value,Potential Loyalists
7886,777,3,"150,3",3,1,1,5,Low-Value,At Risk Customers
7888,510,2,"129,55",4,1,1,6,Mid-Value,Potential Loyalists
7890,0,3,"64,1",5,1,1,7,Mid-Value,Potential Loyalists
7892,112,6,"190,07999999999998",5,1,1,7,Mid-Value,Potential Loyalists
7894,536,4,"96,8",4,1,1,6,Mid-Value,Potential Loyalists
7895,987,1,"37,7",3,1,1,5,Low-Value,At Risk Customers
7896,913,6,"302,9",3,1,1,5,Low-Value,At Risk Customers
7897,101,5,"1050,4",5,1,2,8,High-Value,Potential Loyalists
7898,1214,1,"100,1",2,1,1,4,Low-Value,Can't Lose
7899,155,3,"110,4",5,1,1,7,Mid-Value,Potential Loyalists
7901,679,5,"315,65",4,1,1,6,Mid-Value,Potential Loyalists
7902,740,3,"147,10000000000002",3,1,1,5,Low-Value,At Risk Customers
7903,215,5,"134,75",5,1,1,7,Mid-Value,Potential Loyalists
7905,164,1,"80,9",5,1,1,7,Mid-Value,Potential Loyalists
7906,528,2,"102,7",4,1,1,6,Mid-Value,Potential Loyalists
7907,1117,2,"240,85",2,1,1,4,Low-Value,Can't Lose
7910,635,1,"62,4",4,1,1,6,Mid-Value,Potential Loyalists
7911,80,2,"74,05",5,1,1,7,Mid-Value,Potential Loyalists
7912,683,5,"533,5",4,1,1,6,Mid-Value,Potential Loyalists
7913,969,1,"14,15",3,1,1,5,Low-Value,At Risk Customers
7914,144,3,"284,85",5,1,1,7,Mid-Value,Potential Loyalists
7917,534,4,"121,5",4,1,1,6,Mid-Value,Potential Loyalists
7918,1474,2,"110,0",1,1,1,3,Low-Value,Lost
7919,1474,1,"3,35",1,1,1,3,Low-Value,Lost
7920,242,5,"191,5",5,1,1,7,Mid-Value,Potential Loyalists
7921,624,3,"154,15",4,1,1,6,Mid-Value,Potential Loyalists
7924,762,4,"122,14999999999999",3,1,1,5,Low-Value,At Risk Customers
7928,546,2,"124,19999999999999",4,1,1,6,Mid-Value,Potential Loyalists
7930,529,2,"76,9",4,1,1,6,Mid-Value,Potential Loyalists
7931,422,3,"189,9",4,1,1,6,Mid-Value,Potential Loyalists
7934,195,4,"499,6",5,1,1,7,Mid-Value,Potential Loyalists
7935,816,4,"210,29999999999998",3,1,1,5,Low-Value,At Risk Customers
7938,20,8,"379,54999999999995",5,2,1,8,High-Value,Potential Loyalists
7939,1703,1,"75,9",1,1,1,3,Low-Value,Lost
7941,399,2,"36,0",4,1,1,6,Mid-Value,Potential Loyalists
7942,947,4,"266,9",3,1,1,5,Low-Value,At Risk Customers
7943,1130,4,"372,3",2,1,1,4,Low-Value,Can't Lose
7944,133,5,"395,04999999999995",5,1,1,7,Mid-Value,Potential Loyalists
7945,299,4,"362,05",5,1,1,7,Mid-Value,Potential Loyalists
7948,1505,2,"36,35",1,1,1,3,Low-Value,Lost
7949,505,7,"529,2",4,2,1,7,Mid-Value,Potential Loyalists
7950,809,3,"144,85",3,1,1,5,Low-Value,At Risk Customers
7951,744,8,"497,85",3,2,1,6,Mid-Value,Potential Loyalists
7952,276,7,"376,2",5,2,1,8,High-Value,Potential Loyalists
7953,824,1,"23,6",3,1,1,5,Low-Value,At Risk Customers
7955,46,9,"594,75",5,2,1,8,High-Value,Potential Loyalists
7956,193,3,"65,69",5,1,1,7,Mid-Value,Potential Loyalists
7958,1685,1,"76,3",1,1,1,3,Low-Value,Lost
7959,438,3,"68,5",4,1,1,6,Mid-Value,Potential Loyalists
7961,239,6,"223,95",5,1,1,7,Mid-Value,Potential Loyalists
7962,286,1,"53,6",5,1,1,7,Mid-Value,Potential Loyalists
7964,26,7,"243,05",5,2,1,8,High-Value,Potential Loyalists
7965,1776,1,"12,45",1,1,1,3,Low-Value,Lost
7966,799,4,"147,4",3,1,1,5,Low-Value,At Risk Customers
7968,175,1,"126,4",5,1,1,7,Mid-Value,Potential Loyalists
7969,1049,1,"69,8",3,1,1,5,Low-Value,At Risk Customers
7972,968,5,"271,05",3,1,1,5,Low-Value,At Risk Customers
7973,560,4,"202,2",4,1,1,6,Mid-Value,Potential Loyalists
7974,0,4,"542,0",5,1,1,7,Mid-Value,Potential Loyalists
7975,131,4,"260,8",5,1,1,7,Mid-Value,Potential Loyalists
7976,431,3,"116,15",4,1,1,6,Mid-Value,Potential Loyalists
7977,495,1,"32,8",4,1,1,6,Mid-Value,Potential Loyalists
7978,94,2,"17,0",5,1,1,7,Mid-Value,Potential Loyalists
7980,552,3,"173,75",4,1,1,6,Mid-Value,Potential Loyalists
7981,1451,1,"16,8",2,1,1,4,Low-Value,Can't Lose
7982,1166,1,"24,2",2,1,1,4,Low-Value,Can't Lose
7987,1612,2,"58,5",1,1,1,3,Low-Value,Lost
7991,416,1,"11,6",4,1,1,6,Mid-Value,Potential Loyalists
7994,149,5,"112,45",5,1,1,7,Mid-Value,Potential Loyalists
7996,81,3,"102,4",5,1,1,7,Mid-Value,Potential Loyalists
7998,174,5,"309,2",5,1,1,7,Mid-Value,Potential Loyalists
8002,1285,1,"50,3",2,1,1,4,Low-Value,Can't Lose
8004,838,4,"373,8",3,1,1,5,Low-Value,At Risk Customers
8005,520,3,"61,45",4,1,1,6,Mid-Value,Potential Loyalists
8006,593,3,"53,650000000000006",4,1,1,6,Mid-Value,Potential Loyalists
8008,256,4,"225,5",5,1,1,7,Mid-Value,Potential Loyalists
8011,1138,4,"120,7",2,1,1,4,Low-Value,Can't Lose
8012,82,4,"374,05",5,1,1,7,Mid-Value,Potential Loyalists
8013,26,3,"240,0",5,1,1,7,Mid-Value,Potential Loyalists
8014,923,1,"24,6",3,1,1,5,Low-Value,At Risk Customers
8015,250,3,"183,60000000000002",5,1,1,7,Mid-Value,Potential Loyalists
8017,927,1,"66,5",3,1,1,5,Low-Value,At Risk Customers
8018,227,9,"1033,1",5,2,2,9,High-Value,Champions
8020,1581,2,"41,15",1,1,1,3,Low-Value,Lost
8021,731,2,"375,5",3,1,1,5,Low-Value,At Risk Customers
8024,609,2,"51,45",4,1,1,6,Mid-Value,Potential Loyalists
8025,923,3,"37,6",3,1,1,5,Low-Value,At Risk Customers
8026,367,5,"396,55",4,1,1,6,Mid-Value,Potential Loyalists
8027,956,2,"42,400000000000006",3,1,1,5,Low-Value,At Risk Customers
8028,788,5,"211,0",3,1,1,5,Low-Value,At Risk Customers
8029,885,2,"328,9",3,1,1,5,Low-Value,At Risk Customers
8034,10,3,"88,30000000000001",5,1,1,7,Mid-Value,Potential Loyalists
8035,94,4,"354,95",5,1,1,7,Mid-Value,Potential Loyalists
8036,789,6,"244,1",3,1,1,5,Low-Value,At Risk Customers
8037,588,3,"504,09999999999997",4,1,1,6,Mid-Value,Potential Loyalists
8038,709,1,"30,65",4,1,1,6,Mid-Value,Potential Loyalists
8039,973,2,"25,450000000000003",3,1,1,5,Low-Value,At Risk Customers
8040,94,5,"218,4",5,1,1,7,Mid-Value,Potential Loyalists
8041,985,1,"377,9",3,1,1,5,Low-Value,At Risk Customers
8042,1431,2,"126,4",2,1,1,4,Low-Value,Can't Lose
8044,21,3,"58,5",5,1,1,7,Mid-Value,Potential Loyalists
8045,1190,2,"21,95",2,1,1,4,Low-Value,Can't Lose
8046,750,7,"568,45",3,2,1,6,Mid-Value,Potential Loyalists
8047,55,3,"67,2",5,1,1,7,Mid-Value,Potential Loyalists
8049,892,1,"93,3",3,1,1,5,Low-Value,At Risk Customers
8050,377,2,"97,30000000000001",4,1,1,6,Mid-Value,Potential Loyalists
8051,740,4,"317,79999999999995",3,1,1,5,Low-Value,At Risk Customers
8052,3,14,"1173,35",5,3,2,10,High-Value,Champions
8053,604,4,"128,54999999999998",4,1,1,6,Mid-Value,Potential Loyalists
8054,311,2,"70,0",5,1,1,7,Mid-Value,Potential Loyalists
8056,536,2,"121,60000000000001",4,1,1,6,Mid-Value,Potential Loyalists
8058,199,8,"243,75",5,2,1,8,High-Value,Potential Loyalists
8060,1205,2,"192,0",2,1,1,4,Low-Value,Can't Lose
8061,57,4,"250,10000000000002",5,1,1,7,Mid-Value,Potential Loyalists
8063,1462,3,"346,75",1,1,1,3,Low-Value,Lost
8065,1553,2,"17,1",1,1,1,3,Low-Value,Lost
8067,715,4,"361,0",4,1,1,6,Mid-Value,Potential Loyalists
8068,71,3,"211,6",5,1,1,7,Mid-Value,Potential Loyalists
8070,1469,2,"158,65",1,1,1,3,Low-Value,Lost
8071,258,4,"137,55",5,1,1,7,Mid-Value,Potential Loyalists
8072,231,1,"4,65",5,1,1,7,Mid-Value,Potential Loyalists
8073,891,3,"197,7",3,1,1,5,Low-Value,At Risk Customers
8075,99,1,"12,4",5,1,1,7,Mid-Value,Potential Loyalists
8077,378,11,"380,65",4,2,1,7,Mid-Value,Potential Loyalists
8079,138,7,"241,2",5,2,1,8,High-Value,Potential Loyalists
8080,171,3,"211,05",5,1,1,7,Mid-Value,Potential Loyalists
8081,389,2,"143,2",4,1,1,6,Mid-Value,Potential Loyalists
8083,779,3,"185,29999999999998",3,1,1,5,Low-Value,At Risk Customers
8085,92,8,"395,55",5,2,1,8,High-Value,Potential Loyalists
8086,869,1,"7,7",3,1,1,5,Low-Value,At Risk Customers
8087,573,4,"66,35000000000001",4,1,1,6,Mid-Value,Potential Loyalists
8090,38,4,"143,55",5,1,1,7,Mid-Value,Potential Loyalists
8091,69,5,"216,7",5,1,1,7,Mid-Value,Potential Loyalists
8092,330,2,"285,7",5,1,1,7,Mid-Value,Potential Loyalists
8093,528,4,"402,55",4,1,1,6,Mid-Value,Potential Loyalists
8094,498,5,"533,9",4,1,1,6,Mid-Value,Potential Loyalists
8095,1065,1,"19,2",3,1,1,5,Low-Value,At Risk Customers
8098,710,1,"11,75",4,1,1,6,Mid-Value,Potential Loyalists
8099,27,5,"312,0",5,1,1,7,Mid-Value,Potential Loyalists
8102,1362,1,"41,6",2,1,1,4,Low-Value,Can't Lose
8103,260,2,"67,35",5,1,1,7,Mid-Value,Potential Loyalists
8104,220,4,"193,5",5,1,1,7,Mid-Value,Potential Loyalists
8105,1,2,"46,25",5,1,1,7,Mid-Value,Potential Loyalists
8107,1489,1,"122,0",1,1,1,3,Low-Value,Lost
8109,429,2,"86,0",4,1,1,6,Mid-Value,Potential Loyalists
8110,1042,5,"291,1",3,1,1,5,Low-Value,At Risk Customers
8112,11,4,"131,85",5,1,1,7,Mid-Value,Potential Loyalists
8113,429,4,"274,75",4,1,1,6,Mid-Value,Potential Loyalists
8114,534,2,"89,30000000000001",4,1,1,6,Mid-Value,Potential Loyalists
8115,87,3,"160,89999999999998",5,1,1,7,Mid-Value,Potential Loyalists
8116,388,1,"66,5",4,1,1,6,Mid-Value,Potential Loyalists
8118,825,3,"47,85",3,1,1,5,Low-Value,At Risk Customers
8119,5,3,"289,65",5,1,1,7,Mid-Value,Potential Loyalists
8120,29,9,"463,3",5,2,1,8,High-Value,Potential Loyalists
8122,487,6,"396,45000000000005",4,1,1,6,Mid-Value,Potential Loyalists
8123,311,4,"153,0",5,1,1,7,Mid-Value,Potential Loyalists
8125,55,5,"286,2",5,1,1,7,Mid-Value,Potential Loyalists
8128,14,6,"288,5",5,1,1,7,Mid-Value,Potential Loyalists
8129,552,4,"353,2",4,1,1,6,Mid-Value,Potential Loyalists
8130,19,6,"582,0",5,1,1,7,Mid-Value,Potential Loyalists
8131,1225,1,"104,2",2,1,1,4,Low-Value,Can't Lose
8132,15,15,"1729,45",5,3,3,11,High-Value,Champions
8133,205,2,"188,35000000000002",5,1,1,7,Mid-Value,Potential Loyalists
8134,1166,3,"58,4",2,1,1,4,Low-Value,Can't Lose
8135,467,2,"44,8",4,1,1,6,Mid-Value,Potential Loyalists
8136,1351,5,"164,04999999999998",2,1,1,4,Low-Value,Can't Lose
8137,542,1,"66,0",4,1,1,6,Mid-Value,Potential Loyalists
8138,370,2,"317,19999999999993",4,1,1,6,Mid-Value,Potential Loyalists
8139,44,2,"57,0",5,1,1,7,Mid-Value,Potential Loyalists
8140,1746,1,"92,4",1,1,1,3,Low-Value,Lost
8145,960,1,"50,849999999999994",3,1,1,5,Low-Value,At Risk Customers
8147,210,2,"256,3",5,1,1,7,Mid-Value,Potential Loyalists
8148,507,1,"57,3",4,1,1,6,Mid-Value,Potential Loyalists
8149,732,3,"369,3",3,1,1,5,Low-Value,At Risk Customers
8150,24,5,"464,50000000000006",5,1,1,7,Mid-Value,Potential Loyalists
8152,882,5,"207,1",3,1,1,5,Low-Value,At Risk Customers
8153,349,2,"87,3",5,1,1,7,Mid-Value,Potential Loyalists
8155,53,10,"273,05",5,2,1,8,High-Value,Potential Loyalists
8156,1257,2,"188,25",2,1,1,4,Low-Value,Can't Lose
8159,147,3,"146,2",5,1,1,7,Mid-Value,Potential Loyalists
8160,246,4,"210,29999999999998",5,1,1,7,Mid-Value,Potential Loyalists
8161,130,3,"220,0",5,1,1,7,Mid-Value,Potential Loyalists
8162,564,1,"19,35",4,1,1,6,Mid-Value,Potential Loyalists
8164,1268,1,"130,35000000000002",2,1,1,4,Low-Value,Can't Lose
8166,564,2,"182,65",4,1,1,6,Mid-Value,Potential Loyalists
8167,147,4,"114,0",5,1,1,7,Mid-Value,Potential Loyalists
8169,124,5,"669,55",5,1,2,8,High-Value,Potential Loyalists
8170,801,1,"96,8",3,1,1,5,Low-Value,At Risk Customers
8171,742,10,"728,5",3,2,2,7,Mid-Value,Potential Loyalists
8174,453,6,"231,65",4,1,1,6,Mid-Value,Potential Loyalists
8177,528,5,"219,35",4,1,1,6,Mid-Value,Potential Loyalists
8178,506,3,"87,75",4,1,1,6,Mid-Value,Potential Loyalists
8179,293,3,"521,1999999999999",5,1,1,7,Mid-Value,Potential Loyalists
8181,775,1,"9,25",3,1,1,5,Low-Value,At Risk Customers
8182,566,1,"117,8",4,1,1,6,Mid-Value,Potential Loyalists
8184,1667,1,"204,9",1,1,1,3,Low-Value,Lost
8185,47,3,"613,4",5,1,1,7,Mid-Value,Potential Loyalists
8186,49,3,"155,35",5,1,1,7,Mid-Value,Potential Loyalists
8187,473,7,"279,15000000000003",4,2,1,7,Mid-Value,Potential Loyalists
8189,101,9,"574,4",5,2,1,8,High-Value,Potential Loyalists
8191,98,3,"114,25",5,1,1,7,Mid-Value,Potential Loyalists
8192,32,10,"456,85",5,2,1,8,High-Value,Potential Loyalists
8198,58,5,"433,1",5,1,1,7,Mid-Value,Potential Loyalists
8199,605,4,"144,95",4,1,1,6,Mid-Value,Potential Loyalists
8202,1650,1,"829,75",1,1,2,4,Low-Value,Can't Lose
8204,514,5,"277,55",4,1,1,6,Mid-Value,Potential Loyalists
8205,753,2,"95,35",3,1,1,5,Low-Value,At Risk Customers
8207,766,2,"81,2",3,1,1,5,Low-Value,At Risk Customers
8208,36,5,"213,3",5,1,1,7,Mid-Value,Potential Loyalists
8209,626,3,"382,2",4,1,1,6,Mid-Value,Potential Loyalists
8211,938,1,"22,8",3,1,1,5,Low-Value,At Risk Customers
8212,522,2,"223,29999999999998",4,1,1,6,Mid-Value,Potential Loyalists
8213,132,4,"772,8499999999999",5,1,2,8,High-Value,Potential Loyalists
8214,972,2,"63,9",3,1,1,5,Low-Value,At Risk Customers
8222,617,2,"138,1",4,1,1,6,Mid-Value,Potential Loyalists
8225,161,5,"406,09999999999997",5,1,1,7,Mid-Value,Potential Loyalists
8226,819,2,"31,05",3,1,1,5,Low-Value,At Risk Customers
8228,530,3,"387,1",4,1,1,6,Mid-Value,Potential Loyalists
8230,22,7,"230,95000000000002",5,2,1,8,High-Value,Potential Loyalists
8232,788,2,"45,449999999999996",3,1,1,5,Low-Value,At Risk Customers
8234,1123,1,"86,25",2,1,1,4,Low-Value,Can't Lose
8236,29,6,"247,45",5,1,1,7,Mid-Value,Potential Loyalists
8237,767,5,"311,9",3,1,1,5,Low-Value,At Risk Customers
8241,571,1,"43,7",4,1,1,6,Mid-Value,Potential Loyalists
8244,454,2,"90,4",4,1,1,6,Mid-Value,Potential Loyalists
8246,374,2,"86,45",4,1,1,6,Mid-Value,Potential Loyalists
8247,387,2,"201,64999999999998",4,1,1,6,Mid-Value,Potential Loyalists
8248,45,8,"532,95",5,2,1,8,High-Value,Potential Loyalists
8250,591,2,"97,9",4,1,1,6,Mid-Value,Potential Loyalists
8253,1624,2,"190,60000000000002",1,1,1,3,Low-Value,Lost
8254,122,5,"198,8",5,1,1,7,Mid-Value,Potential Loyalists
8256,1466,2,"165,54999999999998",1,1,1,3,Low-Value,Lost
8257,1254,1,"43,349999999999994",2,1,1,4,Low-Value,Can't Lose
8258,453,2,"138,85",4,1,1,6,Mid-Value,Potential Loyalists
8259,1492,2,"51,25",1,1,1,3,Low-Value,Lost
8260,237,5,"333,6",5,1,1,7,Mid-Value,Potential Loyalists
8263,188,2,"55,65",5,1,1,7,Mid-Value,Potential Loyalists
8264,32,8,"369,79999999999995",5,2,1,8,High-Value,Potential Loyalists
8265,27,3,"224,95",5,1,1,7,Mid-Value,Potential Loyalists
8266,955,1,"122,8",3,1,1,5,Low-Value,At Risk Customers
8269,960,2,"136,35000000000002",3,1,1,5,Low-Value,At Risk Customers
8270,1047,2,"29,75",3,1,1,5,Low-Value,At Risk Customers
8272,148,6,"448,2",5,1,1,7,Mid-Value,Potential Loyalists
8274,1,7,"474,4",5,2,1,8,High-Value,Potential Loyalists
8276,266,5,"254,5",5,1,1,7,Mid-Value,Potential Loyalists
8280,418,2,"44,7",4,1,1,6,Mid-Value,Potential Loyalists
8282,1316,2,"261,65",2,1,1,4,Low-Value,Can't Lose
8287,386,7,"370,05",4,2,1,7,Mid-Value,Potential Loyalists
8289,276,2,"39,15",5,1,1,7,Mid-Value,Potential Loyalists
8290,21,2,"154,2",5,1,1,7,Mid-Value,Potential Loyalists
8291,242,6,"413,34999999999997",5,1,1,7,Mid-Value,Potential Loyalists
8292,119,3,"83,6",5,1,1,7,Mid-Value,Potential Loyalists
8294,927,3,"240,10000000000002",3,1,1,5,Low-Value,At Risk Customers
8295,86,7,"218,6",5,2,1,8,High-Value,Potential Loyalists
8296,227,3,"96,5",5,1,1,7,Mid-Value,Potential Loyalists
8297,766,3,"75,25",3,1,1,5,Low-Value,At Risk Customers
8298,307,7,"245,95",5,2,1,8,High-Value,Potential Loyalists
8299,683,4,"140,2",4,1,1,6,Mid-Value,Potential Loyalists
8301,202,4,"71,94999999999999",5,1,1,7,Mid-Value,Potential Loyalists
8303,128,2,"66,5",5,1,1,7,Mid-Value,Potential Loyalists
8305,398,2,"17,55",4,1,1,6,Mid-Value,Potential Loyalists
8307,1457,1,"17,8",2,1,1,4,Low-Value,Can't Lose
8308,641,1,"18,1",4,1,1,6,Mid-Value,Potential Loyalists
8309,581,3,"88,5",4,1,1,6,Mid-Value,Potential Loyalists
8310,455,6,"271,25",4,1,1,6,Mid-Value,Potential Loyalists
8312,157,2,"341,5",5,1,1,7,Mid-Value,Potential Loyalists
8314,511,4,"360,7",4,1,1,6,Mid-Value,Potential Loyalists
8317,415,2,"260,0",4,1,1,6,Mid-Value,Potential Loyalists
8318,1556,1,"103,95",1,1,1,3,Low-Value,Lost
8320,1450,1,"53,0",2,1,1,4,Low-Value,Can't Lose
8321,1098,1,"60,5",2,1,1,4,Low-Value,Can't Lose
8322,399,5,"123,4",4,1,1,6,Mid-Value,Potential Loyalists
8326,18,7,"443,7",5,2,1,8,High-Value,Potential Loyalists
8327,615,3,"114,55",4,1,1,6,Mid-Value,Potential Loyalists
8328,580,4,"255,84999999999997",4,1,1,6,Mid-Value,Potential Loyalists
8329,14,8,"686,8",5,2,2,9,High-Value,Champions
8330,513,5,"245,85",4,1,1,6,Mid-Value,Potential Loyalists
8332,143,5,"403,95000000000005",5,1,1,7,Mid-Value,Potential Loyalists
8333,910,2,"21,3",3,1,1,5,Low-Value,At Risk Customers
8334,343,2,"71,75",5,1,1,7,Mid-Value,Potential Loyalists
8335,69,3,"217,2",5,1,1,7,Mid-Value,Potential Loyalists
8336,138,11,"569,6",5,2,1,8,High-Value,Potential Loyalists
8337,428,1,"33,95",4,1,1,6,Mid-Value,Potential Loyalists
8338,497,7,"400,5",4,2,1,7,Mid-Value,Potential Loyalists
8340,10,6,"387,84999999999997",5,1,1,7,Mid-Value,Potential Loyalists
8341,669,3,"678,0",4,1,2,7,Mid-Value,Potential Loyalists
8342,711,3,"158,2",4,1,1,6,Mid-Value,Potential Loyalists
8343,817,1,"18,2",3,1,1,5,Low-Value,At Risk Customers
8344,758,2,"98,19999999999999",3,1,1,5,Low-Value,At Risk Customers
8345,46,3,"64,7",5,1,1,7,Mid-Value,Potential Loyalists
8347,146,6,"327,65",5,1,1,7,Mid-Value,Potential Loyalists
8348,307,1,"28,35",5,1,1,7,Mid-Value,Potential Loyalists
8349,1506,1,"19,8",1,1,1,3,Low-Value,Lost
8352,60,10,"602,85",5,2,1,8,High-Value,Potential Loyalists
8353,17,2,"102,8",5,1,1,7,Mid-Value,Potential Loyalists
8354,1719,1,"47,05",1,1,1,3,Low-Value,Lost
8355,815,3,"400,9",3,1,1,5,Low-Value,At Risk Customers
8356,15,5,"355,25",5,1,1,7,Mid-Value,Potential Loyalists
8357,503,8,"477,15",4,2,1,7,Mid-Value,Potential Loyalists
8358,374,3,"342,45",4,1,1,6,Mid-Value,Potential Loyalists
8361,941,4,"36,15",3,1,1,5,Low-Value,At Risk Customers
8362,82,9,"608,6999999999999",5,2,1,8,High-Value,Potential Loyalists
8363,735,1,"51,8",3,1,1,5,Low-Value,At Risk Customers
8365,48,2,"133,35",5,1,1,7,Mid-Value,Potential Loyalists
8367,38,4,"119,0",5,1,1,7,Mid-Value,Potential Loyalists
8368,691,5,"192,04999999999998",4,1,1,6,Mid-Value,Potential Loyalists
8370,1812,1,"9,1",1,1,1,3,Low-Value,Lost
8371,291,3,"168,60000000000002",5,1,1,7,Mid-Value,Potential Loyalists
8373,513,3,"242,1",4,1,1,6,Mid-Value,Potential Loyalists
8374,539,1,"465,4",4,1,1,6,Mid-Value,Potential Loyalists
8375,221,5,"67,7",5,1,1,7,Mid-Value,Potential Loyalists
8376,778,5,"205,3",3,1,1,5,Low-Value,At Risk Customers
8377,400,3,"158,3",4,1,1,6,Mid-Value,Potential Loyalists
8378,528,2,"37,4",4,1,1,6,Mid-Value,Potential Loyalists
8379,925,1,"25,799999999999997",3,1,1,5,Low-Value,At Risk Customers
8381,21,1,"11,5",5,1,1,7,Mid-Value,Potential Loyalists
8382,603,1,"77,8",4,1,1,6,Mid-Value,Potential Loyalists
8384,796,5,"234,1",3,1,1,5,Low-Value,At Risk Customers
8385,553,2,"525,55",4,1,1,6,Mid-Value,Potential Loyalists
8387,808,2,"151,75",3,1,1,5,Low-Value,At Risk Customers
8390,1001,4,"196,1",3,1,1,5,Low-Value,At Risk Customers
8391,307,3,"239,5",5,1,1,7,Mid-Value,Potential Loyalists
8393,577,3,"168,14999999999998",4,1,1,6,Mid-Value,Potential Loyalists
8394,1110,3,"145,39999999999998",2,1,1,4,Low-Value,Can't Lose
8396,1309,3,"47,25",2,1,1,4,Low-Value,Can't Lose
8397,951,4,"188,05",3,1,1,5,Low-Value,At Risk Customers
8398,843,3,"101,3",3,1,1,5,Low-Value,At Risk Customers
8399,693,7,"333,15000000000003",4,2,1,7,Mid-Value,Potential Loyalists
8401,1306,1,"114,1",2,1,1,4,Low-Value,Can't Lose
8402,178,5,"301,1",5,1,1,7,Mid-Value,Potential Loyalists
8404,129,3,"72,25",5,1,1,7,Mid-Value,Potential Loyalists
8405,1451,1,"9,5",2,1,1,4,Low-Value,Can't Lose
8406,979,4,"118,0",3,1,1,5,Low-Value,At Risk Customers
8408,250,6,"239,14999999999998",5,1,1,7,Mid-Value,Potential Loyalists
8409,1752,1,"17,0",1,1,1,3,Low-Value,Lost
8412,43,3,"136,7",5,1,1,7,Mid-Value,Potential Loyalists
8415,1765,1,"27,9",1,1,1,3,Low-Value,Lost
8416,43,3,"27,6",5,1,1,7,Mid-Value,Potential Loyalists
8417,976,1,"89,6",3,1,1,5,Low-Value,At Risk Customers
8419,210,8,"726,85",5,2,2,9,High-Value,Champions
8420,312,1,"12,1",5,1,1,7,Mid-Value,Potential Loyalists
8421,95,3,"92,95",5,1,1,7,Mid-Value,Potential Loyalists
8424,696,3,"96,25",4,1,1,6,Mid-Value,Potential Loyalists
8426,855,5,"218,9",3,1,1,5,Low-Value,At Risk Customers
8428,714,1,"11,95",4,1,1,6,Mid-Value,Potential Loyalists
8429,204,9,"681,5",5,2,2,9,High-Value,Champions
8430,365,1,"100,8",5,1,1,7,Mid-Value,Potential Loyalists
8431,679,1,"124,05",4,1,1,6,Mid-Value,Potential Loyalists
8433,540,2,"67,05",4,1,1,6,Mid-Value,Potential Loyalists
8434,1323,2,"68,19999999999999",2,1,1,4,Low-Value,Can't Lose
8435,126,4,"278,3",5,1,1,7,Mid-Value,Potential Loyalists
8436,1705,1,"63,9",1,1,1,3,Low-Value,Lost
8437,480,1,"49,3",4,1,1,6,Mid-Value,Potential Loyalists
8440,1289,1,"84,3",2,1,1,4,Low-Value,Can't Lose
8441,157,1,"177,75",5,1,1,7,Mid-Value,Potential Loyalists
8443,490,4,"110,25",4,1,1,6,Mid-Value,Potential Loyalists
8444,153,1,"34,4",5,1,1,7,Mid-Value,Potential Loyalists
8445,279,1,"48,1",5,1,1,7,Mid-Value,Potential Loyalists
8446,497,8,"424,7",4,2,1,7,Mid-Value,Potential Loyalists
8447,1331,1,"41,4",2,1,1,4,Low-Value,Can't Lose
8450,1348,1,"37,8",2,1,1,4,Low-Value,Can't Lose
8451,550,3,"57,699999999999996",4,1,1,6,Mid-Value,Potential Loyalists
8452,600,2,"217,10000000000002",4,1,1,6,Mid-Value,Potential Loyalists
8453,932,3,"258,1",3,1,1,5,Low-Value,At Risk Customers
8454,1375,1,"281,5",2,1,1,4,Low-Value,Can't Lose
8456,557,2,"118,55",4,1,1,6,Mid-Value,Potential Loyalists
8457,32,10,"633,4",5,2,1,8,High-Value,Potential Loyalists
8459,424,5,"333,6",4,1,1,6,Mid-Value,Potential Loyalists
8460,18,11,"615,9",5,2,1,8,High-Value,Potential Loyalists
8461,501,3,"477,5",4,1,1,6,Mid-Value,Potential Loyalists
8464,173,4,"617,55",5,1,1,7,Mid-Value,Potential Loyalists
8465,386,7,"186,55",4,2,1,7,Mid-Value,Potential Loyalists
8466,415,1,"5,9",4,1,1,6,Mid-Value,Potential Loyalists
8467,173,5,"420,15000000000003",5,1,1,7,Mid-Value,Potential Loyalists
8473,536,1,"39,5",4,1,1,6,Mid-Value,Potential Loyalists
8474,361,3,"76,19999999999999",5,1,1,7,Mid-Value,Potential Loyalists
8475,1133,1,"16,2",2,1,1,4,Low-Value,Can't Lose
8477,256,2,"33,2",5,1,1,7,Mid-Value,Potential Loyalists
8479,21,2,"33,900000000000006",5,1,1,7,Mid-Value,Potential Loyalists
8480,1298,1,"109,7",2,1,1,4,Low-Value,Can't Lose
8482,55,2,"218,25",5,1,1,7,Mid-Value,Potential Loyalists
8484,199,1,"130,2",5,1,1,7,Mid-Value,Potential Loyalists
8485,78,8,"358,6",5,2,1,8,High-Value,Potential Loyalists
8486,447,3,"290,23",4,1,1,6,Mid-Value,Potential Loyalists
8488,493,4,"360,9",4,1,1,6,Mid-Value,Potential Loyalists
8489,8,13,"1100,5",5,3,2,10,High-Value,Champions
8490,1473,4,"859,1",1,1,2,4,Low-Value,Can't Lose
8491,1168,4,"200,4",2,1,1,4,Low-Value,Can't Lose
8492,27,4,"163,35000000000002",5,1,1,7,Mid-Value,Potential Loyalists
8494,1521,2,"109,65",1,1,1,3,Low-Value,Lost
8495,733,5,"371,7",3,1,1,5,Low-Value,At Risk Customers
8496,1125,3,"489,54999999999995",2,1,1,4,Low-Value,Can't Lose
8497,1480,2,"162,49999999999997",1,1,1,3,Low-Value,Lost
8498,32,1,"38,5",5,1,1,7,Mid-Value,Potential Loyalists
8499,1085,2,"237,29999999999998",3,1,1,5,Low-Value,At Risk Customers
8500,30,6,"633,15",5,1,1,7,Mid-Value,Potential Loyalists
8501,574,1,"103,4",4,1,1,6,Mid-Value,Potential Loyalists
8502,82,3,"145,5",5,1,1,7,Mid-Value,Potential Loyalists
8504,1130,2,"119,65",2,1,1,4,Low-Value,Can't Lose
8506,905,3,"215,25",3,1,1,5,Low-Value,At Risk Customers
8507,557,3,"197,15000000000003",4,1,1,6,Mid-Value,Potential Loyalists
8508,83,2,"126,65",5,1,1,7,Mid-Value,Potential Loyalists
8509,575,6,"394,1",4,1,1,6,Mid-Value,Potential Loyalists
8511,354,1,"50,6",5,1,1,7,Mid-Value,Potential Loyalists
8512,843,2,"60,3",3,1,1,5,Low-Value,At Risk Customers
8513,525,3,"213,5",4,1,1,6,Mid-Value,Potential Loyalists
8514,551,2,"126,25",4,1,1,6,Mid-Value,Potential Loyalists
8515,155,4,"347,1",5,1,1,7,Mid-Value,Potential Loyalists
8516,299,5,"369,45",5,1,1,7,Mid-Value,Potential Loyalists
8518,454,1,"85,35",4,1,1,6,Mid-Value,Potential Loyalists
8519,145,7,"368,0",5,2,1,8,High-Value,Potential Loyalists
8521,202,2,"173,2",5,1,1,7,Mid-Value,Potential Loyalists
8522,786,1,"16,6",3,1,1,5,Low-Value,At Risk Customers
8524,484,7,"694,7",4,2,2,8,High-Value,Potential Loyalists
8525,1659,1,"115,6",1,1,1,3,Low-Value,Lost
8526,1513,1,"12,8",1,1,1,3,Low-Value,Lost
8528,105,2,"88,85",5,1,1,7,Mid-Value,Potential Loyalists
8529,238,2,"268,75",5,1,1,7,Mid-Value,Potential Loyalists
8530,103,3,"434,34999999999997",5,1,1,7,Mid-Value,Potential Loyalists
8531,1266,1,"25,200000000000003",2,1,1,4,Low-Value,Can't Lose
8532,221,3,"155,75",5,1,1,7,Mid-Value,Potential Loyalists
8534,21,3,"88,69999999999999",5,1,1,7,Mid-Value,Potential Loyalists
8535,1746,1,"20,6",1,1,1,3,Low-Value,Lost
8536,49,2,"13,55",5,1,1,7,Mid-Value,Potential Loyalists
8537,987,2,"221,8",3,1,1,5,Low-Value,At Risk Customers
8538,1033,1,"84,0",3,1,1,5,Low-Value,At Risk Customers
8539,125,6,"303,3",5,1,1,7,Mid-Value,Potential Loyalists
8540,1156,3,"191,60000000000002",2,1,1,4,Low-Value,Can't Lose
8541,920,2,"594,3499999999999",3,1,1,5,Low-Value,At Risk Customers
8542,242,2,"37,25",5,1,1,7,Mid-Value,Potential Loyalists
8543,750,2,"61,3",3,1,1,5,Low-Value,At Risk Customers
8544,270,8,"726,0",5,2,2,9,High-Value,Champions
8545,67,8,"223,64999999999998",5,2,1,8,High-Value,Potential Loyalists
8546,1665,2,"112,95",1,1,1,3,Low-Value,Lost
8547,19,5,"211,35000000000002",5,1,1,7,Mid-Value,Potential Loyalists
8549,313,4,"187,15",5,1,1,7,Mid-Value,Potential Loyalists
8552,115,1,"28,9",5,1,1,7,Mid-Value,Potential Loyalists
8553,274,8,"404,6",5,2,1,8,High-Value,Potential Loyalists
8554,488,6,"734,4",4,1,2,7,Mid-Value,Potential Loyalists
8555,1011,1,"8,05",3,1,1,5,Low-Value,At Risk Customers
8556,276,3,"426,6",5,1,1,7,Mid-Value,Potential Loyalists
8558,487,3,"70,5",4,1,1,6,Mid-Value,Potential Loyalists
8559,107,2,"56,15",5,1,1,7,Mid-Value,Potential Loyalists
8560,980,1,"13,5",3,1,1,5,Low-Value,At Risk Customers
8562,523,2,"38,6",4,1,1,6,Mid-Value,Potential Loyalists
8563,732,4,"401,75",3,1,1,5,Low-Value,At Risk Customers
8564,785,2,"69,25",3,1,1,5,Low-Value,At Risk Customers
8567,1052,1,"18,45",3,1,1,5,Low-Value,At Risk Customers
8568,509,5,"368,9",4,1,1,6,Mid-Value,Potential Loyalists
8569,1100,3,"120,55000000000001",2,1,1,4,Low-Value,Can't Lose
8571,487,2,"321,35",4,1,1,6,Mid-Value,Potential Loyalists
8573,549,2,"450,59999999999997",4,1,1,6,Mid-Value,Potential Loyalists
8576,915,3,"227,75",3,1,1,5,Low-Value,At Risk Customers
8578,298,1,"45,5",5,1,1,7,Mid-Value,Potential Loyalists
8580,948,2,"158,25",3,1,1,5,Low-Value,At Risk Customers
8581,829,2,"148,55",3,1,1,5,Low-Value,At Risk Customers
8586,15,5,"269,95",5,1,1,7,Mid-Value,Potential Loyalists
8590,529,2,"216,65",4,1,1,6,Mid-Value,Potential Loyalists
8591,251,2,"130,5",5,1,1,7,Mid-Value,Potential Loyalists
8592,278,3,"160,15",5,1,1,7,Mid-Value,Potential Loyalists
8596,1394,1,"18,3",2,1,1,4,Low-Value,Can't Lose
8597,730,3,"235,54999999999995",4,1,1,6,Mid-Value,Potential Loyalists
8601,898,3,"258,29999999999995",3,1,1,5,Low-Value,At Risk Customers
8604,1285,2,"28,9",2,1,1,4,Low-Value,Can't Lose
8605,246,6,"307,0",5,1,1,7,Mid-Value,Potential Loyalists
8606,1160,2,"82,25",2,1,1,4,Low-Value,Can't Lose
8608,3,10,"725,0",5,2,2,9,High-Value,Champions
8609,1355,1,"50,05",2,1,1,4,Low-Value,Can't Lose
8612,247,1,"11,05",5,1,1,7,Mid-Value,Potential Loyalists
8613,8,4,"191,5",5,1,1,7,Mid-Value,Potential Loyalists
8615,78,7,"869,45",5,2,2,9,High-Value,Champions
8616,420,4,"850,65",4,1,2,7,Mid-Value,Potential Loyalists
8617,326,2,"31,75",5,1,1,7,Mid-Value,Potential Loyalists
8618,466,6,"342,5",4,1,1,6,Mid-Value,Potential Loyalists
8619,97,2,"96,10000000000001",5,1,1,7,Mid-Value,Potential Loyalists
8623,1481,5,"184,4",1,1,1,3,Low-Value,Lost
8624,152,3,"172,3",5,1,1,7,Mid-Value,Potential Loyalists
8626,209,3,"71,5",5,1,1,7,Mid-Value,Potential Loyalists
8628,600,2,"390,09999999999997",4,1,1,6,Mid-Value,Potential Loyalists
8629,377,3,"294,45000000000005",4,1,1,6,Mid-Value,Potential Loyalists
8631,136,1,"125,55000000000001",5,1,1,7,Mid-Value,Potential Loyalists
8632,546,2,"387,70000000000005",4,1,1,6,Mid-Value,Potential Loyalists
8633,832,1,"50,1",3,1,1,5,Low-Value,At Risk Customers
8634,379,1,"36,9",4,1,1,6,Mid-Value,Potential Loyalists
8636,414,6,"170,8",4,1,1,6,Mid-Value,Potential Loyalists
8637,35,5,"277,84999999999997",5,1,1,7,Mid-Value,Potential Loyalists
8638,17,16,"603,3000000000001",5,3,1,9,High-Value,Champions
8639,123,2,"237,2",5,1,1,7,Mid-Value,Potential Loyalists
8640,456,1,"15,65",4,1,1,6,Mid-Value,Potential Loyalists
8641,258,8,"923,95",5,2,2,9,High-Value,Champions
8642,332,5,"331,05",5,1,1,7,Mid-Value,Potential Loyalists
8643,586,3,"183,6",4,1,1,6,Mid-Value,Potential Loyalists
8644,752,4,"215,6",3,1,1,5,Low-Value,At Risk Customers
8645,869,1,"72,6",3,1,1,5,Low-Value,At Risk Customers
8647,1720,2,"217,1",1,1,1,3,Low-Value,Lost
8649,1466,1,"72,0",1,1,1,3,Low-Value,Lost
8650,11,17,"1054,75",5,4,2,11,High-Value,Champions
8652,144,4,"272,95",5,1,1,7,Mid-Value,Potential Loyalists
8654,151,3,"81,15",5,1,1,7,Mid-Value,Potential Loyalists
8655,136,6,"660,0",5,1,1,7,Mid-Value,Potential Loyalists
8656,116,1,"23,65",5,1,1,7,Mid-Value,Potential Loyalists
8658,1319,2,"42,35",2,1,1,4,Low-Value,Can't Lose
8661,341,3,"222,35000000000002",5,1,1,7,Mid-Value,Potential Loyalists
8662,267,3,"330,25",5,1,1,7,Mid-Value,Potential Loyalists
8664,397,4,"113,80000000000001",4,1,1,6,Mid-Value,Potential Loyalists
8665,1140,2,"724,9",2,1,2,5,Low-Value,At Risk Customers
8667,78,3,"135,05",5,1,1,7,Mid-Value,Potential Loyalists
8669,313,4,"272,85",5,1,1,7,Mid-Value,Potential Loyalists
8670,384,5,"272,5",4,1,1,6,Mid-Value,Potential Loyalists
8671,272,1,"10,55",5,1,1,7,Mid-Value,Potential Loyalists
8674,744,8,"675,5999999999999",3,2,2,7,Mid-Value,Potential Loyalists
8675,203,1,"28,9",5,1,1,7,Mid-Value,Potential Loyalists
8676,470,2,"29,299999999999997",4,1,1,6,Mid-Value,Potential Loyalists
8677,269,8,"645,2",5,2,1,8,High-Value,Potential Loyalists
8679,81,4,"209,4",5,1,1,7,Mid-Value,Potential Loyalists
8680,354,1,"33,1",5,1,1,7,Mid-Value,Potential Loyalists
8681,141,2,"266,05",5,1,1,7,Mid-Value,Potential Loyalists
8682,66,6,"486,8",5,1,1,7,Mid-Value,Potential Loyalists
8683,323,3,"153,9",5,1,1,7,Mid-Value,Potential Loyalists
8684,452,1,"8,8",4,1,1,6,Mid-Value,Potential Loyalists
8685,246,4,"166,8",5,1,1,7,Mid-Value,Potential Loyalists
8686,1750,1,"18,2",1,1,1,3,Low-Value,Lost
8688,1609,1,"113,9",1,1,1,3,Low-Value,Lost
8689,293,1,"8,8",5,1,1,7,Mid-Value,Potential Loyalists
8691,218,3,"789,8000000000001",5,1,2,8,High-Value,Potential Loyalists
8693,274,1,"54,8",5,1,1,7,Mid-Value,Potential Loyalists
8694,525,3,"102,85",4,1,1,6,Mid-Value,Potential Loyalists
8695,222,2,"57,75",5,1,1,7,Mid-Value,Potential Loyalists
8696,742,2,"158,85",3,1,1,5,Low-Value,At Risk Customers
8697,206,5,"90,55",5,1,1,7,Mid-Value,Potential Loyalists
8698,497,2,"105,69999999999999",4,1,1,6,Mid-Value,Potential Loyalists
8701,1575,1,"12,2",1,1,1,3,Low-Value,Lost
8702,1614,1,"154,0",1,1,1,3,Low-Value,Lost
8703,130,4,"632,4499999999999",5,1,1,7,Mid-Value,Potential Loyalists
8704,1455,1,"24,15",2,1,1,4,Low-Value,Can't Lose
8705,683,1,"4,35",4,1,1,6,Mid-Value,Potential Loyalists
8706,581,2,"25,950000000000003",4,1,1,6,Mid-Value,Potential Loyalists
8707,838,1,"19,1",3,1,1,5,Low-Value,At Risk Customers
8708,1214,3,"405,1000000000001",2,1,1,4,Low-Value,Can't Lose
8709,553,1,"111,5",4,1,1,6,Mid-Value,Potential Loyalists
8710,664,5,"110,9",4,1,1,6,Mid-Value,Potential Loyalists
8715,500,4,"372,34999999999997",4,1,1,6,Mid-Value,Potential Loyalists
8716,136,6,"251,29999999999998",5,1,1,7,Mid-Value,Potential Loyalists
8717,792,2,"114,1",3,1,1,5,Low-Value,At Risk Customers
8719,227,1,"96,9",5,1,1,7,Mid-Value,Potential Loyalists
8720,241,2,"130,25",5,1,1,7,Mid-Value,Potential Loyalists
8721,46,7,"342,1",5,2,1,8,High-Value,Potential Loyalists
8725,228,6,"379,4",5,1,1,7,Mid-Value,Potential Loyalists
8726,863,2,"130,9",3,1,1,5,Low-Value,At Risk Customers
8727,554,1,"47,400000000000006",4,1,1,6,Mid-Value,Potential Loyalists
8728,922,6,"325,55",3,1,1,5,Low-Value,At Risk Customers
8729,155,7,"360,15",5,2,1,8,High-Value,Potential Loyalists
8734,136,14,"1241,9",5,3,2,10,High-Value,Champions
8736,668,7,"316,7",4,2,1,7,Mid-Value,Potential Loyalists
8737,1449,1,"600,0",2,1,1,4,Low-Value,Can't Lose
8739,67,4,"85,9",5,1,1,7,Mid-Value,Potential Loyalists
8740,458,2,"87,0",4,1,1,6,Mid-Value,Potential Loyalists
8743,629,3,"93,85",4,1,1,6,Mid-Value,Potential Loyalists
8744,749,4,"234,15",3,1,1,5,Low-Value,At Risk Customers
8745,122,8,"586,15",5,2,1,8,High-Value,Potential Loyalists
8748,137,5,"444,35",5,1,1,7,Mid-Value,Potential Loyalists
8750,650,1,"13,9",4,1,1,6,Mid-Value,Potential Loyalists
8751,386,4,"199,15",4,1,1,6,Mid-Value,Potential Loyalists
8752,333,4,"522,55",5,1,1,7,Mid-Value,Potential Loyalists
8754,225,3,"91,0",5,1,1,7,Mid-Value,Potential Loyalists
8756,168,5,"614,3",5,1,1,7,Mid-Value,Potential Loyalists
8757,1292,1,"145,1",2,1,1,4,Low-Value,Can't Lose
8760,1092,1,"27,0",3,1,1,5,Low-Value,At Risk Customers
8761,555,1,"95,3",4,1,1,6,Mid-Value,Potential Loyalists
8762,144,4,"687,45",5,1,2,8,High-Value,Potential Loyalists
8763,592,1,"175,8",4,1,1,6,Mid-Value,Potential Loyalists
8765,80,4,"259,25",5,1,1,7,Mid-Value,Potential Loyalists
8767,75,6,"269,1",5,1,1,7,Mid-Value,Potential Loyalists
8768,847,3,"261,4",3,1,1,5,Low-Value,At Risk Customers
8769,1167,2,"44,3",2,1,1,4,Low-Value,Can't Lose
8770,3,3,"241,45",5,1,1,7,Mid-Value,Potential Loyalists
8771,399,15,"863,5",4,3,2,9,High-Value,Champions
8772,76,9,"223,25",5,2,1,8,High-Value,Potential Loyalists
8773,187,3,"549,55",5,1,1,7,Mid-Value,Potential Loyalists
8774,418,3,"107,65",4,1,1,6,Mid-Value,Potential Loyalists
8775,35,2,"52,3",5,1,1,7,Mid-Value,Potential Loyalists
8776,406,4,"237,95",4,1,1,6,Mid-Value,Potential Loyalists
8777,367,1,"38,2",4,1,1,6,Mid-Value,Potential Loyalists
8779,376,3,"196,35",4,1,1,6,Mid-Value,Potential Loyalists
8781,1584,2,"120,30000000000001",1,1,1,3,Low-Value,Lost
8782,437,8,"589,05",4,2,1,7,Mid-Value,Potential Loyalists
8783,53,6,"420,0",5,1,1,7,Mid-Value,Potential Loyalists
8784,74,4,"483,25",5,1,1,7,Mid-Value,Potential Loyalists
8786,386,3,"169,25",4,1,1,6,Mid-Value,Potential Loyalists
8787,480,4,"145,7",4,1,1,6,Mid-Value,Potential Loyalists
8788,333,7,"165,95",5,2,1,8,High-Value,Potential Loyalists
8789,1340,1,"23,45",2,1,1,4,Low-Value,Can't Lose
8792,876,1,"81,3",3,1,1,5,Low-Value,At Risk Customers
8794,780,4,"170,9",3,1,1,5,Low-Value,At Risk Customers
8795,127,2,"126,15",5,1,1,7,Mid-Value,Potential Loyalists
8796,551,2,"109,5",4,1,1,6,Mid-Value,Potential Loyalists
8798,146,3,"270,75",5,1,1,7,Mid-Value,Potential Loyalists
8799,1345,1,"71,6",2,1,1,4,Low-Value,Can't Lose
8801,1116,1,"125,0",2,1,1,4,Low-Value,Can't Lose
8802,546,4,"280,75",4,1,1,6,Mid-Value,Potential Loyalists
8804,374,1,"100,6",4,1,1,6,Mid-Value,Potential Loyalists
8805,329,4,"192,5",5,1,1,7,Mid-Value,Potential Loyalists
8808,441,5,"84,55",4,1,1,6,Mid-Value,Potential Loyalists
8809,247,6,"400,4",5,1,1,7,Mid-Value,Potential Loyalists
8812,928,2,"100,19999999999999",3,1,1,5,Low-Value,At Risk Customers
8815,791,2,"99,1",3,1,1,5,Low-Value,At Risk Customers
8816,266,6,"164,45",5,1,1,7,Mid-Value,Potential Loyalists
8818,381,6,"354,45000000000005",4,1,1,6,Mid-Value,Potential Loyalists
8819,552,2,"23,2",4,1,1,6,Mid-Value,Potential Loyalists
8820,398,9,"608,15",4,2,1,7,Mid-Value,Potential Loyalists
8821,177,9,"753,5",5,2,2,9,High-Value,Champions
8822,21,2,"75,69999999999999",5,1,1,7,Mid-Value,Potential Loyalists
8823,764,1,"49,6",3,1,1,5,Low-Value,At Risk Customers
8824,599,1,"35,3",4,1,1,6,Mid-Value,Potential Loyalists
8825,850,3,"270,59999999999997",3,1,1,5,Low-Value,At Risk Customers
8827,45,4,"102,6",5,1,1,7,Mid-Value,Potential Loyalists
8829,193,1,"41,3",5,1,1,7,Mid-Value,Potential Loyalists
8834,50,1,"12,9",5,1,1,7,Mid-Value,Potential Loyalists
8835,169,3,"85,45",5,1,1,7,Mid-Value,Potential Loyalists
8839,213,1,"51,75",5,1,1,7,Mid-Value,Potential Loyalists
8840,1,6,"348,55",5,1,1,7,Mid-Value,Potential Loyalists
8841,126,2,"392,80000000000007",5,1,1,7,Mid-Value,Potential Loyalists
8842,46,3,"101,8",5,1,1,7,Mid-Value,Potential Loyalists
8843,117,1,"12,5",5,1,1,7,Mid-Value,Potential Loyalists
8844,257,1,"526,0",5,1,1,7,Mid-Value,Potential Loyalists
8845,56,3,"28,25",5,1,1,7,Mid-Value,Potential Loyalists
8846,215,7,"595,5500000000001",5,2,1,8,High-Value,Potential Loyalists
8847,445,4,"110,25",4,1,1,6,Mid-Value,Potential Loyalists
8849,218,3,"145,0",5,1,1,7,Mid-Value,Potential Loyalists
8850,68,4,"380,4",5,1,1,7,Mid-Value,Potential Loyalists
8851,284,10,"482,5",5,2,1,8,High-Value,Potential Loyalists
8853,70,5,"103,25",5,1,1,7,Mid-Value,Potential Loyalists
8855,41,5,"145,82999999999998",5,1,1,7,Mid-Value,Potential Loyalists
8856,100,4,"389,94999999999993",5,1,1,7,Mid-Value,Potential Loyalists
8858,193,2,"294,0",5,1,1,7,Mid-Value,Potential Loyalists
8859,587,1,"21,05",4,1,1,6,Mid-Value,Potential Loyalists
8860,1815,1,"48,45",1,1,1,3,Low-Value,Lost
8862,1002,1,"45,45",3,1,1,5,Low-Value,At Risk Customers
8864,957,2,"75,15",3,1,1,5,Low-Value,At Risk Customers
8865,372,19,"1482,15",4,4,3,11,High-Value,Champions
8866,1089,2,"80,69999999999999",3,1,1,5,Low-Value,At Risk Customers
8867,1331,1,"71,55000000000001",2,1,1,4,Low-Value,Can't Lose
8868,409,7,"285,40000000000003",4,2,1,7,Mid-Value,Potential Loyalists
8869,785,5,"99,85000000000001",3,1,1,5,Low-Value,At Risk Customers
8870,511,2,"76,8",4,1,1,6,Mid-Value,Potential Loyalists
8871,367,10,"435,5",4,2,1,7,Mid-Value,Potential Loyalists
8873,332,3,"189,89999999999998",5,1,1,7,Mid-Value,Potential Loyalists
8874,479,2,"16,8",4,1,1,6,Mid-Value,Potential Loyalists
8876,11,1,"18,8",5,1,1,7,Mid-Value,Potential Loyalists
8878,949,2,"315,55",3,1,1,5,Low-Value,At Risk Customers
8879,568,3,"150,25",4,1,1,6,Mid-Value,Potential Loyalists
8880,123,2,"110,75",5,1,1,7,Mid-Value,Potential Loyalists
8881,876,2,"125,65",3,1,1,5,Low-Value,At Risk Customers
8882,98,3,"144,7",5,1,1,7,Mid-Value,Potential Loyalists
8884,846,7,"324,95",3,2,1,6,Mid-Value,Potential Loyalists
8887,663,5,"241,35000000000002",4,1,1,6,Mid-Value,Potential Loyalists
8891,0,7,"238,05",5,2,1,8,High-Value,Potential Loyalists
8892,97,5,"106,0",5,1,1,7,Mid-Value,Potential Loyalists
8893,722,2,"79,65",4,1,1,6,Mid-Value,Potential Loyalists
8894,711,2,"80,30000000000001",4,1,1,6,Mid-Value,Potential Loyalists
8896,767,4,"221,15",3,1,1,5,Low-Value,At Risk Customers
8897,1105,4,"144,79999999999998",2,1,1,4,Low-Value,Can't Lose
8898,1487,1,"16,2",1,1,1,3,Low-Value,Lost
8899,27,4,"97,9",5,1,1,7,Mid-Value,Potential Loyalists
8900,1012,4,"232,4",3,1,1,5,Low-Value,At Risk Customers
8902,1434,1,"5,9",2,1,1,4,Low-Value,Can't Lose
8903,892,1,"21,2",3,1,1,5,Low-Value,At Risk Customers
8904,648,1,"4,3",4,1,1,6,Mid-Value,Potential Loyalists
8906,5,9,"521,5",5,2,1,8,High-Value,Potential Loyalists
8909,251,6,"245,75",5,1,1,7,Mid-Value,Potential Loyalists
8910,424,3,"147,05",4,1,1,6,Mid-Value,Potential Loyalists
8911,202,1,"177,6",5,1,1,7,Mid-Value,Potential Loyalists
8912,391,5,"130,39999999999998",4,1,1,6,Mid-Value,Potential Loyalists
8913,369,5,"147,61",4,1,1,6,Mid-Value,Potential Loyalists
8914,719,1,"38,6",4,1,1,6,Mid-Value,Potential Loyalists
8915,489,3,"274,04999999999995",4,1,1,6,Mid-Value,Potential Loyalists
8916,119,4,"104,85",5,1,1,7,Mid-Value,Potential Loyalists
8917,393,3,"156,45",4,1,1,6,Mid-Value,Potential Loyalists
8918,1204,5,"446,86",2,1,1,4,Low-Value,Can't Lose
8919,1503,1,"225,60000000000002",1,1,1,3,Low-Value,Lost
8920,426,3,"111,54999999999998",4,1,1,6,Mid-Value,Potential Loyalists
8921,193,4,"106,0",5,1,1,7,Mid-Value,Potential Loyalists
8922,747,1,"39,9",3,1,1,5,Low-Value,At Risk Customers
8923,1125,3,"538,75",2,1,1,4,Low-Value,Can't Lose
8924,864,2,"53,9",3,1,1,5,Low-Value,At Risk Customers
8928,160,10,"281,7",5,2,1,8,High-Value,Potential Loyalists
8929,784,7,"378,25",3,2,1,6,Mid-Value,Potential Loyalists
8930,1425,2,"142,95",2,1,1,4,Low-Value,Can't Lose
8931,101,5,"382,05",5,1,1,7,Mid-Value,Potential Loyalists
8932,322,4,"386,35",5,1,1,7,Mid-Value,Potential Loyalists
8934,1461,2,"94,39999999999999",1,1,1,3,Low-Value,Lost
8936,63,3,"808,75",5,1,2,8,High-Value,Potential Loyalists
8937,88,3,"369,75",5,1,1,7,Mid-Value,Potential Loyalists
8938,17,1,"32,4",5,1,1,7,Mid-Value,Potential Loyalists
8939,635,3,"263,45",4,1,1,6,Mid-Value,Potential Loyalists
8942,68,5,"355,65",5,1,1,7,Mid-Value,Potential Loyalists
8944,1638,1,"86,85",1,1,1,3,Low-Value,Lost
8945,1692,1,"29,35",1,1,1,3,Low-Value,Lost
8949,183,3,"683,7",5,1,2,8,High-Value,Potential Loyalists
8951,967,1,"11,75",3,1,1,5,Low-Value,At Risk Customers
8954,1303,1,"30,7",2,1,1,4,Low-Value,Can't Lose
8955,391,1,"191,3",4,1,1,6,Mid-Value,Potential Loyalists
8956,1681,2,"280,45",1,1,1,3,Low-Value,Lost
8957,151,2,"47,349999999999994",5,1,1,7,Mid-Value,Potential Loyalists
8961,1308,1,"336,1",2,1,1,4,Low-Value,Can't Lose
8962,123,3,"209,10000000000002",5,1,1,7,Mid-Value,Potential Loyalists
8963,1284,1,"22,3",2,1,1,4,Low-Value,Can't Lose
8965,759,5,"767,9",3,1,2,6,Mid-Value,Potential Loyalists
8966,24,2,"368,0",5,1,1,7,Mid-Value,Potential Loyalists
8968,1809,1,"9,7",1,1,1,3,Low-Value,Lost
8969,92,5,"525,0",5,1,1,7,Mid-Value,Potential Loyalists
8970,453,1,"29,1",4,1,1,6,Mid-Value,Potential Loyalists
8971,217,6,"864,9",5,1,2,8,High-Value,Potential Loyalists
8974,378,1,"139,45",4,1,1,6,Mid-Value,Potential Loyalists
8975,801,2,"129,55",3,1,1,5,Low-Value,At Risk Customers
8977,585,2,"40,5",4,1,1,6,Mid-Value,Potential Loyalists
8978,21,3,"169,3",5,1,1,7,Mid-Value,Potential Loyalists
8979,10,5,"276,45",5,1,1,7,Mid-Value,Potential Loyalists
8980,551,4,"190,64999999999998",4,1,1,6,Mid-Value,Potential Loyalists
8982,339,4,"590,85",5,1,1,7,Mid-Value,Potential Loyalists
8983,1482,2,"158,9",1,1,1,3,Low-Value,Lost
8984,45,7,"205,7",5,2,1,8,High-Value,Potential Loyalists
8987,1370,1,"11,8",2,1,1,4,Low-Value,Can't Lose
8988,1261,1,"163,2",2,1,1,4,Low-Value,Can't Lose
8990,54,4,"189,25",5,1,1,7,Mid-Value,Potential Loyalists
8992,563,2,"41,7",4,1,1,6,Mid-Value,Potential Loyalists
8996,99,2,"268,1",5,1,1,7,Mid-Value,Potential Loyalists
8997,1402,1,"14,8",2,1,1,4,Low-Value,Can't Lose
8998,529,7,"627,5",4,2,1,7,Mid-Value,Potential Loyalists
8999,531,11,"732,5500000000001",4,2,2,8,High-Value,Potential Loyalists
9001,740,11,"1056,6",3,2,2,7,Mid-Value,Potential Loyalists
9002,238,5,"384,84999999999997",5,1,1,7,Mid-Value,Potential Loyalists
9003,323,1,"47,85",5,1,1,7,Mid-Value,Potential Loyalists
9006,1065,1,"60,05",3,1,1,5,Low-Value,At Risk Customers
9007,510,5,"219,6",4,1,1,6,Mid-Value,Potential Loyalists
9008,602,3,"45,15",4,1,1,6,Mid-Value,Potential Loyalists
9009,1042,1,"135,0",3,1,1,5,Low-Value,At Risk Customers
9010,372,4,"286,45",4,1,1,6,Mid-Value,Potential Loyalists
9013,3,12,"645,5",5,3,1,9,High-Value,Champions
9014,117,7,"242,2",5,2,1,8,High-Value,Potential Loyalists
9018,296,4,"609,65",5,1,1,7,Mid-Value,Potential Loyalists
9019,453,5,"238,15",4,1,1,6,Mid-Value,Potential Loyalists
9020,815,1,"26,0",3,1,1,5,Low-Value,At Risk Customers
9021,129,3,"251,1",5,1,1,7,Mid-Value,Potential Loyalists
9022,1033,2,"79,35",3,1,1,5,Low-Value,At Risk Customers
9025,339,1,"42,95",5,1,1,7,Mid-Value,Potential Loyalists
9026,521,1,"43,4",4,1,1,6,Mid-Value,Potential Loyalists
9027,965,2,"57,35",3,1,1,5,Low-Value,At Risk Customers
9030,189,6,"403,6",5,1,1,7,Mid-Value,Potential Loyalists
9031,214,5,"271,79999999999995",5,1,1,7,Mid-Value,Potential Loyalists
9032,1722,1,"22,8",1,1,1,3,Low-Value,Lost
9033,1151,1,"116,05",2,1,1,4,Low-Value,Can't Lose
9035,947,9,"326,45",3,2,1,6,Mid-Value,Potential Loyalists
9036,397,4,"80,58",4,1,1,6,Mid-Value,Potential Loyalists
9037,1238,1,"56,7",2,1,1,4,Low-Value,Can't Lose
9039,886,2,"151,5",3,1,1,5,Low-Value,At Risk Customers
9041,445,3,"233,9",4,1,1,6,Mid-Value,Potential Loyalists
9044,768,5,"199,4",3,1,1,5,Low-Value,At Risk Customers
9045,636,1,"80,45",4,1,1,6,Mid-Value,Potential Loyalists
9048,20,3,"277,0",5,1,1,7,Mid-Value,Potential Loyalists
9050,357,2,"86,8",5,1,1,7,Mid-Value,Potential Loyalists
9051,43,4,"186,39999999999998",5,1,1,7,Mid-Value,Potential Loyalists
9053,1275,4,"530,15",2,1,1,4,Low-Value,Can't Lose
9055,185,8,"264,9",5,2,1,8,High-Value,Potential Loyalists
9056,7,7,"651,35",5,2,1,8,High-Value,Potential Loyalists
9057,437,4,"168,5",4,1,1,6,Mid-Value,Potential Loyalists
9059,17,4,"293,75",5,1,1,7,Mid-Value,Potential Loyalists
9060,1631,3,"132,9",1,1,1,3,Low-Value,Lost
9061,368,4,"114,05",4,1,1,6,Mid-Value,Potential Loyalists
9065,1375,3,"99,0",2,1,1,4,Low-Value,Can't Lose
9066,780,2,"88,1",3,1,1,5,Low-Value,At Risk Customers
9068,637,2,"191,75",4,1,1,6,Mid-Value,Potential Loyalists
9070,767,5,"229,25",3,1,1,5,Low-Value,At Risk Customers
9071,163,3,"149,05",5,1,1,7,Mid-Value,Potential Loyalists
9073,180,6,"448,0",5,1,1,7,Mid-Value,Potential Loyalists
9074,1371,1,"18,35",2,1,1,4,Low-Value,Can't Lose
9075,704,1,"24,05",4,1,1,6,Mid-Value,Potential Loyalists
9076,159,4,"396,85",5,1,1,7,Mid-Value,Potential Loyalists
9077,137,1,"54,9",5,1,1,7,Mid-Value,Potential Loyalists
9078,143,4,"257,79999999999995",5,1,1,7,Mid-Value,Potential Loyalists
9079,1143,3,"157,0",2,1,1,4,Low-Value,Can't Lose
9080,19,3,"210,64999999999998",5,1,1,7,Mid-Value,Potential Loyalists
9081,512,4,"333,30000000000007",4,1,1,6,Mid-Value,Potential Loyalists
9082,1646,1,"41,3",1,1,1,3,Low-Value,Lost
9083,839,1,"40,75",3,1,1,5,Low-Value,At Risk Customers
9084,374,4,"79,35",4,1,1,6,Mid-Value,Potential Loyalists
9085,171,4,"47,2",5,1,1,7,Mid-Value,Potential Loyalists
9086,69,3,"124,6",5,1,1,7,Mid-Value,Potential Loyalists
9087,994,2,"194,7",3,1,1,5,Low-Value,At Risk Customers
9088,691,1,"58,6",4,1,1,6,Mid-Value,Potential Loyalists
9091,757,3,"293,75",3,1,1,5,Low-Value,At Risk Customers
9092,1314,1,"14,8",2,1,1,4,Low-Value,Can't Lose
9094,105,5,"278,75",5,1,1,7,Mid-Value,Potential Loyalists
9095,868,2,"58,599999999999994",3,1,1,5,Low-Value,At Risk Customers
9096,590,1,"98,35",4,1,1,6,Mid-Value,Potential Loyalists
9097,230,4,"400,5",5,1,1,7,Mid-Value,Potential Loyalists
9099,1042,1,"206,5",3,1,1,5,Low-Value,At Risk Customers
9100,705,1,"117,8",4,1,1,6,Mid-Value,Potential Loyalists
9102,408,3,"85,0",4,1,1,6,Mid-Value,Potential Loyalists
9103,1446,1,"20,1",2,1,1,4,Low-Value,Can't Lose
9104,555,3,"222,8",4,1,1,6,Mid-Value,Potential Loyalists
9107,220,1,"40,9",5,1,1,7,Mid-Value,Potential Loyalists
9108,155,2,"70,6",5,1,1,7,Mid-Value,Potential Loyalists
9110,833,4,"118,35",3,1,1,5,Low-Value,At Risk Customers
9113,864,4,"80,94999999999999",3,1,1,5,Low-Value,At Risk Customers
9115,10,4,"692,55",5,1,2,8,High-Value,Potential Loyalists
9116,796,3,"196,65",3,1,1,5,Low-Value,At Risk Customers
9119,1595,1,"152,6",1,1,1,3,Low-Value,Lost
9121,137,1,"84,0",5,1,1,7,Mid-Value,Potential Loyalists
9122,19,2,"136,7",5,1,1,7,Mid-Value,Potential Loyalists
9124,1740,1,"124,1",1,1,1,3,Low-Value,Lost
9126,33,2,"168,1",5,1,1,7,Mid-Value,Potential Loyalists
9128,103,1,"41,3",5,1,1,7,Mid-Value,Potential Loyalists
9129,413,1,"3,5",4,1,1,6,Mid-Value,Potential Loyalists
9130,327,7,"374,7",5,2,1,8,High-Value,Potential Loyalists
9131,83,13,"1723,3000000000002",5,3,3,11,High-Value,Champions
9134,1629,1,"270,0",1,1,1,3,Low-Value,Lost
9135,1,5,"332,3",5,1,1,7,Mid-Value,Potential Loyalists
9136,258,3,"391,54999999999995",5,1,1,7,Mid-Value,Potential Loyalists
9138,132,4,"406,8",5,1,1,7,Mid-Value,Potential Loyalists
9141,229,3,"81,8",5,1,1,7,Mid-Value,Potential Loyalists
9144,841,4,"366,25",3,1,1,5,Low-Value,At Risk Customers
9145,843,1,"80,2",3,1,1,5,Low-Value,At Risk Customers
9149,829,8,"691,45",3,2,2,7,Mid-Value,Potential Loyalists
9152,122,3,"228,05",5,1,1,7,Mid-Value,Potential Loyalists
9157,749,2,"103,8",3,1,1,5,Low-Value,At Risk Customers
9158,1113,1,"105,7",2,1,1,4,Low-Value,Can't Lose
9160,47,3,"130,65",5,1,1,7,Mid-Value,Potential Loyalists
9161,1133,2,"151,8",2,1,1,4,Low-Value,Can't Lose
9162,431,2,"126,0",4,1,1,6,Mid-Value,Potential Loyalists
9164,100,8,"480,79999999999995",5,2,1,8,High-Value,Potential Loyalists
9165,315,1,"46,65",5,1,1,7,Mid-Value,Potential Loyalists
9166,144,2,"156,25",5,1,1,7,Mid-Value,Potential Loyalists
9167,798,6,"269,3",3,1,1,5,Low-Value,At Risk Customers
9168,379,1,"26,0",4,1,1,6,Mid-Value,Potential Loyalists
9169,430,4,"130,3",4,1,1,6,Mid-Value,Potential Loyalists
9170,749,1,"106,6",3,1,1,5,Low-Value,At Risk Customers
9173,1106,2,"57,8",2,1,1,4,Low-Value,Can't Lose
9174,923,1,"8,25",3,1,1,5,Low-Value,At Risk Customers
9176,589,1,"47,05",4,1,1,6,Mid-Value,Potential Loyalists
9177,143,7,"372,1",5,2,1,8,High-Value,Potential Loyalists
9179,9,2,"74,5",5,1,1,7,Mid-Value,Potential Loyalists
9181,217,2,"60,5",5,1,1,7,Mid-Value,Potential Loyalists
9183,1046,2,"58,95",3,1,1,5,Low-Value,At Risk Customers
9184,1061,2,"77,85",3,1,1,5,Low-Value,At Risk Customers
9185,1805,1,"23,7",1,1,1,3,Low-Value,Lost
9186,407,6,"147,5",4,1,1,6,Mid-Value,Potential Loyalists
9187,134,2,"29,9",5,1,1,7,Mid-Value,Potential Loyalists
9188,392,3,"192,14999999999998",4,1,1,6,Mid-Value,Potential Loyalists
9189,777,5,"1158,65",3,1,2,6,Mid-Value,Potential Loyalists
9190,1295,1,"70,9",2,1,1,4,Low-Value,Can't Lose
9191,1031,3,"142,75",3,1,1,5,Low-Value,At Risk Customers
9193,1504,2,"23,0",1,1,1,3,Low-Value,Lost
9194,565,3,"371,2",4,1,1,6,Mid-Value,Potential Loyalists
9195,326,3,"236,7",5,1,1,7,Mid-Value,Potential Loyalists
9196,397,5,"151,26",4,1,1,6,Mid-Value,Potential Loyalists
9197,539,1,"2,7",4,1,1,6,Mid-Value,Potential Loyalists
9198,368,3,"343,8",4,1,1,6,Mid-Value,Potential Loyalists
9199,350,1,"10,0",5,1,1,7,Mid-Value,Potential Loyalists
9200,206,1,"398,0",5,1,1,7,Mid-Value,Potential Loyalists
9201,174,3,"718,85",5,1,2,8,High-Value,Potential Loyalists
9203,1134,1,"18,85",2,1,1,4,Low-Value,Can't Lose
9205,958,1,"34,9",3,1,1,5,Low-Value,At Risk Customers
9207,837,4,"126,75",3,1,1,5,Low-Value,At Risk Customers
9209,486,3,"739,1999999999999",4,1,2,7,Mid-Value,Potential Loyalists
9210,534,1,"22,7",4,1,1,6,Mid-Value,Potential Loyalists
9211,69,8,"408,2",5,2,1,8,High-Value,Potential Loyalists
9214,501,2,"139,45",4,1,1,6,Mid-Value,Potential Loyalists
9216,582,3,"108,2",4,1,1,6,Mid-Value,Potential Loyalists
9217,77,8,"764,2",5,2,2,9,High-Value,Champions
9218,357,1,"20,75",5,1,1,7,Mid-Value,Potential Loyalists
9219,43,4,"224,3",5,1,1,7,Mid-Value,Potential Loyalists
9220,596,1,"28,950000000000003",4,1,1,6,Mid-Value,Potential Loyalists
9221,868,4,"475,0",3,1,1,5,Low-Value,At Risk Customers
9225,1,3,"228,4",5,1,1,7,Mid-Value,Potential Loyalists
9226,684,1,"30,05",4,1,1,6,Mid-Value,Potential Loyalists
9227,229,11,"411,65000000000003",5,2,1,8,High-Value,Potential Loyalists
9228,1548,1,"16,75",1,1,1,3,Low-Value,Lost
9231,727,1,"12,3",4,1,1,6,Mid-Value,Potential Loyalists
9234,1118,2,"471,15",2,1,1,4,Low-Value,Can't Lose
9235,70,2,"230,7",5,1,1,7,Mid-Value,Potential Loyalists
9236,251,1,"41,849999999999994",5,1,1,7,Mid-Value,Potential Loyalists
9238,143,4,"218,4",5,1,1,7,Mid-Value,Potential Loyalists
9240,1598,1,"11,6",1,1,1,3,Low-Value,Lost
9241,776,2,"42,1",3,1,1,5,Low-Value,At Risk Customers
9242,728,8,"214,45",4,2,1,7,Mid-Value,Potential Loyalists
9243,137,2,"33,8",5,1,1,7,Mid-Value,Potential Loyalists
9244,187,2,"157,5",5,1,1,7,Mid-Value,Potential Loyalists
9245,19,2,"43,8",5,1,1,7,Mid-Value,Potential Loyalists
9248,90,11,"483,95",5,2,1,8,High-Value,Potential Loyalists
9249,644,4,"261,55",4,1,1,6,Mid-Value,Potential Loyalists
9250,1285,2,"44,849999999999994",2,1,1,4,Low-Value,Can't Lose
9251,547,1,"37,9",4,1,1,6,Mid-Value,Potential Loyalists
9252,1781,1,"40,9",1,1,1,3,Low-Value,Lost
9253,350,2,"95,1",5,1,1,7,Mid-Value,Potential Loyalists
9255,448,2,"77,15",4,1,1,6,Mid-Value,Potential Loyalists
9258,464,9,"519,41",4,2,1,7,Mid-Value,Potential Loyalists
9259,148,3,"175,7",5,1,1,7,Mid-Value,Potential Loyalists
9260,3,6,"187,15",5,1,1,7,Mid-Value,Potential Loyalists
9263,777,2,"178,6",3,1,1,5,Low-Value,At Risk Customers
9265,534,1,"67,05000000000001",4,1,1,6,Mid-Value,Potential Loyalists
9266,682,1,"25,8",4,1,1,6,Mid-Value,Potential Loyalists
9267,864,1,"15,2",3,1,1,5,Low-Value,At Risk Customers
9270,1230,2,"161,7",2,1,1,4,Low-Value,Can't Lose
9272,134,3,"473,1",5,1,1,7,Mid-Value,Potential Loyalists
9273,39,2,"78,7",5,1,1,7,Mid-Value,Potential Loyalists
9274,385,10,"655,0",4,2,1,7,Mid-Value,Potential Loyalists
9275,384,6,"419,29999999999995",4,1,1,6,Mid-Value,Potential Loyalists
9276,1019,2,"134,1",3,1,1,5,Low-Value,At Risk Customers
9277,1470,1,"30,6",1,1,1,3,Low-Value,Lost
9279,40,1,"47,1",5,1,1,7,Mid-Value,Potential Loyalists
9280,1336,3,"197,04999999999998",2,1,1,4,Low-Value,Can't Lose
9282,848,2,"50,949999999999996",3,1,1,5,Low-Value,At Risk Customers
9286,931,1,"30,2",3,1,1,5,Low-Value,At Risk Customers
9287,62,2,"24,849999999999998",5,1,1,7,Mid-Value,Potential Loyalists
9288,551,1,"9,0",4,1,1,6,Mid-Value,Potential Loyalists
9289,1160,3,"85,94999999999999",2,1,1,4,Low-Value,Can't Lose
9292,1250,2,"180,5",2,1,1,4,Low-Value,Can't Lose
9295,26,13,"874,55",5,3,2,10,High-Value,Champions
9296,722,8,"337,9",4,2,1,7,Mid-Value,Potential Loyalists
9297,1676,1,"64,6",1,1,1,3,Low-Value,Lost
9300,1551,1,"4,3",1,1,1,3,Low-Value,Lost
9301,1451,2,"124,25",2,1,1,4,Low-Value,Can't Lose
9302,362,4,"90,60000000000001",5,1,1,7,Mid-Value,Potential Loyalists
9303,1590,2,"60,7",1,1,1,3,Low-Value,Lost
9304,1425,1,"25,5",2,1,1,4,Low-Value,Can't Lose
9305,50,8,"265,6",5,2,1,8,High-Value,Potential Loyalists
9306,97,5,"239,14999999999998",5,1,1,7,Mid-Value,Potential Loyalists
9307,579,1,"8,2",4,1,1,6,Mid-Value,Potential Loyalists
9308,409,2,"19,75",4,1,1,6,Mid-Value,Potential Loyalists
9309,326,7,"412,65",5,2,1,8,High-Value,Potential Loyalists
9311,1289,1,"24,6",2,1,1,4,Low-Value,Can't Lose
9312,119,1,"26,75",5,1,1,7,Mid-Value,Potential Loyalists
9313,48,6,"360,95",5,1,1,7,Mid-Value,Potential Loyalists
9314,706,1,"22,4",4,1,1,6,Mid-Value,Potential Loyalists
9316,91,2,"10,0",5,1,1,7,Mid-Value,Potential Loyalists
9317,831,3,"103,85000000000001",3,1,1,5,Low-Value,At Risk Customers
9319,762,2,"45,75",3,1,1,5,Low-Value,At Risk Customers
9320,634,1,"39,2",4,1,1,6,Mid-Value,Potential Loyalists
9321,75,2,"65,55",5,1,1,7,Mid-Value,Potential Loyalists
9322,36,2,"80,7",5,1,1,7,Mid-Value,Potential Loyalists
9323,674,1,"10,65",4,1,1,6,Mid-Value,Potential Loyalists
9324,1121,3,"135,4",2,1,1,4,Low-Value,Can't Lose
9325,153,1,"40,75",5,1,1,7,Mid-Value,Potential Loyalists
9326,66,11,"368,9",5,2,1,8,High-Value,Potential Loyalists
9328,6,16,"531,45",5,3,1,9,High-Value,Champions
9329,1438,1,"58,55",2,1,1,4,Low-Value,Can't Lose
9330,207,2,"30,85",5,1,1,7,Mid-Value,Potential Loyalists
9331,747,8,"680,4000000000001",3,2,2,7,Mid-Value,Potential Loyalists
9332,144,4,"112,4",5,1,1,7,Mid-Value,Potential Loyalists
9333,372,2,"117,35000000000001",4,1,1,6,Mid-Value,Potential Loyalists
9334,458,2,"78,35",4,1,1,6,Mid-Value,Potential Loyalists
9336,225,4,"157,9",5,1,1,7,Mid-Value,Potential Loyalists
9337,857,4,"155,65",3,1,1,5,Low-Value,At Risk Customers
9338,1279,1,"73,6",2,1,1,4,Low-Value,Can't Lose
9342,428,3,"141,70000000000002",4,1,1,6,Mid-Value,Potential Loyalists
9344,1139,5,"277,0",2,1,1,4,Low-Value,Can't Lose
9345,1137,2,"109,45",2,1,1,4,Low-Value,Can't Lose
9346,1027,1,"48,45",3,1,1,5,Low-Value,At Risk Customers
9350,398,1,"34,9",4,1,1,6,Mid-Value,Potential Loyalists
9352,137,5,"183,05",5,1,1,7,Mid-Value,Potential Loyalists
9353,442,1,"21,95",4,1,1,6,Mid-Value,Potential Loyalists
9355,321,2,"24,7",5,1,1,7,Mid-Value,Potential Loyalists
9357,421,3,"289,8",4,1,1,6,Mid-Value,Potential Loyalists
9359,1442,4,"318,5",2,1,1,4,Low-Value,Can't Lose
9361,446,1,"2,25",4,1,1,6,Mid-Value,Potential Loyalists
9365,1147,2,"99,35",2,1,1,4,Low-Value,Can't Lose
9369,1667,1,"22,2",1,1,1,3,Low-Value,Lost
9370,420,1,"24,05",4,1,1,6,Mid-Value,Potential Loyalists
9372,1450,1,"20,45",2,1,1,4,Low-Value,Can't Lose
9374,772,5,"289,84999999999997",3,1,1,5,Low-Value,At Risk Customers
9376,26,1,"219,60000000000002",5,1,1,7,Mid-Value,Potential Loyalists
9377,369,1,"1,25",4,1,1,6,Mid-Value,Potential Loyalists
9378,900,2,"18,4",3,1,1,5,Low-Value,At Risk Customers
9379,389,3,"349,2",4,1,1,6,Mid-Value,Potential Loyalists
9381,74,4,"138,8",5,1,1,7,Mid-Value,Potential Loyalists
9382,647,1,"250,7",4,1,1,6,Mid-Value,Potential Loyalists
9384,658,4,"160,0",4,1,1,6,Mid-Value,Potential Loyalists
9385,194,5,"221,25",5,1,1,7,Mid-Value,Potential Loyalists
9390,21,8,"373,15",5,2,1,8,High-Value,Potential Loyalists
9391,336,3,"309,45",5,1,1,7,Mid-Value,Potential Loyalists
9392,89,3,"102,05",5,1,1,7,Mid-Value,Potential Loyalists
9394,696,2,"92,5",4,1,1,6,Mid-Value,Potential Loyalists
9395,1351,2,"10,850000000000001",2,1,1,4,Low-Value,Can't Lose
9398,1138,2,"85,4",2,1,1,4,Low-Value,Can't Lose
9400,41,4,"456,5",5,1,1,7,Mid-Value,Potential Loyalists
9401,152,1,"238,3",5,1,1,7,Mid-Value,Potential Loyalists
9402,519,4,"283,3",4,1,1,6,Mid-Value,Potential Loyalists
9404,1243,1,"9,45",2,1,1,4,Low-Value,Can't Lose
9406,68,9,"375,8",5,2,1,8,High-Value,Potential Loyalists
9407,604,2,"148,10000000000002",4,1,1,6,Mid-Value,Potential Loyalists
9408,986,1,"37,85",3,1,1,5,Low-Value,At Risk Customers
9409,393,1,"15,899999999999999",4,1,1,6,Mid-Value,Potential Loyalists
9411,693,1,"2,2",4,1,1,6,Mid-Value,Potential Loyalists
9415,1015,1,"67,4",3,1,1,5,Low-Value,At Risk Customers
9416,393,4,"158,1",4,1,1,6,Mid-Value,Potential Loyalists
9418,85,1,"37,7",5,1,1,7,Mid-Value,Potential Loyalists
9420,162,7,"239,0",5,2,1,8,High-Value,Potential Loyalists
9421,785,5,"474,05",3,1,1,5,Low-Value,At Risk Customers
9422,311,1,"95,1",5,1,1,7,Mid-Value,Potential Loyalists
9423,139,2,"145,6",5,1,1,7,Mid-Value,Potential Loyalists
9424,34,3,"36,379999999999995",5,1,1,7,Mid-Value,Potential Loyalists
9425,514,3,"282,5",4,1,1,6,Mid-Value,Potential Loyalists
9426,210,3,"180,39999999999998",5,1,1,7,Mid-Value,Potential Loyalists
9430,1110,5,"110,6",2,1,1,4,Low-Value,Can't Lose
9431,53,2,"65,25",5,1,1,7,Mid-Value,Potential Loyalists
9432,154,1,"82,7",5,1,1,7,Mid-Value,Potential Loyalists
9434,42,2,"34,849999999999994",5,1,1,7,Mid-Value,Potential Loyalists
9436,235,1,"10,35",5,1,1,7,Mid-Value,Potential Loyalists
9438,535,1,"28,1",4,1,1,6,Mid-Value,Potential Loyalists
9439,1022,3,"70,45",3,1,1,5,Low-Value,At Risk Customers
9442,1117,2,"45,4",2,1,1,4,Low-Value,Can't Lose
9443,249,2,"119,25",5,1,1,7,Mid-Value,Potential Loyalists
9445,251,2,"145,8",5,1,1,7,Mid-Value,Potential Loyalists
9446,49,3,"63,15",5,1,1,7,Mid-Value,Potential Loyalists
9450,1309,2,"90,85",2,1,1,4,Low-Value,Can't Lose
9451,313,6,"451,75000000000006",5,1,1,7,Mid-Value,Potential Loyalists
9452,23,5,"527,5999999999999",5,1,1,7,Mid-Value,Potential Loyalists
9453,391,6,"333,05",4,1,1,6,Mid-Value,Potential Loyalists
9456,789,2,"37,95",3,1,1,5,Low-Value,At Risk Customers
9457,127,4,"183,0",5,1,1,7,Mid-Value,Potential Loyalists
9458,484,7,"464,35",4,2,1,7,Mid-Value,Potential Loyalists
9460,588,1,"57,85",4,1,1,6,Mid-Value,Potential Loyalists
9461,34,7,"307,4",5,2,1,8,High-Value,Potential Loyalists
9463,1459,1,"7,8",2,1,1,4,Low-Value,Can't Lose
9464,439,5,"345,75",4,1,1,6,Mid-Value,Potential Loyalists
9467,164,1,"67,5",5,1,1,7,Mid-Value,Potential Loyalists
9471,292,3,"70,64999999999999",5,1,1,7,Mid-Value,Potential Loyalists
9472,1762,2,"102,85",1,1,1,3,Low-Value,Lost
9473,518,1,"77,2",4,1,1,6,Mid-Value,Potential Loyalists
9476,556,4,"188,79999999999998",4,1,1,6,Mid-Value,Potential Loyalists
9478,21,3,"61,55",5,1,1,7,Mid-Value,Potential Loyalists
9479,678,6,"906,75",4,1,2,7,Mid-Value,Potential Loyalists
9480,1109,2,"188,75",2,1,1,4,Low-Value,Can't Lose
9481,498,3,"176,55",4,1,1,6,Mid-Value,Potential Loyalists
9483,1776,1,"276,0",1,1,1,3,Low-Value,Lost
9485,288,3,"485,1",5,1,1,7,Mid-Value,Potential Loyalists
9488,187,5,"279,9",5,1,1,7,Mid-Value,Potential Loyalists
9489,199,3,"127,5",5,1,1,7,Mid-Value,Potential Loyalists
9490,6,7,"1443,9499999999998",5,2,3,10,High-Value,Champions
9491,904,1,"5,8",3,1,1,5,Low-Value,At Risk Customers
9493,114,1,"11,7",5,1,1,7,Mid-Value,Potential Loyalists
9494,175,2,"44,25",5,1,1,7,Mid-Value,Potential Loyalists
9497,29,4,"103,25",5,1,1,7,Mid-Value,Potential Loyalists
9498,1507,1,"9,95",1,1,1,3,Low-Value,Lost
9500,122,1,"34,9",5,1,1,7,Mid-Value,Potential Loyalists
9501,492,1,"42,0",4,1,1,6,Mid-Value,Potential Loyalists
9502,48,1,"127,95",5,1,1,7,Mid-Value,Potential Loyalists
9503,178,3,"132,8",5,1,1,7,Mid-Value,Potential Loyalists
9504,1117,1,"179,8",2,1,1,4,Low-Value,Can't Lose
9505,205,4,"352,08",5,1,1,7,Mid-Value,Potential Loyalists
9507,454,4,"73,95",4,1,1,6,Mid-Value,Potential Loyalists
9508,696,2,"104,65",4,1,1,6,Mid-Value,Potential Loyalists
9510,2,4,"176,9",5,1,1,7,Mid-Value,Potential Loyalists
9511,140,3,"105,4",5,1,1,7,Mid-Value,Potential Loyalists
9513,479,3,"258,7",4,1,1,6,Mid-Value,Potential Loyalists
9515,750,4,"249,64999999999998",3,1,1,5,Low-Value,At Risk Customers
9517,206,4,"76,44999999999999",5,1,1,7,Mid-Value,Potential Loyalists
9518,255,2,"20,450000000000003",5,1,1,7,Mid-Value,Potential Loyalists
9519,340,3,"88,15",5,1,1,7,Mid-Value,Potential Loyalists
9520,931,1,"464,44999999999993",3,1,1,5,Low-Value,At Risk Customers
9521,436,5,"235,70000000000002",4,1,1,6,Mid-Value,Potential Loyalists
9526,907,1,"64,1",3,1,1,5,Low-Value,At Risk Customers
9528,1403,1,"31,9",2,1,1,4,Low-Value,Can't Lose
9529,386,5,"403,35",4,1,1,6,Mid-Value,Potential Loyalists
9532,204,4,"122,5",5,1,1,7,Mid-Value,Potential Loyalists
9533,365,4,"879,65",5,1,2,8,High-Value,Potential Loyalists
9534,1390,2,"14,55",2,1,1,4,Low-Value,Can't Lose
9536,1063,3,"499,35",3,1,1,5,Low-Value,At Risk Customers
9537,1134,3,"85,4",2,1,1,4,Low-Value,Can't Lose
9539,850,1,"28,75",3,1,1,5,Low-Value,At Risk Customers
9540,1193,1,"30,3",2,1,1,4,Low-Value,Can't Lose
9541,175,2,"51,45",5,1,1,7,Mid-Value,Potential Loyalists
9542,881,8,"773,1999999999999",3,2,2,7,Mid-Value,Potential Loyalists
9544,48,1,"12,35",5,1,1,7,Mid-Value,Potential Loyalists
9545,626,3,"65,0",4,1,1,6,Mid-Value,Potential Loyalists
9546,102,2,"38,1",5,1,1,7,Mid-Value,Potential Loyalists
9547,432,4,"105,65",4,1,1,6,Mid-Value,Potential Loyalists
9548,895,2,"77,05",3,1,1,5,Low-Value,At Risk Customers
9551,862,2,"174,75",3,1,1,5,Low-Value,At Risk Customers
9552,585,4,"419,25",4,1,1,6,Mid-Value,Potential Loyalists
9553,384,5,"186,2",4,1,1,6,Mid-Value,Potential Loyalists
9554,176,3,"86,25",5,1,1,7,Mid-Value,Potential Loyalists
9557,1449,2,"212,7",2,1,1,4,Low-Value,Can't Lose
9558,445,1,"77,8",4,1,1,6,Mid-Value,Potential Loyalists
9561,566,3,"278,5",4,1,1,6,Mid-Value,Potential Loyalists
9562,1313,2,"179,25",2,1,1,4,Low-Value,Can't Lose
9563,139,5,"419,45",5,1,1,7,Mid-Value,Potential Loyalists
9564,1146,1,"15,65",2,1,1,4,Low-Value,Can't Lose
9566,860,1,"15,7",3,1,1,5,Low-Value,At Risk Customers
9569,611,1,"352,8",4,1,1,6,Mid-Value,Potential Loyalists
9570,1425,3,"256,5",2,1,1,4,Low-Value,Can't Lose
9574,185,3,"136,1",5,1,1,7,Mid-Value,Potential Loyalists
9575,1110,1,"12,9",2,1,1,4,Low-Value,Can't Lose
9577,12,2,"525,65",5,1,1,7,Mid-Value,Potential Loyalists
9578,315,2,"35,15",5,1,1,7,Mid-Value,Potential Loyalists
9579,167,6,"273,0",5,1,1,7,Mid-Value,Potential Loyalists
9584,20,3,"121,7",5,1,1,7,Mid-Value,Potential Loyalists
9587,497,3,"237,5",4,1,1,6,Mid-Value,Potential Loyalists
9588,239,4,"127,3",5,1,1,7,Mid-Value,Potential Loyalists
9589,2,1,"10,9",5,1,1,7,Mid-Value,Potential Loyalists
9591,41,5,"363,7",5,1,1,7,Mid-Value,Potential Loyalists
9592,1575,2,"89,1",1,1,1,3,Low-Value,Lost
9593,31,5,"142,55",5,1,1,7,Mid-Value,Potential Loyalists
9596,329,3,"383,2",5,1,1,7,Mid-Value,Potential Loyalists
9600,10,7,"327,15",5,2,1,8,High-Value,Potential Loyalists
9601,903,1,"154,5",3,1,1,5,Low-Value,At Risk Customers
9602,468,2,"60,65",4,1,1,6,Mid-Value,Potential Loyalists
9603,1266,2,"71,1",2,1,1,4,Low-Value,Can't Lose
9605,62,5,"227,20000000000002",5,1,1,7,Mid-Value,Potential Loyalists
9606,938,1,"20,9",3,1,1,5,Low-Value,At Risk Customers
9607,531,3,"979,8000000000001",4,1,2,7,Mid-Value,Potential Loyalists
9608,26,5,"358,54999999999995",5,1,1,7,Mid-Value,Potential Loyalists
9609,735,2,"95,0",3,1,1,5,Low-Value,At Risk Customers
9613,132,4,"62,650000000000006",5,1,1,7,Mid-Value,Potential Loyalists
9614,56,3,"153,9",5,1,1,7,Mid-Value,Potential Loyalists
9615,74,1,"42,45",5,1,1,7,Mid-Value,Potential Loyalists
9616,144,9,"518,9",5,2,1,8,High-Value,Potential Loyalists
9617,540,4,"234,4",4,1,1,6,Mid-Value,Potential Loyalists
9618,581,5,"192,4",4,1,1,6,Mid-Value,Potential Loyalists
9619,780,8,"307,3",3,2,1,6,Mid-Value,Potential Loyalists
9620,1236,1,"188,10000000000002",2,1,1,4,Low-Value,Can't Lose
9621,1118,3,"110,15",2,1,1,4,Low-Value,Can't Lose
9622,0,4,"241,4",5,1,1,7,Mid-Value,Potential Loyalists
9630,88,7,"774,25",5,2,2,9,High-Value,Champions
9632,1047,4,"168,9",3,1,1,5,Low-Value,At Risk Customers
9633,864,3,"110,85",3,1,1,5,Low-Value,At Risk Customers
9636,1321,1,"132,89999999999998",2,1,1,4,Low-Value,Can't Lose
9638,199,1,"7,2",5,1,1,7,Mid-Value,Potential Loyalists
9640,276,6,"382,95",5,1,1,7,Mid-Value,Potential Loyalists
9641,1133,6,"642,9",2,1,1,4,Low-Value,Can't Lose
9642,441,2,"29,15",4,1,1,6,Mid-Value,Potential Loyalists
9643,23,5,"437,05",5,1,1,7,Mid-Value,Potential Loyalists
9644,406,2,"22,9",4,1,1,6,Mid-Value,Potential Loyalists
9645,589,3,"529,4",4,1,1,6,Mid-Value,Potential Loyalists
9646,466,10,"558,8000000000001",4,2,1,7,Mid-Value,Potential Loyalists
9648,1122,6,"793,2",2,1,2,5,Low-Value,At Risk Customers
9649,229,3,"273,65",5,1,1,7,Mid-Value,Potential Loyalists
9650,773,3,"134,05",3,1,1,5,Low-Value,At Risk Customers
9651,92,8,"702,4",5,2,2,9,High-Value,Champions
9656,367,4,"245,45",4,1,1,6,Mid-Value,Potential Loyalists
9657,171,6,"853,7",5,1,2,8,High-Value,Potential Loyalists
9659,493,10,"955,75",4,2,2,8,High-Value,Potential Loyalists
9660,127,8,"331,95",5,2,1,8,High-Value,Potential Loyalists
9661,17,6,"214,0",5,1,1,7,Mid-Value,Potential Loyalists
9667,365,8,"317,45",5,2,1,8,High-Value,Potential Loyalists
9668,1778,1,"74,3",1,1,1,3,Low-Value,Lost
9669,522,2,"173,95",4,1,1,6,Mid-Value,Potential Loyalists
9670,1209,1,"72,0",2,1,1,4,Low-Value,Can't Lose
9671,17,18,"788,4",5,4,2,11,High-Value,Champions
9672,1496,2,"42,7",1,1,1,3,Low-Value,Lost
9678,33,11,"1898,6999999999998",5,2,3,10,High-Value,Champions
9679,392,1,"2,7",4,1,1,6,Mid-Value,Potential Loyalists
9680,578,3,"124,6",4,1,1,6,Mid-Value,Potential Loyalists
9685,189,3,"567,9000000000001",5,1,1,7,Mid-Value,Potential Loyalists
9688,554,3,"146,55",4,1,1,6,Mid-Value,Potential Loyalists
9689,840,4,"293,5",3,1,1,5,Low-Value,At Risk Customers
9690,897,1,"43,7",3,1,1,5,Low-Value,At Risk Customers
9693,557,3,"74,95",4,1,1,6,Mid-Value,Potential Loyalists
9694,745,1,"22,1",3,1,1,5,Low-Value,At Risk Customers
9695,216,1,"3,75",5,1,1,7,Mid-Value,Potential Loyalists
9696,995,6,"295,6",3,1,1,5,Low-Value,At Risk Customers
9699,336,7,"439,4",5,2,1,8,High-Value,Potential Loyalists
9702,214,2,"54,15",5,1,1,7,Mid-Value,Potential Loyalists
9703,794,3,"23,950000000000003",3,1,1,5,Low-Value,At Risk Customers
9708,1122,1,"21,8",2,1,1,4,Low-Value,Can't Lose
9709,270,3,"64,8",5,1,1,7,Mid-Value,Potential Loyalists
9710,715,1,"18,5",4,1,1,6,Mid-Value,Potential Loyalists
9714,42,3,"184,0",5,1,1,7,Mid-Value,Potential Loyalists
9716,265,4,"170,4",5,1,1,7,Mid-Value,Potential Loyalists
9718,1073,1,"55,75",3,1,1,5,Low-Value,At Risk Customers
9719,416,2,"64,15",4,1,1,6,Mid-Value,Potential Loyalists
9720,56,9,"660,85",5,2,1,8,High-Value,Potential Loyalists
9721,3,5,"230,45",5,1,1,7,Mid-Value,Potential Loyalists
9724,403,5,"1581,65",4,1,3,8,High-Value,Potential Loyalists
9725,41,1,"51,4",5,1,1,7,Mid-Value,Potential Loyalists
9727,219,5,"177,5",5,1,1,7,Mid-Value,Potential Loyalists
9728,63,4,"68,6",5,1,1,7,Mid-Value,Potential Loyalists
9729,111,3,"132,8",5,1,1,7,Mid-Value,Potential Loyalists
9732,938,2,"80,4",3,1,1,5,Low-Value,At Risk Customers
9733,167,1,"252,8",5,1,1,7,Mid-Value,Potential Loyalists
9734,927,1,"15,0",3,1,1,5,Low-Value,At Risk Customers
9736,1131,4,"75,25",2,1,1,4,Low-Value,Can't Lose
9739,983,5,"399,59999999999997",3,1,1,5,Low-Value,At Risk Customers
9742,545,1,"443,8",4,1,1,6,Mid-Value,Potential Loyalists
9743,508,2,"95,95",4,1,1,6,Mid-Value,Potential Loyalists
9745,70,2,"86,15",5,1,1,7,Mid-Value,Potential Loyalists
9746,1382,1,"179,2",2,1,1,4,Low-Value,Can't Lose
9748,738,4,"235,7",3,1,1,5,Low-Value,At Risk Customers
9749,812,2,"27,65",3,1,1,5,Low-Value,At Risk Customers
9751,208,1,"31,650000000000002",5,1,1,7,Mid-Value,Potential Loyalists
9752,596,6,"380,0",4,1,1,6,Mid-Value,Potential Loyalists
9753,70,1,"10,3",5,1,1,7,Mid-Value,Potential Loyalists
9756,443,1,"87,15",4,1,1,6,Mid-Value,Potential Loyalists
9758,212,2,"159,4",5,1,1,7,Mid-Value,Potential Loyalists
9760,368,2,"95,35000000000001",4,1,1,6,Mid-Value,Potential Loyalists
9762,189,3,"200,45000000000002",5,1,1,7,Mid-Value,Potential Loyalists
9763,334,2,"94,75",5,1,1,7,Mid-Value,Potential Loyalists
9769,59,4,"198,35",5,1,1,7,Mid-Value,Potential Loyalists
9771,327,5,"443,95",5,1,1,7,Mid-Value,Potential Loyalists
9773,420,2,"56,300000000000004",4,1,1,6,Mid-Value,Potential Loyalists
9774,1090,1,"37,35",3,1,1,5,Low-Value,At Risk Customers
9776,173,5,"192,65",5,1,1,7,Mid-Value,Potential Loyalists
9777,256,3,"51,05",5,1,1,7,Mid-Value,Potential Loyalists
9778,57,8,"563,6",5,2,1,8,High-Value,Potential Loyalists
9779,1042,1,"4,85",3,1,1,5,Low-Value,At Risk Customers
9781,507,2,"345,3",4,1,1,6,Mid-Value,Potential Loyalists
9785,764,3,"407,5",3,1,1,5,Low-Value,At Risk Customers
9786,1466,5,"400,65",1,1,1,3,Low-Value,Lost
9789,1464,1,"126,4",1,1,1,3,Low-Value,Lost
9790,565,1,"20,6",4,1,1,6,Mid-Value,Potential Loyalists
9791,923,1,"60,9",3,1,1,5,Low-Value,At Risk Customers
9792,82,6,"455,15",5,1,1,7,Mid-Value,Potential Loyalists
9793,1070,3,"163,15",3,1,1,5,Low-Value,At Risk Customers
9794,449,2,"43,25",4,1,1,6,Mid-Value,Potential Loyalists
9795,525,5,"108,9",4,1,1,6,Mid-Value,Potential Loyalists
9796,865,4,"177,35",3,1,1,5,Low-Value,At Risk Customers
9799,213,1,"67,5",5,1,1,7,Mid-Value,Potential Loyalists
9800,256,3,"60,35",5,1,1,7,Mid-Value,Potential Loyalists
9801,124,1,"71,25",5,1,1,7,Mid-Value,Potential Loyalists
9807,75,1,"8,9",5,1,1,7,Mid-Value,Potential Loyalists
9808,90,10,"740,75",5,2,2,9,High-Value,Champions
9809,113,1,"19,35",5,1,1,7,Mid-Value,Potential Loyalists
9810,1499,1,"112,85",1,1,1,3,Low-Value,Lost
9812,563,1,"672,2",4,1,2,7,Mid-Value,Potential Loyalists
9813,268,2,"165,2",5,1,1,7,Mid-Value,Potential Loyalists
9815,110,2,"71,45",5,1,1,7,Mid-Value,Potential Loyalists
9817,60,2,"51,15",5,1,1,7,Mid-Value,Potential Loyalists
9818,909,4,"151,9",3,1,1,5,Low-Value,At Risk Customers
9819,1633,1,"37,15",1,1,1,3,Low-Value,Lost
9820,195,1,"26,3",5,1,1,7,Mid-Value,Potential Loyalists
9822,224,5,"183,6",5,1,1,7,Mid-Value,Potential Loyalists
9824,805,3,"74,6",3,1,1,5,Low-Value,At Risk Customers
9825,138,6,"270,85",5,1,1,7,Mid-Value,Potential Loyalists
9826,1023,1,"11,05",3,1,1,5,Low-Value,At Risk Customers
9827,616,1,"204,0",4,1,1,6,Mid-Value,Potential Loyalists
9831,571,1,"23,0",4,1,1,6,Mid-Value,Potential Loyalists
9832,3,6,"484,5",5,1,1,7,Mid-Value,Potential Loyalists
9833,101,3,"365,95000000000005",5,1,1,7,Mid-Value,Potential Loyalists
9834,0,5,"171,39999999999998",5,1,1,7,Mid-Value,Potential Loyalists
9835,967,4,"174,6",3,1,1,5,Low-Value,At Risk Customers
9836,927,3,"238,95",3,1,1,5,Low-Value,At Risk Customers
9838,76,2,"19,1",5,1,1,7,Mid-Value,Potential Loyalists
9839,133,6,"339,35",5,1,1,7,Mid-Value,Potential Loyalists
9841,1201,1,"21,7",2,1,1,4,Low-Value,Can't Lose
9843,1138,1,"12,1",2,1,1,4,Low-Value,Can't Lose
9845,803,1,"247,25",3,1,1,5,Low-Value,At Risk Customers
9847,1757,1,"60,7",1,1,1,3,Low-Value,Lost
9849,726,3,"134,0",4,1,1,6,Mid-Value,Potential Loyalists
9850,1727,1,"122,69999999999999",1,1,1,3,Low-Value,Lost
9853,1015,1,"24,75",3,1,1,5,Low-Value,At Risk Customers
9855,617,2,"145,05",4,1,1,6,Mid-Value,Potential Loyalists
9856,1115,2,"30,8",2,1,1,4,Low-Value,Can't Lose
9857,185,4,"284,3",5,1,1,7,Mid-Value,Potential Loyalists
9858,166,4,"55,3",5,1,1,7,Mid-Value,Potential Loyalists
9860,1522,1,"19,8",1,1,1,3,Low-Value,Lost
9861,25,4,"159,05",5,1,1,7,Mid-Value,Potential Loyalists
9863,827,3,"202,64999999999998",3,1,1,5,Low-Value,At Risk Customers
9864,188,1,"17,7",5,1,1,7,Mid-Value,Potential Loyalists
9865,160,2,"163,4",5,1,1,7,Mid-Value,Potential Loyalists
9866,383,2,"144,4",4,1,1,6,Mid-Value,Potential Loyalists
9867,239,6,"789,3",5,1,2,8,High-Value,Potential Loyalists
9869,1760,1,"131,5",1,1,1,3,Low-Value,Lost
9870,286,4,"1002,6",5,1,2,8,High-Value,Potential Loyalists
9871,776,2,"87,35",3,1,1,5,Low-Value,At Risk Customers
9873,421,1,"2,75",4,1,1,6,Mid-Value,Potential Loyalists
9874,1159,2,"117,44999999999999",2,1,1,4,Low-Value,Can't Lose
9878,591,4,"332,59999999999997",4,1,1,6,Mid-Value,Potential Loyalists
9879,1381,1,"64,95",2,1,1,4,Low-Value,Can't Lose
9881,15,8,"430,95000000000005",5,2,1,8,High-Value,Potential Loyalists
9884,804,3,"110,94999999999999",3,1,1,5,Low-Value,At Risk Customers
9886,462,3,"187,79999999999998",4,1,1,6,Mid-Value,Potential Loyalists
9887,1311,1,"36,7",2,1,1,4,Low-Value,Can't Lose
9888,1172,1,"16,9",2,1,1,4,Low-Value,Can't Lose
9890,1434,1,"23,1",2,1,1,4,Low-Value,Can't Lose
9893,678,2,"288,7",4,1,1,6,Mid-Value,Potential Loyalists
9894,14,7,"703,85",5,2,2,9,High-Value,Champions
9895,367,1,"11,0",4,1,1,6,Mid-Value,Potential Loyalists
9896,104,1,"38,7",5,1,1,7,Mid-Value,Potential Loyalists
9898,26,4,"608,6999999999999",5,1,1,7,Mid-Value,Potential Loyalists
9902,689,2,"65,15",4,1,1,6,Mid-Value,Potential Loyalists
9903,732,6,"274,1",3,1,1,5,Low-Value,At Risk Customers
9904,1647,1,"9,8",1,1,1,3,Low-Value,Lost
9905,391,6,"424,6",4,1,1,6,Mid-Value,Potential Loyalists
9906,90,3,"171,4",5,1,1,7,Mid-Value,Potential Loyalists
9909,922,9,"408,95",3,2,1,6,Mid-Value,Potential Loyalists
9911,857,3,"173,75",3,1,1,5,Low-Value,At Risk Customers
9912,563,2,"55,0",4,1,1,6,Mid-Value,Potential Loyalists
9913,1420,1,"9,85",2,1,1,4,Low-Value,Can't Lose
9914,636,3,"127,6",4,1,1,6,Mid-Value,Potential Loyalists
9916,682,1,"28,15",4,1,1,6,Mid-Value,Potential Loyalists
9917,914,1,"78,7",3,1,1,5,Low-Value,At Risk Customers
9919,1147,1,"16,8",2,1,1,4,Low-Value,Can't Lose
9920,228,1,"272,4",5,1,1,7,Mid-Value,Potential Loyalists
9921,785,3,"41,1",3,1,1,5,Low-Value,At Risk Customers
9923,872,1,"55,5",3,1,1,5,Low-Value,At Risk Customers
9924,43,6,"665,5",5,1,2,8,High-Value,Potential Loyalists
9925,1209,3,"152,95",2,1,1,4,Low-Value,Can't Lose
9926,621,6,"1202,35",4,1,2,7,Mid-Value,Potential Loyalists
9927,1328,1,"737,4000000000001",2,1,2,5,Low-Value,At Risk Customers
9930,1302,2,"248,15",2,1,1,4,Low-Value,Can't Lose
9931,162,1,"93,6",5,1,1,7,Mid-Value,Potential Loyalists
9933,5,7,"448,45",5,2,1,8,High-Value,Potential Loyalists
9934,749,3,"135,6",3,1,1,5,Low-Value,At Risk Customers
9935,1134,2,"177,25",2,1,1,4,Low-Value,Can't Lose
9936,154,3,"127,05",5,1,1,7,Mid-Value,Potential Loyalists
9938,636,2,"212,15",4,1,1,6,Mid-Value,Potential Loyalists
9939,503,3,"155,15",4,1,1,6,Mid-Value,Potential Loyalists
9940,1037,1,"34,45",3,1,1,5,Low-Value,At Risk Customers
9942,1041,2,"38,7",3,1,1,5,Low-Value,At Risk Customers
9944,5,1,"133,0",5,1,1,7,Mid-Value,Potential Loyalists
9945,1508,1,"38,55",1,1,1,3,Low-Value,Lost
9947,1162,5,"111,75",2,1,1,4,Low-Value,Can't Lose
9948,136,6,"592,0",5,1,1,7,Mid-Value,Potential Loyalists
9950,800,3,"116,35",3,1,1,5,Low-Value,At Risk Customers
9952,31,2,"85,8",5,1,1,7,Mid-Value,Potential Loyalists
9955,111,3,"103,80000000000001",5,1,1,7,Mid-Value,Potential Loyalists
9957,314,2,"222,85000000000002",5,1,1,7,Mid-Value,Potential Loyalists
9958,76,2,"123,55",5,1,1,7,Mid-Value,Potential Loyalists
9959,55,1,"35,0",5,1,1,7,Mid-Value,Potential Loyalists
9960,129,3,"258,15",5,1,1,7,Mid-Value,Potential Loyalists
9961,127,6,"192,2",5,1,1,7,Mid-Value,Potential Loyalists
9962,103,5,"130,85",5,1,1,7,Mid-Value,Potential Loyalists
9963,377,5,"588,0500000000001",4,1,1,6,Mid-Value,Potential Loyalists
9964,309,2,"43,14999999999999",5,1,1,7,Mid-Value,Potential Loyalists
9965,299,1,"8,5",5,1,1,7,Mid-Value,Potential Loyalists
9967,18,13,"984,1",5,3,2,10,High-Value,Champions
9968,99,6,"235,85",5,1,1,7,Mid-Value,Potential Loyalists
9969,747,5,"198,95",3,1,1,5,Low-Value,At Risk Customers
9970,170,20,"749,0500000000001",5,4,2,11,High-Value,Champions
9971,59,6,"945,95",5,1,2,8,High-Value,Potential Loyalists
9972,1270,1,"217,8",2,1,1,4,Low-Value,Can't Lose
9973,154,2,"153,25",5,1,1,7,Mid-Value,Potential Loyalists
9975,844,2,"97,45",3,1,1,5,Low-Value,At Risk Customers
9976,11,5,"380,69999999999993",5,1,1,7,Mid-Value,Potential Loyalists
9977,420,2,"57,4",4,1,1,6,Mid-Value,Potential Loyalists
9978,740,4,"196,25",3,1,1,5,Low-Value,At Risk Customers
9979,203,3,"119,6",5,1,1,7,Mid-Value,Potential Loyalists
9980,1124,1,"125,65",2,1,1,4,Low-Value,Can't Lose
9984,440,2,"57,45",4,1,1,6,Mid-Value,Potential Loyalists
9986,382,4,"117,9",4,1,1,6,Mid-Value,Potential Loyalists
9987,810,1,"36,85",3,1,1,5,Low-Value,At Risk Customers
9988,252,6,"308,84999999999997",5,1,1,7,Mid-Value,Potential Loyalists
9990,789,3,"142,55",3,1,1,5,Low-Value,At Risk Customers
9991,738,7,"234,89999999999998",3,2,1,6,Mid-Value,Potential Loyalists
9992,418,1,"83,5",4,1,1,6,Mid-Value,Potential Loyalists
9993,1783,1,"116,0",1,1,1,3,Low-Value,Lost
9994,1810,1,"41,4",1,1,1,3,Low-Value,Lost
9995,568,1,"180,14999999999998",4,1,1,6,Mid-Value,Potential Loyalists
9996,132,7,"784,25",5,2,2,9,High-Value,Champions
9997,622,2,"55,800000000000004",4,1,1,6,Mid-Value,Potential Loyalists
9999,325,8,"399,6",5,2,1,8,High-Value,Potential Loyalists
10001,84,13,"1065,65",5,3,2,10,High-Value,Champions
10002,325,6,"389,65",5,1,1,7,Mid-Value,Potential Loyalists
10003,91,2,"97,55",5,1,1,7,Mid-Value,Potential Loyalists
10004,216,2,"488,25",5,1,1,7,Mid-Value,Potential Loyalists
10010,1449,1,"32,65",2,1,1,4,Low-Value,Can't Lose
10011,52,1,"29,95",5,1,1,7,Mid-Value,Potential Loyalists
10012,309,2,"150,5",5,1,1,7,Mid-Value,Potential Loyalists
10015,162,6,"571,35",5,1,1,7,Mid-Value,Potential Loyalists
10016,601,1,"60,7",4,1,1,6,Mid-Value,Potential Loyalists
10018,662,6,"312,55",4,1,1,6,Mid-Value,Potential Loyalists
10019,505,3,"206,7",4,1,1,6,Mid-Value,Potential Loyalists
10020,23,3,"60,8",5,1,1,7,Mid-Value,Potential Loyalists
10021,931,5,"160,85",3,1,1,5,Low-Value,At Risk Customers
10022,474,5,"301,15000000000003",4,1,1,6,Mid-Value,Potential Loyalists
10023,1078,1,"8,6",3,1,1,5,Low-Value,At Risk Customers
10024,237,16,"874,0500000000001",5,3,2,10,High-Value,Champions
10025,908,2,"107,75",3,1,1,5,Low-Value,At Risk Customers
10026,49,7,"379,15",5,2,1,8,High-Value,Potential Loyalists
10027,604,2,"58,75",4,1,1,6,Mid-Value,Potential Loyalists
10028,3,3,"250,3",5,1,1,7,Mid-Value,Potential Loyalists
10030,365,3,"205,6",5,1,1,7,Mid-Value,Potential Loyalists
10031,1211,3,"194,55",2,1,1,4,Low-Value,Can't Lose
10032,118,13,"743,55",5,3,2,10,High-Value,Champions
10033,1549,1,"68,15",1,1,1,3,Low-Value,Lost
10034,510,4,"254,35",4,1,1,6,Mid-Value,Potential Loyalists
10036,42,4,"300,99",5,1,1,7,Mid-Value,Potential Loyalists
10037,34,3,"140,10000000000002",5,1,1,7,Mid-Value,Potential Loyalists
10039,498,3,"152,04999999999998",4,1,1,6,Mid-Value,Potential Loyalists
10040,120,8,"440,20000000000005",5,2,1,8,High-Value,Potential Loyalists
10042,1,3,"148,35000000000002",5,1,1,7,Mid-Value,Potential Loyalists
10043,1410,1,"33,6",2,1,1,4,Low-Value,Can't Lose
10044,1289,1,"166,95",2,1,1,4,Low-Value,Can't Lose
10045,367,2,"188,85000000000002",4,1,1,6,Mid-Value,Potential Loyalists
10046,237,1,"234,75",5,1,1,7,Mid-Value,Potential Loyalists
10048,130,1,"31,799999999999997",5,1,1,7,Mid-Value,Potential Loyalists
10050,5,11,"790,8499999999999",5,2,2,9,High-Value,Champions
10052,32,6,"449,25",5,1,1,7,Mid-Value,Potential Loyalists
10056,598,2,"54,5",4,1,1,6,Mid-Value,Potential Loyalists
10057,507,7,"382,1",4,2,1,7,Mid-Value,Potential Loyalists
10058,254,6,"118,5",5,1,1,7,Mid-Value,Potential Loyalists
10059,10,9,"587,75",5,2,1,8,High-Value,Potential Loyalists
10060,96,3,"123,00000000000001",5,1,1,7,Mid-Value,Potential Loyalists
10062,325,6,"297,85",5,1,1,7,Mid-Value,Potential Loyalists
10063,206,7,"544,95",5,2,1,8,High-Value,Potential Loyalists
10064,61,3,"80,55",5,1,1,7,Mid-Value,Potential Loyalists
10065,252,5,"375,7",5,1,1,7,Mid-Value,Potential Loyalists
10067,274,1,"48,45",5,1,1,7,Mid-Value,Potential Loyalists
10068,212,1,"85,15",5,1,1,7,Mid-Value,Potential Loyalists
10069,772,3,"348,25",3,1,1,5,Low-Value,At Risk Customers
10071,643,5,"121,14999999999999",4,1,1,6,Mid-Value,Potential Loyalists
10072,313,2,"121,45",5,1,1,7,Mid-Value,Potential Loyalists
10073,1110,2,"196,2",2,1,1,4,Low-Value,Can't Lose
10074,86,4,"429,2",5,1,1,7,Mid-Value,Potential Loyalists
10075,240,2,"46,3",5,1,1,7,Mid-Value,Potential Loyalists
10076,224,2,"274,85",5,1,1,7,Mid-Value,Potential Loyalists
10077,745,2,"124,4",3,1,1,5,Low-Value,At Risk Customers
10078,858,5,"351,65",3,1,1,5,Low-Value,At Risk Customers
10080,143,9,"788,3",5,2,2,9,High-Value,Champions
10081,847,1,"34,5",3,1,1,5,Low-Value,At Risk Customers
10082,1545,1,"68,0",1,1,1,3,Low-Value,Lost
10083,1126,3,"432,8",2,1,1,4,Low-Value,Can't Lose
10084,529,1,"6,1",4,1,1,6,Mid-Value,Potential Loyalists
10085,181,5,"300,6",5,1,1,7,Mid-Value,Potential Loyalists
10086,1236,2,"230,75",2,1,1,4,Low-Value,Can't Lose
10087,80,4,"384,55",5,1,1,7,Mid-Value,Potential Loyalists
10089,473,5,"99,35",4,1,1,6,Mid-Value,Potential Loyalists
10090,81,9,"687,65",5,2,2,9,High-Value,Champions
10091,1317,3,"83,39999999999999",2,1,1,4,Low-Value,Can't Lose
10092,72,3,"68,15",5,1,1,7,Mid-Value,Potential Loyalists
10093,1355,4,"462,6",2,1,1,4,Low-Value,Can't Lose
10095,200,5,"116,0",5,1,1,7,Mid-Value,Potential Loyalists
10096,66,7,"434,09999999999997",5,2,1,8,High-Value,Potential Loyalists
10098,957,1,"61,15",3,1,1,5,Low-Value,At Risk Customers
10101,813,3,"106,60000000000001",3,1,1,5,Low-Value,At Risk Customers
10103,550,4,"321,8",4,1,1,6,Mid-Value,Potential Loyalists
10104,953,2,"30,150000000000002",3,1,1,5,Low-Value,At Risk Customers
10105,29,2,"89,3",5,1,1,7,Mid-Value,Potential Loyalists
10106,201,1,"47,9",5,1,1,7,Mid-Value,Potential Loyalists
10107,197,8,"458,2",5,2,1,8,High-Value,Potential Loyalists
10108,940,3,"297,15",3,1,1,5,Low-Value,At Risk Customers
10111,1007,4,"95,15",3,1,1,5,Low-Value,At Risk Customers
10112,20,1,"28,9",5,1,1,7,Mid-Value,Potential Loyalists
10113,554,5,"147,2",4,1,1,6,Mid-Value,Potential Loyalists
10114,141,8,"508,1",5,2,1,8,High-Value,Potential Loyalists
10116,1340,2,"33,25",2,1,1,4,Low-Value,Can't Lose
10117,1253,2,"80,35",2,1,1,4,Low-Value,Can't Lose
10118,1295,4,"117,15",2,1,1,4,Low-Value,Can't Lose
10119,306,1,"9,3",5,1,1,7,Mid-Value,Potential Loyalists
10120,201,1,"338,1",5,1,1,7,Mid-Value,Potential Loyalists
10121,768,7,"692,9",3,2,2,7,Mid-Value,Potential Loyalists
10122,589,2,"142,3",4,1,1,6,Mid-Value,Potential Loyalists
10123,402,3,"41,0",4,1,1,6,Mid-Value,Potential Loyalists
10124,558,3,"138,10000000000002",4,1,1,6,Mid-Value,Potential Loyalists
10126,202,4,"253,29999999999998",5,1,1,7,Mid-Value,Potential Loyalists
10129,36,1,"22,799999999999997",5,1,1,7,Mid-Value,Potential Loyalists
10132,1149,2,"65,6",2,1,1,4,Low-Value,Can't Lose
10133,649,3,"72,0",4,1,1,6,Mid-Value,Potential Loyalists
10134,1065,1,"107,2",3,1,1,5,Low-Value,At Risk Customers
10135,591,1,"110,15",4,1,1,6,Mid-Value,Potential Loyalists
10137,862,2,"63,400000000000006",3,1,1,5,Low-Value,At Risk Customers
10138,933,1,"89,8",3,1,1,5,Low-Value,At Risk Customers
10139,66,2,"396,15",5,1,1,7,Mid-Value,Potential Loyalists
10140,113,2,"32,95",5,1,1,7,Mid-Value,Potential Loyalists
10141,177,4,"149,1",5,1,1,7,Mid-Value,Potential Loyalists
10142,26,2,"168,0",5,1,1,7,Mid-Value,Potential Loyalists
10143,462,1,"58,6",4,1,1,6,Mid-Value,Potential Loyalists
10144,317,3,"55,45",5,1,1,7,Mid-Value,Potential Loyalists
10145,1028,3,"107,0",3,1,1,5,Low-Value,At Risk Customers
10146,485,2,"78,14999999999999",4,1,1,6,Mid-Value,Potential Loyalists
10148,1252,1,"29,15",2,1,1,4,Low-Value,Can't Lose
10150,1347,1,"17,25",2,1,1,4,Low-Value,Can't Lose
10152,896,4,"133,05",3,1,1,5,Low-Value,At Risk Customers
10154,1190,3,"239,5",2,1,1,4,Low-Value,Can't Lose
10155,1419,1,"19,7",2,1,1,4,Low-Value,Can't Lose
10157,173,2,"82,1",5,1,1,7,Mid-Value,Potential Loyalists
10159,395,1,"463,8",4,1,1,6,Mid-Value,Potential Loyalists
10161,1059,1,"58,0",3,1,1,5,Low-Value,At Risk Customers
10165,440,5,"293,25",4,1,1,6,Mid-Value,Potential Loyalists
10167,382,2,"47,7",4,1,1,6,Mid-Value,Potential Loyalists
10168,739,1,"13,3",3,1,1,5,Low-Value,At Risk Customers
10169,773,5,"155,3",3,1,1,5,Low-Value,At Risk Customers
10170,949,1,"87,15",3,1,1,5,Low-Value,At Risk Customers
10171,621,6,"141,0",4,1,1,6,Mid-Value,Potential Loyalists
10172,1273,1,"491,6",2,1,1,4,Low-Value,Can't Lose
10173,280,2,"48,55",5,1,1,7,Mid-Value,Potential Loyalists
10174,357,1,"49,0",5,1,1,7,Mid-Value,Potential Loyalists
10175,5,15,"1105,95",5,3,2,10,High-Value,Champions
10177,922,1,"22,4",3,1,1,5,Low-Value,At Risk Customers
10178,136,4,"176,6",5,1,1,7,Mid-Value,Potential Loyalists
10179,326,3,"157,45",5,1,1,7,Mid-Value,Potential Loyalists
10180,215,1,"4,6",5,1,1,7,Mid-Value,Potential Loyalists
10181,1113,5,"333,9",2,1,1,4,Low-Value,Can't Lose
10182,440,2,"42,260000000000005",4,1,1,6,Mid-Value,Potential Loyalists
10183,867,1,"35,7",3,1,1,5,Low-Value,At Risk Customers
10186,103,2,"176,7",5,1,1,7,Mid-Value,Potential Loyalists
10187,788,7,"503,0",3,2,1,6,Mid-Value,Potential Loyalists
10188,1765,1,"17,6",1,1,1,3,Low-Value,Lost
10189,128,2,"133,4",5,1,1,7,Mid-Value,Potential Loyalists
10190,535,4,"376,84999999999997",4,1,1,6,Mid-Value,Potential Loyalists
10192,1501,2,"58,75",1,1,1,3,Low-Value,Lost
10193,905,2,"79,1",3,1,1,5,Low-Value,At Risk Customers
10194,1185,3,"528,65",2,1,1,4,Low-Value,Can't Lose
10195,27,4,"364,75",5,1,1,7,Mid-Value,Potential Loyalists
10196,403,4,"181,65",4,1,1,6,Mid-Value,Potential Loyalists
10197,266,2,"48,5",5,1,1,7,Mid-Value,Potential Loyalists
10201,1339,2,"84,0",2,1,1,4,Low-Value,Can't Lose
10203,35,5,"177,7",5,1,1,7,Mid-Value,Potential Loyalists
10204,928,1,"18,9",3,1,1,5,Low-Value,At Risk Customers
10207,3,4,"226,5",5,1,1,7,Mid-Value,Potential Loyalists
10208,318,3,"177,60000000000002",5,1,1,7,Mid-Value,Potential Loyalists
10209,4,2,"58,5",5,1,1,7,Mid-Value,Potential Loyalists
10211,699,2,"51,9",4,1,1,6,Mid-Value,Potential Loyalists
10212,784,3,"247,25",3,1,1,5,Low-Value,At Risk Customers
10214,1515,3,"149,6",1,1,1,3,Low-Value,Lost
10216,1026,1,"42,15",3,1,1,5,Low-Value,At Risk Customers
10217,13,4,"268,0",5,1,1,7,Mid-Value,Potential Loyalists
10218,4,1,"20,6",5,1,1,7,Mid-Value,Potential Loyalists
10219,31,7,"331,45",5,2,1,8,High-Value,Potential Loyalists
10220,413,1,"68,1",4,1,1,6,Mid-Value,Potential Loyalists
10222,504,2,"227,5",4,1,1,6,Mid-Value,Potential Loyalists
10223,787,3,"157,85",3,1,1,5,Low-Value,At Risk Customers
10224,166,6,"345,6",5,1,1,7,Mid-Value,Potential Loyalists
10225,174,3,"299,1",5,1,1,7,Mid-Value,Potential Loyalists
10227,639,12,"402,3",4,3,1,8,High-Value,Potential Loyalists
10228,894,1,"18,7",3,1,1,5,Low-Value,At Risk Customers
10229,248,6,"282,05",5,1,1,7,Mid-Value,Potential Loyalists
10230,1485,3,"158,15",1,1,1,3,Low-Value,Lost
10233,1134,3,"177,7",2,1,1,4,Low-Value,Can't Lose
10234,694,1,"5,75",4,1,1,6,Mid-Value,Potential Loyalists
10236,1166,2,"694,3499999999999",2,1,2,5,Low-Value,At Risk Customers
10237,1001,5,"664,5",3,1,2,6,Mid-Value,Potential Loyalists
10241,1482,1,"241,0",1,1,1,3,Low-Value,Lost
10242,1162,1,"1,3",2,1,1,4,Low-Value,Can't Lose
10243,67,2,"125,65",5,1,1,7,Mid-Value,Potential Loyalists
10244,802,2,"65,95",3,1,1,5,Low-Value,At Risk Customers
10245,469,1,"3,6",4,1,1,6,Mid-Value,Potential Loyalists
10247,941,1,"26,5",3,1,1,5,Low-Value,At Risk Customers
10248,1127,1,"31,4",2,1,1,4,Low-Value,Can't Lose
10249,699,4,"173,3",4,1,1,6,Mid-Value,Potential Loyalists
10250,1691,1,"207,9",1,1,1,3,Low-Value,Lost
10251,657,4,"217,75000000000003",4,1,1,6,Mid-Value,Potential Loyalists
10254,378,1,"66,2",4,1,1,6,Mid-Value,Potential Loyalists
10255,1580,1,"19,7",1,1,1,3,Low-Value,Lost
10257,784,2,"143,54999999999998",3,1,1,5,Low-Value,At Risk Customers
10258,420,2,"138,8",4,1,1,6,Mid-Value,Potential Loyalists
10260,790,1,"49,5",3,1,1,5,Low-Value,At Risk Customers
10261,677,3,"15,8",4,1,1,6,Mid-Value,Potential Loyalists
10262,129,3,"258,8",5,1,1,7,Mid-Value,Potential Loyalists
10264,239,4,"174,65",5,1,1,7,Mid-Value,Potential Loyalists
10266,1204,1,"18,7",2,1,1,4,Low-Value,Can't Lose
10270,1241,1,"26,400000000000002",2,1,1,4,Low-Value,Can't Lose
10271,1587,1,"54,5",1,1,1,3,Low-Value,Lost
10273,140,9,"313,4",5,2,1,8,High-Value,Potential Loyalists
10274,16,2,"98,2",5,1,1,7,Mid-Value,Potential Loyalists
10275,689,1,"22,25",4,1,1,6,Mid-Value,Potential Loyalists
10276,1802,1,"33,6",1,1,1,3,Low-Value,Lost
10277,36,2,"165,8",5,1,1,7,Mid-Value,Potential Loyalists
10278,166,1,"5,8",5,1,1,7,Mid-Value,Potential Loyalists
10279,910,5,"280,65",3,1,1,5,Low-Value,At Risk Customers
10281,385,4,"352,15000000000003",4,1,1,6,Mid-Value,Potential Loyalists
10284,1819,1,"19,4",1,1,1,3,Low-Value,Lost
10286,777,6,"323,1",3,1,1,5,Low-Value,At Risk Customers
10289,834,1,"58,1",3,1,1,5,Low-Value,At Risk Customers
10290,1750,1,"22,5",1,1,1,3,Low-Value,Lost
10294,322,7,"304,9",5,2,1,8,High-Value,Potential Loyalists
10295,1511,1,"10,23",1,1,1,3,Low-Value,Lost
10296,845,1,"17,7",3,1,1,5,Low-Value,At Risk Customers
10298,489,2,"173,1",4,1,1,6,Mid-Value,Potential Loyalists
10300,129,1,"11,75",5,1,1,7,Mid-Value,Potential Loyalists
10304,10,4,"234,39999999999998",5,1,1,7,Mid-Value,Potential Loyalists
10305,119,1,"40,75",5,1,1,7,Mid-Value,Potential Loyalists
10306,1412,1,"86,4",2,1,1,4,Low-Value,Can't Lose
10310,1772,2,"53,0",1,1,1,3,Low-Value,Lost
10311,563,1,"1,4",4,1,1,6,Mid-Value,Potential Loyalists
10312,253,3,"134,4",5,1,1,7,Mid-Value,Potential Loyalists
10313,567,1,"94,0",4,1,1,6,Mid-Value,Potential Loyalists
10317,75,7,"510,1",5,2,1,8,High-Value,Potential Loyalists
10318,1706,2,"152,1",1,1,1,3,Low-Value,Lost
10319,1183,3,"466,79999999999995",2,1,1,4,Low-Value,Can't Lose
10320,120,1,"196,15",5,1,1,7,Mid-Value,Potential Loyalists
10321,49,10,"1129,2",5,2,2,9,High-Value,Champions
10322,306,5,"352,95",5,1,1,7,Mid-Value,Potential Loyalists
10324,909,1,"54,0",3,1,1,5,Low-Value,At Risk Customers
10326,405,3,"149,10000000000002",4,1,1,6,Mid-Value,Potential Loyalists
10328,482,4,"71,14999999999999",4,1,1,6,Mid-Value,Potential Loyalists
10330,299,3,"787,8",5,1,2,8,High-Value,Potential Loyalists
10331,72,6,"569,55",5,1,1,7,Mid-Value,Potential Loyalists
10333,1469,5,"293,45",1,1,1,3,Low-Value,Lost
10334,1507,1,"42,45",1,1,1,3,Low-Value,Lost
10336,181,2,"95,89999999999999",5,1,1,7,Mid-Value,Potential Loyalists
10337,686,2,"48,1",4,1,1,6,Mid-Value,Potential Loyalists
10338,904,6,"937,3",3,1,2,6,Mid-Value,Potential Loyalists
10339,783,9,"838,55",3,2,2,7,Mid-Value,Potential Loyalists
10341,215,2,"104,15",5,1,1,7,Mid-Value,Potential Loyalists
10342,131,6,"516,9",5,1,1,7,Mid-Value,Potential Loyalists
10343,227,1,"31,6",5,1,1,7,Mid-Value,Potential Loyalists
10344,498,5,"170,8",4,1,1,6,Mid-Value,Potential Loyalists
10345,359,3,"175,95",5,1,1,7,Mid-Value,Potential Loyalists
10346,45,2,"93,4",5,1,1,7,Mid-Value,Potential Loyalists
10347,802,4,"335,8",3,1,1,5,Low-Value,At Risk Customers
10348,525,2,"55,900000000000006",4,1,1,6,Mid-Value,Potential Loyalists
10349,864,6,"1344,2",3,1,3,7,Mid-Value,Potential Loyalists
10350,563,4,"201,25",4,1,1,6,Mid-Value,Potential Loyalists
10351,313,2,"58,35",5,1,1,7,Mid-Value,Potential Loyalists
10352,375,6,"833,3000000000001",4,1,2,7,Mid-Value,Potential Loyalists
10353,188,5,"415,15",5,1,1,7,Mid-Value,Potential Loyalists
10354,94,5,"653,1",5,1,1,7,Mid-Value,Potential Loyalists
10355,20,9,"349,3",5,2,1,8,High-Value,Potential Loyalists
10356,738,2,"147,7",3,1,1,5,Low-Value,At Risk Customers
10357,106,8,"411,04999999999995",5,2,1,8,High-Value,Potential Loyalists
10358,71,2,"107,3",5,1,1,7,Mid-Value,Potential Loyalists
10362,197,5,"337,8",5,1,1,7,Mid-Value,Potential Loyalists
10364,522,1,"45,0",4,1,1,6,Mid-Value,Potential Loyalists
10366,399,4,"228,9",4,1,1,6,Mid-Value,Potential Loyalists
10367,1463,1,"12,2",1,1,1,3,Low-Value,Lost
10368,541,1,"19,5",4,1,1,6,Mid-Value,Potential Loyalists
10369,1238,1,"82,8",2,1,1,4,Low-Value,Can't Lose
10371,1100,4,"408,7",2,1,1,4,Low-Value,Can't Lose
10372,1154,1,"14,75",2,1,1,4,Low-Value,Can't Lose
10373,687,2,"40,95",4,1,1,6,Mid-Value,Potential Loyalists
10375,1508,3,"129,65",1,1,1,3,Low-Value,Lost
10376,129,3,"94,30000000000001",5,1,1,7,Mid-Value,Potential Loyalists
10379,98,5,"139,85",5,1,1,7,Mid-Value,Potential Loyalists
10380,626,5,"286,6",4,1,1,6,Mid-Value,Potential Loyalists
10382,152,3,"129,9",5,1,1,7,Mid-Value,Potential Loyalists
10383,1280,4,"436,1",2,1,1,4,Low-Value,Can't Lose
10385,984,2,"114,7",3,1,1,5,Low-Value,At Risk Customers
10386,27,8,"331,0",5,2,1,8,High-Value,Potential Loyalists
10389,351,1,"34,05",5,1,1,7,Mid-Value,Potential Loyalists
10391,977,3,"124,5",3,1,1,5,Low-Value,At Risk Customers
10392,200,4,"191,8",5,1,1,7,Mid-Value,Potential Loyalists
10393,925,2,"29,15",3,1,1,5,Low-Value,At Risk Customers
10396,420,4,"93,05",4,1,1,6,Mid-Value,Potential Loyalists
10398,75,5,"385,3",5,1,1,7,Mid-Value,Potential Loyalists
10399,575,1,"193,8",4,1,1,6,Mid-Value,Potential Loyalists
10401,855,7,"697,1999999999999",3,2,2,7,Mid-Value,Potential Loyalists
10402,632,2,"52,45",4,1,1,6,Mid-Value,Potential Loyalists
10403,196,3,"98,9",5,1,1,7,Mid-Value,Potential Loyalists
10405,1138,1,"80,2",2,1,1,4,Low-Value,Can't Lose
10406,769,2,"139,9",3,1,1,5,Low-Value,At Risk Customers
10407,151,2,"86,5",5,1,1,7,Mid-Value,Potential Loyalists
10409,803,1,"202,8",3,1,1,5,Low-Value,At Risk Customers
10410,1,3,"95,35",5,1,1,7,Mid-Value,Potential Loyalists
10412,112,1,"36,55",5,1,1,7,Mid-Value,Potential Loyalists
10415,1274,2,"120,75",2,1,1,4,Low-Value,Can't Lose
10416,139,2,"88,2",5,1,1,7,Mid-Value,Potential Loyalists
10417,1755,2,"62,15",1,1,1,3,Low-Value,Lost
10418,447,4,"193,5",4,1,1,6,Mid-Value,Potential Loyalists
10419,232,5,"860,75",5,1,2,8,High-Value,Potential Loyalists
10420,712,1,"10,3",4,1,1,6,Mid-Value,Potential Loyalists
10421,872,1,"42,1",3,1,1,5,Low-Value,At Risk Customers
10422,948,1,"185,6",3,1,1,5,Low-Value,At Risk Customers
10424,624,1,"148,45",4,1,1,6,Mid-Value,Potential Loyalists
10428,56,2,"67,8",5,1,1,7,Mid-Value,Potential Loyalists
10429,1428,1,"16,8",2,1,1,4,Low-Value,Can't Lose
10430,631,3,"173,1",4,1,1,6,Mid-Value,Potential Loyalists
10431,15,6,"569,75",5,1,1,7,Mid-Value,Potential Loyalists
10432,751,3,"199,9",3,1,1,5,Low-Value,At Risk Customers
10433,152,8,"602,15",5,2,1,8,High-Value,Potential Loyalists
10434,1651,3,"245,35000000000002",1,1,1,3,Low-Value,Lost
10435,52,6,"157,1",5,1,1,7,Mid-Value,Potential Loyalists
10436,393,2,"24,1",4,1,1,6,Mid-Value,Potential Loyalists
10438,820,2,"119,15",3,1,1,5,Low-Value,At Risk Customers
10439,16,6,"419,6",5,1,1,7,Mid-Value,Potential Loyalists
10441,401,5,"159,25",4,1,1,6,Mid-Value,Potential Loyalists
10442,883,3,"153,45",3,1,1,5,Low-Value,At Risk Customers
10443,115,1,"5,4",5,1,1,7,Mid-Value,Potential Loyalists
10444,834,1,"32,3",3,1,1,5,Low-Value,At Risk Customers
10445,1535,4,"454,74999999999994",1,1,1,3,Low-Value,Lost
10446,98,10,"473,25",5,2,1,8,High-Value,Potential Loyalists
10448,634,2,"116,3",4,1,1,6,Mid-Value,Potential Loyalists
10449,10,13,"840,95",5,3,2,10,High-Value,Champions
10450,7,5,"380,4",5,1,1,7,Mid-Value,Potential Loyalists
10451,41,4,"294,35",5,1,1,7,Mid-Value,Potential Loyalists
10452,862,2,"133,65",3,1,1,5,Low-Value,At Risk Customers
10453,1729,1,"25,650000000000002",1,1,1,3,Low-Value,Lost
10458,47,3,"543,35",5,1,1,7,Mid-Value,Potential Loyalists
10460,1705,2,"104,2",1,1,1,3,Low-Value,Lost
10463,256,1,"63,9",5,1,1,7,Mid-Value,Potential Loyalists
10465,497,2,"76,15",4,1,1,6,Mid-Value,Potential Loyalists
10466,1354,2,"37,5",2,1,1,4,Low-Value,Can't Lose
10467,555,3,"156,55",4,1,1,6,Mid-Value,Potential Loyalists
10471,861,1,"78,8",3,1,1,5,Low-Value,At Risk Customers
10475,745,2,"73,2",3,1,1,5,Low-Value,At Risk Customers
10477,633,5,"199,35",4,1,1,6,Mid-Value,Potential Loyalists
10478,504,8,"592,0",4,2,1,7,Mid-Value,Potential Loyalists
10479,876,2,"67,9",3,1,1,5,Low-Value,At Risk Customers
10480,778,6,"140,85",3,1,1,5,Low-Value,At Risk Customers
10481,134,2,"67,3",5,1,1,7,Mid-Value,Potential Loyalists
10484,389,3,"37,2",4,1,1,6,Mid-Value,Potential Loyalists
10485,66,11,"443,6",5,2,1,8,High-Value,Potential Loyalists
10486,281,4,"206,3",5,1,1,7,Mid-Value,Potential Loyalists
10487,123,7,"455,65",5,2,1,8,High-Value,Potential Loyalists
10488,63,6,"194,9",5,1,1,7,Mid-Value,Potential Loyalists
10489,904,4,"215,55",3,1,1,5,Low-Value,At Risk Customers
10491,461,1,"12,85",4,1,1,6,Mid-Value,Potential Loyalists
10493,629,2,"41,1",4,1,1,6,Mid-Value,Potential Loyalists
10494,896,2,"136,0",3,1,1,5,Low-Value,At Risk Customers
10497,1225,1,"19,8",2,1,1,4,Low-Value,Can't Lose
10498,455,1,"53,3",4,1,1,6,Mid-Value,Potential Loyalists
10499,513,4,"490,54999999999995",4,1,1,6,Mid-Value,Potential Loyalists
10500,174,3,"254,95000000000002",5,1,1,7,Mid-Value,Potential Loyalists
10501,315,1,"17,9",5,1,1,7,Mid-Value,Potential Loyalists
10502,91,2,"19,4",5,1,1,7,Mid-Value,Potential Loyalists
10504,157,5,"610,45",5,1,1,7,Mid-Value,Potential Loyalists
10505,1472,3,"336,65",1,1,1,3,Low-Value,Lost
10507,84,2,"43,6",5,1,1,7,Mid-Value,Potential Loyalists
10508,162,6,"224,39999999999998",5,1,1,7,Mid-Value,Potential Loyalists
10509,15,2,"33,9",5,1,1,7,Mid-Value,Potential Loyalists
10511,575,7,"617,6",4,2,1,7,Mid-Value,Potential Loyalists
10512,12,3,"402,9",5,1,1,7,Mid-Value,Potential Loyalists
10513,384,4,"135,60000000000002",4,1,1,6,Mid-Value,Potential Loyalists
10514,251,7,"268,3",5,2,1,8,High-Value,Potential Loyalists
10515,375,11,"777,25",4,2,2,8,High-Value,Potential Loyalists
10516,913,4,"218,45",3,1,1,5,Low-Value,At Risk Customers
10519,327,7,"596,25",5,2,1,8,High-Value,Potential Loyalists
10522,763,3,"583,8",3,1,1,5,Low-Value,At Risk Customers
10523,123,1,"8,3",5,1,1,7,Mid-Value,Potential Loyalists
10524,519,2,"142,45",4,1,1,6,Mid-Value,Potential Loyalists
10525,1035,1,"18,15",3,1,1,5,Low-Value,At Risk Customers
10526,305,5,"114,4",5,1,1,7,Mid-Value,Potential Loyalists
10527,182,2,"292,35",5,1,1,7,Mid-Value,Potential Loyalists
10528,255,10,"448,1",5,2,1,8,High-Value,Potential Loyalists
10529,353,9,"1406,5",5,2,3,10,High-Value,Champions
10535,199,6,"99,65",5,1,1,7,Mid-Value,Potential Loyalists
10537,407,3,"1255,15",4,1,2,7,Mid-Value,Potential Loyalists
10539,1727,1,"46,65",1,1,1,3,Low-Value,Lost
10540,886,2,"101,60000000000001",3,1,1,5,Low-Value,At Risk Customers
10543,370,3,"255,45",4,1,1,6,Mid-Value,Potential Loyalists
10544,40,3,"252,2",5,1,1,7,Mid-Value,Potential Loyalists
10545,214,3,"166,9",5,1,1,7,Mid-Value,Potential Loyalists
10547,397,2,"51,1",4,1,1,6,Mid-Value,Potential Loyalists
10549,658,1,"56,5",4,1,1,6,Mid-Value,Potential Loyalists
10550,901,3,"130,95",3,1,1,5,Low-Value,At Risk Customers
10552,12,4,"276,59999999999997",5,1,1,7,Mid-Value,Potential Loyalists
10553,45,4,"287,9",5,1,1,7,Mid-Value,Potential Loyalists
10554,5,8,"901,9",5,2,2,9,High-Value,Champions
10555,57,4,"155,8",5,1,1,7,Mid-Value,Potential Loyalists
10556,406,4,"171,60000000000002",4,1,1,6,Mid-Value,Potential Loyalists
10557,455,3,"115,15",4,1,1,6,Mid-Value,Potential Loyalists
10558,1321,1,"106,65",2,1,1,4,Low-Value,Can't Lose
10559,628,3,"178,39999999999998",4,1,1,6,Mid-Value,Potential Loyalists
10560,456,4,"315,6",4,1,1,6,Mid-Value,Potential Loyalists
10561,155,6,"716,55",5,1,2,8,High-Value,Potential Loyalists
10562,170,3,"279,5",5,1,1,7,Mid-Value,Potential Loyalists
10565,13,11,"1176,95",5,2,2,9,High-Value,Champions
10566,809,1,"9,2",3,1,1,5,Low-Value,At Risk Customers
10567,1242,2,"463,5",2,1,1,4,Low-Value,Can't Lose
10568,284,3,"53,60000000000001",5,1,1,7,Mid-Value,Potential Loyalists
10569,1593,2,"127,39999999999999",1,1,1,3,Low-Value,Lost
10571,199,2,"72,2",5,1,1,7,Mid-Value,Potential Loyalists
10572,294,1,"13,4",5,1,1,7,Mid-Value,Potential Loyalists
10573,89,8,"357,95",5,2,1,8,High-Value,Potential Loyalists
10574,448,4,"201,5",4,1,1,6,Mid-Value,Potential Loyalists
10576,1238,2,"19,4",2,1,1,4,Low-Value,Can't Lose
10577,571,1,"54,9",4,1,1,6,Mid-Value,Potential Loyalists
10584,1246,1,"56,7",2,1,1,4,Low-Value,Can't Lose
10585,1521,2,"132,05",1,1,1,3,Low-Value,Lost
10586,96,9,"298,26",5,2,1,8,High-Value,Potential Loyalists
10590,1188,1,"31,2",2,1,1,4,Low-Value,Can't Lose
10591,102,4,"182,8",5,1,1,7,Mid-Value,Potential Loyalists
10592,399,3,"385,1",4,1,1,6,Mid-Value,Potential Loyalists
10593,343,3,"224,14999999999998",5,1,1,7,Mid-Value,Potential Loyalists
10594,421,2,"58,300000000000004",4,1,1,6,Mid-Value,Potential Loyalists
10595,1,9,"237,05",5,2,1,8,High-Value,Potential Loyalists
10596,735,5,"310,55",3,1,1,5,Low-Value,At Risk Customers
10597,677,2,"153,05",4,1,1,6,Mid-Value,Potential Loyalists
10599,65,2,"280,40000000000003",5,1,1,7,Mid-Value,Potential Loyalists
10602,251,5,"531,35",5,1,1,7,Mid-Value,Potential Loyalists
10606,15,3,"207,75",5,1,1,7,Mid-Value,Potential Loyalists
10607,633,2,"142,45",4,1,1,6,Mid-Value,Potential Loyalists
10609,31,4,"511,15",5,1,1,7,Mid-Value,Potential Loyalists
10613,655,6,"302,85",4,1,1,6,Mid-Value,Potential Loyalists
10614,937,4,"361,84999999999997",3,1,1,5,Low-Value,At Risk Customers
10615,17,1,"31,2",5,1,1,7,Mid-Value,Potential Loyalists
10617,841,2,"102,4",3,1,1,5,Low-Value,At Risk Customers
10618,1666,1,"204,9",1,1,1,3,Low-Value,Lost
10619,1047,3,"250,3",3,1,1,5,Low-Value,At Risk Customers
10621,165,4,"193,75",5,1,1,7,Mid-Value,Potential Loyalists
10622,348,2,"63,650000000000006",5,1,1,7,Mid-Value,Potential Loyalists
10624,28,4,"341,35",5,1,1,7,Mid-Value,Potential Loyalists
10625,89,4,"215,3",5,1,1,7,Mid-Value,Potential Loyalists
10626,1443,2,"21,45",2,1,1,4,Low-Value,Can't Lose
10627,71,4,"982,5999999999999",5,1,2,8,High-Value,Potential Loyalists
10628,49,7,"366,0",5,2,1,8,High-Value,Potential Loyalists
10629,1166,1,"17,25",2,1,1,4,Low-Value,Can't Lose
10630,497,2,"406,75",4,1,1,6,Mid-Value,Potential Loyalists
10631,886,4,"348,25",3,1,1,5,Low-Value,At Risk Customers
10632,1411,1,"11,95",2,1,1,4,Low-Value,Can't Lose
10633,551,4,"135,7",4,1,1,6,Mid-Value,Potential Loyalists
10634,1178,1,"7,6",2,1,1,4,Low-Value,Can't Lose
10635,11,2,"429,6",5,1,1,7,Mid-Value,Potential Loyalists
10637,611,3,"132,45",4,1,1,6,Mid-Value,Potential Loyalists
10638,605,5,"1081,85",4,1,2,7,Mid-Value,Potential Loyalists
10641,224,2,"131,14999999999998",5,1,1,7,Mid-Value,Potential Loyalists
10643,1463,1,"30,4",1,1,1,3,Low-Value,Lost
10646,9,3,"180,1",5,1,1,7,Mid-Value,Potential Loyalists
10647,797,8,"494,05",3,2,1,6,Mid-Value,Potential Loyalists
10651,811,1,"4,9",3,1,1,5,Low-Value,At Risk Customers
10652,655,3,"216,0",4,1,1,6,Mid-Value,Potential Loyalists
10653,790,2,"41,35",3,1,1,5,Low-Value,At Risk Customers
10654,869,1,"127,80000000000001",3,1,1,5,Low-Value,At Risk Customers
10657,769,1,"38,8",3,1,1,5,Low-Value,At Risk Customers
10659,61,3,"63,55",5,1,1,7,Mid-Value,Potential Loyalists
10660,522,3,"108,85",4,1,1,6,Mid-Value,Potential Loyalists
10661,169,2,"67,45",5,1,1,7,Mid-Value,Potential Loyalists
10662,1091,2,"45,18000000000001",3,1,1,5,Low-Value,At Risk Customers
10663,417,1,"17,55",4,1,1,6,Mid-Value,Potential Loyalists
10664,216,2,"43,45",5,1,1,7,Mid-Value,Potential Loyalists
10667,1508,2,"22,75",1,1,1,3,Low-Value,Lost
10668,409,3,"257,15",4,1,1,6,Mid-Value,Potential Loyalists
10671,1326,1,"21,45",2,1,1,4,Low-Value,Can't Lose
10673,24,3,"67,5",5,1,1,7,Mid-Value,Potential Loyalists
10674,522,3,"213,1",4,1,1,6,Mid-Value,Potential Loyalists
10675,292,2,"54,650000000000006",5,1,1,7,Mid-Value,Potential Loyalists
10676,942,5,"616,6999999999999",3,1,1,5,Low-Value,At Risk Customers
10677,999,1,"92,05",3,1,1,5,Low-Value,At Risk Customers
10678,43,3,"65,25",5,1,1,7,Mid-Value,Potential Loyalists
10679,1620,1,"92,5",1,1,1,3,Low-Value,Lost
10680,712,1,"5,95",4,1,1,6,Mid-Value,Potential Loyalists
10681,24,1,"250,5",5,1,1,7,Mid-Value,Potential Loyalists
10683,1229,2,"248,1",2,1,1,4,Low-Value,Can't Lose
10693,748,6,"688,6",3,1,2,6,Mid-Value,Potential Loyalists
10694,350,1,"17,85",5,1,1,7,Mid-Value,Potential Loyalists
10695,735,1,"14,5",3,1,1,5,Low-Value,At Risk Customers
10696,471,8,"417,75",4,2,1,7,Mid-Value,Potential Loyalists
10698,1330,3,"48,35",2,1,1,4,Low-Value,Can't Lose
10699,869,3,"311,7",3,1,1,5,Low-Value,At Risk Customers
10700,178,6,"799,1",5,1,2,8,High-Value,Potential Loyalists
10701,966,3,"48,65",3,1,1,5,Low-Value,At Risk Customers
10702,106,4,"33,05",5,1,1,7,Mid-Value,Potential Loyalists
10703,221,6,"394,25",5,1,1,7,Mid-Value,Potential Loyalists
10704,358,3,"184,4",5,1,1,7,Mid-Value,Potential Loyalists
10705,35,15,"1877,45",5,3,3,11,High-Value,Champions
10706,7,3,"244,6",5,1,1,7,Mid-Value,Potential Loyalists
10707,273,1,"755,0999999999999",5,1,2,8,High-Value,Potential Loyalists
10708,1579,2,"94,60000000000001",1,1,1,3,Low-Value,Lost
10709,69,3,"350,70000000000005",5,1,1,7,Mid-Value,Potential Loyalists
10710,269,1,"178,2",5,1,1,7,Mid-Value,Potential Loyalists
10711,634,1,"49,05",4,1,1,6,Mid-Value,Potential Loyalists
10712,74,3,"119,55000000000001",5,1,1,7,Mid-Value,Potential Loyalists
10717,1347,1,"45,6",2,1,1,4,Low-Value,Can't Lose
10718,633,2,"66,1",4,1,1,6,Mid-Value,Potential Loyalists
10720,397,1,"13,3",4,1,1,6,Mid-Value,Potential Loyalists
10724,177,4,"135,85",5,1,1,7,Mid-Value,Potential Loyalists
10725,902,2,"48,95",3,1,1,5,Low-Value,At Risk Customers
10726,27,3,"364,3",5,1,1,7,Mid-Value,Potential Loyalists
10727,511,3,"81,45",4,1,1,6,Mid-Value,Potential Loyalists
10728,1357,1,"43,15",2,1,1,4,Low-Value,Can't Lose
10729,266,7,"530,6",5,2,1,8,High-Value,Potential Loyalists
10733,325,5,"248,65",5,1,1,7,Mid-Value,Potential Loyalists
10735,223,4,"166,05",5,1,1,7,Mid-Value,Potential Loyalists
10740,1062,1,"42,75",3,1,1,5,Low-Value,At Risk Customers
10741,829,2,"125,35",3,1,1,5,Low-Value,At Risk Customers
10742,291,4,"58,2",5,1,1,7,Mid-Value,Potential Loyalists
10743,3,11,"473,15000000000003",5,2,1,8,High-Value,Potential Loyalists
10749,482,1,"39,4",4,1,1,6,Mid-Value,Potential Loyalists
10750,305,4,"59,5",5,1,1,7,Mid-Value,Potential Loyalists
10751,268,7,"373,0",5,2,1,8,High-Value,Potential Loyalists
10752,521,1,"6,7",4,1,1,6,Mid-Value,Potential Loyalists
10753,150,6,"420,8",5,1,1,7,Mid-Value,Potential Loyalists
10755,661,5,"313,8",4,1,1,6,Mid-Value,Potential Loyalists
10758,20,16,"754,7",5,3,2,10,High-Value,Champions
10760,236,2,"22,15",5,1,1,7,Mid-Value,Potential Loyalists
10761,49,2,"233,7",5,1,1,7,Mid-Value,Potential Loyalists
10763,132,1,"147,0",5,1,1,7,Mid-Value,Potential Loyalists
10764,1271,2,"25,2",2,1,1,4,Low-Value,Can't Lose
10765,264,8,"307,75",5,2,1,8,High-Value,Potential Loyalists
10766,16,4,"551,7",5,1,1,7,Mid-Value,Potential Loyalists
10770,1298,1,"85,05000000000001",2,1,1,4,Low-Value,Can't Lose
10773,1592,2,"85,9",1,1,1,3,Low-Value,Lost
10774,992,2,"899,0000000000001",3,1,2,6,Mid-Value,Potential Loyalists
10775,153,2,"52,8",5,1,1,7,Mid-Value,Potential Loyalists
10777,178,5,"473,94999999999993",5,1,1,7,Mid-Value,Potential Loyalists
10778,1315,3,"128,0",2,1,1,4,Low-Value,Can't Lose
10781,194,2,"297,1",5,1,1,7,Mid-Value,Potential Loyalists
10782,312,2,"130,45",5,1,1,7,Mid-Value,Potential Loyalists
10783,32,3,"153,5",5,1,1,7,Mid-Value,Potential Loyalists
10785,656,1,"57,0",4,1,1,6,Mid-Value,Potential Loyalists
10786,1772,1,"58,6",1,1,1,3,Low-Value,Lost
10787,1301,1,"35,7",2,1,1,4,Low-Value,Can't Lose
10788,514,3,"201,45",4,1,1,6,Mid-Value,Potential Loyalists
10789,1515,1,"15,15",1,1,1,3,Low-Value,Lost
10791,206,3,"252,15",5,1,1,7,Mid-Value,Potential Loyalists
10792,390,6,"326,3",4,1,1,6,Mid-Value,Potential Loyalists
10793,760,4,"269,2",3,1,1,5,Low-Value,At Risk Customers
10794,1763,1,"219,1",1,1,1,3,Low-Value,Lost
10797,16,3,"48,65",5,1,1,7,Mid-Value,Potential Loyalists
10799,197,1,"64,6",5,1,1,7,Mid-Value,Potential Loyalists
10801,960,2,"33,8",3,1,1,5,Low-Value,At Risk Customers
10802,784,2,"59,10000000000001",3,1,1,5,Low-Value,At Risk Customers
10803,1280,2,"27,150000000000002",2,1,1,4,Low-Value,Can't Lose
10807,262,4,"216,60000000000002",5,1,1,7,Mid-Value,Potential Loyalists
10809,87,3,"107,5",5,1,1,7,Mid-Value,Potential Loyalists
10810,1133,3,"236,39999999999998",2,1,1,4,Low-Value,Can't Lose
10812,524,1,"8,55",4,1,1,6,Mid-Value,Potential Loyalists
10813,139,5,"202,05",5,1,1,7,Mid-Value,Potential Loyalists
10814,341,7,"333,9",5,2,1,8,High-Value,Potential Loyalists
10818,893,4,"233,75",3,1,1,5,Low-Value,At Risk Customers
10823,69,2,"14,5",5,1,1,7,Mid-Value,Potential Loyalists
10824,1606,1,"169,8",1,1,1,3,Low-Value,Lost
10825,1672,1,"76,35",1,1,1,3,Low-Value,Lost
10826,391,5,"113,1",4,1,1,6,Mid-Value,Potential Loyalists
10827,817,2,"45,0",3,1,1,5,Low-Value,At Risk Customers
10830,662,1,"11,0",4,1,1,6,Mid-Value,Potential Loyalists
10831,444,3,"88,1",4,1,1,6,Mid-Value,Potential Loyalists
10833,793,2,"302,65",3,1,1,5,Low-Value,At Risk Customers
10834,384,1,"247,2",4,1,1,6,Mid-Value,Potential Loyalists
10835,53,6,"468,65000000000003",5,1,1,7,Mid-Value,Potential Loyalists
10838,12,7,"301,95",5,2,1,8,High-Value,Potential Loyalists
10844,621,3,"123,0",4,1,1,6,Mid-Value,Potential Loyalists
10845,1366,2,"36,650000000000006",2,1,1,4,Low-Value,Can't Lose
10849,1453,1,"29,2",2,1,1,4,Low-Value,Can't Lose
10850,421,1,"11,8",4,1,1,6,Mid-Value,Potential Loyalists
10851,381,4,"233,5",4,1,1,6,Mid-Value,Potential Loyalists
10852,396,5,"537,5",4,1,1,6,Mid-Value,Potential Loyalists
10854,54,2,"32,760000000000005",5,1,1,7,Mid-Value,Potential Loyalists
10855,589,4,"569,1500000000001",4,1,1,6,Mid-Value,Potential Loyalists
10856,213,9,"672,45",5,2,2,9,High-Value,Champions
10858,118,4,"67,25",5,1,1,7,Mid-Value,Potential Loyalists
10860,539,5,"518,5",4,1,1,6,Mid-Value,Potential Loyalists
10863,116,1,"38,3",5,1,1,7,Mid-Value,Potential Loyalists
10864,63,6,"187,6",5,1,1,7,Mid-Value,Potential Loyalists
10865,186,2,"38,300000000000004",5,1,1,7,Mid-Value,Potential Loyalists
10866,221,3,"264,85",5,1,1,7,Mid-Value,Potential Loyalists
10867,32,4,"121,8",5,1,1,7,Mid-Value,Potential Loyalists
10868,804,3,"47,9",3,1,1,5,Low-Value,At Risk Customers
10869,367,2,"306,25",4,1,1,6,Mid-Value,Potential Loyalists
10870,5,2,"59,599999999999994",5,1,1,7,Mid-Value,Potential Loyalists
10874,1267,1,"37,349999999999994",2,1,1,4,Low-Value,Can't Lose
10876,1669,2,"57,1",1,1,1,3,Low-Value,Lost
10877,1135,4,"92,1",2,1,1,4,Low-Value,Can't Lose
10878,539,3,"108,65",4,1,1,6,Mid-Value,Potential Loyalists
10879,1727,1,"20,2",1,1,1,3,Low-Value,Lost
10881,1816,1,"16,8",1,1,1,3,Low-Value,Lost
10882,168,1,"38,8",5,1,1,7,Mid-Value,Potential Loyalists
10885,274,1,"41,25",5,1,1,7,Mid-Value,Potential Loyalists
10886,46,2,"63,349999999999994",5,1,1,7,Mid-Value,Potential Loyalists
10888,519,2,"50,3",4,1,1,6,Mid-Value,Potential Loyalists
10889,265,4,"185,15",5,1,1,7,Mid-Value,Potential Loyalists
10890,421,2,"188,4",4,1,1,6,Mid-Value,Potential Loyalists
10891,74,9,"500,95",5,2,1,8,High-Value,Potential Loyalists
10892,409,8,"473,34999999999997",4,2,1,7,Mid-Value,Potential Loyalists
10893,1016,1,"36,65",3,1,1,5,Low-Value,At Risk Customers
10895,137,9,"829,3499999999999",5,2,2,9,High-Value,Champions
10896,226,1,"398,0",5,1,1,7,Mid-Value,Potential Loyalists
10898,19,3,"190,3",5,1,1,7,Mid-Value,Potential Loyalists
10900,857,1,"77,3",3,1,1,5,Low-Value,At Risk Customers
10901,22,8,"272,25",5,2,1,8,High-Value,Potential Loyalists
10904,971,2,"273,15",3,1,1,5,Low-Value,At Risk Customers
10905,145,4,"152,65",5,1,1,7,Mid-Value,Potential Loyalists
10906,97,4,"219,85000000000002",5,1,1,7,Mid-Value,Potential Loyalists
10908,768,2,"53,5",3,1,1,5,Low-Value,At Risk Customers
10909,157,4,"376,90000000000003",5,1,1,7,Mid-Value,Potential Loyalists
10910,899,2,"96,6",3,1,1,5,Low-Value,At Risk Customers
10912,1176,1,"10,45",2,1,1,4,Low-Value,Can't Lose
10913,1674,1,"97,05",1,1,1,3,Low-Value,Lost
10914,1607,2,"233,0",1,1,1,3,Low-Value,Lost
10917,9,7,"380,2",5,2,1,8,High-Value,Potential Loyalists
10918,1372,1,"56,7",2,1,1,4,Low-Value,Can't Lose
10920,279,3,"196,6",5,1,1,7,Mid-Value,Potential Loyalists
10925,1237,2,"140,6",2,1,1,4,Low-Value,Can't Lose
10926,643,2,"211,8",4,1,1,6,Mid-Value,Potential Loyalists
10927,934,1,"270,0",3,1,1,5,Low-Value,At Risk Customers
10928,218,3,"83,19999999999999",5,1,1,7,Mid-Value,Potential Loyalists
10929,1039,7,"773,4",3,2,2,7,Mid-Value,Potential Loyalists
10931,1234,1,"60,3",2,1,1,4,Low-Value,Can't Lose
10935,445,7,"650,6",4,2,1,7,Mid-Value,Potential Loyalists
10936,302,3,"106,35",5,1,1,7,Mid-Value,Potential Loyalists
10937,1076,2,"45,300000000000004",3,1,1,5,Low-Value,At Risk Customers
10938,21,7,"423,4",5,2,1,8,High-Value,Potential Loyalists
10939,220,5,"738,4499999999999",5,1,2,8,High-Value,Potential Loyalists
10940,201,2,"117,35",5,1,1,7,Mid-Value,Potential Loyalists
10941,12,6,"670,5500000000001",5,1,2,8,High-Value,Potential Loyalists
10942,1124,1,"21,5",2,1,1,4,Low-Value,Can't Lose
10943,1505,1,"7,25",1,1,1,3,Low-Value,Lost
10945,492,8,"574,4",4,2,1,7,Mid-Value,Potential Loyalists
10947,213,2,"523,1999999999999",5,1,1,7,Mid-Value,Potential Loyalists
10948,685,1,"65,75",4,1,1,6,Mid-Value,Potential Loyalists
10949,83,3,"274,0",5,1,1,7,Mid-Value,Potential Loyalists
10951,808,1,"90,8",3,1,1,5,Low-Value,At Risk Customers
10952,69,2,"42,9",5,1,1,7,Mid-Value,Potential Loyalists
10953,417,5,"209,4",4,1,1,6,Mid-Value,Potential Loyalists
10954,320,7,"684,0",5,2,2,9,High-Value,Champions
10956,1047,3,"131,9",3,1,1,5,Low-Value,At Risk Customers
10959,1201,2,"152,7",2,1,1,4,Low-Value,Can't Lose
10960,342,1,"45,75",5,1,1,7,Mid-Value,Potential Loyalists
10962,23,7,"426,1",5,2,1,8,High-Value,Potential Loyalists
10965,207,1,"284,0",5,1,1,7,Mid-Value,Potential Loyalists
10966,125,1,"285,29999999999995",5,1,1,7,Mid-Value,Potential Loyalists
10967,16,9,"946,25",5,2,2,9,High-Value,Champions
10968,159,3,"275,3",5,1,1,7,Mid-Value,Potential Loyalists
10969,523,9,"861,4",4,2,2,8,High-Value,Potential Loyalists
10970,765,4,"270,84999999999997",3,1,1,5,Low-Value,At Risk Customers
10972,84,5,"1027,5",5,1,2,8,High-Value,Potential Loyalists
10974,693,1,"250,7",4,1,1,6,Mid-Value,Potential Loyalists
10975,144,6,"470,95000000000005",5,1,1,7,Mid-Value,Potential Loyalists
10977,455,6,"236,85",4,1,1,6,Mid-Value,Potential Loyalists
10978,410,1,"10,6",4,1,1,6,Mid-Value,Potential Loyalists
10979,57,5,"153,8",5,1,1,7,Mid-Value,Potential Loyalists
10981,259,1,"63,2",5,1,1,7,Mid-Value,Potential Loyalists
10983,161,2,"198,95",5,1,1,7,Mid-Value,Potential Loyalists
10984,40,4,"387,9",5,1,1,7,Mid-Value,Potential Loyalists
10985,1470,1,"256,6",1,1,1,3,Low-Value,Lost
10988,25,3,"78,85",5,1,1,7,Mid-Value,Potential Loyalists
10990,151,8,"616,75",5,2,1,8,High-Value,Potential Loyalists
10991,953,1,"29,45",3,1,1,5,Low-Value,At Risk Customers
10992,862,2,"93,35",3,1,1,5,Low-Value,At Risk Customers
10993,977,3,"169,55",3,1,1,5,Low-Value,At Risk Customers
10994,175,3,"500,79999999999995",5,1,1,7,Mid-Value,Potential Loyalists
10995,892,4,"107,1",3,1,1,5,Low-Value,At Risk Customers
10997,1560,1,"9,8",1,1,1,3,Low-Value,Lost
10998,64,6,"1009,5",5,1,2,8,High-Value,Potential Loyalists
10999,681,3,"200,65",4,1,1,6,Mid-Value,Potential Loyalists
11000,32,4,"246,8",5,1,1,7,Mid-Value,Potential Loyalists
11002,1006,2,"54,75",3,1,1,5,Low-Value,At Risk Customers
11003,904,1,"51,8",3,1,1,5,Low-Value,At Risk Customers
11004,475,1,"37,4",4,1,1,6,Mid-Value,Potential Loyalists
11005,1446,2,"22,85",2,1,1,4,Low-Value,Can't Lose
11006,1614,1,"22,3",1,1,1,3,Low-Value,Lost
11007,343,7,"532,0",5,2,1,8,High-Value,Potential Loyalists
11008,654,5,"206,3",4,1,1,6,Mid-Value,Potential Loyalists
11010,376,3,"110,9",4,1,1,6,Mid-Value,Potential Loyalists
11011,860,3,"177,1",3,1,1,5,Low-Value,At Risk Customers
11012,786,2,"151,0",3,1,1,5,Low-Value,At Risk Customers
11013,634,5,"255,55",4,1,1,6,Mid-Value,Potential Loyalists
11014,382,4,"215,25",4,1,1,6,Mid-Value,Potential Loyalists
11015,201,5,"325,55",5,1,1,7,Mid-Value,Potential Loyalists
11016,197,4,"386,55",5,1,1,7,Mid-Value,Potential Loyalists
11018,804,2,"245,4",3,1,1,5,Low-Value,At Risk Customers
11019,262,3,"219,7",5,1,1,7,Mid-Value,Potential Loyalists
11023,81,7,"483,8",5,2,1,8,High-Value,Potential Loyalists
11025,1485,1,"171,8",1,1,1,3,Low-Value,Lost
11026,1229,1,"289,79999999999995",2,1,1,4,Low-Value,Can't Lose
11029,1114,2,"24,7",2,1,1,4,Low-Value,Can't Lose
11030,1471,1,"23,0",1,1,1,3,Low-Value,Lost
11031,1,10,"1018,45",5,2,2,9,High-Value,Champions
11034,1523,1,"25,6",1,1,1,3,Low-Value,Lost
11035,26,2,"337,25",5,1,1,7,Mid-Value,Potential Loyalists
11037,94,8,"247,8",5,2,1,8,High-Value,Potential Loyalists
11040,758,4,"613,75",3,1,1,5,Low-Value,At Risk Customers
11041,687,2,"139,60000000000002",4,1,1,6,Mid-Value,Potential Loyalists
11043,1762,1,"27,05",1,1,1,3,Low-Value,Lost
11044,187,6,"294,35",5,1,1,7,Mid-Value,Potential Loyalists
11046,1161,1,"19,5",2,1,1,4,Low-Value,Can't Lose
11047,908,2,"126,75",3,1,1,5,Low-Value,At Risk Customers
11048,406,3,"182,39999999999998",4,1,1,6,Mid-Value,Potential Loyalists
11050,979,1,"99,0",3,1,1,5,Low-Value,At Risk Customers
11054,754,5,"213,20000000000002",3,1,1,5,Low-Value,At Risk Customers
11056,1678,1,"89,4",1,1,1,3,Low-Value,Lost
11057,446,4,"38,6",4,1,1,6,Mid-Value,Potential Loyalists
11059,1350,2,"142,05",2,1,1,4,Low-Value,Can't Lose
11065,562,3,"137,75",4,1,1,6,Mid-Value,Potential Loyalists
11066,564,2,"35,9",4,1,1,6,Mid-Value,Potential Loyalists
11068,1081,1,"32,15",3,1,1,5,Low-Value,At Risk Customers
11071,1686,1,"392,3",1,1,1,3,Low-Value,Lost
11072,68,2,"21,15",5,1,1,7,Mid-Value,Potential Loyalists
11073,211,3,"77,2",5,1,1,7,Mid-Value,Potential Loyalists
11074,1448,3,"119,39999999999999",2,1,1,4,Low-Value,Can't Lose
11075,619,10,"515,9",4,2,1,7,Mid-Value,Potential Loyalists
11077,103,2,"83,6",5,1,1,7,Mid-Value,Potential Loyalists
11079,262,4,"235,35",5,1,1,7,Mid-Value,Potential Loyalists
11080,792,5,"96,1",3,1,1,5,Low-Value,At Risk Customers
11081,705,1,"11,8",4,1,1,6,Mid-Value,Potential Loyalists
11083,1169,5,"138,2",2,1,1,4,Low-Value,Can't Lose
11084,196,5,"385,25",5,1,1,7,Mid-Value,Potential Loyalists
11089,506,2,"305,85",4,1,1,6,Mid-Value,Potential Loyalists
11092,376,5,"269,1",4,1,1,6,Mid-Value,Potential Loyalists
11093,151,1,"14,5",5,1,1,7,Mid-Value,Potential Loyalists
11094,234,3,"72,5",5,1,1,7,Mid-Value,Potential Loyalists
11095,108,7,"335,25",5,2,1,8,High-Value,Potential Loyalists
11096,718,1,"18,2",4,1,1,6,Mid-Value,Potential Loyalists
11097,140,5,"90,2",5,1,1,7,Mid-Value,Potential Loyalists
11098,15,6,"131,3",5,1,1,7,Mid-Value,Potential Loyalists
11100,360,4,"183,75000000000003",5,1,1,7,Mid-Value,Potential Loyalists
11102,0,3,"356,5",5,1,1,7,Mid-Value,Potential Loyalists
11104,144,1,"47,6",5,1,1,7,Mid-Value,Potential Loyalists
11106,854,1,"60,5",3,1,1,5,Low-Value,At Risk Customers
11107,521,4,"199,1",4,1,1,6,Mid-Value,Potential Loyalists
11109,772,6,"174,79999999999998",3,1,1,5,Low-Value,At Risk Customers
11112,1144,1,"42,15",2,1,1,4,Low-Value,Can't Lose
11113,478,5,"206,59999999999997",4,1,1,6,Mid-Value,Potential Loyalists
11114,17,1,"153,8",5,1,1,7,Mid-Value,Potential Loyalists
11117,766,3,"71,0",3,1,1,5,Low-Value,At Risk Customers
11118,211,9,"413,04999999999995",5,2,1,8,High-Value,Potential Loyalists
11120,161,8,"994,85",5,2,2,9,High-Value,Champions
11122,747,4,"630,0999999999999",3,1,1,5,Low-Value,At Risk Customers
11123,527,3,"77,30000000000001",4,1,1,6,Mid-Value,Potential Loyalists
11124,1769,1,"5,9",1,1,1,3,Low-Value,Lost
11126,877,1,"19,3",3,1,1,5,Low-Value,At Risk Customers
11128,53,3,"68,05",5,1,1,7,Mid-Value,Potential Loyalists
11129,1027,3,"110,55000000000001",3,1,1,5,Low-Value,At Risk Customers
11130,908,2,"126,2",3,1,1,5,Low-Value,At Risk Customers
11131,1098,1,"35,5",2,1,1,4,Low-Value,Can't Lose
11133,358,1,"24,2",5,1,1,7,Mid-Value,Potential Loyalists
11134,586,4,"468,70000000000005",4,1,1,6,Mid-Value,Potential Loyalists
11135,1481,1,"14,25",1,1,1,3,Low-Value,Lost
11136,253,4,"210,55",5,1,1,7,Mid-Value,Potential Loyalists
11137,1044,2,"162,2",3,1,1,5,Low-Value,At Risk Customers
11139,1130,3,"219,04999999999998",2,1,1,4,Low-Value,Can't Lose
11142,208,4,"235,85",5,1,1,7,Mid-Value,Potential Loyalists
11143,748,5,"193,45",3,1,1,5,Low-Value,At Risk Customers
11145,312,1,"341,0",5,1,1,7,Mid-Value,Potential Loyalists
11146,101,3,"534,1",5,1,1,7,Mid-Value,Potential Loyalists
11147,1645,1,"482,0",1,1,1,3,Low-Value,Lost
11151,80,10,"922,5",5,2,2,9,High-Value,Champions
11153,472,1,"7,6",4,1,1,6,Mid-Value,Potential Loyalists
11154,175,2,"239,14999999999998",5,1,1,7,Mid-Value,Potential Loyalists
11156,1338,1,"55,5",2,1,1,4,Low-Value,Can't Lose
11157,148,2,"214,6",5,1,1,7,Mid-Value,Potential Loyalists
11158,1407,1,"18,75",2,1,1,4,Low-Value,Can't Lose
11159,1163,1,"82,25",2,1,1,4,Low-Value,Can't Lose
11161,99,3,"111,25",5,1,1,7,Mid-Value,Potential Loyalists
11164,904,1,"53,4",3,1,1,5,Low-Value,At Risk Customers
11165,964,4,"156,1",3,1,1,5,Low-Value,At Risk Customers
11166,342,5,"223,4",5,1,1,7,Mid-Value,Potential Loyalists
11167,155,5,"338,5",5,1,1,7,Mid-Value,Potential Loyalists
11168,419,3,"92,8",4,1,1,6,Mid-Value,Potential Loyalists
11169,222,4,"170,55",5,1,1,7,Mid-Value,Potential Loyalists
11170,1014,1,"57,2",3,1,1,5,Low-Value,At Risk Customers
11173,60,4,"117,5",5,1,1,7,Mid-Value,Potential Loyalists
11174,1134,1,"50,4",2,1,1,4,Low-Value,Can't Lose
11175,1104,1,"137,2",2,1,1,4,Low-Value,Can't Lose
11176,1252,1,"614,0",2,1,1,4,Low-Value,Can't Lose
11177,1630,1,"13,1",1,1,1,3,Low-Value,Lost
11178,419,6,"543,55",4,1,1,6,Mid-Value,Potential Loyalists
11179,29,2,"190,1",5,1,1,7,Mid-Value,Potential Loyalists
11180,434,2,"119,35",4,1,1,6,Mid-Value,Potential Loyalists
11181,4,10,"364,85",5,2,1,8,High-Value,Potential Loyalists
11182,931,2,"270,4",3,1,1,5,Low-Value,At Risk Customers
11183,158,6,"484,75",5,1,1,7,Mid-Value,Potential Loyalists
11184,963,4,"296,04999999999995",3,1,1,5,Low-Value,At Risk Customers
11185,877,3,"235,75",3,1,1,5,Low-Value,At Risk Customers
11186,773,1,"3,45",3,1,1,5,Low-Value,At Risk Customers
11187,431,5,"482,20000000000005",4,1,1,6,Mid-Value,Potential Loyalists
11188,797,2,"11,45",3,1,1,5,Low-Value,At Risk Customers
11191,22,4,"121,55",5,1,1,7,Mid-Value,Potential Loyalists
11192,188,5,"683,75",5,1,2,8,High-Value,Potential Loyalists
11194,56,6,"1370,15",5,1,3,9,High-Value,Champions
11197,28,4,"98,19999999999999",5,1,1,7,Mid-Value,Potential Loyalists
11198,1321,1,"22,15",2,1,1,4,Low-Value,Can't Lose
11202,541,7,"224,05",4,2,1,7,Mid-Value,Potential Loyalists
11203,1219,3,"174,9",2,1,1,4,Low-Value,Can't Lose
11204,1447,1,"58,6",2,1,1,4,Low-Value,Can't Lose
11206,260,4,"152,65",5,1,1,7,Mid-Value,Potential Loyalists
11209,1362,4,"372,95000000000005",2,1,1,4,Low-Value,Can't Lose
11210,503,4,"36,55",4,1,1,6,Mid-Value,Potential Loyalists
11211,593,5,"639,4",4,1,1,6,Mid-Value,Potential Loyalists
11212,18,2,"70,25",5,1,1,7,Mid-Value,Potential Loyalists
11213,81,1,"54,85",5,1,1,7,Mid-Value,Potential Loyalists
11216,1181,1,"6,35",2,1,1,4,Low-Value,Can't Lose
11217,302,2,"66,85",5,1,1,7,Mid-Value,Potential Loyalists
11218,1187,4,"88,95",2,1,1,4,Low-Value,Can't Lose
11219,319,2,"152,6",5,1,1,7,Mid-Value,Potential Loyalists
11220,52,2,"127,24999999999999",5,1,1,7,Mid-Value,Potential Loyalists
11222,63,1,"19,3",5,1,1,7,Mid-Value,Potential Loyalists
11223,105,3,"115,35",5,1,1,7,Mid-Value,Potential Loyalists
11227,508,4,"460,5",4,1,1,6,Mid-Value,Potential Loyalists
11229,564,3,"174,95",4,1,1,6,Mid-Value,Potential Loyalists
11230,644,2,"86,45",4,1,1,6,Mid-Value,Potential Loyalists
11231,430,3,"213,45",4,1,1,6,Mid-Value,Potential Loyalists
11232,490,2,"142,75",4,1,1,6,Mid-Value,Potential Loyalists
11233,444,5,"936,05",4,1,2,7,Mid-Value,Potential Loyalists
11234,787,3,"99,65",3,1,1,5,Low-Value,At Risk Customers
11237,1546,1,"19,8",1,1,1,3,Low-Value,Lost
11238,29,5,"225,8",5,1,1,7,Mid-Value,Potential Loyalists
11239,243,4,"99,2",5,1,1,7,Mid-Value,Potential Loyalists
11241,538,2,"145,5",4,1,1,6,Mid-Value,Potential Loyalists
11243,194,1,"65,85",5,1,1,7,Mid-Value,Potential Loyalists
11244,873,3,"117,2",3,1,1,5,Low-Value,At Risk Customers
11245,304,6,"521,05",5,1,1,7,Mid-Value,Potential Loyalists
11248,527,1,"28,7",4,1,1,6,Mid-Value,Potential Loyalists
11252,458,3,"60,9",4,1,1,6,Mid-Value,Potential Loyalists
11253,182,2,"157,0",5,1,1,7,Mid-Value,Potential Loyalists
11254,263,7,"336,95000000000005",5,2,1,8,High-Value,Potential Loyalists
11257,213,3,"157,8",5,1,1,7,Mid-Value,Potential Loyalists
11258,738,2,"69,25",3,1,1,5,Low-Value,At Risk Customers
11260,103,5,"385,05",5,1,1,7,Mid-Value,Potential Loyalists
11261,141,3,"58,5",5,1,1,7,Mid-Value,Potential Loyalists
11262,89,5,"184,25",5,1,1,7,Mid-Value,Potential Loyalists
11263,292,4,"91,85",5,1,1,7,Mid-Value,Potential Loyalists
11270,123,7,"498,65",5,2,1,8,High-Value,Potential Loyalists
11272,115,4,"156,60000000000002",5,1,1,7,Mid-Value,Potential Loyalists
11273,27,2,"136,45",5,1,1,7,Mid-Value,Potential Loyalists
11274,1571,2,"9,15",1,1,1,3,Low-Value,Lost
11275,390,7,"453,04999999999995",4,2,1,7,Mid-Value,Potential Loyalists
11276,1229,1,"118,5",2,1,1,4,Low-Value,Can't Lose
11278,231,3,"262,85",5,1,1,7,Mid-Value,Potential Loyalists
11279,513,4,"88,15",4,1,1,6,Mid-Value,Potential Loyalists
11280,347,1,"9,8",5,1,1,7,Mid-Value,Potential Loyalists
11281,1473,2,"117,4",1,1,1,3,Low-Value,Lost
11282,25,14,"666,65",5,3,2,10,High-Value,Champions
11284,382,4,"161,45",4,1,1,6,Mid-Value,Potential Loyalists
11285,246,1,"218,8",5,1,1,7,Mid-Value,Potential Loyalists
11286,54,6,"254,6",5,1,1,7,Mid-Value,Potential Loyalists
11287,29,5,"538,95",5,1,1,7,Mid-Value,Potential Loyalists
11288,1786,1,"75,9",1,1,1,3,Low-Value,Lost
11289,1677,2,"178,7",1,1,1,3,Low-Value,Lost
11290,1168,4,"96,0",2,1,1,4,Low-Value,Can't Lose
11292,1131,1,"35,2",2,1,1,4,Low-Value,Can't Lose
11294,24,4,"95,4",5,1,1,7,Mid-Value,Potential Loyalists
11295,508,2,"129,95",4,1,1,6,Mid-Value,Potential Loyalists
11296,1147,1,"5,35",2,1,1,4,Low-Value,Can't Lose
11298,584,5,"151,45",4,1,1,6,Mid-Value,Potential Loyalists
11299,370,4,"554,5",4,1,1,6,Mid-Value,Potential Loyalists
11301,389,5,"255,9",4,1,1,6,Mid-Value,Potential Loyalists
11302,22,1,"38,0",5,1,1,7,Mid-Value,Potential Loyalists
11305,378,3,"172,25",4,1,1,6,Mid-Value,Potential Loyalists
11306,1074,1,"14,9",3,1,1,5,Low-Value,At Risk Customers
11307,273,2,"29,05",5,1,1,7,Mid-Value,Potential Loyalists
11308,529,1,"116,15",4,1,1,6,Mid-Value,Potential Loyalists
11310,1453,2,"73,65",2,1,1,4,Low-Value,Can't Lose
11313,375,2,"91,9",4,1,1,6,Mid-Value,Potential Loyalists
11314,480,2,"113,80000000000001",4,1,1,6,Mid-Value,Potential Loyalists
11315,841,2,"17,7",3,1,1,5,Low-Value,At Risk Customers
11316,1224,2,"61,75",2,1,1,4,Low-Value,Can't Lose
11317,861,7,"296,8",3,2,1,6,Mid-Value,Potential Loyalists
11318,18,11,"637,4",5,2,1,8,High-Value,Potential Loyalists
11321,169,7,"534,45",5,2,1,8,High-Value,Potential Loyalists
11322,3,3,"68,1",5,1,1,7,Mid-Value,Potential Loyalists
11324,432,4,"57,9",4,1,1,6,Mid-Value,Potential Loyalists
11327,43,2,"80,7",5,1,1,7,Mid-Value,Potential Loyalists
11329,546,2,"44,7",4,1,1,6,Mid-Value,Potential Loyalists
11330,82,2,"82,25",5,1,1,7,Mid-Value,Potential Loyalists
11332,641,5,"320,3",4,1,1,6,Mid-Value,Potential Loyalists
11333,278,3,"96,7",5,1,1,7,Mid-Value,Potential Loyalists
11335,173,4,"217,55",5,1,1,7,Mid-Value,Potential Loyalists
11338,448,3,"163,75",4,1,1,6,Mid-Value,Potential Loyalists
11339,130,2,"197,75",5,1,1,7,Mid-Value,Potential Loyalists
11341,34,5,"186,18",5,1,1,7,Mid-Value,Potential Loyalists
11344,280,1,"109,35",5,1,1,7,Mid-Value,Potential Loyalists
11345,150,5,"182,6",5,1,1,7,Mid-Value,Potential Loyalists
11346,299,5,"530,5",5,1,1,7,Mid-Value,Potential Loyalists
11348,18,7,"323,3",5,2,1,8,High-Value,Potential Loyalists
11351,279,6,"224,8",5,1,1,7,Mid-Value,Potential Loyalists
11352,964,3,"80,25",3,1,1,5,Low-Value,At Risk Customers
11353,26,10,"199,6",5,2,1,8,High-Value,Potential Loyalists
11354,60,3,"49,05",5,1,1,7,Mid-Value,Potential Loyalists
11355,81,3,"69,35",5,1,1,7,Mid-Value,Potential Loyalists
11357,138,6,"669,3",5,1,2,8,High-Value,Potential Loyalists
11358,31,11,"459,85",5,2,1,8,High-Value,Potential Loyalists
11359,413,2,"212,2",4,1,1,6,Mid-Value,Potential Loyalists
11360,482,5,"376,2",4,1,1,6,Mid-Value,Potential Loyalists
11361,78,7,"220,7",5,2,1,8,High-Value,Potential Loyalists
11362,981,1,"1,75",3,1,1,5,Low-Value,At Risk Customers
11364,206,4,"208,45",5,1,1,7,Mid-Value,Potential Loyalists
11367,1490,2,"180,8",1,1,1,3,Low-Value,Lost
11368,1012,1,"71,55",3,1,1,5,Low-Value,At Risk Customers
11377,529,2,"137,1",4,1,1,6,Mid-Value,Potential Loyalists
11380,244,3,"60,75",5,1,1,7,Mid-Value,Potential Loyalists
11381,606,3,"134,7",4,1,1,6,Mid-Value,Potential Loyalists
11382,1573,1,"19,25",1,1,1,3,Low-Value,Lost
11383,421,4,"280,0",4,1,1,6,Mid-Value,Potential Loyalists
11384,1439,1,"16,3",2,1,1,4,Low-Value,Can't Lose
11386,572,1,"115,9",4,1,1,6,Mid-Value,Potential Loyalists
11390,350,1,"8,05",5,1,1,7,Mid-Value,Potential Loyalists
11391,268,2,"11,55",5,1,1,7,Mid-Value,Potential Loyalists
11392,495,5,"340,05",4,1,1,6,Mid-Value,Potential Loyalists
11393,63,6,"326,1",5,1,1,7,Mid-Value,Potential Loyalists
11395,421,1,"37,5",4,1,1,6,Mid-Value,Potential Loyalists
11396,24,6,"557,2",5,1,1,7,Mid-Value,Potential Loyalists
11397,375,2,"29,0",4,1,1,6,Mid-Value,Potential Loyalists
11398,124,7,"387,95",5,2,1,8,High-Value,Potential Loyalists
11399,927,3,"237,3",3,1,1,5,Low-Value,At Risk Customers
11400,558,2,"46,55",4,1,1,6,Mid-Value,Potential Loyalists
11401,44,14,"516,25",5,3,1,9,High-Value,Champions
11402,780,1,"20,5",3,1,1,5,Low-Value,At Risk Customers
11403,83,3,"90,55",5,1,1,7,Mid-Value,Potential Loyalists
11404,344,4,"536,45",5,1,1,7,Mid-Value,Potential Loyalists
11405,1142,2,"52,8",2,1,1,4,Low-Value,Can't Lose
11406,496,2,"168,4",4,1,1,6,Mid-Value,Potential Loyalists
11407,259,2,"17,7",5,1,1,7,Mid-Value,Potential Loyalists
11409,95,4,"208,85",5,1,1,7,Mid-Value,Potential Loyalists
11410,685,2,"366,95",4,1,1,6,Mid-Value,Potential Loyalists
11411,67,7,"177,25",5,2,1,8,High-Value,Potential Loyalists
11412,169,5,"491,8",5,1,1,7,Mid-Value,Potential Loyalists
11413,1314,2,"110,7",2,1,1,4,Low-Value,Can't Lose
11414,213,7,"443,75",5,2,1,8,High-Value,Potential Loyalists
11415,237,5,"490,94999999999993",5,1,1,7,Mid-Value,Potential Loyalists
11416,857,1,"12,5",3,1,1,5,Low-Value,At Risk Customers
11417,45,4,"194,15",5,1,1,7,Mid-Value,Potential Loyalists
11418,214,7,"698,45",5,2,2,9,High-Value,Champions
11419,23,1,"184,1",5,1,1,7,Mid-Value,Potential Loyalists
11420,315,5,"207,25",5,1,1,7,Mid-Value,Potential Loyalists
11421,571,1,"172,2",4,1,1,6,Mid-Value,Potential Loyalists
11423,1442,1,"6,7",2,1,1,4,Low-Value,Can't Lose
11425,607,4,"321,25",4,1,1,6,Mid-Value,Potential Loyalists
11426,126,2,"133,55",5,1,1,7,Mid-Value,Potential Loyalists
11428,1196,1,"7,0",2,1,1,4,Low-Value,Can't Lose
11432,428,3,"285,9",4,1,1,6,Mid-Value,Potential Loyalists
11436,42,1,"26,5",5,1,1,7,Mid-Value,Potential Loyalists
11437,1261,3,"40,25",2,1,1,4,Low-Value,Can't Lose
11438,1097,2,"119,5",2,1,1,4,Low-Value,Can't Lose
11440,238,7,"481,6",5,2,1,8,High-Value,Potential Loyalists
11441,425,1,"28,0",4,1,1,6,Mid-Value,Potential Loyalists
11442,85,2,"64,8",5,1,1,7,Mid-Value,Potential Loyalists
11444,214,2,"103,25",5,1,1,7,Mid-Value,Potential Loyalists
11445,1224,1,"166,8",2,1,1,4,Low-Value,Can't Lose
11446,556,1,"101,1",4,1,1,6,Mid-Value,Potential Loyalists
11448,45,6,"445,15",5,1,1,7,Mid-Value,Potential Loyalists
11449,173,1,"53,5",5,1,1,7,Mid-Value,Potential Loyalists
11452,431,6,"129,95",4,1,1,6,Mid-Value,Potential Loyalists
11453,598,3,"80,0",4,1,1,6,Mid-Value,Potential Loyalists
11454,18,4,"619,3",5,1,1,7,Mid-Value,Potential Loyalists
11456,120,11,"414,15",5,2,1,8,High-Value,Potential Loyalists
11460,46,2,"623,4",5,1,1,7,Mid-Value,Potential Loyalists
11461,176,10,"949,2",5,2,2,9,High-Value,Champions
11463,234,6,"247,60000000000002",5,1,1,7,Mid-Value,Potential Loyalists
11464,1763,1,"171,14999999999998",1,1,1,3,Low-Value,Lost
11469,704,3,"168,14999999999998",4,1,1,6,Mid-Value,Potential Loyalists
11470,1494,4,"299,85",1,1,1,3,Low-Value,Lost
11471,879,2,"183,89999999999998",3,1,1,5,Low-Value,At Risk Customers
11472,75,5,"231,95000000000002",5,1,1,7,Mid-Value,Potential Loyalists
11473,117,4,"373,75",5,1,1,7,Mid-Value,Potential Loyalists
11474,680,1,"27,8",4,1,1,6,Mid-Value,Potential Loyalists
11475,11,2,"41,05",5,1,1,7,Mid-Value,Potential Loyalists
11477,162,4,"134,2",5,1,1,7,Mid-Value,Potential Loyalists
11478,1061,1,"38,7",3,1,1,5,Low-Value,At Risk Customers
11479,999,1,"8,55",3,1,1,5,Low-Value,At Risk Customers
11480,414,5,"139,91",4,1,1,6,Mid-Value,Potential Loyalists
11484,89,10,"483,65",5,2,1,8,High-Value,Potential Loyalists
11485,23,7,"927,25",5,2,2,9,High-Value,Champions
11486,746,3,"190,65",3,1,1,5,Low-Value,At Risk Customers
11488,393,5,"276,05",4,1,1,6,Mid-Value,Potential Loyalists
11489,789,2,"118,15",3,1,1,5,Low-Value,At Risk Customers
11491,615,3,"175,35000000000002",4,1,1,6,Mid-Value,Potential Loyalists
11493,38,2,"37,25",5,1,1,7,Mid-Value,Potential Loyalists
11497,1522,2,"43,2",1,1,1,3,Low-Value,Lost
11499,876,2,"86,1",3,1,1,5,Low-Value,At Risk Customers
11500,25,1,"34,4",5,1,1,7,Mid-Value,Potential Loyalists
11501,545,1,"125,1",4,1,1,6,Mid-Value,Potential Loyalists
11503,189,4,"398,95",5,1,1,7,Mid-Value,Potential Loyalists
11505,583,3,"115,9",4,1,1,6,Mid-Value,Potential Loyalists
11506,1356,2,"29,1",2,1,1,4,Low-Value,Can't Lose
11507,220,11,"624,35",5,2,1,8,High-Value,Potential Loyalists
11508,1307,3,"90,85000000000001",2,1,1,4,Low-Value,Can't Lose
11509,578,1,"36,4",4,1,1,6,Mid-Value,Potential Loyalists
11510,1309,2,"30,35",2,1,1,4,Low-Value,Can't Lose
11511,230,6,"261,35",5,1,1,7,Mid-Value,Potential Loyalists
11514,211,4,"103,30000000000001",5,1,1,7,Mid-Value,Potential Loyalists
11515,386,1,"50,4",4,1,1,6,Mid-Value,Potential Loyalists
11516,462,3,"211,45",4,1,1,6,Mid-Value,Potential Loyalists
11519,764,2,"118,05",3,1,1,5,Low-Value,At Risk Customers
11520,138,2,"227,6",5,1,1,7,Mid-Value,Potential Loyalists
11521,1497,2,"105,3",1,1,1,3,Low-Value,Lost
11524,629,2,"49,7",4,1,1,6,Mid-Value,Potential Loyalists
11528,131,3,"176,35",5,1,1,7,Mid-Value,Potential Loyalists
11529,927,7,"558,8000000000001",3,2,1,6,Mid-Value,Potential Loyalists
11531,12,1,"275,6",5,1,1,7,Mid-Value,Potential Loyalists
11532,246,6,"344,75",5,1,1,7,Mid-Value,Potential Loyalists
11534,19,1,"63,3",5,1,1,7,Mid-Value,Potential Loyalists
11535,1189,1,"77,25",2,1,1,4,Low-Value,Can't Lose
11537,290,1,"27,4",5,1,1,7,Mid-Value,Potential Loyalists
11538,73,4,"179,2",5,1,1,7,Mid-Value,Potential Loyalists
11539,1383,2,"60,550000000000004",2,1,1,4,Low-Value,Can't Lose
11540,147,8,"810,25",5,2,2,9,High-Value,Champions
11542,273,1,"14,95",5,1,1,7,Mid-Value,Potential Loyalists
11543,26,7,"333,35",5,2,1,8,High-Value,Potential Loyalists
11544,437,4,"339,35",4,1,1,6,Mid-Value,Potential Loyalists
11545,327,3,"140,55",5,1,1,7,Mid-Value,Potential Loyalists
11547,694,1,"11,7",4,1,1,6,Mid-Value,Potential Loyalists
11548,1074,1,"13,75",3,1,1,5,Low-Value,At Risk Customers
11549,208,2,"165,65",5,1,1,7,Mid-Value,Potential Loyalists
11552,620,2,"20,700000000000003",4,1,1,6,Mid-Value,Potential Loyalists
11553,158,5,"137,64999999999998",5,1,1,7,Mid-Value,Potential Loyalists
11555,108,1,"35,9",5,1,1,7,Mid-Value,Potential Loyalists
11558,176,8,"213,8",5,2,1,8,High-Value,Potential Loyalists
11559,18,10,"398,55",5,2,1,8,High-Value,Potential Loyalists
11560,858,2,"141,15",3,1,1,5,Low-Value,At Risk Customers
11562,1462,3,"185,4",1,1,1,3,Low-Value,Lost
11564,1127,3,"316,3",2,1,1,4,Low-Value,Can't Lose
11565,358,3,"152,25",5,1,1,7,Mid-Value,Potential Loyalists
11568,3,4,"241,5",5,1,1,7,Mid-Value,Potential Loyalists
11569,1527,2,"71,4",1,1,1,3,Low-Value,Lost
11570,1130,2,"123,9",2,1,1,4,Low-Value,Can't Lose
11571,172,8,"653,2",5,2,1,8,High-Value,Potential Loyalists
11572,241,1,"48,900000000000006",5,1,1,7,Mid-Value,Potential Loyalists
11573,89,3,"80,45",5,1,1,7,Mid-Value,Potential Loyalists
11574,40,3,"140,15",5,1,1,7,Mid-Value,Potential Loyalists
11576,837,3,"360,1",3,1,1,5,Low-Value,At Risk Customers
11577,13,8,"525,85",5,2,1,8,High-Value,Potential Loyalists
11579,532,4,"225,7",4,1,1,6,Mid-Value,Potential Loyalists
11580,11,3,"135,1",5,1,1,7,Mid-Value,Potential Loyalists
11581,710,1,"135,0",4,1,1,6,Mid-Value,Potential Loyalists
11583,388,1,"108,30000000000001",4,1,1,6,Mid-Value,Potential Loyalists
11584,379,2,"170,2",4,1,1,6,Mid-Value,Potential Loyalists
11585,1327,2,"13,7",2,1,1,4,Low-Value,Can't Lose
11587,168,3,"149,0",5,1,1,7,Mid-Value,Potential Loyalists
11589,276,1,"32,15",5,1,1,7,Mid-Value,Potential Loyalists
11590,1734,1,"30,8",1,1,1,3,Low-Value,Lost
11591,864,2,"196,2",3,1,1,5,Low-Value,At Risk Customers
11592,442,1,"56,0",4,1,1,6,Mid-Value,Potential Loyalists
11593,869,3,"108,25",3,1,1,5,Low-Value,At Risk Customers
11594,81,1,"44,35",5,1,1,7,Mid-Value,Potential Loyalists
11595,155,6,"428,5",5,1,1,7,Mid-Value,Potential Loyalists
11597,34,2,"27,0",5,1,1,7,Mid-Value,Potential Loyalists
11598,321,2,"53,0",5,1,1,7,Mid-Value,Potential Loyalists
11601,412,3,"216,25",4,1,1,6,Mid-Value,Potential Loyalists
11602,1505,3,"167,20000000000002",1,1,1,3,Low-Value,Lost
11603,304,4,"221,25",5,1,1,7,Mid-Value,Potential Loyalists
11604,448,1,"44,0",4,1,1,6,Mid-Value,Potential Loyalists
11605,708,1,"57,45",4,1,1,6,Mid-Value,Potential Loyalists
11606,379,4,"482,95",4,1,1,6,Mid-Value,Potential Loyalists
11608,730,2,"67,25",4,1,1,6,Mid-Value,Potential Loyalists
11609,794,2,"15,149999999999999",3,1,1,5,Low-Value,At Risk Customers
11611,1256,2,"373,75",2,1,1,4,Low-Value,Can't Lose
11612,118,6,"322,85",5,1,1,7,Mid-Value,Potential Loyalists
11613,440,1,"83,1",4,1,1,6,Mid-Value,Potential Loyalists
11615,10,5,"295,2",5,1,1,7,Mid-Value,Potential Loyalists
11617,119,2,"60,5",5,1,1,7,Mid-Value,Potential Loyalists
11618,707,3,"89,2",4,1,1,6,Mid-Value,Potential Loyalists
11621,388,15,"959,25",4,3,2,9,High-Value,Champions
11622,426,6,"568,9",4,1,1,6,Mid-Value,Potential Loyalists
11626,773,4,"151,6",3,1,1,5,Low-Value,At Risk Customers
11627,421,4,"399,45",4,1,1,6,Mid-Value,Potential Loyalists
11629,501,3,"97,6",4,1,1,6,Mid-Value,Potential Loyalists
11634,737,5,"315,79999999999995",3,1,1,5,Low-Value,At Risk Customers
11635,367,5,"371,5",4,1,1,6,Mid-Value,Potential Loyalists
11639,332,6,"909,6",5,1,2,8,High-Value,Potential Loyalists
11640,1383,1,"48,25",2,1,1,4,Low-Value,Can't Lose
11641,1487,3,"144,2",1,1,1,3,Low-Value,Lost
11642,1288,2,"260,15",2,1,1,4,Low-Value,Can't Lose
11644,470,2,"25,35",4,1,1,6,Mid-Value,Potential Loyalists
11647,1117,3,"99,6",2,1,1,4,Low-Value,Can't Lose
11648,43,5,"621,65",5,1,1,7,Mid-Value,Potential Loyalists
11650,17,2,"54,2",5,1,1,7,Mid-Value,Potential Loyalists
11653,400,6,"212,5",4,1,1,6,Mid-Value,Potential Loyalists
11655,640,3,"39,5",4,1,1,6,Mid-Value,Potential Loyalists
11656,164,6,"391,4",5,1,1,7,Mid-Value,Potential Loyalists
11657,30,10,"414,2",5,2,1,8,High-Value,Potential Loyalists
11659,1250,2,"70,5",2,1,1,4,Low-Value,Can't Lose
11660,183,5,"265,15",5,1,1,7,Mid-Value,Potential Loyalists
11662,1036,3,"166,3",3,1,1,5,Low-Value,At Risk Customers
11663,27,3,"252,65",5,1,1,7,Mid-Value,Potential Loyalists
11665,219,2,"163,7",5,1,1,7,Mid-Value,Potential Loyalists
11666,1386,1,"7,85",2,1,1,4,Low-Value,Can't Lose
11667,604,5,"407,90000000000003",4,1,1,6,Mid-Value,Potential Loyalists
11668,324,2,"108,65",5,1,1,7,Mid-Value,Potential Loyalists
11669,373,1,"19,8",4,1,1,6,Mid-Value,Potential Loyalists
11670,447,2,"100,05",4,1,1,6,Mid-Value,Potential Loyalists
11671,21,4,"229,25",5,1,1,7,Mid-Value,Potential Loyalists
11672,762,1,"34,4",3,1,1,5,Low-Value,At Risk Customers
11673,648,8,"392,75",4,2,1,7,Mid-Value,Potential Loyalists
11674,505,2,"238,0",4,1,1,6,Mid-Value,Potential Loyalists
11676,41,7,"149,4",5,2,1,8,High-Value,Potential Loyalists
11677,732,1,"10,9",3,1,1,5,Low-Value,At Risk Customers
11678,1301,1,"14,6",2,1,1,4,Low-Value,Can't Lose
11679,229,7,"916,0500000000001",5,2,2,9,High-Value,Champions
11681,931,2,"74,95",3,1,1,5,Low-Value,At Risk Customers
11683,1048,1,"5,95",3,1,1,5,Low-Value,At Risk Customers
11684,123,1,"11,3",5,1,1,7,Mid-Value,Potential Loyalists
11685,367,1,"150,8",4,1,1,6,Mid-Value,Potential Loyalists
11686,1431,1,"10,05",2,1,1,4,Low-Value,Can't Lose
11688,1195,4,"375,25",2,1,1,4,Low-Value,Can't Lose
11689,584,6,"271,75",4,1,1,6,Mid-Value,Potential Loyalists
11690,111,8,"686,55",5,2,2,9,High-Value,Champions
11691,355,4,"247,05",5,1,1,7,Mid-Value,Potential Loyalists
11693,844,1,"3,5",3,1,1,5,Low-Value,At Risk Customers
11699,546,2,"249,54999999999998",4,1,1,6,Mid-Value,Potential Loyalists
11700,1,3,"151,25",5,1,1,7,Mid-Value,Potential Loyalists
11701,23,7,"384,09999999999997",5,2,1,8,High-Value,Potential Loyalists
11702,812,3,"143,5",3,1,1,5,Low-Value,At Risk Customers
11705,119,5,"635,15",5,1,1,7,Mid-Value,Potential Loyalists
11706,965,2,"111,0",3,1,1,5,Low-Value,At Risk Customers
11707,1617,1,"73,5",1,1,1,3,Low-Value,Lost
11708,389,3,"246,4",4,1,1,6,Mid-Value,Potential Loyalists
11710,341,2,"92,15",5,1,1,7,Mid-Value,Potential Loyalists
11712,4,4,"710,05",5,1,2,8,High-Value,Potential Loyalists
11713,62,1,"9,7",5,1,1,7,Mid-Value,Potential Loyalists
11714,1514,1,"58,0",1,1,1,3,Low-Value,Lost
11715,994,1,"59,4",3,1,1,5,Low-Value,At Risk Customers
11716,22,5,"344,75",5,1,1,7,Mid-Value,Potential Loyalists
11717,66,4,"125,30000000000001",5,1,1,7,Mid-Value,Potential Loyalists
11719,551,5,"232,8",4,1,1,6,Mid-Value,Potential Loyalists
11721,735,1,"339,15",3,1,1,5,Low-Value,At Risk Customers
11723,863,3,"105,6",3,1,1,5,Low-Value,At Risk Customers
11724,353,3,"103,1",5,1,1,7,Mid-Value,Potential Loyalists
11726,667,8,"664,9",4,2,2,8,High-Value,Potential Loyalists
11727,388,2,"79,15",4,1,1,6,Mid-Value,Potential Loyalists
11728,874,5,"254,55",3,1,1,5,Low-Value,At Risk Customers
11730,122,3,"341,9",5,1,1,7,Mid-Value,Potential Loyalists
11733,41,6,"269,25",5,1,1,7,Mid-Value,Potential Loyalists
11734,8,11,"462,59999999999997",5,2,1,8,High-Value,Potential Loyalists
11736,1330,3,"335,15",2,1,1,4,Low-Value,Can't Lose
11737,196,12,"788,95",5,3,2,10,High-Value,Champions
11738,585,3,"134,4",4,1,1,6,Mid-Value,Potential Loyalists
11740,835,1,"42,45",3,1,1,5,Low-Value,At Risk Customers
11742,419,4,"226,85",4,1,1,6,Mid-Value,Potential Loyalists
11744,136,8,"1174,5",5,2,2,9,High-Value,Champions
11745,517,3,"291,7",4,1,1,6,Mid-Value,Potential Loyalists
11746,969,2,"83,3",3,1,1,5,Low-Value,At Risk Customers
11748,49,7,"238,0",5,2,1,8,High-Value,Potential Loyalists
11752,973,1,"32,25",3,1,1,5,Low-Value,At Risk Customers
11754,94,5,"298,5",5,1,1,7,Mid-Value,Potential Loyalists
11755,1470,2,"181,9",1,1,1,3,Low-Value,Lost
11756,836,7,"468,6",3,2,1,6,Mid-Value,Potential Loyalists
11757,536,5,"559,95",4,1,1,6,Mid-Value,Potential Loyalists
11760,385,5,"428,0",4,1,1,6,Mid-Value,Potential Loyalists
11761,1115,2,"385,2",2,1,1,4,Low-Value,Can't Lose
11763,970,3,"207,8",3,1,1,5,Low-Value,At Risk Customers
11764,1103,1,"78,5",2,1,1,4,Low-Value,Can't Lose
11765,19,1,"20,9",5,1,1,7,Mid-Value,Potential Loyalists
11767,739,2,"405,90000000000003",3,1,1,5,Low-Value,At Risk Customers
11768,389,5,"546,9000000000001",4,1,1,6,Mid-Value,Potential Loyalists
11769,245,6,"126,1",5,1,1,7,Mid-Value,Potential Loyalists
11770,756,8,"580,25",3,2,1,6,Mid-Value,Potential Loyalists
11771,155,1,"6,6000000000000005",5,1,1,7,Mid-Value,Potential Loyalists
11772,954,2,"60,300000000000004",3,1,1,5,Low-Value,At Risk Customers
11774,250,2,"58,95",5,1,1,7,Mid-Value,Potential Loyalists
11776,773,3,"143,35",3,1,1,5,Low-Value,At Risk Customers
11777,903,2,"69,05",3,1,1,5,Low-Value,At Risk Customers
11778,775,2,"84,94999999999999",3,1,1,5,Low-Value,At Risk Customers
11779,36,4,"392,0",5,1,1,7,Mid-Value,Potential Loyalists
11783,1608,1,"348,75",1,1,1,3,Low-Value,Lost
11790,763,3,"230,2",3,1,1,5,Low-Value,At Risk Customers
11791,1110,3,"84,1",2,1,1,4,Low-Value,Can't Lose
11792,396,3,"218,5",4,1,1,6,Mid-Value,Potential Loyalists
11795,740,4,"158,6",3,1,1,5,Low-Value,At Risk Customers
11797,232,2,"30,76",5,1,1,7,Mid-Value,Potential Loyalists
11801,751,2,"117,55",3,1,1,5,Low-Value,At Risk Customers
11802,11,3,"71,35000000000001",5,1,1,7,Mid-Value,Potential Loyalists
11805,1164,1,"42,45",2,1,1,4,Low-Value,Can't Lose
11806,1175,3,"131,5",2,1,1,4,Low-Value,Can't Lose
11808,706,1,"26,6",4,1,1,6,Mid-Value,Potential Loyalists
11809,81,4,"181,7",5,1,1,7,Mid-Value,Potential Loyalists
11810,1094,1,"16,95",3,1,1,5,Low-Value,At Risk Customers
11812,957,1,"19,15",3,1,1,5,Low-Value,At Risk Customers
11813,370,1,"49,8",4,1,1,6,Mid-Value,Potential Loyalists
11815,821,1,"14,95",3,1,1,5,Low-Value,At Risk Customers
11816,971,4,"260,7",3,1,1,5,Low-Value,At Risk Customers
11817,4,4,"401,95",5,1,1,7,Mid-Value,Potential Loyalists
11818,287,6,"360,15",5,1,1,7,Mid-Value,Potential Loyalists
11819,123,4,"163,14999999999998",5,1,1,7,Mid-Value,Potential Loyalists
11820,302,1,"20,9",5,1,1,7,Mid-Value,Potential Loyalists
11822,730,1,"23,9",4,1,1,6,Mid-Value,Potential Loyalists
11825,186,5,"152,9",5,1,1,7,Mid-Value,Potential Loyalists
11826,968,1,"41,6",3,1,1,5,Low-Value,At Risk Customers
11829,1237,1,"125,4",2,1,1,4,Low-Value,Can't Lose
11830,553,4,"651,4",4,1,1,6,Mid-Value,Potential Loyalists
11831,151,6,"289,95",5,1,1,7,Mid-Value,Potential Loyalists
11832,1499,2,"60,5",1,1,1,3,Low-Value,Lost
11833,1234,1,"48,599999999999994",2,1,1,4,Low-Value,Can't Lose
11834,1134,5,"361,29999999999995",2,1,1,4,Low-Value,Can't Lose
11835,5,10,"494,45",5,2,1,8,High-Value,Potential Loyalists
11837,59,3,"512,25",5,1,1,7,Mid-Value,Potential Loyalists
11842,154,1,"24,4",5,1,1,7,Mid-Value,Potential Loyalists
11843,348,1,"7,35",5,1,1,7,Mid-Value,Potential Loyalists
11845,263,1,"74,35",5,1,1,7,Mid-Value,Potential Loyalists
11846,112,2,"72,6",5,1,1,7,Mid-Value,Potential Loyalists
11848,50,4,"119,5",5,1,1,7,Mid-Value,Potential Loyalists
11850,188,2,"509,45000000000005",5,1,1,7,Mid-Value,Potential Loyalists
11851,1362,2,"24,05",2,1,1,4,Low-Value,Can't Lose
11853,421,4,"126,85",4,1,1,6,Mid-Value,Potential Loyalists
11854,514,3,"55,8",4,1,1,6,Mid-Value,Potential Loyalists
11855,919,4,"400,3",3,1,1,5,Low-Value,At Risk Customers
11859,360,3,"54,75",5,1,1,7,Mid-Value,Potential Loyalists
11860,1684,1,"40,650000000000006",1,1,1,3,Low-Value,Lost
11862,836,1,"29,75",3,1,1,5,Low-Value,At Risk Customers
11864,1484,1,"103,95",1,1,1,3,Low-Value,Lost
11865,332,2,"143,3",5,1,1,7,Mid-Value,Potential Loyalists
11867,1036,2,"44,550000000000004",3,1,1,5,Low-Value,At Risk Customers
11869,71,11,"769,05",5,2,2,9,High-Value,Champions
11870,489,1,"41,3",4,1,1,6,Mid-Value,Potential Loyalists
11871,502,4,"71,65",4,1,1,6,Mid-Value,Potential Loyalists
11874,1525,3,"70,85",1,1,1,3,Low-Value,Lost
11875,732,2,"50,45",3,1,1,5,Low-Value,At Risk Customers
11877,1464,2,"274,05",1,1,1,3,Low-Value,Lost
11878,505,3,"393,2",4,1,1,6,Mid-Value,Potential Loyalists
11885,322,2,"23,85",5,1,1,7,Mid-Value,Potential Loyalists
11887,1311,1,"110,39999999999999",2,1,1,4,Low-Value,Can't Lose
11889,27,6,"337,59999999999997",5,1,1,7,Mid-Value,Potential Loyalists
11890,125,2,"378,4",5,1,1,7,Mid-Value,Potential Loyalists
11891,1470,1,"44,2",1,1,1,3,Low-Value,Lost
11892,1441,1,"167,8",2,1,1,4,Low-Value,Can't Lose
11894,137,4,"168,25",5,1,1,7,Mid-Value,Potential Loyalists
11896,73,6,"162,15",5,1,1,7,Mid-Value,Potential Loyalists
11897,143,4,"349,6",5,1,1,7,Mid-Value,Potential Loyalists
11901,194,2,"121,69999999999999",5,1,1,7,Mid-Value,Potential Loyalists
11902,21,3,"83,9",5,1,1,7,Mid-Value,Potential Loyalists
11903,1343,1,"53,65",2,1,1,4,Low-Value,Can't Lose
11906,412,5,"241,95",4,1,1,6,Mid-Value,Potential Loyalists
11908,840,1,"11,95",3,1,1,5,Low-Value,At Risk Customers
11910,417,2,"63,550000000000004",4,1,1,6,Mid-Value,Potential Loyalists
11911,195,4,"612,7",5,1,1,7,Mid-Value,Potential Loyalists
11912,397,6,"1176,95",4,1,2,7,Mid-Value,Potential Loyalists
11913,769,8,"407,05",3,2,1,6,Mid-Value,Potential Loyalists
11914,368,8,"386,15",4,2,1,7,Mid-Value,Potential Loyalists
11915,191,1,"84,3",5,1,1,7,Mid-Value,Potential Loyalists
11916,550,1,"255,75",4,1,1,6,Mid-Value,Potential Loyalists
11919,1304,1,"15,7",2,1,1,4,Low-Value,Can't Lose
11920,965,2,"52,099999999999994",3,1,1,5,Low-Value,At Risk Customers
11922,868,3,"281,45",3,1,1,5,Low-Value,At Risk Customers
11924,410,3,"287,29999999999995",4,1,1,6,Mid-Value,Potential Loyalists
11926,211,3,"87,44999999999999",5,1,1,7,Mid-Value,Potential Loyalists
11929,139,6,"612,45",5,1,1,7,Mid-Value,Potential Loyalists
11931,1339,2,"49,1",2,1,1,4,Low-Value,Can't Lose
11933,1317,1,"31,45",2,1,1,4,Low-Value,Can't Lose
11935,138,1,"81,1",5,1,1,7,Mid-Value,Potential Loyalists
11937,1146,1,"5,45",2,1,1,4,Low-Value,Can't Lose
11938,1063,2,"117,64999999999999",3,1,1,5,Low-Value,At Risk Customers
11939,117,13,"785,5",5,3,2,10,High-Value,Champions
11940,283,4,"114,85",5,1,1,7,Mid-Value,Potential Loyalists
11941,931,2,"91,05000000000001",3,1,1,5,Low-Value,At Risk Customers
11942,346,3,"91,89999999999999",5,1,1,7,Mid-Value,Potential Loyalists
11943,418,4,"328,55",4,1,1,6,Mid-Value,Potential Loyalists
11944,250,2,"62,8",5,1,1,7,Mid-Value,Potential Loyalists
11946,199,1,"133,0",5,1,1,7,Mid-Value,Potential Loyalists
11947,7,6,"397,7",5,1,1,7,Mid-Value,Potential Loyalists
11949,437,2,"367,15",4,1,1,6,Mid-Value,Potential Loyalists
11950,605,1,"16,799999999999997",4,1,1,6,Mid-Value,Potential Loyalists
11952,389,2,"36,05",4,1,1,6,Mid-Value,Potential Loyalists
11953,738,5,"251,8",3,1,1,5,Low-Value,At Risk Customers
11954,14,3,"313,65000000000003",5,1,1,7,Mid-Value,Potential Loyalists
11956,216,6,"632,15",5,1,1,7,Mid-Value,Potential Loyalists
11958,434,5,"112,75000000000001",4,1,1,6,Mid-Value,Potential Loyalists
11960,1273,2,"269,9",2,1,1,4,Low-Value,Can't Lose
11962,154,2,"256,2",5,1,1,7,Mid-Value,Potential Loyalists
11963,1457,3,"104,05",2,1,1,4,Low-Value,Can't Lose
11964,759,1,"111,0",3,1,1,5,Low-Value,At Risk Customers
11965,1106,6,"310,5",2,1,1,4,Low-Value,Can't Lose
11966,10,4,"391,65",5,1,1,7,Mid-Value,Potential Loyalists
11967,860,1,"166,8",3,1,1,5,Low-Value,At Risk Customers
11968,764,6,"303,55",3,1,1,5,Low-Value,At Risk Customers
11969,1378,2,"213,65",2,1,1,4,Low-Value,Can't Lose
11970,59,1,"17,6",5,1,1,7,Mid-Value,Potential Loyalists
11971,1015,1,"46,55",3,1,1,5,Low-Value,At Risk Customers
11972,684,3,"120,0",4,1,1,6,Mid-Value,Potential Loyalists
11974,278,1,"15,9",5,1,1,7,Mid-Value,Potential Loyalists
11975,1293,2,"67,85",2,1,1,4,Low-Value,Can't Lose
11976,957,3,"201,05",3,1,1,5,Low-Value,At Risk Customers
11977,132,1,"189,3",5,1,1,7,Mid-Value,Potential Loyalists
11978,734,3,"228,4",3,1,1,5,Low-Value,At Risk Customers
11979,269,1,"42,05",5,1,1,7,Mid-Value,Potential Loyalists
11980,224,3,"61,2",5,1,1,7,Mid-Value,Potential Loyalists
11981,1166,1,"11,75",2,1,1,4,Low-Value,Can't Lose
11982,1587,2,"47,849999999999994",1,1,1,3,Low-Value,Lost
11983,528,3,"145,05",4,1,1,6,Mid-Value,Potential Loyalists
11984,1552,2,"23,5",1,1,1,3,Low-Value,Lost
11986,1362,1,"21,2",2,1,1,4,Low-Value,Can't Lose
11987,703,1,"25,7",4,1,1,6,Mid-Value,Potential Loyalists
11989,214,2,"468,2",5,1,1,7,Mid-Value,Potential Loyalists
11990,21,10,"1044,0",5,2,2,9,High-Value,Champions
11991,936,3,"549,95",3,1,1,5,Low-Value,At Risk Customers
11992,1155,2,"246,25",2,1,1,4,Low-Value,Can't Lose
11995,1526,2,"120,7",1,1,1,3,Low-Value,Lost
11997,175,7,"415,1",5,2,1,8,High-Value,Potential Loyalists
12000,32,7,"487,0",5,2,1,8,High-Value,Potential Loyalists
12001,909,2,"71,25000000000001",3,1,1,5,Low-Value,At Risk Customers
12008,373,4,"53,449999999999996",4,1,1,6,Mid-Value,Potential Loyalists
12009,391,2,"72,2",4,1,1,6,Mid-Value,Potential Loyalists
12010,820,1,"12,7",3,1,1,5,Low-Value,At Risk Customers
12011,728,1,"15,6",4,1,1,6,Mid-Value,Potential Loyalists
12014,995,2,"160,3",3,1,1,5,Low-Value,At Risk Customers
12016,1419,1,"176,7",2,1,1,4,Low-Value,Can't Lose
12019,580,6,"781,0",4,1,2,7,Mid-Value,Potential Loyalists
12020,570,4,"609,55",4,1,1,6,Mid-Value,Potential Loyalists
12024,7,2,"12,1",5,1,1,7,Mid-Value,Potential Loyalists
12028,838,4,"430,8",3,1,1,5,Low-Value,At Risk Customers
12029,53,1,"21,5",5,1,1,7,Mid-Value,Potential Loyalists
12031,555,2,"40,7",4,1,1,6,Mid-Value,Potential Loyalists
12032,168,6,"266,55",5,1,1,7,Mid-Value,Potential Loyalists
12033,906,2,"195,14999999999998",3,1,1,5,Low-Value,At Risk Customers
12034,2,3,"215,85",5,1,1,7,Mid-Value,Potential Loyalists
12035,475,2,"196,79999999999998",4,1,1,6,Mid-Value,Potential Loyalists
12036,893,2,"50,7",3,1,1,5,Low-Value,At Risk Customers
12038,568,2,"92,55",4,1,1,6,Mid-Value,Potential Loyalists
12040,1771,1,"98,7",1,1,1,3,Low-Value,Lost
12041,89,7,"939,15",5,2,2,9,High-Value,Champions
12042,10,4,"171,5",5,1,1,7,Mid-Value,Potential Loyalists
12046,1041,4,"113,5",3,1,1,5,Low-Value,At Risk Customers
12049,1596,1,"9,55",1,1,1,3,Low-Value,Lost
12052,262,7,"225,64999999999998",5,2,1,8,High-Value,Potential Loyalists
12053,99,1,"30,25",5,1,1,7,Mid-Value,Potential Loyalists
12054,159,8,"547,3499999999999",5,2,1,8,High-Value,Potential Loyalists
12055,885,3,"233,85000000000002",3,1,1,5,Low-Value,At Risk Customers
12056,516,4,"285,15",4,1,1,6,Mid-Value,Potential Loyalists
12057,302,2,"47,65",5,1,1,7,Mid-Value,Potential Loyalists
12058,208,3,"130,95000000000002",5,1,1,7,Mid-Value,Potential Loyalists
12060,264,3,"132,85",5,1,1,7,Mid-Value,Potential Loyalists
12062,1203,3,"94,90000000000002",2,1,1,4,Low-Value,Can't Lose
12063,1,5,"118,95",5,1,1,7,Mid-Value,Potential Loyalists
12065,77,18,"914,55",5,4,2,11,High-Value,Champions
12066,681,2,"39,95",4,1,1,6,Mid-Value,Potential Loyalists
12067,383,3,"68,6",4,1,1,6,Mid-Value,Potential Loyalists
12068,497,2,"51,1",4,1,1,6,Mid-Value,Potential Loyalists
12069,593,2,"208,70000000000002",4,1,1,6,Mid-Value,Potential Loyalists
12070,739,2,"171,6",3,1,1,5,Low-Value,At Risk Customers
12072,376,3,"232,0",4,1,1,6,Mid-Value,Potential Loyalists
12074,127,2,"64,75",5,1,1,7,Mid-Value,Potential Loyalists
12076,1246,4,"265,04999999999995",2,1,1,4,Low-Value,Can't Lose
12079,895,2,"67,0",3,1,1,5,Low-Value,At Risk Customers
12081,524,1,"177,75",4,1,1,6,Mid-Value,Potential Loyalists
12084,179,7,"333,35",5,2,1,8,High-Value,Potential Loyalists
12085,206,2,"68,0",5,1,1,7,Mid-Value,Potential Loyalists
12086,397,2,"182,4",4,1,1,6,Mid-Value,Potential Loyalists
12089,406,1,"4,4",4,1,1,6,Mid-Value,Potential Loyalists
12090,387,1,"23,45",4,1,1,6,Mid-Value,Potential Loyalists
12092,689,2,"202,39999999999998",4,1,1,6,Mid-Value,Potential Loyalists
12093,560,2,"185,3",4,1,1,6,Mid-Value,Potential Loyalists
12095,852,4,"794,3",3,1,2,6,Mid-Value,Potential Loyalists
12096,1053,2,"88,94999999999999",3,1,1,5,Low-Value,At Risk Customers
12097,711,5,"140,8",4,1,1,6,Mid-Value,Potential Loyalists
12101,1274,1,"112,05000000000001",2,1,1,4,Low-Value,Can't Lose
12102,1300,1,"58,3",2,1,1,4,Low-Value,Can't Lose
12103,1036,1,"108,2",3,1,1,5,Low-Value,At Risk Customers
12106,823,1,"8,5",3,1,1,5,Low-Value,At Risk Customers
12107,739,5,"207,2",3,1,1,5,Low-Value,At Risk Customers
12109,216,1,"33,0",5,1,1,7,Mid-Value,Potential Loyalists
12110,634,2,"54,6",4,1,1,6,Mid-Value,Potential Loyalists
12112,1691,3,"215,35000000000002",1,1,1,3,Low-Value,Lost
12114,861,2,"104,19999999999999",3,1,1,5,Low-Value,At Risk Customers
12115,1223,1,"99,3",2,1,1,4,Low-Value,Can't Lose
12116,698,8,"608,3",4,2,1,7,Mid-Value,Potential Loyalists
12117,444,8,"314,65",4,2,1,7,Mid-Value,Potential Loyalists
12118,986,1,"115,6",3,1,1,5,Low-Value,At Risk Customers
12120,1151,2,"37,3",2,1,1,4,Low-Value,Can't Lose
12124,770,5,"264,9",3,1,1,5,Low-Value,At Risk Customers
12125,393,1,"149,9",4,1,1,6,Mid-Value,Potential Loyalists
12127,178,2,"374,85",5,1,1,7,Mid-Value,Potential Loyalists
12128,1508,1,"3,35",1,1,1,3,Low-Value,Lost
12130,587,1,"43,4",4,1,1,6,Mid-Value,Potential Loyalists
12131,1560,1,"72,35",1,1,1,3,Low-Value,Lost
12134,1554,1,"70,3",1,1,1,3,Low-Value,Lost
12135,376,3,"163,91",4,1,1,6,Mid-Value,Potential Loyalists
12136,41,5,"140,4",5,1,1,7,Mid-Value,Potential Loyalists
12137,58,6,"384,75",5,1,1,7,Mid-Value,Potential Loyalists
12138,340,6,"103,45",5,1,1,7,Mid-Value,Potential Loyalists
12140,270,1,"75,25",5,1,1,7,Mid-Value,Potential Loyalists
12147,613,1,"28,65",4,1,1,6,Mid-Value,Potential Loyalists
12149,1806,1,"36,65",1,1,1,3,Low-Value,Lost
12150,864,2,"72,0",3,1,1,5,Low-Value,At Risk Customers
12151,217,2,"121,60000000000001",5,1,1,7,Mid-Value,Potential Loyalists
12154,765,8,"350,8",3,2,1,6,Mid-Value,Potential Loyalists
12156,1543,1,"7,7",1,1,1,3,Low-Value,Lost
12157,105,8,"390,1",5,2,1,8,High-Value,Potential Loyalists
12158,199,5,"532,55",5,1,1,7,Mid-Value,Potential Loyalists
12161,872,2,"150,15",3,1,1,5,Low-Value,At Risk Customers
12162,427,5,"457,95",4,1,1,6,Mid-Value,Potential Loyalists
12163,20,6,"392,35",5,1,1,7,Mid-Value,Potential Loyalists
12165,535,2,"257,8",4,1,1,6,Mid-Value,Potential Loyalists
12166,22,5,"250,1",5,1,1,7,Mid-Value,Potential Loyalists
12167,108,7,"370,95",5,2,1,8,High-Value,Potential Loyalists
12169,0,13,"837,15",5,3,2,10,High-Value,Champions
12170,971,2,"590,9499999999999",3,1,1,5,Low-Value,At Risk Customers
12171,907,1,"31,349999999999998",3,1,1,5,Low-Value,At Risk Customers
12172,362,2,"154,29999999999998",5,1,1,7,Mid-Value,Potential Loyalists
12173,56,6,"589,6",5,1,1,7,Mid-Value,Potential Loyalists
12174,127,9,"432,1",5,2,1,8,High-Value,Potential Loyalists
12175,161,8,"331,25",5,2,1,8,High-Value,Potential Loyalists
12176,349,2,"219,35000000000002",5,1,1,7,Mid-Value,Potential Loyalists
12177,74,4,"54,0",5,1,1,7,Mid-Value,Potential Loyalists
12179,327,2,"234,9",5,1,1,7,Mid-Value,Potential Loyalists
12180,832,4,"301,4",3,1,1,5,Low-Value,At Risk Customers
12181,208,7,"215,54999999999998",5,2,1,8,High-Value,Potential Loyalists
12184,1217,1,"15,0",2,1,1,4,Low-Value,Can't Lose
12186,1500,1,"29,7",1,1,1,3,Low-Value,Lost
12188,165,1,"238,3",5,1,1,7,Mid-Value,Potential Loyalists
12192,41,1,"8,0",5,1,1,7,Mid-Value,Potential Loyalists
12193,644,3,"38,0",4,1,1,6,Mid-Value,Potential Loyalists
12195,96,4,"375,45",5,1,1,7,Mid-Value,Potential Loyalists
12196,131,4,"224,0",5,1,1,7,Mid-Value,Potential Loyalists
12197,345,1,"14,35",5,1,1,7,Mid-Value,Potential Loyalists
12201,500,5,"638,75",4,1,1,6,Mid-Value,Potential Loyalists
12202,10,10,"536,4",5,2,1,8,High-Value,Potential Loyalists
12203,209,5,"362,3",5,1,1,7,Mid-Value,Potential Loyalists
12206,81,4,"133,45",5,1,1,7,Mid-Value,Potential Loyalists
12207,195,2,"221,54999999999998",5,1,1,7,Mid-Value,Potential Loyalists
12208,15,4,"107,10000000000001",5,1,1,7,Mid-Value,Potential Loyalists
12210,67,8,"342,09999999999997",5,2,1,8,High-Value,Potential Loyalists
12212,532,4,"259,55",4,1,1,6,Mid-Value,Potential Loyalists
12214,638,3,"193,75",4,1,1,6,Mid-Value,Potential Loyalists
12215,906,2,"419,3",3,1,1,5,Low-Value,At Risk Customers
12217,913,1,"31,349999999999998",3,1,1,5,Low-Value,At Risk Customers
12219,832,2,"141,9",3,1,1,5,Low-Value,At Risk Customers
12220,1015,3,"119,85000000000001",3,1,1,5,Low-Value,At Risk Customers
12222,873,2,"42,2",3,1,1,5,Low-Value,At Risk Customers
12224,59,3,"52,8",5,1,1,7,Mid-Value,Potential Loyalists
12225,144,4,"418,3",5,1,1,7,Mid-Value,Potential Loyalists
12227,268,9,"855,75",5,2,2,9,High-Value,Champions
12228,423,2,"67,0",4,1,1,6,Mid-Value,Potential Loyalists
12230,130,3,"270,95",5,1,1,7,Mid-Value,Potential Loyalists
12231,262,8,"518,6",5,2,1,8,High-Value,Potential Loyalists
12232,2,4,"699,05",5,1,2,8,High-Value,Potential Loyalists
12233,717,1,"45,6",4,1,1,6,Mid-Value,Potential Loyalists
12236,34,4,"142,95",5,1,1,7,Mid-Value,Potential Loyalists
12239,1630,1,"16,85",1,1,1,3,Low-Value,Lost
12240,1412,1,"10,65",2,1,1,4,Low-Value,Can't Lose
12241,4,4,"257,15",5,1,1,7,Mid-Value,Potential Loyalists
12243,1088,1,"355,8",3,1,1,5,Low-Value,At Risk Customers
12245,1118,1,"42,15",2,1,1,4,Low-Value,Can't Lose
12249,308,2,"111,69999999999999",5,1,1,7,Mid-Value,Potential Loyalists
12250,751,8,"516,3",3,2,1,6,Mid-Value,Potential Loyalists
12251,1464,2,"265,15",1,1,1,3,Low-Value,Lost
12252,818,3,"89,35",3,1,1,5,Low-Value,At Risk Customers
12254,1128,1,"41,0",2,1,1,4,Low-Value,Can't Lose
12257,83,3,"230,35",5,1,1,7,Mid-Value,Potential Loyalists
12259,1470,1,"30,35",1,1,1,3,Low-Value,Lost
12260,10,2,"99,44999999999999",5,1,1,7,Mid-Value,Potential Loyalists
12261,891,2,"307,95000000000005",3,1,1,5,Low-Value,At Risk Customers
12262,866,7,"294,0",3,2,1,6,Mid-Value,Potential Loyalists
12264,29,6,"525,55",5,1,1,7,Mid-Value,Potential Loyalists
12265,163,9,"374,1",5,2,1,8,High-Value,Potential Loyalists
12266,1642,1,"75,9",1,1,1,3,Low-Value,Lost
12267,1167,1,"26,1",2,1,1,4,Low-Value,Can't Lose
12268,766,3,"33,45",3,1,1,5,Low-Value,At Risk Customers
12269,1670,1,"161,10000000000002",1,1,1,3,Low-Value,Lost
12270,1162,2,"246,1",2,1,1,4,Low-Value,Can't Lose
12271,1195,1,"10,7",2,1,1,4,Low-Value,Can't Lose
12272,764,1,"46,55",3,1,1,5,Low-Value,At Risk Customers
12273,546,1,"170,2",4,1,1,6,Mid-Value,Potential Loyalists
12275,1261,2,"91,35",2,1,1,4,Low-Value,Can't Lose
12276,68,5,"217,84999999999997",5,1,1,7,Mid-Value,Potential Loyalists
12277,888,2,"77,3",3,1,1,5,Low-Value,At Risk Customers
12278,647,2,"48,15",4,1,1,6,Mid-Value,Potential Loyalists
12280,144,4,"257,79999999999995",5,1,1,7,Mid-Value,Potential Loyalists
12281,508,1,"37,8",4,1,1,6,Mid-Value,Potential Loyalists
12282,1570,1,"32,25",1,1,1,3,Low-Value,Lost
12285,67,1,"9,3",5,1,1,7,Mid-Value,Potential Loyalists
12288,164,3,"423,4",5,1,1,7,Mid-Value,Potential Loyalists
12290,1008,1,"71,6",3,1,1,5,Low-Value,At Risk Customers
12295,563,4,"134,15",4,1,1,6,Mid-Value,Potential Loyalists
12296,1211,2,"50,55",2,1,1,4,Low-Value,Can't Lose
12297,1207,2,"29,0",2,1,1,4,Low-Value,Can't Lose
12298,11,5,"349,45",5,1,1,7,Mid-Value,Potential Loyalists
12299,176,1,"13,4",5,1,1,7,Mid-Value,Potential Loyalists
12300,1649,1,"25,7",1,1,1,3,Low-Value,Lost
12302,1487,2,"110,0",1,1,1,3,Low-Value,Lost
12304,462,3,"61,0",4,1,1,6,Mid-Value,Potential Loyalists
12306,566,2,"120,3",4,1,1,6,Mid-Value,Potential Loyalists
12309,350,4,"227,35",5,1,1,7,Mid-Value,Potential Loyalists
12311,939,1,"327,3",3,1,1,5,Low-Value,At Risk Customers
12312,402,2,"147,25",4,1,1,6,Mid-Value,Potential Loyalists
12314,791,2,"121,85",3,1,1,5,Low-Value,At Risk Customers
12315,1029,1,"33,9",3,1,1,5,Low-Value,At Risk Customers
12316,1614,1,"115,6",1,1,1,3,Low-Value,Lost
12319,542,3,"208,15",4,1,1,6,Mid-Value,Potential Loyalists
12321,465,1,"32,3",4,1,1,6,Mid-Value,Potential Loyalists
12322,455,5,"557,55",4,1,1,6,Mid-Value,Potential Loyalists
12323,429,4,"376,79999999999995",4,1,1,6,Mid-Value,Potential Loyalists
12324,810,2,"76,3",3,1,1,5,Low-Value,At Risk Customers
12326,1424,1,"192,35",2,1,1,4,Low-Value,Can't Lose
12327,991,1,"8,45",3,1,1,5,Low-Value,At Risk Customers
12329,629,3,"169,04999999999998",4,1,1,6,Mid-Value,Potential Loyalists
12330,1075,4,"152,70000000000002",3,1,1,5,Low-Value,At Risk Customers
12332,232,4,"250,20000000000002",5,1,1,7,Mid-Value,Potential Loyalists
12335,3,11,"718,0500000000001",5,2,2,9,High-Value,Champions
12337,1485,1,"126,0",1,1,1,3,Low-Value,Lost
12339,796,8,"340,35",3,2,1,6,Mid-Value,Potential Loyalists
12340,467,5,"117,65",4,1,1,6,Mid-Value,Potential Loyalists
12342,42,11,"631,5",5,2,1,8,High-Value,Potential Loyalists
12345,598,2,"48,15",4,1,1,6,Mid-Value,Potential Loyalists
12347,988,3,"480,59999999999997",3,1,1,5,Low-Value,At Risk Customers
12349,1134,2,"52,8",2,1,1,4,Low-Value,Can't Lose
12350,40,10,"369,2",5,2,1,8,High-Value,Potential Loyalists
12353,49,5,"200,05",5,1,1,7,Mid-Value,Potential Loyalists
12354,811,1,"9,9",3,1,1,5,Low-Value,At Risk Customers
12355,923,1,"193,8",3,1,1,5,Low-Value,At Risk Customers
12357,1092,1,"170,5",3,1,1,5,Low-Value,At Risk Customers
12358,1029,1,"3,3",3,1,1,5,Low-Value,At Risk Customers
12359,540,1,"494,5",4,1,1,6,Mid-Value,Potential Loyalists
12360,1539,2,"486,35",1,1,1,3,Low-Value,Lost
12364,993,3,"253,15",3,1,1,5,Low-Value,At Risk Customers
12365,1730,1,"11,1",1,1,1,3,Low-Value,Lost
12367,191,8,"582,85",5,2,1,8,High-Value,Potential Loyalists
12372,445,3,"96,65",4,1,1,6,Mid-Value,Potential Loyalists
12376,593,2,"47,45",4,1,1,6,Mid-Value,Potential Loyalists
12377,1022,4,"211,60000000000002",3,1,1,5,Low-Value,At Risk Customers
12378,88,3,"91,6",5,1,1,7,Mid-Value,Potential Loyalists
12379,46,1,"26,95",5,1,1,7,Mid-Value,Potential Loyalists
12381,1078,1,"33,6",3,1,1,5,Low-Value,At Risk Customers
12382,1055,1,"15,75",3,1,1,5,Low-Value,At Risk Customers
12383,1,2,"578,9",5,1,1,7,Mid-Value,Potential Loyalists
12384,9,3,"407,20000000000005",5,1,1,7,Mid-Value,Potential Loyalists
12385,969,4,"194,7",3,1,1,5,Low-Value,At Risk Customers
12387,125,4,"445,15",5,1,1,7,Mid-Value,Potential Loyalists
12388,15,3,"85,15",5,1,1,7,Mid-Value,Potential Loyalists
12389,1702,1,"86,85",1,1,1,3,Low-Value,Lost
12390,467,5,"73,15",4,1,1,6,Mid-Value,Potential Loyalists
12391,760,5,"540,8",3,1,1,5,Low-Value,At Risk Customers
12397,1171,2,"195,05",2,1,1,4,Low-Value,Can't Lose
12398,116,4,"80,95",5,1,1,7,Mid-Value,Potential Loyalists
12401,56,7,"272,25",5,2,1,8,High-Value,Potential Loyalists
12404,902,2,"66,44999999999999",3,1,1,5,Low-Value,At Risk Customers
12405,1613,1,"93,0",1,1,1,3,Low-Value,Lost
12406,1622,1,"62,8",1,1,1,3,Low-Value,Lost
12407,12,3,"817,85",5,1,2,8,High-Value,Potential Loyalists
12408,476,3,"117,35",4,1,1,6,Mid-Value,Potential Loyalists
12409,132,4,"160,1",5,1,1,7,Mid-Value,Potential Loyalists
12412,1091,1,"39,5",3,1,1,5,Low-Value,At Risk Customers
12413,64,1,"16,2",5,1,1,7,Mid-Value,Potential Loyalists
12414,540,1,"89,8",4,1,1,6,Mid-Value,Potential Loyalists
12415,526,2,"193,25",4,1,1,6,Mid-Value,Potential Loyalists
12418,616,4,"164,89999999999998",4,1,1,6,Mid-Value,Potential Loyalists
12420,1500,1,"32,5",1,1,1,3,Low-Value,Lost
12421,817,4,"896,9000000000001",3,1,2,6,Mid-Value,Potential Loyalists
12422,7,7,"187,0",5,2,1,8,High-Value,Potential Loyalists
12423,14,2,"245,35",5,1,1,7,Mid-Value,Potential Loyalists
12425,429,9,"459,95",4,2,1,7,Mid-Value,Potential Loyalists
12426,87,7,"463,35",5,2,1,8,High-Value,Potential Loyalists
12427,1229,1,"11,5",2,1,1,4,Low-Value,Can't Lose
12428,710,1,"88,8",4,1,1,6,Mid-Value,Potential Loyalists
12430,483,2,"534,5500000000001",4,1,1,6,Mid-Value,Potential Loyalists
12431,93,2,"51,099999999999994",5,1,1,7,Mid-Value,Potential Loyalists
12433,317,1,"91,7",5,1,1,7,Mid-Value,Potential Loyalists
12436,212,3,"383,0",5,1,1,7,Mid-Value,Potential Loyalists
12437,218,1,"41,4",5,1,1,7,Mid-Value,Potential Loyalists
12438,58,5,"311,5",5,1,1,7,Mid-Value,Potential Loyalists
12439,148,3,"272,9",5,1,1,7,Mid-Value,Potential Loyalists
12440,669,1,"8,5",4,1,1,6,Mid-Value,Potential Loyalists
12441,234,2,"70,5",5,1,1,7,Mid-Value,Potential Loyalists
12442,115,3,"116,6",5,1,1,7,Mid-Value,Potential Loyalists
12443,163,6,"661,15",5,1,1,7,Mid-Value,Potential Loyalists
12445,1536,1,"17,9",1,1,1,3,Low-Value,Lost
12446,115,6,"178,1",5,1,1,7,Mid-Value,Potential Loyalists
12447,635,1,"23,3",4,1,1,6,Mid-Value,Potential Loyalists
12452,143,10,"471,79999999999995",5,2,1,8,High-Value,Potential Loyalists
12453,506,2,"302,55",4,1,1,6,Mid-Value,Potential Loyalists
12455,157,10,"715,65",5,2,2,9,High-Value,Champions
12456,773,4,"249,2",3,1,1,5,Low-Value,At Risk Customers
12458,733,1,"356,4",3,1,1,5,Low-Value,At Risk Customers
12460,754,4,"495,35",3,1,1,5,Low-Value,At Risk Customers
12461,181,4,"526,65",5,1,1,7,Mid-Value,Potential Loyalists
12462,234,1,"152,7",5,1,1,7,Mid-Value,Potential Loyalists
12464,45,7,"309,29999999999995",5,2,1,8,High-Value,Potential Loyalists
12465,101,2,"142,85000000000002",5,1,1,7,Mid-Value,Potential Loyalists
12466,855,1,"102,4",3,1,1,5,Low-Value,At Risk Customers
12467,293,6,"677,4",5,1,2,8,High-Value,Potential Loyalists
12468,907,1,"141,6",3,1,1,5,Low-Value,At Risk Customers
12469,1,5,"934,7499999999999",5,1,2,8,High-Value,Potential Loyalists
12470,329,7,"390,54999999999995",5,2,1,8,High-Value,Potential Loyalists
12471,96,8,"869,5999999999999",5,2,2,9,High-Value,Champions
12472,35,9,"913,2",5,2,2,9,High-Value,Champions
12473,8,1,"270,0",5,1,1,7,Mid-Value,Potential Loyalists
12478,538,1,"10,9",4,1,1,6,Mid-Value,Potential Loyalists
12480,741,6,"392,04999999999995",3,1,1,5,Low-Value,At Risk Customers
12483,834,4,"146,9",3,1,1,5,Low-Value,At Risk Customers
12485,818,2,"100,4",3,1,1,5,Low-Value,At Risk Customers
12486,143,3,"125,8",5,1,1,7,Mid-Value,Potential Loyalists
12489,390,3,"236,75",4,1,1,6,Mid-Value,Potential Loyalists
12492,159,3,"140,79999999999998",5,1,1,7,Mid-Value,Potential Loyalists
12494,955,2,"159,75",3,1,1,5,Low-Value,At Risk Customers
12496,424,3,"53,650000000000006",4,1,1,6,Mid-Value,Potential Loyalists
12497,778,3,"225,6",3,1,1,5,Low-Value,At Risk Customers
12500,114,2,"22,700000000000003",5,1,1,7,Mid-Value,Potential Loyalists
12502,517,5,"236,45",4,1,1,6,Mid-Value,Potential Loyalists
12503,634,1,"71,25",4,1,1,6,Mid-Value,Potential Loyalists
12505,567,1,"103,1",4,1,1,6,Mid-Value,Potential Loyalists
12506,1008,2,"61,7",3,1,1,5,Low-Value,At Risk Customers
12511,1723,1,"54,2",1,1,1,3,Low-Value,Lost
12512,1799,1,"297,1",1,1,1,3,Low-Value,Lost
12513,1340,1,"140,0",2,1,1,4,Low-Value,Can't Lose
12514,1025,3,"42,15",3,1,1,5,Low-Value,At Risk Customers
12516,48,3,"408,8",5,1,1,7,Mid-Value,Potential Loyalists
12518,382,4,"336,95",4,1,1,6,Mid-Value,Potential Loyalists
12519,392,7,"190,2",4,2,1,7,Mid-Value,Potential Loyalists
12520,1154,3,"239,35",2,1,1,4,Low-Value,Can't Lose
12521,390,6,"513,15",4,1,1,6,Mid-Value,Potential Loyalists
12522,1324,5,"145,5",2,1,1,4,Low-Value,Can't Lose
12523,1151,2,"78,3",2,1,1,4,Low-Value,Can't Lose
12525,434,1,"6,95",4,1,1,6,Mid-Value,Potential Loyalists
12527,879,2,"99,5",3,1,1,5,Low-Value,At Risk Customers
12528,158,5,"405,2",5,1,1,7,Mid-Value,Potential Loyalists
12530,599,3,"264,3",4,1,1,6,Mid-Value,Potential Loyalists
12532,900,2,"181,10000000000002",3,1,1,5,Low-Value,At Risk Customers
12535,1602,2,"54,4",1,1,1,3,Low-Value,Lost
12536,1390,4,"616,9000000000001",2,1,1,4,Low-Value,Can't Lose
12538,1168,4,"233,99999999999997",2,1,1,4,Low-Value,Can't Lose
12539,367,3,"61,45",4,1,1,6,Mid-Value,Potential Loyalists
12540,429,3,"122,95",4,1,1,6,Mid-Value,Potential Loyalists
12541,468,2,"32,95",4,1,1,6,Mid-Value,Potential Loyalists
12542,812,3,"83,65",3,1,1,5,Low-Value,At Risk Customers
12547,5,5,"737,65",5,1,2,8,High-Value,Potential Loyalists
12548,761,7,"529,75",3,2,1,6,Mid-Value,Potential Loyalists
12550,276,5,"236,6",5,1,1,7,Mid-Value,Potential Loyalists
12551,106,5,"384,7",5,1,1,7,Mid-Value,Potential Loyalists
12552,952,1,"34,2",3,1,1,5,Low-Value,At Risk Customers
12553,745,6,"174,05",3,1,1,5,Low-Value,At Risk Customers
12554,45,14,"1109,75",5,3,2,10,High-Value,Champions
12557,244,3,"177,35",5,1,1,7,Mid-Value,Potential Loyalists
12559,524,6,"681,15",4,1,2,7,Mid-Value,Potential Loyalists
12561,188,1,"10,3",5,1,1,7,Mid-Value,Potential Loyalists
12562,1356,1,"16,55",2,1,1,4,Low-Value,Can't Lose
12565,459,3,"381,29999999999995",4,1,1,6,Mid-Value,Potential Loyalists
12569,836,3,"180,4",3,1,1,5,Low-Value,At Risk Customers
12570,460,1,"4,4",4,1,1,6,Mid-Value,Potential Loyalists
12572,445,3,"135,45",4,1,1,6,Mid-Value,Potential Loyalists
12573,102,3,"166,65",5,1,1,7,Mid-Value,Potential Loyalists
12574,285,2,"38,9",5,1,1,7,Mid-Value,Potential Loyalists
12576,140,7,"242,65",5,2,1,8,High-Value,Potential Loyalists
12578,397,6,"320,7",4,1,1,6,Mid-Value,Potential Loyalists
12579,1498,1,"22,9",1,1,1,3,Low-Value,Lost
12580,402,4,"436,65",4,1,1,6,Mid-Value,Potential Loyalists
12581,110,7,"352,7",5,2,1,8,High-Value,Potential Loyalists
12582,793,1,"20,9",3,1,1,5,Low-Value,At Risk Customers
12583,912,3,"195,0",3,1,1,5,Low-Value,At Risk Customers
12584,26,3,"83,7",5,1,1,7,Mid-Value,Potential Loyalists
12586,111,3,"1370,45",5,1,3,9,High-Value,Champions
12587,152,1,"83,5",5,1,1,7,Mid-Value,Potential Loyalists
12588,26,4,"977,75",5,1,2,8,High-Value,Potential Loyalists
12589,322,3,"66,85",5,1,1,7,Mid-Value,Potential Loyalists
12590,248,8,"226,45",5,2,1,8,High-Value,Potential Loyalists
12591,257,1,"115,80000000000001",5,1,1,7,Mid-Value,Potential Loyalists
12592,38,2,"48,65",5,1,1,7,Mid-Value,Potential Loyalists
12593,765,2,"105,5",3,1,1,5,Low-Value,At Risk Customers
12594,161,1,"268,95000000000005",5,1,1,7,Mid-Value,Potential Loyalists
12596,1312,1,"26,1",2,1,1,4,Low-Value,Can't Lose
12597,75,5,"403,05",5,1,1,7,Mid-Value,Potential Loyalists
12598,373,2,"392,25",4,1,1,6,Mid-Value,Potential Loyalists
12599,156,8,"426,9",5,2,1,8,High-Value,Potential Loyalists
12601,816,3,"291,0",3,1,1,5,Low-Value,At Risk Customers
12604,1436,3,"173,25",2,1,1,4,Low-Value,Can't Lose
12605,209,6,"355,1",5,1,1,7,Mid-Value,Potential Loyalists
12607,1431,1,"20,3",2,1,1,4,Low-Value,Can't Lose
12608,1673,1,"27,8",1,1,1,3,Low-Value,Lost
12610,91,4,"207,35000000000002",5,1,1,7,Mid-Value,Potential Loyalists
12613,1157,3,"49,28",2,1,1,4,Low-Value,Can't Lose
12617,1657,1,"251,3",1,1,1,3,Low-Value,Lost
12618,343,1,"8,05",5,1,1,7,Mid-Value,Potential Loyalists
12619,18,4,"199,65",5,1,1,7,Mid-Value,Potential Loyalists
12620,1202,1,"8,1",2,1,1,4,Low-Value,Can't Lose
12621,126,1,"57,4",5,1,1,7,Mid-Value,Potential Loyalists
12622,291,1,"21,6",5,1,1,7,Mid-Value,Potential Loyalists
12625,440,4,"175,8",4,1,1,6,Mid-Value,Potential Loyalists
12626,521,4,"275,75",4,1,1,6,Mid-Value,Potential Loyalists
12627,1087,1,"31,9",3,1,1,5,Low-Value,At Risk Customers
12628,1461,1,"85,6",1,1,1,3,Low-Value,Lost
12631,1616,2,"133,75",1,1,1,3,Low-Value,Lost
12632,0,5,"125,65",5,1,1,7,Mid-Value,Potential Loyalists
12633,595,4,"196,2",4,1,1,6,Mid-Value,Potential Loyalists
12634,1068,1,"16,8",3,1,1,5,Low-Value,At Risk Customers
12635,51,4,"525,4499999999999",5,1,1,7,Mid-Value,Potential Loyalists
12636,75,3,"90,55",5,1,1,7,Mid-Value,Potential Loyalists
12640,1627,1,"552,0",1,1,1,3,Low-Value,Lost
12641,390,3,"66,9",4,1,1,6,Mid-Value,Potential Loyalists
12643,395,1,"42,45",4,1,1,6,Mid-Value,Potential Loyalists
12644,48,1,"25,1",5,1,1,7,Mid-Value,Potential Loyalists
12645,650,4,"331,65",4,1,1,6,Mid-Value,Potential Loyalists
12647,605,3,"51,35",4,1,1,6,Mid-Value,Potential Loyalists
12650,218,11,"740,9",5,2,2,9,High-Value,Champions
12651,356,1,"7,0",5,1,1,7,Mid-Value,Potential Loyalists
12652,551,4,"1445,15",4,1,3,8,High-Value,Potential Loyalists
12653,983,2,"125,15",3,1,1,5,Low-Value,At Risk Customers
12654,71,4,"343,65000000000003",5,1,1,7,Mid-Value,Potential Loyalists
12655,56,5,"353,25",5,1,1,7,Mid-Value,Potential Loyalists
12656,239,5,"158,9",5,1,1,7,Mid-Value,Potential Loyalists
12657,394,2,"274,85",4,1,1,6,Mid-Value,Potential Loyalists
12658,227,2,"93,95",5,1,1,7,Mid-Value,Potential Loyalists
12659,423,1,"73,65",4,1,1,6,Mid-Value,Potential Loyalists
12661,407,1,"2,2",4,1,1,6,Mid-Value,Potential Loyalists
12663,403,2,"50,05",4,1,1,6,Mid-Value,Potential Loyalists
12665,722,1,"8,7",4,1,1,6,Mid-Value,Potential Loyalists
12666,375,3,"216,15",4,1,1,6,Mid-Value,Potential Loyalists
12667,9,2,"84,05",5,1,1,7,Mid-Value,Potential Loyalists
12672,11,6,"155,55",5,1,1,7,Mid-Value,Potential Loyalists
12673,780,4,"134,35",3,1,1,5,Low-Value,At Risk Customers
12674,650,6,"199,85",4,1,1,6,Mid-Value,Potential Loyalists
12677,577,7,"829,0",4,2,2,8,High-Value,Potential Loyalists
12678,288,3,"138,95",5,1,1,7,Mid-Value,Potential Loyalists
12679,773,2,"27,200000000000003",3,1,1,5,Low-Value,At Risk Customers
12680,505,4,"321,75",4,1,1,6,Mid-Value,Potential Loyalists
12681,595,1,"18,45",4,1,1,6,Mid-Value,Potential Loyalists
12683,864,1,"34,5",3,1,1,5,Low-Value,At Risk Customers
12684,111,11,"1316,8",5,2,2,9,High-Value,Champions
12686,10,1,"110,4",5,1,1,7,Mid-Value,Potential Loyalists
12689,768,2,"45,3",3,1,1,5,Low-Value,At Risk Customers
12692,26,3,"639,0999999999999",5,1,1,7,Mid-Value,Potential Loyalists
12693,1115,2,"156,35",2,1,1,4,Low-Value,Can't Lose
12694,327,3,"638,65",5,1,1,7,Mid-Value,Potential Loyalists
12695,298,3,"81,9",5,1,1,7,Mid-Value,Potential Loyalists
12696,320,4,"142,9",5,1,1,7,Mid-Value,Potential Loyalists
12698,1076,2,"55,55",3,1,1,5,Low-Value,At Risk Customers
12699,1790,1,"19,8",1,1,1,3,Low-Value,Lost
12700,530,2,"54,25",4,1,1,6,Mid-Value,Potential Loyalists
12701,19,4,"262,8",5,1,1,7,Mid-Value,Potential Loyalists
12702,539,4,"383,85",4,1,1,6,Mid-Value,Potential Loyalists
12703,88,5,"323,25",5,1,1,7,Mid-Value,Potential Loyalists
12704,1793,1,"25,35",1,1,1,3,Low-Value,Lost
12706,283,1,"19,6",5,1,1,7,Mid-Value,Potential Loyalists
12707,1013,2,"102,1",3,1,1,5,Low-Value,At Risk Customers
12710,989,1,"22,8",3,1,1,5,Low-Value,At Risk Customers
12712,42,9,"466,5",5,2,1,8,High-Value,Potential Loyalists
12713,116,6,"255,75",5,1,1,7,Mid-Value,Potential Loyalists
12714,1190,1,"40,65",2,1,1,4,Low-Value,Can't Lose
12715,234,3,"319,65",5,1,1,7,Mid-Value,Potential Loyalists
12716,35,4,"526,9",5,1,1,7,Mid-Value,Potential Loyalists
12719,531,6,"1034,7",4,1,2,7,Mid-Value,Potential Loyalists
12720,1477,1,"29,7",1,1,1,3,Low-Value,Lost
12722,967,2,"15,649999999999999",3,1,1,5,Low-Value,At Risk Customers
12723,633,3,"83,94999999999999",4,1,1,6,Mid-Value,Potential Loyalists
12724,95,2,"76,9",5,1,1,7,Mid-Value,Potential Loyalists
12725,77,2,"37,8",5,1,1,7,Mid-Value,Potential Loyalists
12726,691,1,"47,85",4,1,1,6,Mid-Value,Potential Loyalists
12727,408,2,"67,65",4,1,1,6,Mid-Value,Potential Loyalists
12728,805,1,"24,05",3,1,1,5,Low-Value,At Risk Customers
12730,608,1,"146,10000000000002",4,1,1,6,Mid-Value,Potential Loyalists
12731,8,5,"264,75",5,1,1,7,Mid-Value,Potential Loyalists
12732,1124,2,"96,1",2,1,1,4,Low-Value,Can't Lose
12733,138,6,"396,90000000000003",5,1,1,7,Mid-Value,Potential Loyalists
12734,250,2,"187,5",5,1,1,7,Mid-Value,Potential Loyalists
12736,241,3,"147,55",5,1,1,7,Mid-Value,Potential Loyalists
12737,302,5,"416,9",5,1,1,7,Mid-Value,Potential Loyalists
12738,416,9,"387,65",4,2,1,7,Mid-Value,Potential Loyalists
12739,11,7,"504,35",5,2,1,8,High-Value,Potential Loyalists
12740,41,7,"248,25",5,2,1,8,High-Value,Potential Loyalists
12741,390,2,"134,5",4,1,1,6,Mid-Value,Potential Loyalists
12743,584,2,"108,94999999999999",4,1,1,6,Mid-Value,Potential Loyalists
12745,366,4,"268,15",4,1,1,6,Mid-Value,Potential Loyalists
12746,86,8,"320,8",5,2,1,8,High-Value,Potential Loyalists
12748,159,6,"739,25",5,1,2,8,High-Value,Potential Loyalists
12749,80,3,"122,89999999999999",5,1,1,7,Mid-Value,Potential Loyalists
12750,283,9,"388,05",5,2,1,8,High-Value,Potential Loyalists
12751,262,3,"250,00000000000003",5,1,1,7,Mid-Value,Potential Loyalists
12752,22,3,"226,7",5,1,1,7,Mid-Value,Potential Loyalists
12754,1520,4,"262,85",1,1,1,3,Low-Value,Lost
12755,139,4,"152,7",5,1,1,7,Mid-Value,Potential Loyalists
12759,614,3,"93,75",4,1,1,6,Mid-Value,Potential Loyalists
12761,1228,1,"18,4",2,1,1,4,Low-Value,Can't Lose
12762,150,8,"522,65",5,2,1,8,High-Value,Potential Loyalists
12763,690,1,"165,95",4,1,1,6,Mid-Value,Potential Loyalists
12764,605,3,"263,65",4,1,1,6,Mid-Value,Potential Loyalists
12766,22,2,"236,15",5,1,1,7,Mid-Value,Potential Loyalists
12767,214,2,"196,79999999999998",5,1,1,7,Mid-Value,Potential Loyalists
12768,36,1,"125,65",5,1,1,7,Mid-Value,Potential Loyalists
12770,447,5,"391,05",4,1,1,6,Mid-Value,Potential Loyalists
12771,117,8,"507,0",5,2,1,8,High-Value,Potential Loyalists
12772,486,3,"177,04999999999998",4,1,1,6,Mid-Value,Potential Loyalists
12773,456,6,"365,40000000000003",4,1,1,6,Mid-Value,Potential Loyalists
12774,45,8,"340,85",5,2,1,8,High-Value,Potential Loyalists
12776,832,5,"268,8",3,1,1,5,Low-Value,At Risk Customers
12777,1172,7,"450,4",2,2,1,5,Low-Value,At Risk Customers
12778,31,12,"928,8",5,3,2,10,High-Value,Champions
12779,73,8,"597,75",5,2,1,8,High-Value,Potential Loyalists
12780,1041,3,"265,5",3,1,1,5,Low-Value,At Risk Customers
12781,743,2,"195,6",3,1,1,5,Low-Value,At Risk Customers
12783,77,5,"176,39999999999998",5,1,1,7,Mid-Value,Potential Loyalists
12784,432,3,"312,5",4,1,1,6,Mid-Value,Potential Loyalists
12785,58,5,"121,25",5,1,1,7,Mid-Value,Potential Loyalists
12787,127,4,"231,15",5,1,1,7,Mid-Value,Potential Loyalists
12791,153,3,"104,74999999999999",5,1,1,7,Mid-Value,Potential Loyalists
12792,1069,1,"72,75",3,1,1,5,Low-Value,At Risk Customers
12793,1664,2,"64,15",1,1,1,3,Low-Value,Lost
12795,42,5,"167,75",5,1,1,7,Mid-Value,Potential Loyalists
12796,88,3,"205,45",5,1,1,7,Mid-Value,Potential Loyalists
12797,1726,1,"27,6",1,1,1,3,Low-Value,Lost
12799,583,1,"14,45",4,1,1,6,Mid-Value,Potential Loyalists
12801,110,3,"111,4",5,1,1,7,Mid-Value,Potential Loyalists
12804,59,3,"211,14999999999998",5,1,1,7,Mid-Value,Potential Loyalists
12805,1069,2,"438,79999999999995",3,1,1,5,Low-Value,At Risk Customers
12809,1389,1,"58,9",2,1,1,4,Low-Value,Can't Lose
12810,106,3,"49,7",5,1,1,7,Mid-Value,Potential Loyalists
12811,473,1,"23,9",4,1,1,6,Mid-Value,Potential Loyalists
12812,449,3,"187,8",4,1,1,6,Mid-Value,Potential Loyalists
12813,1126,1,"104,1",2,1,1,4,Low-Value,Can't Lose
12814,363,8,"457,1",5,2,1,8,High-Value,Potential Loyalists
12815,468,1,"111,0",4,1,1,6,Mid-Value,Potential Loyalists
12816,1295,4,"70,8",2,1,1,4,Low-Value,Can't Lose
12818,19,3,"129,25",5,1,1,7,Mid-Value,Potential Loyalists
12819,162,2,"131,4",5,1,1,7,Mid-Value,Potential Loyalists
12820,689,2,"83,35",4,1,1,6,Mid-Value,Potential Loyalists
12822,489,1,"110,10000000000001",4,1,1,6,Mid-Value,Potential Loyalists
12824,124,5,"425,54999999999995",5,1,1,7,Mid-Value,Potential Loyalists
12826,1143,1,"4,75",2,1,1,4,Low-Value,Can't Lose
12827,512,2,"274,15000000000003",4,1,1,6,Mid-Value,Potential Loyalists
12829,325,2,"51,25",5,1,1,7,Mid-Value,Potential Loyalists
12830,1116,4,"292,2",2,1,1,4,Low-Value,Can't Lose
12834,240,2,"116,39999999999999",5,1,1,7,Mid-Value,Potential Loyalists
12835,1287,3,"248,7",2,1,1,4,Low-Value,Can't Lose
12836,577,1,"84,4",4,1,1,6,Mid-Value,Potential Loyalists
12838,430,7,"284,95",4,2,1,7,Mid-Value,Potential Loyalists
12839,103,5,"824,75",5,1,2,8,High-Value,Potential Loyalists
12842,13,6,"156,75",5,1,1,7,Mid-Value,Potential Loyalists
12843,695,1,"7,9",4,1,1,6,Mid-Value,Potential Loyalists
12844,444,10,"420,05",4,2,1,7,Mid-Value,Potential Loyalists
12845,199,1,"41,5",5,1,1,7,Mid-Value,Potential Loyalists
12846,248,5,"674,35",5,1,2,8,High-Value,Potential Loyalists
12850,1630,2,"174,0",1,1,1,3,Low-Value,Lost
12851,49,12,"727,4",5,3,2,10,High-Value,Champions
12852,253,2,"71,85",5,1,1,7,Mid-Value,Potential Loyalists
12853,420,4,"197,5",4,1,1,6,Mid-Value,Potential Loyalists
12854,495,1,"64,9",4,1,1,6,Mid-Value,Potential Loyalists
12857,20,14,"649,35",5,3,1,9,High-Value,Champions
12858,1155,1,"53,85",2,1,1,4,Low-Value,Can't Lose
12861,245,6,"215,1",5,1,1,7,Mid-Value,Potential Loyalists
12862,923,2,"154,60000000000002",3,1,1,5,Low-Value,At Risk Customers
12863,871,5,"262,15",3,1,1,5,Low-Value,At Risk Customers
12866,245,7,"229,75",5,2,1,8,High-Value,Potential Loyalists
12867,71,2,"55,2",5,1,1,7,Mid-Value,Potential Loyalists
12868,522,3,"69,7",4,1,1,6,Mid-Value,Potential Loyalists
12869,893,9,"570,3",3,2,1,6,Mid-Value,Potential Loyalists
12870,8,16,"1292,65",5,3,2,10,High-Value,Champions
12871,1786,1,"70,6",1,1,1,3,Low-Value,Lost
12874,441,5,"568,5999999999999",4,1,1,6,Mid-Value,Potential Loyalists
12875,18,16,"548,8",5,3,1,9,High-Value,Champions
12876,1718,1,"55,5",1,1,1,3,Low-Value,Lost
12877,495,1,"41,9",4,1,1,6,Mid-Value,Potential Loyalists
12878,543,1,"38,5",4,1,1,6,Mid-Value,Potential Loyalists
12879,434,1,"84,6",4,1,1,6,Mid-Value,Potential Loyalists
12882,375,4,"217,2",4,1,1,6,Mid-Value,Potential Loyalists
12884,18,1,"36,3",5,1,1,7,Mid-Value,Potential Loyalists
12885,792,9,"372,8",3,2,1,6,Mid-Value,Potential Loyalists
12886,344,6,"468,8",5,1,1,7,Mid-Value,Potential Loyalists
12887,953,1,"16,200000000000003",3,1,1,5,Low-Value,At Risk Customers
12888,1431,1,"11,2",2,1,1,4,Low-Value,Can't Lose
12890,53,4,"257,55",5,1,1,7,Mid-Value,Potential Loyalists
12892,960,1,"65,55000000000001",3,1,1,5,Low-Value,At Risk Customers
12893,1001,5,"259,6",3,1,1,5,Low-Value,At Risk Customers
12894,161,9,"445,8",5,2,1,8,High-Value,Potential Loyalists
12895,989,4,"165,45",3,1,1,5,Low-Value,At Risk Customers
12896,34,10,"850,15",5,2,2,9,High-Value,Champions
12897,863,1,"63,9",3,1,1,5,Low-Value,At Risk Customers
12898,885,4,"155,6",3,1,1,5,Low-Value,At Risk Customers
12903,144,4,"349,75",5,1,1,7,Mid-Value,Potential Loyalists
12905,256,3,"100,4",5,1,1,7,Mid-Value,Potential Loyalists
12906,494,2,"123,9",4,1,1,6,Mid-Value,Potential Loyalists
12907,958,3,"233,35",3,1,1,5,Low-Value,At Risk Customers
12908,641,6,"145,8",4,1,1,6,Mid-Value,Potential Loyalists
12909,200,3,"112,64999999999999",5,1,1,7,Mid-Value,Potential Loyalists
12910,1490,3,"50,4",1,1,1,3,Low-Value,Lost
12911,1535,3,"164,85",1,1,1,3,Low-Value,Lost
12912,559,4,"178,6",4,1,1,6,Mid-Value,Potential Loyalists
12913,942,2,"45,85",3,1,1,5,Low-Value,At Risk Customers
12918,532,2,"45,800000000000004",4,1,1,6,Mid-Value,Potential Loyalists
12922,1281,1,"5,8",2,1,1,4,Low-Value,Can't Lose
12926,1,15,"984,21",5,3,2,10,High-Value,Champions
12927,115,7,"400,8",5,2,1,8,High-Value,Potential Loyalists
12928,707,4,"356,15000000000003",4,1,1,6,Mid-Value,Potential Loyalists
12929,755,2,"254,8",3,1,1,5,Low-Value,At Risk Customers
12930,248,6,"410,85",5,1,1,7,Mid-Value,Potential Loyalists
12932,424,3,"267,95",4,1,1,6,Mid-Value,Potential Loyalists
12933,900,5,"271,35",3,1,1,5,Low-Value,At Risk Customers
12934,8,3,"188,5",5,1,1,7,Mid-Value,Potential Loyalists
12936,2,5,"211,3",5,1,1,7,Mid-Value,Potential Loyalists
12937,626,1,"50,7",4,1,1,6,Mid-Value,Potential Loyalists
12938,1594,2,"228,25",1,1,1,3,Low-Value,Lost
12940,396,10,"935,55",4,2,2,8,High-Value,Potential Loyalists
12943,178,2,"174,45",5,1,1,7,Mid-Value,Potential Loyalists
12944,160,1,"174,0",5,1,1,7,Mid-Value,Potential Loyalists
12947,499,1,"29,8",4,1,1,6,Mid-Value,Potential Loyalists
12949,1276,4,"148,25",2,1,1,4,Low-Value,Can't Lose
12950,94,3,"246,7",5,1,1,7,Mid-Value,Potential Loyalists
12954,29,8,"669,05",5,2,2,9,High-Value,Champions
12956,700,1,"113,65",4,1,1,6,Mid-Value,Potential Loyalists
12957,71,2,"76,69999999999999",5,1,1,7,Mid-Value,Potential Loyalists
12958,1613,1,"49,8",1,1,1,3,Low-Value,Lost
12960,887,3,"143,2",3,1,1,5,Low-Value,At Risk Customers
12961,130,3,"274,85",5,1,1,7,Mid-Value,Potential Loyalists
12964,1525,1,"22,8",1,1,1,3,Low-Value,Lost
12965,355,4,"366,15",5,1,1,7,Mid-Value,Potential Loyalists
12966,1049,1,"49,25",3,1,1,5,Low-Value,At Risk Customers
12967,497,4,"124,6",4,1,1,6,Mid-Value,Potential Loyalists
12969,1097,1,"79,5",2,1,1,4,Low-Value,Can't Lose
12970,83,1,"51,85",5,1,1,7,Mid-Value,Potential Loyalists
12971,267,8,"429,46",5,2,1,8,High-Value,Potential Loyalists
12972,99,12,"360,65",5,3,1,9,High-Value,Champions
12973,508,10,"688,15",4,2,2,8,High-Value,Potential Loyalists
12974,73,2,"50,45",5,1,1,7,Mid-Value,Potential Loyalists
12975,1510,2,"109,05",1,1,1,3,Low-Value,Lost
12976,788,2,"22,55",3,1,1,5,Low-Value,At Risk Customers
12978,754,3,"304,95",3,1,1,5,Low-Value,At Risk Customers
12980,1777,1,"56,8",1,1,1,3,Low-Value,Lost
12981,257,3,"399,6",5,1,1,7,Mid-Value,Potential Loyalists
12983,1154,1,"52,8",2,1,1,4,Low-Value,Can't Lose
12985,188,4,"379,5",5,1,1,7,Mid-Value,Potential Loyalists
12987,1075,2,"187,8",3,1,1,5,Low-Value,At Risk Customers
12988,718,4,"204,95",4,1,1,6,Mid-Value,Potential Loyalists
12989,302,1,"50,4",5,1,1,7,Mid-Value,Potential Loyalists
12990,83,5,"169,05",5,1,1,7,Mid-Value,Potential Loyalists
12991,1148,1,"45,6",2,1,1,4,Low-Value,Can't Lose
12992,1310,1,"147,7",2,1,1,4,Low-Value,Can't Lose
12994,21,13,"906,0",5,3,2,10,High-Value,Champions
12996,1396,1,"7,85",2,1,1,4,Low-Value,Can't Lose
12998,194,3,"247,4",5,1,1,7,Mid-Value,Potential Loyalists
12999,157,8,"266,05",5,2,1,8,High-Value,Potential Loyalists
13001,693,2,"175,85",4,1,1,6,Mid-Value,Potential Loyalists
13004,403,1,"49,05",4,1,1,6,Mid-Value,Potential Loyalists
13005,186,4,"354,5",5,1,1,7,Mid-Value,Potential Loyalists
13012,817,3,"330,5",3,1,1,5,Low-Value,At Risk Customers
13013,70,6,"259,8",5,1,1,7,Mid-Value,Potential Loyalists
13014,290,9,"222,55",5,2,1,8,High-Value,Potential Loyalists
13015,203,1,"140,0",5,1,1,7,Mid-Value,Potential Loyalists
13016,619,5,"618,2",4,1,1,6,Mid-Value,Potential Loyalists
13020,995,4,"1071,1",3,1,2,6,Mid-Value,Potential Loyalists
13021,518,3,"513,75",4,1,1,6,Mid-Value,Potential Loyalists
13022,585,2,"65,0",4,1,1,6,Mid-Value,Potential Loyalists
13023,104,4,"591,25",5,1,1,7,Mid-Value,Potential Loyalists
13025,1352,1,"17,85",2,1,1,4,Low-Value,Can't Lose
13026,1613,1,"54,5",1,1,1,3,Low-Value,Lost
13027,247,4,"181,2",5,1,1,7,Mid-Value,Potential Loyalists
13028,770,2,"65,2",3,1,1,5,Low-Value,At Risk Customers
13030,586,1,"11,75",4,1,1,6,Mid-Value,Potential Loyalists
13031,379,3,"387,65",4,1,1,6,Mid-Value,Potential Loyalists
13033,378,1,"142,7",4,1,1,6,Mid-Value,Potential Loyalists
13035,858,3,"210,3",3,1,1,5,Low-Value,At Risk Customers
13036,1363,1,"18,15",2,1,1,4,Low-Value,Can't Lose
13037,60,6,"375,15",5,1,1,7,Mid-Value,Potential Loyalists
13039,1294,1,"32,75",2,1,1,4,Low-Value,Can't Lose
13040,107,3,"152,70000000000002",5,1,1,7,Mid-Value,Potential Loyalists
13041,376,7,"486,34999999999997",4,2,1,7,Mid-Value,Potential Loyalists
13043,100,4,"215,75",5,1,1,7,Mid-Value,Potential Loyalists
13046,623,1,"199,0",4,1,1,6,Mid-Value,Potential Loyalists
13047,1221,3,"211,20000000000002",2,1,1,4,Low-Value,Can't Lose
13049,62,5,"412,15",5,1,1,7,Mid-Value,Potential Loyalists
13055,266,3,"414,9",5,1,1,7,Mid-Value,Potential Loyalists
13056,454,3,"196,34999999999997",4,1,1,6,Mid-Value,Potential Loyalists
13057,661,2,"154,0",4,1,1,6,Mid-Value,Potential Loyalists
13059,5,1,"50,4",5,1,1,7,Mid-Value,Potential Loyalists
13064,520,6,"378,69999999999993",4,1,1,6,Mid-Value,Potential Loyalists
13067,1263,1,"55,5",2,1,1,4,Low-Value,Can't Lose
13068,354,1,"30,0",5,1,1,7,Mid-Value,Potential Loyalists
13070,330,1,"7,25",5,1,1,7,Mid-Value,Potential Loyalists
13071,613,2,"106,55",4,1,1,6,Mid-Value,Potential Loyalists
13072,609,2,"27,85",4,1,1,6,Mid-Value,Potential Loyalists
13073,1303,2,"117,1",2,1,1,4,Low-Value,Can't Lose
13075,1013,3,"244,85",3,1,1,5,Low-Value,At Risk Customers
13076,773,3,"201,64999999999998",3,1,1,5,Low-Value,At Risk Customers
13078,1330,1,"58,5",2,1,1,4,Low-Value,Can't Lose
13080,11,5,"806,6999999999999",5,1,2,8,High-Value,Potential Loyalists
13082,430,4,"210,75",4,1,1,6,Mid-Value,Potential Loyalists
13083,1727,1,"94,80000000000001",1,1,1,3,Low-Value,Lost
13084,92,11,"968,5",5,2,2,9,High-Value,Champions
13085,816,5,"99,2",3,1,1,5,Low-Value,At Risk Customers
13087,592,5,"171,55",4,1,1,6,Mid-Value,Potential Loyalists
13089,698,1,"38,35",4,1,1,6,Mid-Value,Potential Loyalists
13091,14,5,"701,3",5,1,2,8,High-Value,Potential Loyalists
13092,386,5,"555,2",4,1,1,6,Mid-Value,Potential Loyalists
13093,225,5,"192,25",5,1,1,7,Mid-Value,Potential Loyalists
13094,184,3,"179,3",5,1,1,7,Mid-Value,Potential Loyalists
13095,1157,1,"55,5",2,1,1,4,Low-Value,Can't Lose
13096,301,3,"330,5",5,1,1,7,Mid-Value,Potential Loyalists
13097,276,4,"395,34999999999997",5,1,1,7,Mid-Value,Potential Loyalists
13098,1608,1,"29,5",1,1,1,3,Low-Value,Lost
13099,13,12,"968,8",5,3,2,10,High-Value,Champions
13100,207,2,"138,95000000000002",5,1,1,7,Mid-Value,Potential Loyalists
13102,421,2,"151,55",4,1,1,6,Mid-Value,Potential Loyalists
13104,557,5,"832,2500000000001",4,1,2,7,Mid-Value,Potential Loyalists
13105,451,4,"296,7",4,1,1,6,Mid-Value,Potential Loyalists
13108,498,6,"173,25",4,1,1,6,Mid-Value,Potential Loyalists
13109,458,1,"42,45",4,1,1,6,Mid-Value,Potential Loyalists
13111,1469,2,"116,95",1,1,1,3,Low-Value,Lost
13113,208,1,"195,9",5,1,1,7,Mid-Value,Potential Loyalists
13117,87,3,"197,7",5,1,1,7,Mid-Value,Potential Loyalists
13119,61,14,"1077,3999999999999",5,3,2,10,High-Value,Champions
13120,806,2,"28,599999999999998",3,1,1,5,Low-Value,At Risk Customers
13121,245,2,"86,5",5,1,1,7,Mid-Value,Potential Loyalists
13122,932,1,"5,75",3,1,1,5,Low-Value,At Risk Customers
13123,57,2,"137,10000000000002",5,1,1,7,Mid-Value,Potential Loyalists
13124,232,5,"264,75",5,1,1,7,Mid-Value,Potential Loyalists
13125,82,2,"32,33",5,1,1,7,Mid-Value,Potential Loyalists
13126,73,1,"7,65",5,1,1,7,Mid-Value,Potential Loyalists
13130,267,7,"200,14999999999998",5,2,1,8,High-Value,Potential Loyalists
13132,536,1,"15,0",4,1,1,6,Mid-Value,Potential Loyalists
13134,193,11,"1613,45",5,2,3,10,High-Value,Champions
13135,1480,1,"23,7",1,1,1,3,Low-Value,Lost
13136,559,3,"302,5",4,1,1,6,Mid-Value,Potential Loyalists
13138,524,4,"235,8",4,1,1,6,Mid-Value,Potential Loyalists
13139,409,8,"295,5",4,2,1,7,Mid-Value,Potential Loyalists
13140,58,4,"151,55",5,1,1,7,Mid-Value,Potential Loyalists
13141,939,3,"387,65",3,1,1,5,Low-Value,At Risk Customers
13143,1603,3,"142,8",1,1,1,3,Low-Value,Lost
13144,479,3,"73,45",4,1,1,6,Mid-Value,Potential Loyalists
13145,29,6,"383,0",5,1,1,7,Mid-Value,Potential Loyalists
13146,1263,1,"95,5",2,1,1,4,Low-Value,Can't Lose
13147,236,1,"17,5",5,1,1,7,Mid-Value,Potential Loyalists
13148,509,8,"365,05",4,2,1,7,Mid-Value,Potential Loyalists
13150,1341,1,"42,45",2,1,1,4,Low-Value,Can't Lose
13154,145,4,"563,5",5,1,1,7,Mid-Value,Potential Loyalists
13155,137,5,"685,7",5,1,2,8,High-Value,Potential Loyalists
13156,41,2,"48,400000000000006",5,1,1,7,Mid-Value,Potential Loyalists
13157,8,2,"143,75",5,1,1,7,Mid-Value,Potential Loyalists
13159,1529,2,"65,7",1,1,1,3,Low-Value,Lost
13160,1405,2,"219,5",2,1,1,4,Low-Value,Can't Lose
13162,200,5,"506,15000000000003",5,1,1,7,Mid-Value,Potential Loyalists
13164,515,2,"174,3",4,1,1,6,Mid-Value,Potential Loyalists
13166,521,2,"117,85",4,1,1,6,Mid-Value,Potential Loyalists
13167,566,4,"129,75",4,1,1,6,Mid-Value,Potential Loyalists
13168,116,6,"334,2",5,1,1,7,Mid-Value,Potential Loyalists
13169,1491,1,"87,8",1,1,1,3,Low-Value,Lost
13170,950,1,"28,9",3,1,1,5,Low-Value,At Risk Customers
13171,287,1,"36,25",5,1,1,7,Mid-Value,Potential Loyalists
13174,395,2,"54,7",4,1,1,6,Mid-Value,Potential Loyalists
13177,1439,2,"66,85",2,1,1,4,Low-Value,Can't Lose
13179,819,4,"257,55",3,1,1,5,Low-Value,At Risk Customers
13182,7,4,"584,05",5,1,1,7,Mid-Value,Potential Loyalists
13183,1241,2,"215,54999999999998",2,1,1,4,Low-Value,Can't Lose
13184,390,7,"316,1",4,2,1,7,Mid-Value,Potential Loyalists
13185,114,3,"80,95",5,1,1,7,Mid-Value,Potential Loyalists
13186,376,4,"357,20000000000005",4,1,1,6,Mid-Value,Potential Loyalists
13188,1209,3,"116,85000000000001",2,1,1,4,Low-Value,Can't Lose
13189,1757,1,"7,8",1,1,1,3,Low-Value,Lost
13190,165,3,"169,45",5,1,1,7,Mid-Value,Potential Loyalists
13195,126,5,"249,85000000000002",5,1,1,7,Mid-Value,Potential Loyalists
13199,1261,4,"90,1",2,1,1,4,Low-Value,Can't Lose
13200,110,3,"154,55",5,1,1,7,Mid-Value,Potential Loyalists
13201,211,6,"317,45",5,1,1,7,Mid-Value,Potential Loyalists
13202,236,4,"229,60000000000002",5,1,1,7,Mid-Value,Potential Loyalists
13203,1472,3,"898,95",1,1,2,4,Low-Value,Can't Lose
13206,904,2,"105,80000000000001",3,1,1,5,Low-Value,At Risk Customers
13207,700,1,"279,4",4,1,1,6,Mid-Value,Potential Loyalists
13208,1608,1,"100,8",1,1,1,3,Low-Value,Lost
13209,1,1,"9,2",5,1,1,7,Mid-Value,Potential Loyalists
13210,1720,1,"32,75",1,1,1,3,Low-Value,Lost
13212,340,5,"308,7",5,1,1,7,Mid-Value,Potential Loyalists
13217,444,4,"267,84999999999997",4,1,1,6,Mid-Value,Potential Loyalists
13218,916,1,"29,6",3,1,1,5,Low-Value,At Risk Customers
13221,1181,1,"9,3",2,1,1,4,Low-Value,Can't Lose
13223,1355,5,"105,25",2,1,1,4,Low-Value,Can't Lose
13224,396,8,"560,7",4,2,1,7,Mid-Value,Potential Loyalists
13227,307,2,"63,849999999999994",5,1,1,7,Mid-Value,Potential Loyalists
13229,827,5,"314,45",3,1,1,5,Low-Value,At Risk Customers
13230,339,1,"41,0",5,1,1,7,Mid-Value,Potential Loyalists
13233,250,3,"76,94999999999999",5,1,1,7,Mid-Value,Potential Loyalists
13235,974,3,"222,95",3,1,1,5,Low-Value,At Risk Customers
13238,1235,2,"325,1",2,1,1,4,Low-Value,Can't Lose
13240,64,4,"262,1",5,1,1,7,Mid-Value,Potential Loyalists
13241,12,3,"735,2",5,1,2,8,High-Value,Potential Loyalists
13242,178,2,"84,9",5,1,1,7,Mid-Value,Potential Loyalists
13243,760,2,"27,2",3,1,1,5,Low-Value,At Risk Customers
13245,321,5,"234,39999999999998",5,1,1,7,Mid-Value,Potential Loyalists
13248,766,5,"152,8",3,1,1,5,Low-Value,At Risk Customers
13249,27,4,"319,5",5,1,1,7,Mid-Value,Potential Loyalists
13250,339,2,"96,6",5,1,1,7,Mid-Value,Potential Loyalists
13251,247,2,"43,5",5,1,1,7,Mid-Value,Potential Loyalists
13252,155,2,"776,0",5,1,2,8,High-Value,Potential Loyalists
13253,754,8,"504,95",3,2,1,6,Mid-Value,Potential Loyalists
13256,63,7,"189,6",5,2,1,8,High-Value,Potential Loyalists
13257,763,12,"870,3",3,3,2,8,High-Value,Potential Loyalists
13258,456,4,"103,2",4,1,1,6,Mid-Value,Potential Loyalists
13259,221,4,"145,35",5,1,1,7,Mid-Value,Potential Loyalists
13262,85,3,"237,45",5,1,1,7,Mid-Value,Potential Loyalists
13265,16,1,"42,15",5,1,1,7,Mid-Value,Potential Loyalists
13266,34,1,"10,3",5,1,1,7,Mid-Value,Potential Loyalists
13267,644,4,"243,5",4,1,1,6,Mid-Value,Potential Loyalists
13271,1081,3,"411,34999999999997",3,1,1,5,Low-Value,At Risk Customers
13272,327,16,"976,7",5,3,2,10,High-Value,Champions
13275,519,2,"323,05",4,1,1,6,Mid-Value,Potential Loyalists
13276,943,1,"67,8",3,1,1,5,Low-Value,At Risk Customers
13277,49,2,"207,95",5,1,1,7,Mid-Value,Potential Loyalists
13280,273,1,"54,55",5,1,1,7,Mid-Value,Potential Loyalists
13282,761,1,"22,7",3,1,1,5,Low-Value,At Risk Customers
13283,1396,3,"94,8",2,1,1,4,Low-Value,Can't Lose
13285,39,2,"66,1",5,1,1,7,Mid-Value,Potential Loyalists
13286,1178,3,"472,05",2,1,1,4,Low-Value,Can't Lose
13288,148,3,"76,9",5,1,1,7,Mid-Value,Potential Loyalists
13289,113,5,"71,35",5,1,1,7,Mid-Value,Potential Loyalists
13290,221,3,"208,95",5,1,1,7,Mid-Value,Potential Loyalists
13294,564,5,"1074,4",4,1,2,7,Mid-Value,Potential Loyalists
13295,1486,2,"37,8",1,1,1,3,Low-Value,Lost
13296,840,2,"83,3",3,1,1,5,Low-Value,At Risk Customers
13297,41,5,"72,8",5,1,1,7,Mid-Value,Potential Loyalists
13298,215,2,"24,75",5,1,1,7,Mid-Value,Potential Loyalists
13299,579,8,"549,95",4,2,1,7,Mid-Value,Potential Loyalists
13302,525,6,"733,0999999999999",4,1,2,7,Mid-Value,Potential Loyalists
13303,1711,1,"40,0",1,1,1,3,Low-Value,Lost
13305,1316,1,"14,8",2,1,1,4,Low-Value,Can't Lose
13307,265,3,"191,45",5,1,1,7,Mid-Value,Potential Loyalists
13309,433,5,"186,55",4,1,1,6,Mid-Value,Potential Loyalists
13310,372,9,"1747,2",4,2,3,9,High-Value,Champions
13311,429,1,"3,45",4,1,1,6,Mid-Value,Potential Loyalists
13312,1705,1,"4,95",1,1,1,3,Low-Value,Lost
13314,1263,1,"157,0",2,1,1,4,Low-Value,Can't Lose
13316,921,1,"1,35",3,1,1,5,Low-Value,At Risk Customers
13317,881,3,"417,5",3,1,1,5,Low-Value,At Risk Customers
13318,24,4,"89,65",5,1,1,7,Mid-Value,Potential Loyalists
13319,1568,1,"55,9",1,1,1,3,Low-Value,Lost
13320,231,1,"27,3",5,1,1,7,Mid-Value,Potential Loyalists
13321,227,2,"134,45",5,1,1,7,Mid-Value,Potential Loyalists
13322,1215,3,"128,85",2,1,1,4,Low-Value,Can't Lose
13324,519,4,"365,85",4,1,1,6,Mid-Value,Potential Loyalists
13327,1000,1,"23,9",3,1,1,5,Low-Value,At Risk Customers
13329,291,2,"66,3",5,1,1,7,Mid-Value,Potential Loyalists
13331,486,4,"439,0",4,1,1,6,Mid-Value,Potential Loyalists
13332,508,3,"110,4",4,1,1,6,Mid-Value,Potential Loyalists
13333,995,2,"121,25",3,1,1,5,Low-Value,At Risk Customers
13334,571,2,"243,2",4,1,1,6,Mid-Value,Potential Loyalists
13335,1546,2,"226,4",1,1,1,3,Low-Value,Lost
13337,408,6,"221,9",4,1,1,6,Mid-Value,Potential Loyalists
13338,1759,1,"50,9",1,1,1,3,Low-Value,Lost
13339,150,3,"82,05",5,1,1,7,Mid-Value,Potential Loyalists
13340,1092,1,"37,35",3,1,1,5,Low-Value,At Risk Customers
13341,643,1,"93,95",4,1,1,6,Mid-Value,Potential Loyalists
13343,427,2,"27,35",4,1,1,6,Mid-Value,Potential Loyalists
13344,1657,1,"64,0",1,1,1,3,Low-Value,Lost
13345,207,2,"22,8",5,1,1,7,Mid-Value,Potential Loyalists
13346,991,1,"10,45",3,1,1,5,Low-Value,At Risk Customers
13347,829,3,"254,75",3,1,1,5,Low-Value,At Risk Customers
13348,394,5,"311,2",4,1,1,6,Mid-Value,Potential Loyalists
13349,182,1,"21,1",5,1,1,7,Mid-Value,Potential Loyalists
13350,116,3,"120,85000000000001",5,1,1,7,Mid-Value,Potential Loyalists
13351,1060,3,"61,35",3,1,1,5,Low-Value,At Risk Customers
13353,24,2,"41,0",5,1,1,7,Mid-Value,Potential Loyalists
13354,318,5,"179,85",5,1,1,7,Mid-Value,Potential Loyalists
13356,483,1,"111,5",4,1,1,6,Mid-Value,Potential Loyalists
13357,955,3,"169,2",3,1,1,5,Low-Value,At Risk Customers
13358,910,2,"46,85",3,1,1,5,Low-Value,At Risk Customers
13359,1617,1,"42,599999999999994",1,1,1,3,Low-Value,Lost
13360,1344,1,"22,75",2,1,1,4,Low-Value,Can't Lose
13362,31,6,"397,70000000000005",5,1,1,7,Mid-Value,Potential Loyalists
13363,922,1,"226,5",3,1,1,5,Low-Value,At Risk Customers
13365,591,1,"40,0",4,1,1,6,Mid-Value,Potential Loyalists
13367,698,2,"48,65",4,1,1,6,Mid-Value,Potential Loyalists
13368,123,1,"126,44999999999999",5,1,1,7,Mid-Value,Potential Loyalists
13369,1206,1,"7,75",2,1,1,4,Low-Value,Can't Lose
13370,255,3,"215,45",5,1,1,7,Mid-Value,Potential Loyalists
13372,31,4,"235,60000000000002",5,1,1,7,Mid-Value,Potential Loyalists
13373,1067,1,"38,3",3,1,1,5,Low-Value,At Risk Customers
13376,137,12,"607,3",5,3,1,9,High-Value,Champions
13378,519,2,"50,1",4,1,1,6,Mid-Value,Potential Loyalists
13386,858,2,"284,75",3,1,1,5,Low-Value,At Risk Customers
13387,1308,4,"154,55",2,1,1,4,Low-Value,Can't Lose
13388,966,2,"69,0",3,1,1,5,Low-Value,At Risk Customers
13389,1056,1,"40,3",3,1,1,5,Low-Value,At Risk Customers
13390,154,6,"267,0",5,1,1,7,Mid-Value,Potential Loyalists
13391,1492,4,"311,70000000000005",1,1,1,3,Low-Value,Lost
13392,494,4,"325,9",4,1,1,6,Mid-Value,Potential Loyalists
13394,1550,2,"66,44999999999999",1,1,1,3,Low-Value,Lost
13395,1488,1,"3,4499999999999997",1,1,1,3,Low-Value,Lost
13396,138,6,"172,65",5,1,1,7,Mid-Value,Potential Loyalists
13398,794,1,"130,55",3,1,1,5,Low-Value,At Risk Customers
13400,1721,1,"27,25",1,1,1,3,Low-Value,Lost
13401,1182,1,"80,9",2,1,1,4,Low-Value,Can't Lose
13403,1158,2,"69,3",2,1,1,4,Low-Value,Can't Lose
13405,761,2,"160,14999999999998",3,1,1,5,Low-Value,At Risk Customers
13408,40,6,"291,55",5,1,1,7,Mid-Value,Potential Loyalists
13409,155,6,"188,6",5,1,1,7,Mid-Value,Potential Loyalists
13410,427,4,"195,75",4,1,1,6,Mid-Value,Potential Loyalists
13411,1114,1,"34,8",2,1,1,4,Low-Value,Can't Lose
13412,148,1,"24,4",5,1,1,7,Mid-Value,Potential Loyalists
13413,769,4,"291,0",3,1,1,5,Low-Value,At Risk Customers
13414,94,3,"44,5",5,1,1,7,Mid-Value,Potential Loyalists
13415,398,2,"105,55000000000001",4,1,1,6,Mid-Value,Potential Loyalists
13416,134,2,"238,64999999999998",5,1,1,7,Mid-Value,Potential Loyalists
13417,979,1,"109,8",3,1,1,5,Low-Value,At Risk Customers
13418,11,3,"620,5",5,1,1,7,Mid-Value,Potential Loyalists
13419,496,2,"75,55",4,1,1,6,Mid-Value,Potential Loyalists
13420,1234,4,"211,0",2,1,1,4,Low-Value,Can't Lose
13421,154,3,"309,15",5,1,1,7,Mid-Value,Potential Loyalists
13423,420,13,"622,15",4,3,1,8,High-Value,Potential Loyalists
13425,105,4,"111,25",5,1,1,7,Mid-Value,Potential Loyalists
13427,68,5,"303,55",5,1,1,7,Mid-Value,Potential Loyalists
13428,1020,1,"55,75",3,1,1,5,Low-Value,At Risk Customers
13430,812,4,"139,9",3,1,1,5,Low-Value,At Risk Customers
13431,831,2,"32,099999999999994",3,1,1,5,Low-Value,At Risk Customers
13432,255,2,"157,0",5,1,1,7,Mid-Value,Potential Loyalists
13434,1328,1,"32,15",2,1,1,4,Low-Value,Can't Lose
13439,577,2,"91,9",4,1,1,6,Mid-Value,Potential Loyalists
13440,14,6,"461,25",5,1,1,7,Mid-Value,Potential Loyalists
13442,587,2,"136,29999999999998",4,1,1,6,Mid-Value,Potential Loyalists
13443,1160,3,"51,3",2,1,1,4,Low-Value,Can't Lose
13444,140,2,"28,799999999999997",5,1,1,7,Mid-Value,Potential Loyalists
13445,293,3,"195,05",5,1,1,7,Mid-Value,Potential Loyalists
13448,952,8,"373,65",3,2,1,6,Mid-Value,Potential Loyalists
13449,603,1,"59,25",4,1,1,6,Mid-Value,Potential Loyalists
13450,390,5,"141,45",4,1,1,6,Mid-Value,Potential Loyalists
13451,846,3,"162,25",3,1,1,5,Low-Value,At Risk Customers
13453,713,1,"15,95",4,1,1,6,Mid-Value,Potential Loyalists
13454,405,7,"149,75",4,2,1,7,Mid-Value,Potential Loyalists
13455,420,5,"263,85",4,1,1,6,Mid-Value,Potential Loyalists
13456,1321,1,"93,3",2,1,1,4,Low-Value,Can't Lose
13458,535,8,"859,95",4,2,2,8,High-Value,Potential Loyalists
13459,4,9,"1386,8",5,2,3,10,High-Value,Champions
13463,53,2,"41,9",5,1,1,7,Mid-Value,Potential Loyalists
13464,698,4,"504,8",4,1,1,6,Mid-Value,Potential Loyalists
13465,155,2,"29,5",5,1,1,7,Mid-Value,Potential Loyalists
13466,260,2,"106,05000000000001",5,1,1,7,Mid-Value,Potential Loyalists
13467,1506,1,"13,55",1,1,1,3,Low-Value,Lost
13470,756,10,"521,4",3,2,1,6,Mid-Value,Potential Loyalists
13472,1733,2,"70,7",1,1,1,3,Low-Value,Lost
13473,54,2,"23,6",5,1,1,7,Mid-Value,Potential Loyalists
13474,1530,1,"50,4",1,1,1,3,Low-Value,Lost
13475,766,5,"526,75",3,1,1,5,Low-Value,At Risk Customers
13477,1419,1,"14,95",2,1,1,4,Low-Value,Can't Lose
13478,511,4,"212,6",4,1,1,6,Mid-Value,Potential Loyalists
13482,568,5,"392,90000000000003",4,1,1,6,Mid-Value,Potential Loyalists
13485,1786,1,"24,15",1,1,1,3,Low-Value,Lost
13486,822,4,"412,4",3,1,1,5,Low-Value,At Risk Customers
13487,202,5,"987,1500000000001",5,1,2,8,High-Value,Potential Loyalists
13490,647,1,"5,6",4,1,1,6,Mid-Value,Potential Loyalists
13491,21,3,"258,45",5,1,1,7,Mid-Value,Potential Loyalists
13492,901,1,"12,9",3,1,1,5,Low-Value,At Risk Customers
13494,1656,1,"4,8",1,1,1,3,Low-Value,Lost
13495,26,4,"154,35",5,1,1,7,Mid-Value,Potential Loyalists
13497,49,5,"261,5",5,1,1,7,Mid-Value,Potential Loyalists
13499,792,5,"524,1",3,1,1,5,Low-Value,At Risk Customers
13500,1312,1,"337,35",2,1,1,4,Low-Value,Can't Lose
13505,1253,1,"18,2",2,1,1,4,Low-Value,Can't Lose
13507,200,10,"620,9",5,2,1,8,High-Value,Potential Loyalists
13508,789,1,"4,1",3,1,1,5,Low-Value,At Risk Customers
13510,127,4,"275,95",5,1,1,7,Mid-Value,Potential Loyalists
13512,77,5,"906,65",5,1,2,8,High-Value,Potential Loyalists
13514,507,3,"81,7",4,1,1,6,Mid-Value,Potential Loyalists
13515,644,1,"116,6",4,1,1,6,Mid-Value,Potential Loyalists
13516,748,6,"210,7",3,1,1,5,Low-Value,At Risk Customers
13518,866,4,"399,8",3,1,1,5,Low-Value,At Risk Customers
13520,750,4,"265,55",3,1,1,5,Low-Value,At Risk Customers
13521,1294,1,"164,25",2,1,1,4,Low-Value,Can't Lose
13522,824,3,"101,8",3,1,1,5,Low-Value,At Risk Customers
13524,262,1,"27,2",5,1,1,7,Mid-Value,Potential Loyalists
13525,984,4,"395,59999999999997",3,1,1,5,Low-Value,At Risk Customers
13526,369,3,"497,20000000000005",4,1,1,6,Mid-Value,Potential Loyalists
13527,165,1,"17,0",5,1,1,7,Mid-Value,Potential Loyalists
13528,1583,2,"124,35",1,1,1,3,Low-Value,Lost
13530,820,3,"131,6",3,1,1,5,Low-Value,At Risk Customers
13531,42,1,"17,3",5,1,1,7,Mid-Value,Potential Loyalists
13532,913,3,"129,85",3,1,1,5,Low-Value,At Risk Customers
13535,376,6,"324,95",4,1,1,6,Mid-Value,Potential Loyalists
13536,444,3,"104,94999999999999",4,1,1,6,Mid-Value,Potential Loyalists
13537,63,9,"335,55",5,2,1,8,High-Value,Potential Loyalists
13538,1145,1,"49,75",2,1,1,4,Low-Value,Can't Lose
13539,99,3,"462,65",5,1,1,7,Mid-Value,Potential Loyalists
13540,1712,2,"181,35000000000002",1,1,1,3,Low-Value,Lost
13541,596,1,"2,9",4,1,1,6,Mid-Value,Potential Loyalists
13542,1469,2,"103,2",1,1,1,3,Low-Value,Lost
13545,1454,1,"199,0",2,1,1,4,Low-Value,Can't Lose
13546,1581,1,"76,8",1,1,1,3,Low-Value,Lost
13548,1809,1,"6,75",1,1,1,3,Low-Value,Lost
13549,38,5,"78,45",5,1,1,7,Mid-Value,Potential Loyalists
13550,605,1,"19,65",4,1,1,6,Mid-Value,Potential Loyalists
13551,43,2,"93,65",5,1,1,7,Mid-Value,Potential Loyalists
13552,481,3,"157,10000000000002",4,1,1,6,Mid-Value,Potential Loyalists
13555,715,1,"35,55",4,1,1,6,Mid-Value,Potential Loyalists
13557,1431,1,"21,75",2,1,1,4,Low-Value,Can't Lose
13558,21,5,"248,2",5,1,1,7,Mid-Value,Potential Loyalists
13559,1652,1,"36,3",1,1,1,3,Low-Value,Lost
13560,477,2,"69,4",4,1,1,6,Mid-Value,Potential Loyalists
13561,1439,2,"41,85",2,1,1,4,Low-Value,Can't Lose
13562,133,9,"354,5",5,2,1,8,High-Value,Potential Loyalists
13563,626,1,"9,15",4,1,1,6,Mid-Value,Potential Loyalists
13564,139,7,"335,6",5,2,1,8,High-Value,Potential Loyalists
13566,810,1,"53,05",3,1,1,5,Low-Value,At Risk Customers
13569,337,4,"385,2",5,1,1,7,Mid-Value,Potential Loyalists
13571,547,3,"10,4",4,1,1,6,Mid-Value,Potential Loyalists
13575,1637,1,"66,9",1,1,1,3,Low-Value,Lost
13576,1685,1,"113,39999999999999",1,1,1,3,Low-Value,Lost
13581,402,6,"289,6",4,1,1,6,Mid-Value,Potential Loyalists
13582,906,2,"193,6",3,1,1,5,Low-Value,At Risk Customers
13583,393,3,"131,75",4,1,1,6,Mid-Value,Potential Loyalists
13584,742,4,"214,05",3,1,1,5,Low-Value,At Risk Customers
13586,798,2,"33,6",3,1,1,5,Low-Value,At Risk Customers
13587,920,2,"189,5",3,1,1,5,Low-Value,At Risk Customers
13588,386,6,"393,95",4,1,1,6,Mid-Value,Potential Loyalists
13589,1305,1,"1229,0",2,1,2,5,Low-Value,At Risk Customers
13591,53,1,"114,1",5,1,1,7,Mid-Value,Potential Loyalists
13592,246,2,"128,8",5,1,1,7,Mid-Value,Potential Loyalists
13593,208,4,"197,85",5,1,1,7,Mid-Value,Potential Loyalists
13596,1461,1,"61,9",1,1,1,3,Low-Value,Lost
13597,774,2,"89,44999999999999",3,1,1,5,Low-Value,At Risk Customers
13599,1421,2,"194,85",2,1,1,4,Low-Value,Can't Lose
13600,605,11,"1226,4499999999998",4,2,2,8,High-Value,Potential Loyalists
13601,587,4,"231,75",4,1,1,6,Mid-Value,Potential Loyalists
13602,1118,4,"74,69999999999999",2,1,1,4,Low-Value,Can't Lose
13604,83,4,"217,6",5,1,1,7,Mid-Value,Potential Loyalists
13606,731,4,"283,3",3,1,1,5,Low-Value,At Risk Customers
13607,501,1,"211,1",4,1,1,6,Mid-Value,Potential Loyalists
13608,1456,1,"109,1",2,1,1,4,Low-Value,Can't Lose
13611,376,1,"51,8",4,1,1,6,Mid-Value,Potential Loyalists
13613,886,1,"23,2",3,1,1,5,Low-Value,At Risk Customers
13614,1255,1,"181,95",2,1,1,4,Low-Value,Can't Lose
13615,194,2,"697,9",5,1,2,8,High-Value,Potential Loyalists
13617,892,3,"62,3",3,1,1,5,Low-Value,At Risk Customers
13618,379,3,"148,8",4,1,1,6,Mid-Value,Potential Loyalists
13624,547,1,"17,0",4,1,1,6,Mid-Value,Potential Loyalists
13625,199,1,"18,4",5,1,1,7,Mid-Value,Potential Loyalists
13626,24,5,"510,40000000000003",5,1,1,7,Mid-Value,Potential Loyalists
13627,297,8,"1471,95",5,2,3,10,High-Value,Champions
13629,627,2,"150,15",4,1,1,6,Mid-Value,Potential Loyalists
13630,1810,1,"79,0",1,1,1,3,Low-Value,Lost
13631,207,11,"483,55",5,2,1,8,High-Value,Potential Loyalists
13632,167,2,"108,3",5,1,1,7,Mid-Value,Potential Loyalists
13633,1330,1,"56,45",2,1,1,4,Low-Value,Can't Lose
13635,939,2,"130,05",3,1,1,5,Low-Value,At Risk Customers
13637,557,2,"37,05",4,1,1,6,Mid-Value,Potential Loyalists
13638,214,1,"139,8",5,1,1,7,Mid-Value,Potential Loyalists
13640,1065,1,"51,45",3,1,1,5,Low-Value,At Risk Customers
13644,404,5,"111,75",4,1,1,6,Mid-Value,Potential Loyalists
13645,172,1,"34,5",5,1,1,7,Mid-Value,Potential Loyalists
13646,407,6,"306,9",4,1,1,6,Mid-Value,Potential Loyalists
13647,844,3,"149,15",3,1,1,5,Low-Value,At Risk Customers
13649,657,1,"58,9",4,1,1,6,Mid-Value,Potential Loyalists
13651,440,2,"24,7",4,1,1,6,Mid-Value,Potential Loyalists
13652,536,5,"213,79999999999998",4,1,1,6,Mid-Value,Potential Loyalists
13655,925,3,"811,15",3,1,2,6,Mid-Value,Potential Loyalists
13656,5,1,"127,35000000000001",5,1,1,7,Mid-Value,Potential Loyalists
13658,306,4,"111,5",5,1,1,7,Mid-Value,Potential Loyalists
13659,44,1,"77,8",5,1,1,7,Mid-Value,Potential Loyalists
13660,296,1,"13,6",5,1,1,7,Mid-Value,Potential Loyalists
13662,152,7,"227,39999999999998",5,2,1,8,High-Value,Potential Loyalists
13664,381,6,"223,2",4,1,1,6,Mid-Value,Potential Loyalists
13665,21,1,"47,6",5,1,1,7,Mid-Value,Potential Loyalists
13666,990,1,"15,0",3,1,1,5,Low-Value,At Risk Customers
13670,470,6,"231,15",4,1,1,6,Mid-Value,Potential Loyalists
13671,405,2,"24,15",4,1,1,6,Mid-Value,Potential Loyalists
13673,717,2,"78,5",4,1,1,6,Mid-Value,Potential Loyalists
13674,200,1,"75,2",5,1,1,7,Mid-Value,Potential Loyalists
13677,572,1,"5,7",4,1,1,6,Mid-Value,Potential Loyalists
13678,593,4,"175,6",4,1,1,6,Mid-Value,Potential Loyalists
13680,424,2,"181,6",4,1,1,6,Mid-Value,Potential Loyalists
13681,161,2,"90,65",5,1,1,7,Mid-Value,Potential Loyalists
13684,7,3,"56,900000000000006",5,1,1,7,Mid-Value,Potential Loyalists
13688,462,3,"65,45",4,1,1,6,Mid-Value,Potential Loyalists
13690,19,4,"100,5",5,1,1,7,Mid-Value,Potential Loyalists
13693,105,4,"390,25",5,1,1,7,Mid-Value,Potential Loyalists
13694,488,2,"104,44999999999999",4,1,1,6,Mid-Value,Potential Loyalists
13696,600,1,"23,75",4,1,1,6,Mid-Value,Potential Loyalists
13698,426,4,"203,0",4,1,1,6,Mid-Value,Potential Loyalists
13699,1036,1,"54,55",3,1,1,5,Low-Value,At Risk Customers
13701,54,11,"825,8",5,2,2,9,High-Value,Champions
13703,501,2,"52,7",4,1,1,6,Mid-Value,Potential Loyalists
13705,39,18,"738,3499999999999",5,4,2,11,High-Value,Champions
13707,152,5,"261,7",5,1,1,7,Mid-Value,Potential Loyalists
13709,646,2,"56,3",4,1,1,6,Mid-Value,Potential Loyalists
13710,605,4,"106,35",4,1,1,6,Mid-Value,Potential Loyalists
13711,244,5,"312,15",5,1,1,7,Mid-Value,Potential Loyalists
13714,1268,1,"78,5",2,1,1,4,Low-Value,Can't Lose
13715,1312,2,"87,95",2,1,1,4,Low-Value,Can't Lose
13718,1546,1,"7,85",1,1,1,3,Low-Value,Lost
13719,385,2,"94,75",4,1,1,6,Mid-Value,Potential Loyalists
13720,29,11,"409,7",5,2,1,8,High-Value,Potential Loyalists
13721,916,2,"179,3",3,1,1,5,Low-Value,At Risk Customers
13722,755,2,"273,65000000000003",3,1,1,5,Low-Value,At Risk Customers
13724,65,2,"299,85",5,1,1,7,Mid-Value,Potential Loyalists
13726,1816,1,"9,5",1,1,1,3,Low-Value,Lost
13727,86,2,"27,330000000000002",5,1,1,7,Mid-Value,Potential Loyalists
13728,1413,1,"6,1",2,1,1,4,Low-Value,Can't Lose
13729,1481,1,"128,3",1,1,1,3,Low-Value,Lost
13731,1074,2,"34,15",3,1,1,5,Low-Value,At Risk Customers
13734,130,2,"74,9",5,1,1,7,Mid-Value,Potential Loyalists
13735,79,5,"351,25",5,1,1,7,Mid-Value,Potential Loyalists
13736,26,3,"71,9",5,1,1,7,Mid-Value,Potential Loyalists
13737,1269,1,"20,4",2,1,1,4,Low-Value,Can't Lose
13739,367,1,"66,7",4,1,1,6,Mid-Value,Potential Loyalists
13741,385,2,"177,15",4,1,1,6,Mid-Value,Potential Loyalists
13742,1105,4,"214,7",2,1,1,4,Low-Value,Can't Lose
13743,140,2,"186,45000000000002",5,1,1,7,Mid-Value,Potential Loyalists
13744,46,8,"255,35",5,2,1,8,High-Value,Potential Loyalists
13746,161,6,"388,45000000000005",5,1,1,7,Mid-Value,Potential Loyalists
13747,1104,4,"110,79999999999998",2,1,1,4,Low-Value,Can't Lose
13749,287,2,"130,45000000000002",5,1,1,7,Mid-Value,Potential Loyalists
13750,23,3,"205,8",5,1,1,7,Mid-Value,Potential Loyalists
13756,1561,2,"242,5",1,1,1,3,Low-Value,Lost
13758,749,5,"236,64999999999998",3,1,1,5,Low-Value,At Risk Customers
13759,98,4,"264,15",5,1,1,7,Mid-Value,Potential Loyalists
13760,102,5,"452,1",5,1,1,7,Mid-Value,Potential Loyalists
13761,738,6,"294,1",3,1,1,5,Low-Value,At Risk Customers
13762,371,5,"321,65",4,1,1,6,Mid-Value,Potential Loyalists
13763,887,3,"212,55",3,1,1,5,Low-Value,At Risk Customers
13767,755,2,"79,05",3,1,1,5,Low-Value,At Risk Customers
13768,832,1,"9,95",3,1,1,5,Low-Value,At Risk Customers
13769,694,4,"208,0",4,1,1,6,Mid-Value,Potential Loyalists
13770,673,4,"216,04999999999998",4,1,1,6,Mid-Value,Potential Loyalists
13771,381,4,"627,15",4,1,1,6,Mid-Value,Potential Loyalists
13772,197,4,"123,6",5,1,1,7,Mid-Value,Potential Loyalists
13773,97,11,"962,45",5,2,2,9,High-Value,Champions
13775,56,2,"41,6",5,1,1,7,Mid-Value,Potential Loyalists
13776,112,2,"23,200000000000003",5,1,1,7,Mid-Value,Potential Loyalists
13779,376,5,"155,78",4,1,1,6,Mid-Value,Potential Loyalists
13780,1109,2,"98,25",2,1,1,4,Low-Value,Can't Lose
13782,477,5,"134,05",4,1,1,6,Mid-Value,Potential Loyalists
13783,655,4,"101,5",4,1,1,6,Mid-Value,Potential Loyalists
13785,924,1,"24,8",3,1,1,5,Low-Value,At Risk Customers
13786,1287,1,"117,1",2,1,1,4,Low-Value,Can't Lose
13787,1685,1,"4,5",1,1,1,3,Low-Value,Lost
13788,1238,1,"26,1",2,1,1,4,Low-Value,Can't Lose
13789,88,2,"58,55",5,1,1,7,Mid-Value,Potential Loyalists
13790,274,12,"885,1",5,3,2,10,High-Value,Champions
13791,1080,1,"117,8",3,1,1,5,Low-Value,At Risk Customers
13792,32,10,"550,75",5,2,1,8,High-Value,Potential Loyalists
13795,185,6,"249,55",5,1,1,7,Mid-Value,Potential Loyalists
13797,3,5,"261,8",5,1,1,7,Mid-Value,Potential Loyalists
13798,1252,2,"30,0",2,1,1,4,Low-Value,Can't Lose
13799,608,3,"635,9",4,1,1,6,Mid-Value,Potential Loyalists
13800,1818,1,"49,8",1,1,1,3,Low-Value,Lost
13801,1676,1,"16,5",1,1,1,3,Low-Value,Lost
13803,1626,2,"41,099999999999994",1,1,1,3,Low-Value,Lost
13807,771,3,"100,15",3,1,1,5,Low-Value,At Risk Customers
13808,304,3,"201,6",5,1,1,7,Mid-Value,Potential Loyalists
13818,309,6,"234,95",5,1,1,7,Mid-Value,Potential Loyalists
13822,886,3,"205,0",3,1,1,5,Low-Value,At Risk Customers
13823,4,13,"678,4",5,3,2,10,High-Value,Champions
13824,1265,2,"83,6",2,1,1,4,Low-Value,Can't Lose
13825,1221,2,"335,6",2,1,1,4,Low-Value,Can't Lose
13827,74,2,"127,05",5,1,1,7,Mid-Value,Potential Loyalists
13829,1053,2,"59,55",3,1,1,5,Low-Value,At Risk Customers
13834,102,1,"13,4",5,1,1,7,Mid-Value,Potential Loyalists
13836,11,2,"104,45",5,1,1,7,Mid-Value,Potential Loyalists
13837,162,4,"104,5",5,1,1,7,Mid-Value,Potential Loyalists
13838,227,2,"366,3",5,1,1,7,Mid-Value,Potential Loyalists
13839,473,3,"193,8",4,1,1,6,Mid-Value,Potential Loyalists
13844,1109,1,"222,45000000000002",2,1,1,4,Low-Value,Can't Lose
13847,252,4,"140,3",5,1,1,7,Mid-Value,Potential Loyalists
13850,145,4,"270,8",5,1,1,7,Mid-Value,Potential Loyalists
13853,697,5,"152,3",4,1,1,6,Mid-Value,Potential Loyalists
13855,505,7,"406,1",4,2,1,7,Mid-Value,Potential Loyalists
13857,293,2,"52,2",5,1,1,7,Mid-Value,Potential Loyalists
13858,1659,1,"11,8",1,1,1,3,Low-Value,Lost
13859,946,1,"226,9",3,1,1,5,Low-Value,At Risk Customers
13860,1283,1,"233,2",2,1,1,4,Low-Value,Can't Lose
13861,1272,2,"32,55",2,1,1,4,Low-Value,Can't Lose
13862,346,4,"175,75",5,1,1,7,Mid-Value,Potential Loyalists
13864,409,5,"162,85",4,1,1,6,Mid-Value,Potential Loyalists
13865,230,3,"73,89999999999999",5,1,1,7,Mid-Value,Potential Loyalists
13867,124,1,"66,75",5,1,1,7,Mid-Value,Potential Loyalists
13868,372,12,"676,8",4,3,2,9,High-Value,Champions
13869,965,2,"104,85",3,1,1,5,Low-Value,At Risk Customers
13871,643,1,"58,9",4,1,1,6,Mid-Value,Potential Loyalists
13872,740,7,"693,0999999999999",3,2,2,7,Mid-Value,Potential Loyalists
13875,546,7,"748,5",4,2,2,8,High-Value,Potential Loyalists
13877,805,2,"11,98",3,1,1,5,Low-Value,At Risk Customers
13878,151,4,"152,6",5,1,1,7,Mid-Value,Potential Loyalists
13879,462,4,"214,3",4,1,1,6,Mid-Value,Potential Loyalists
13881,172,2,"24,25",5,1,1,7,Mid-Value,Potential Loyalists
13883,832,4,"418,29999999999995",3,1,1,5,Low-Value,At Risk Customers
13885,1466,2,"70,25",1,1,1,3,Low-Value,Lost
13886,621,1,"4,6",4,1,1,6,Mid-Value,Potential Loyalists
13887,225,5,"237,3",5,1,1,7,Mid-Value,Potential Loyalists
13888,59,1,"9,55",5,1,1,7,Mid-Value,Potential Loyalists
13890,619,1,"63,05",4,1,1,6,Mid-Value,Potential Loyalists
13891,620,3,"78,8",4,1,1,6,Mid-Value,Potential Loyalists
13892,1034,1,"9,8",3,1,1,5,Low-Value,At Risk Customers
13893,479,4,"115,4",4,1,1,6,Mid-Value,Potential Loyalists
13894,115,6,"308,59999999999997",5,1,1,7,Mid-Value,Potential Loyalists
13895,788,2,"167,60000000000002",3,1,1,5,Low-Value,At Risk Customers
13896,144,7,"314,75",5,2,1,8,High-Value,Potential Loyalists
13899,110,2,"99,94999999999999",5,1,1,7,Mid-Value,Potential Loyalists
13900,172,3,"152,6",5,1,1,7,Mid-Value,Potential Loyalists
13902,127,2,"53,5",5,1,1,7,Mid-Value,Potential Loyalists
13903,1363,4,"302,15",2,1,1,4,Low-Value,Can't Lose
13905,896,7,"259,05",3,2,1,6,Mid-Value,Potential Loyalists
13908,583,2,"112,55",4,1,1,6,Mid-Value,Potential Loyalists
13909,146,5,"591,2",5,1,1,7,Mid-Value,Potential Loyalists
13911,127,3,"205,15",5,1,1,7,Mid-Value,Potential Loyalists
13912,75,3,"377,75",5,1,1,7,Mid-Value,Potential Loyalists
13913,12,2,"24,5",5,1,1,7,Mid-Value,Potential Loyalists
13914,1156,2,"63,400000000000006",2,1,1,4,Low-Value,Can't Lose
13916,306,1,"139,35",5,1,1,7,Mid-Value,Potential Loyalists
13917,280,2,"97,60000000000001",5,1,1,7,Mid-Value,Potential Loyalists
13918,24,5,"358,65",5,1,1,7,Mid-Value,Potential Loyalists
13919,799,1,"67,4",3,1,1,5,Low-Value,At Risk Customers
13920,73,3,"45,8",5,1,1,7,Mid-Value,Potential Loyalists
13922,46,3,"63,550000000000004",5,1,1,7,Mid-Value,Potential Loyalists
13923,134,1,"81,8",5,1,1,7,Mid-Value,Potential Loyalists
13924,395,2,"289,65000000000003",4,1,1,6,Mid-Value,Potential Loyalists
13926,133,5,"159,0",5,1,1,7,Mid-Value,Potential Loyalists
13928,744,5,"95,85000000000001",3,1,1,5,Low-Value,At Risk Customers
13929,1297,1,"12,3",2,1,1,4,Low-Value,Can't Lose
13933,171,5,"506,3",5,1,1,7,Mid-Value,Potential Loyalists
13934,1523,2,"120,2",1,1,1,3,Low-Value,Lost
13936,1114,5,"491,79999999999995",2,1,1,4,Low-Value,Can't Lose
13942,1015,4,"162,85",3,1,1,5,Low-Value,At Risk Customers
13943,1494,3,"339,95",1,1,1,3,Low-Value,Lost
13945,880,3,"242,21",3,1,1,5,Low-Value,At Risk Customers
13947,917,3,"124,8",3,1,1,5,Low-Value,At Risk Customers
13949,743,24,"1361,7",3,5,3,11,High-Value,Champions
13950,554,3,"233,05",4,1,1,6,Mid-Value,Potential Loyalists
13952,707,4,"345,29999999999995",4,1,1,6,Mid-Value,Potential Loyalists
13953,872,2,"91,6",3,1,1,5,Low-Value,At Risk Customers
13954,316,3,"145,35",5,1,1,7,Mid-Value,Potential Loyalists
13956,3,3,"172,29999999999998",5,1,1,7,Mid-Value,Potential Loyalists
13958,270,1,"15,4",5,1,1,7,Mid-Value,Potential Loyalists
13961,82,3,"107,85",5,1,1,7,Mid-Value,Potential Loyalists
13965,1347,1,"13,2",2,1,1,4,Low-Value,Can't Lose
13970,319,1,"30,7",5,1,1,7,Mid-Value,Potential Loyalists
13971,102,2,"18,9",5,1,1,7,Mid-Value,Potential Loyalists
13972,675,2,"332,84999999999997",4,1,1,6,Mid-Value,Potential Loyalists
13973,129,2,"93,55",5,1,1,7,Mid-Value,Potential Loyalists
13974,108,2,"59,1",5,1,1,7,Mid-Value,Potential Loyalists
13975,1219,1,"22,8",2,1,1,4,Low-Value,Can't Lose
13976,1143,1,"109,1",2,1,1,4,Low-Value,Can't Lose
13978,1491,1,"900,6",1,1,2,4,Low-Value,Can't Lose
13979,30,5,"303,70000000000005",5,1,1,7,Mid-Value,Potential Loyalists
13980,21,1,"19,3",5,1,1,7,Mid-Value,Potential Loyalists
13982,1098,8,"844,5999999999999",2,2,2,6,Mid-Value,Potential Loyalists
13986,785,3,"178,15",3,1,1,5,Low-Value,At Risk Customers
13987,1528,1,"25,5",1,1,1,3,Low-Value,Lost
13988,244,7,"695,3",5,2,2,9,High-Value,Champions
13989,393,5,"712,65",4,1,2,7,Mid-Value,Potential Loyalists
13991,854,3,"211,6",3,1,1,5,Low-Value,At Risk Customers
13999,332,1,"8,6",5,1,1,7,Mid-Value,Potential Loyalists
14000,148,4,"212,45",5,1,1,7,Mid-Value,Potential Loyalists
14003,216,3,"137,95",5,1,1,7,Mid-Value,Potential Loyalists
14004,270,2,"81,85",5,1,1,7,Mid-Value,Potential Loyalists
14005,417,6,"371,05",4,1,1,6,Mid-Value,Potential Loyalists
14006,429,1,"16,6",4,1,1,6,Mid-Value,Potential Loyalists
14010,695,5,"171,9",4,1,1,6,Mid-Value,Potential Loyalists
14012,405,8,"377,4",4,2,1,7,Mid-Value,Potential Loyalists
14013,1184,1,"59,4",2,1,1,4,Low-Value,Can't Lose
14017,487,2,"45,3",4,1,1,6,Mid-Value,Potential Loyalists
14020,199,1,"28,6",5,1,1,7,Mid-Value,Potential Loyalists
14021,1806,1,"12,9",1,1,1,3,Low-Value,Lost
14022,19,2,"159,8",5,1,1,7,Mid-Value,Potential Loyalists
14023,1164,2,"36,05",2,1,1,4,Low-Value,Can't Lose
14024,800,3,"69,4",3,1,1,5,Low-Value,At Risk Customers
14025,1,5,"237,95",5,1,1,7,Mid-Value,Potential Loyalists
14026,128,12,"1367,35",5,3,3,11,High-Value,Champions
14027,361,12,"686,3",5,3,2,10,High-Value,Champions
14030,23,6,"190,64999999999998",5,1,1,7,Mid-Value,Potential Loyalists
14032,20,3,"86,8",5,1,1,7,Mid-Value,Potential Loyalists
14033,1316,1,"77,2",2,1,1,4,Low-Value,Can't Lose
14035,1643,2,"148,6",1,1,1,3,Low-Value,Lost
14036,114,2,"186,45000000000002",5,1,1,7,Mid-Value,Potential Loyalists
14037,367,3,"358,8",4,1,1,6,Mid-Value,Potential Loyalists
14041,1091,2,"72,2",3,1,1,5,Low-Value,At Risk Customers
14044,157,2,"129,8",5,1,1,7,Mid-Value,Potential Loyalists
14046,937,1,"205,79999999999998",3,1,1,5,Low-Value,At Risk Customers
14047,127,6,"570,75",5,1,1,7,Mid-Value,Potential Loyalists
14048,503,2,"227,6",4,1,1,6,Mid-Value,Potential Loyalists
14049,1372,1,"80,85",2,1,1,4,Low-Value,Can't Lose
14051,1678,3,"181,45",1,1,1,3,Low-Value,Lost
14054,488,1,"28,9",4,1,1,6,Mid-Value,Potential Loyalists
14056,1717,2,"60,4",1,1,1,3,Low-Value,Lost
14059,785,3,"55,5",3,1,1,5,Low-Value,At Risk Customers
14060,234,5,"358,85",5,1,1,7,Mid-Value,Potential Loyalists
14061,1594,2,"124,69999999999999",1,1,1,3,Low-Value,Lost
14062,920,1,"226,9",3,1,1,5,Low-Value,At Risk Customers
14063,21,5,"162,3",5,1,1,7,Mid-Value,Potential Loyalists
14066,529,3,"71,5",4,1,1,6,Mid-Value,Potential Loyalists
14067,453,2,"62,95",4,1,1,6,Mid-Value,Potential Loyalists
14068,8,3,"141,04999999999998",5,1,1,7,Mid-Value,Potential Loyalists
14069,1809,1,"47,7",1,1,1,3,Low-Value,Lost
14070,73,2,"139,5",5,1,1,7,Mid-Value,Potential Loyalists
14071,938,3,"614,9",3,1,1,5,Low-Value,At Risk Customers
14075,22,2,"52,8",5,1,1,7,Mid-Value,Potential Loyalists
14077,472,6,"217,65",4,1,1,6,Mid-Value,Potential Loyalists
14078,527,2,"79,35000000000001",4,1,1,6,Mid-Value,Potential Loyalists
14079,62,4,"173,8",5,1,1,7,Mid-Value,Potential Loyalists
14080,1660,1,"41,0",1,1,1,3,Low-Value,Lost
14081,15,7,"343,9",5,2,1,8,High-Value,Potential Loyalists
14082,367,6,"174,05",4,1,1,6,Mid-Value,Potential Loyalists
14083,40,7,"341,5",5,2,1,8,High-Value,Potential Loyalists
14084,502,3,"45,2",4,1,1,6,Mid-Value,Potential Loyalists
14085,413,3,"159,05",4,1,1,6,Mid-Value,Potential Loyalists
14086,236,4,"163,2",5,1,1,7,Mid-Value,Potential Loyalists
14088,588,3,"133,25",4,1,1,6,Mid-Value,Potential Loyalists
14090,66,5,"514,55",5,1,1,7,Mid-Value,Potential Loyalists
14093,944,2,"70,65",3,1,1,5,Low-Value,At Risk Customers
14094,63,6,"201,95",5,1,1,7,Mid-Value,Potential Loyalists
14098,73,5,"118,8",5,1,1,7,Mid-Value,Potential Loyalists
14099,90,15,"963,1",5,3,2,10,High-Value,Champions
14100,59,2,"102,9",5,1,1,7,Mid-Value,Potential Loyalists
14101,258,1,"7,45",5,1,1,7,Mid-Value,Potential Loyalists
14102,1481,1,"16,2",1,1,1,3,Low-Value,Lost
14104,28,2,"62,8",5,1,1,7,Mid-Value,Potential Loyalists
14105,95,6,"593,45",5,1,1,7,Mid-Value,Potential Loyalists
14107,270,5,"371,84999999999997",5,1,1,7,Mid-Value,Potential Loyalists
14108,239,6,"254,75",5,1,1,7,Mid-Value,Potential Loyalists
14109,1036,1,"5,35",3,1,1,5,Low-Value,At Risk Customers
14110,1098,3,"189,29999999999998",2,1,1,4,Low-Value,Can't Lose
14112,841,10,"725,0",3,2,2,7,Mid-Value,Potential Loyalists
14113,1527,1,"11,7",1,1,1,3,Low-Value,Lost
14115,1382,1,"29,6",2,1,1,4,Low-Value,Can't Lose
14116,290,6,"264,85",5,1,1,7,Mid-Value,Potential Loyalists
14117,1126,5,"598,6",2,1,1,4,Low-Value,Can't Lose
14118,959,3,"75,30000000000001",3,1,1,5,Low-Value,At Risk Customers
14119,1156,1,"22,1",2,1,1,4,Low-Value,Can't Lose
14123,601,2,"171,39999999999998",4,1,1,6,Mid-Value,Potential Loyalists
14124,1284,3,"181,8",2,1,1,4,Low-Value,Can't Lose
14126,519,6,"754,0999999999999",4,1,2,7,Mid-Value,Potential Loyalists
14128,67,2,"123,9",5,1,1,7,Mid-Value,Potential Loyalists
14129,564,4,"264,85",4,1,1,6,Mid-Value,Potential Loyalists
14130,31,1,"5,6",5,1,1,7,Mid-Value,Potential Loyalists
14131,1733,1,"14,9",1,1,1,3,Low-Value,Lost
14133,1259,2,"214,35000000000002",2,1,1,4,Low-Value,Can't Lose
14134,16,3,"114,4",5,1,1,7,Mid-Value,Potential Loyalists
14136,1405,1,"30,0",2,1,1,4,Low-Value,Can't Lose
14137,1094,2,"58,6",3,1,1,5,Low-Value,At Risk Customers
14140,244,9,"545,5999999999999",5,2,1,8,High-Value,Potential Loyalists
14141,1117,2,"47,5",2,1,1,4,Low-Value,Can't Lose
14142,25,1,"20,46",5,1,1,7,Mid-Value,Potential Loyalists
14143,755,2,"25,4",3,1,1,5,Low-Value,At Risk Customers
14144,629,5,"149,6",4,1,1,6,Mid-Value,Potential Loyalists
14145,475,1,"31,9",4,1,1,6,Mid-Value,Potential Loyalists
14146,173,3,"208,55",5,1,1,7,Mid-Value,Potential Loyalists
14148,497,5,"141,29999999999998",4,1,1,6,Mid-Value,Potential Loyalists
14149,1623,2,"324,79999999999995",1,1,1,3,Low-Value,Lost
14150,523,1,"25,7",4,1,1,6,Mid-Value,Potential Loyalists
14151,914,3,"107,2",3,1,1,5,Low-Value,At Risk Customers
14152,3,3,"179,0",5,1,1,7,Mid-Value,Potential Loyalists
14153,1104,2,"181,3",2,1,1,4,Low-Value,Can't Lose
14154,30,4,"368,8",5,1,1,7,Mid-Value,Potential Loyalists
14155,130,3,"78,35",5,1,1,7,Mid-Value,Potential Loyalists
14157,142,1,"24,4",5,1,1,7,Mid-Value,Potential Loyalists
14159,3,6,"710,8499999999999",5,1,2,8,High-Value,Potential Loyalists
14161,472,2,"49,349999999999994",4,1,1,6,Mid-Value,Potential Loyalists
14164,41,3,"137,1",5,1,1,7,Mid-Value,Potential Loyalists
14166,118,9,"675,95",5,2,2,9,High-Value,Champions
14167,67,3,"140,70000000000002",5,1,1,7,Mid-Value,Potential Loyalists
14170,568,7,"490,09999999999997",4,2,1,7,Mid-Value,Potential Loyalists
14171,253,3,"121,75",5,1,1,7,Mid-Value,Potential Loyalists
14173,1067,1,"10,1",3,1,1,5,Low-Value,At Risk Customers
14174,130,5,"167,05",5,1,1,7,Mid-Value,Potential Loyalists
14176,68,2,"12,5",5,1,1,7,Mid-Value,Potential Loyalists
14178,1243,1,"47,5",2,1,1,4,Low-Value,Can't Lose
14179,1438,2,"38,9",2,1,1,4,Low-Value,Can't Lose
14180,1109,1,"66,8",2,1,1,4,Low-Value,Can't Lose
14182,688,1,"60,65",4,1,1,6,Mid-Value,Potential Loyalists
14184,1466,1,"23,0",1,1,1,3,Low-Value,Lost
14186,383,6,"78,69999999999999",4,1,1,6,Mid-Value,Potential Loyalists
14187,67,10,"448,65",5,2,1,8,High-Value,Potential Loyalists
14188,505,7,"729,85",4,2,2,8,High-Value,Potential Loyalists
14189,710,5,"346,35",4,1,1,6,Mid-Value,Potential Loyalists
14190,71,4,"130,45",5,1,1,7,Mid-Value,Potential Loyalists
14191,92,5,"377,15",5,1,1,7,Mid-Value,Potential Loyalists
14192,911,1,"24,2",3,1,1,5,Low-Value,At Risk Customers
14194,25,10,"552,75",5,2,1,8,High-Value,Potential Loyalists
14196,1464,1,"422,2",1,1,1,3,Low-Value,Lost
14197,108,6,"260,45",5,1,1,7,Mid-Value,Potential Loyalists
14198,815,1,"25,45",3,1,1,5,Low-Value,At Risk Customers
14199,228,7,"367,55",5,2,1,8,High-Value,Potential Loyalists
14201,663,3,"44,7",4,1,1,6,Mid-Value,Potential Loyalists
14206,406,2,"22,6",4,1,1,6,Mid-Value,Potential Loyalists
14208,24,4,"551,2",5,1,1,7,Mid-Value,Potential Loyalists
14210,634,4,"375,9",4,1,1,6,Mid-Value,Potential Loyalists
14211,554,2,"125,30000000000001",4,1,1,6,Mid-Value,Potential Loyalists
14213,48,5,"185,20000000000002",5,1,1,7,Mid-Value,Potential Loyalists
14214,265,5,"80,1",5,1,1,7,Mid-Value,Potential Loyalists
14215,12,4,"106,0",5,1,1,7,Mid-Value,Potential Loyalists
14220,1141,1,"166,2",2,1,1,4,Low-Value,Can't Lose
14222,368,3,"204,70000000000002",4,1,1,6,Mid-Value,Potential Loyalists
14223,449,6,"209,55",4,1,1,6,Mid-Value,Potential Loyalists
14226,153,3,"116,85",5,1,1,7,Mid-Value,Potential Loyalists
14229,344,3,"92,5",5,1,1,7,Mid-Value,Potential Loyalists
14233,28,4,"428,8",5,1,1,7,Mid-Value,Potential Loyalists
14236,1411,1,"159,0",2,1,1,4,Low-Value,Can't Lose
14237,64,12,"617,95",5,3,1,9,High-Value,Champions
14238,216,1,"85,35",5,1,1,7,Mid-Value,Potential Loyalists
14239,82,2,"41,599999999999994",5,1,1,7,Mid-Value,Potential Loyalists
14242,74,5,"133,64999999999998",5,1,1,7,Mid-Value,Potential Loyalists
14243,10,11,"750,2",5,2,2,9,High-Value,Champions
14244,466,3,"298,09999999999997",4,1,1,6,Mid-Value,Potential Loyalists
14245,436,2,"89,65",4,1,1,6,Mid-Value,Potential Loyalists
14246,1428,1,"28,55",2,1,1,4,Low-Value,Can't Lose
14249,1574,4,"307,65",1,1,1,3,Low-Value,Lost
14250,837,5,"329,8",3,1,1,5,Low-Value,At Risk Customers
14251,12,3,"116,60000000000001",5,1,1,7,Mid-Value,Potential Loyalists
14252,1147,2,"61,5",2,1,1,4,Low-Value,Can't Lose
14254,571,2,"190,8",4,1,1,6,Mid-Value,Potential Loyalists
14256,1427,1,"42,45",2,1,1,4,Low-Value,Can't Lose
14257,949,1,"30,69",3,1,1,5,Low-Value,At Risk Customers
14258,423,9,"286,95",4,2,1,7,Mid-Value,Potential Loyalists
14259,1105,1,"36,9",2,1,1,4,Low-Value,Can't Lose
14261,38,7,"392,5",5,2,1,8,High-Value,Potential Loyalists
14262,189,5,"451,85",5,1,1,7,Mid-Value,Potential Loyalists
14263,36,10,"330,03",5,2,1,8,High-Value,Potential Loyalists
14264,1259,2,"401,15",2,1,1,4,Low-Value,Can't Lose
14266,439,3,"181,5",4,1,1,6,Mid-Value,Potential Loyalists
14269,956,2,"60,2",3,1,1,5,Low-Value,At Risk Customers
14274,7,7,"866,8",5,2,2,9,High-Value,Champions
14275,975,2,"30,85",3,1,1,5,Low-Value,At Risk Customers
14276,995,2,"232,4",3,1,1,5,Low-Value,At Risk Customers
14277,7,19,"1234,4",5,4,2,11,High-Value,Champions
14278,543,4,"392,0",4,1,1,6,Mid-Value,Potential Loyalists
14279,570,2,"238,85",4,1,1,6,Mid-Value,Potential Loyalists
14280,1465,1,"91,2",1,1,1,3,Low-Value,Lost
14281,903,1,"245,6",3,1,1,5,Low-Value,At Risk Customers
14282,382,3,"149,9",4,1,1,6,Mid-Value,Potential Loyalists
14285,747,5,"218,0",3,1,1,5,Low-Value,At Risk Customers
14287,472,2,"170,2",4,1,1,6,Mid-Value,Potential Loyalists
14288,537,4,"162,25",4,1,1,6,Mid-Value,Potential Loyalists
14291,606,2,"125,80000000000001",4,1,1,6,Mid-Value,Potential Loyalists
14293,208,4,"325,95",5,1,1,7,Mid-Value,Potential Loyalists
14294,26,13,"593,9",5,3,1,9,High-Value,Champions
14295,956,5,"468,15000000000003",3,1,1,5,Low-Value,At Risk Customers
14296,1589,4,"359,85",1,1,1,3,Low-Value,Lost
14297,907,1,"40,5",3,1,1,5,Low-Value,At Risk Customers
14298,49,1,"13,15",5,1,1,7,Mid-Value,Potential Loyalists
14299,622,1,"4,65",4,1,1,6,Mid-Value,Potential Loyalists
14301,64,6,"387,29999999999995",5,1,1,7,Mid-Value,Potential Loyalists
14302,523,3,"209,9",4,1,1,6,Mid-Value,Potential Loyalists
14303,775,8,"270,55",3,2,1,6,Mid-Value,Potential Loyalists
14304,880,1,"23,0",3,1,1,5,Low-Value,At Risk Customers
14310,10,5,"337,05",5,1,1,7,Mid-Value,Potential Loyalists
14311,173,3,"39,2",5,1,1,7,Mid-Value,Potential Loyalists
14313,103,13,"616,6",5,3,1,9,High-Value,Champions
14314,82,8,"963,38",5,2,2,9,High-Value,Champions
14315,470,9,"332,0",4,2,1,7,Mid-Value,Potential Loyalists
14316,810,2,"72,75",3,1,1,5,Low-Value,At Risk Customers
14319,154,7,"289,05",5,2,1,8,High-Value,Potential Loyalists
14320,1221,4,"108,35",2,1,1,4,Low-Value,Can't Lose
14321,386,2,"70,3",4,1,1,6,Mid-Value,Potential Loyalists
14322,188,2,"120,6",5,1,1,7,Mid-Value,Potential Loyalists
14324,1001,3,"73,85",3,1,1,5,Low-Value,At Risk Customers
14325,35,4,"236,2",5,1,1,7,Mid-Value,Potential Loyalists
14326,95,1,"48,7",5,1,1,7,Mid-Value,Potential Loyalists
14327,1228,4,"678,2",2,1,2,5,Low-Value,At Risk Customers
14331,978,1,"13,15",3,1,1,5,Low-Value,At Risk Customers
14332,47,4,"111,80000000000001",5,1,1,7,Mid-Value,Potential Loyalists
14338,949,5,"150,14999999999998",3,1,1,5,Low-Value,At Risk Customers
14339,687,3,"367,54999999999995",4,1,1,6,Mid-Value,Potential Loyalists
14340,682,1,"17,7",4,1,1,6,Mid-Value,Potential Loyalists
14341,195,7,"241,25",5,2,1,8,High-Value,Potential Loyalists
14342,633,1,"177,60000000000002",4,1,1,6,Mid-Value,Potential Loyalists
14343,1117,1,"32,2",2,1,1,4,Low-Value,Can't Lose
14344,551,2,"71,05",4,1,1,6,Mid-Value,Potential Loyalists
14345,195,10,"461,35",5,2,1,8,High-Value,Potential Loyalists
14346,368,1,"11,9",4,1,1,6,Mid-Value,Potential Loyalists
14347,396,2,"70,85",4,1,1,6,Mid-Value,Potential Loyalists
14348,690,1,"16,1",4,1,1,6,Mid-Value,Potential Loyalists
14353,1178,1,"11,15",2,1,1,4,Low-Value,Can't Lose
14354,147,1,"31,2",5,1,1,7,Mid-Value,Potential Loyalists
14355,955,3,"218,05",3,1,1,5,Low-Value,At Risk Customers
14356,265,2,"167,7",5,1,1,7,Mid-Value,Potential Loyalists
14357,807,2,"426,9",3,1,1,5,Low-Value,At Risk Customers
14359,391,3,"28,95",4,1,1,6,Mid-Value,Potential Loyalists
14360,1086,1,"16,75",3,1,1,5,Low-Value,At Risk Customers
14361,159,5,"328,55",5,1,1,7,Mid-Value,Potential Loyalists
14364,1176,1,"31,25",2,1,1,4,Low-Value,Can't Lose
14365,738,6,"238,45",3,1,1,5,Low-Value,At Risk Customers
14366,1059,3,"65,2",3,1,1,5,Low-Value,At Risk Customers
14367,366,1,"21,6",4,1,1,6,Mid-Value,Potential Loyalists
14368,1076,2,"117,3",3,1,1,5,Low-Value,At Risk Customers
14370,131,4,"203,6",5,1,1,7,Mid-Value,Potential Loyalists
14372,579,1,"1,2",4,1,1,6,Mid-Value,Potential Loyalists
14374,154,6,"220,35",5,1,1,7,Mid-Value,Potential Loyalists
14375,480,2,"72,6",4,1,1,6,Mid-Value,Potential Loyalists
14376,1430,2,"46,3",2,1,1,4,Low-Value,Can't Lose
14377,266,2,"265,8",5,1,1,7,Mid-Value,Potential Loyalists
14378,101,9,"223,64999999999998",5,2,1,8,High-Value,Potential Loyalists
14379,853,2,"60,45",3,1,1,5,Low-Value,At Risk Customers
14380,1086,1,"34,25",3,1,1,5,Low-Value,At Risk Customers
14383,1104,1,"40,9",2,1,1,4,Low-Value,Can't Lose
14384,399,8,"455,15000000000003",4,2,1,7,Mid-Value,Potential Loyalists
14385,305,6,"243,25",5,1,1,7,Mid-Value,Potential Loyalists
14387,448,2,"54,8",4,1,1,6,Mid-Value,Potential Loyalists
14390,911,3,"230,9",3,1,1,5,Low-Value,At Risk Customers
14393,251,4,"172,45",5,1,1,7,Mid-Value,Potential Loyalists
14394,97,1,"106,75",5,1,1,7,Mid-Value,Potential Loyalists
14396,537,3,"41,95",4,1,1,6,Mid-Value,Potential Loyalists
14397,383,3,"315,84999999999997",4,1,1,6,Mid-Value,Potential Loyalists
14400,455,2,"69,85",4,1,1,6,Mid-Value,Potential Loyalists
14401,1299,1,"28,7",2,1,1,4,Low-Value,Can't Lose
14402,573,2,"74,5",4,1,1,6,Mid-Value,Potential Loyalists
14403,557,2,"105,75",4,1,1,6,Mid-Value,Potential Loyalists
14405,118,9,"556,4",5,2,1,8,High-Value,Potential Loyalists
14406,244,6,"160,1",5,1,1,7,Mid-Value,Potential Loyalists
14407,1119,1,"100,8",2,1,1,4,Low-Value,Can't Lose
14408,1492,1,"17,05",1,1,1,3,Low-Value,Lost
14410,62,6,"338,15000000000003",5,1,1,7,Mid-Value,Potential Loyalists
14411,102,6,"248,05",5,1,1,7,Mid-Value,Potential Loyalists
14413,240,5,"364,25",5,1,1,7,Mid-Value,Potential Loyalists
14414,1109,2,"120,4",2,1,1,4,Low-Value,Can't Lose
14415,583,1,"67,25",4,1,1,6,Mid-Value,Potential Loyalists
14419,25,1,"313,95000000000005",5,1,1,7,Mid-Value,Potential Loyalists
14420,494,3,"190,0",4,1,1,6,Mid-Value,Potential Loyalists
14421,501,4,"799,85",4,1,2,7,Mid-Value,Potential Loyalists
14422,149,1,"58,949999999999996",5,1,1,7,Mid-Value,Potential Loyalists
14424,672,2,"36,650000000000006",4,1,1,6,Mid-Value,Potential Loyalists
14425,327,2,"28,88",5,1,1,7,Mid-Value,Potential Loyalists
14428,731,9,"418,4",3,2,1,6,Mid-Value,Potential Loyalists
14429,39,3,"135,1",5,1,1,7,Mid-Value,Potential Loyalists
14430,1086,4,"118,9",3,1,1,5,Low-Value,At Risk Customers
14431,646,2,"77,35",4,1,1,6,Mid-Value,Potential Loyalists
14433,907,3,"224,55",3,1,1,5,Low-Value,At Risk Customers
14434,69,3,"98,94999999999999",5,1,1,7,Mid-Value,Potential Loyalists
14436,172,7,"382,1",5,2,1,8,High-Value,Potential Loyalists
14438,10,1,"48,0",5,1,1,7,Mid-Value,Potential Loyalists
14439,872,3,"209,8",3,1,1,5,Low-Value,At Risk Customers
14440,12,13,"805,2",5,3,2,10,High-Value,Champions
14442,30,3,"566,9499999999999",5,1,1,7,Mid-Value,Potential Loyalists
14443,356,6,"128,6",5,1,1,7,Mid-Value,Potential Loyalists
14444,178,3,"133,95000000000002",5,1,1,7,Mid-Value,Potential Loyalists
14450,512,1,"88,94999999999999",4,1,1,6,Mid-Value,Potential Loyalists
14451,870,1,"140,0",3,1,1,5,Low-Value,At Risk Customers
14452,619,2,"112,69999999999999",4,1,1,6,Mid-Value,Potential Loyalists
14454,1485,3,"184,55",1,1,1,3,Low-Value,Lost
14457,490,2,"94,25",4,1,1,6,Mid-Value,Potential Loyalists
14459,905,4,"247,5",3,1,1,5,Low-Value,At Risk Customers
14460,2,9,"515,9499999999999",5,2,1,8,High-Value,Potential Loyalists
14461,1390,1,"208,4",2,1,1,4,Low-Value,Can't Lose
14463,255,2,"264,5",5,1,1,7,Mid-Value,Potential Loyalists
14464,896,2,"14,7",3,1,1,5,Low-Value,At Risk Customers
14466,1814,1,"63,2",1,1,1,3,Low-Value,Lost
14467,10,14,"1066,95",5,3,2,10,High-Value,Champions
14468,160,3,"52,95",5,1,1,7,Mid-Value,Potential Loyalists
14469,749,4,"239,35",3,1,1,5,Low-Value,At Risk Customers
14471,15,2,"220,75",5,1,1,7,Mid-Value,Potential Loyalists
14472,54,7,"384,95",5,2,1,8,High-Value,Potential Loyalists
14476,887,1,"39,0",3,1,1,5,Low-Value,At Risk Customers
14477,1353,2,"111,35",2,1,1,4,Low-Value,Can't Lose
14480,81,1,"13,9",5,1,1,7,Mid-Value,Potential Loyalists
14482,25,6,"709,35",5,1,2,8,High-Value,Potential Loyalists
14483,1412,1,"318,0",2,1,1,4,Low-Value,Can't Lose
14484,365,2,"192,15",5,1,1,7,Mid-Value,Potential Loyalists
14487,1386,1,"93,75",2,1,1,4,Low-Value,Can't Lose
14490,965,3,"201,70000000000002",3,1,1,5,Low-Value,At Risk Customers
14491,377,1,"27,5",4,1,1,6,Mid-Value,Potential Loyalists
14492,770,2,"184,1",3,1,1,5,Low-Value,At Risk Customers
14493,988,2,"78,5",3,1,1,5,Low-Value,At Risk Customers
14494,423,1,"156,05",4,1,1,6,Mid-Value,Potential Loyalists
14496,60,4,"302,25",5,1,1,7,Mid-Value,Potential Loyalists
14497,1643,2,"62,599999999999994",1,1,1,3,Low-Value,Lost
14499,673,2,"56,35",4,1,1,6,Mid-Value,Potential Loyalists
14500,35,6,"232,25",5,1,1,7,Mid-Value,Potential Loyalists
14501,1473,1,"117,8",1,1,1,3,Low-Value,Lost
14503,16,7,"231,35",5,2,1,8,High-Value,Potential Loyalists
14504,414,1,"37,85",4,1,1,6,Mid-Value,Potential Loyalists
14505,318,10,"643,0",5,2,1,8,High-Value,Potential Loyalists
14506,329,2,"96,7",5,1,1,7,Mid-Value,Potential Loyalists
14508,109,12,"1567,75",5,3,3,11,High-Value,Champions
14509,672,2,"119,1",4,1,1,6,Mid-Value,Potential Loyalists
14510,528,1,"16,5",4,1,1,6,Mid-Value,Potential Loyalists
14512,1247,3,"414,25",2,1,1,4,Low-Value,Can't Lose
14513,603,1,"71,9",4,1,1,6,Mid-Value,Potential Loyalists
14514,222,2,"73,10000000000001",5,1,1,7,Mid-Value,Potential Loyalists
14515,39,5,"185,49999999999997",5,1,1,7,Mid-Value,Potential Loyalists
14518,991,2,"41,4",3,1,1,5,Low-Value,At Risk Customers
14519,159,3,"179,45",5,1,1,7,Mid-Value,Potential Loyalists
14521,132,2,"86,75",5,1,1,7,Mid-Value,Potential Loyalists
14522,381,4,"197,29999999999998",4,1,1,6,Mid-Value,Potential Loyalists
14523,12,8,"314,95",5,2,1,8,High-Value,Potential Loyalists
14524,428,7,"186,1",4,2,1,7,Mid-Value,Potential Loyalists
14526,908,1,"237,1",3,1,1,5,Low-Value,At Risk Customers
14527,1067,1,"46,1",3,1,1,5,Low-Value,At Risk Customers
14528,602,2,"94,10000000000001",4,1,1,6,Mid-Value,Potential Loyalists
14531,59,4,"133,9",5,1,1,7,Mid-Value,Potential Loyalists
14532,178,2,"283,2",5,1,1,7,Mid-Value,Potential Loyalists
14533,859,1,"149,5",3,1,1,5,Low-Value,At Risk Customers
14534,1042,2,"59,949999999999996",3,1,1,5,Low-Value,At Risk Customers
14535,304,6,"108,45",5,1,1,7,Mid-Value,Potential Loyalists
14539,734,4,"97,25",3,1,1,5,Low-Value,At Risk Customers
14544,556,1,"93,3",4,1,1,6,Mid-Value,Potential Loyalists
14546,0,8,"261,31",5,2,1,8,High-Value,Potential Loyalists
14550,460,1,"278,9",4,1,1,6,Mid-Value,Potential Loyalists
14551,865,1,"76,0",3,1,1,5,Low-Value,At Risk Customers
14552,1732,2,"55,099999999999994",1,1,1,3,Low-Value,Lost
14555,157,2,"201,05",5,1,1,7,Mid-Value,Potential Loyalists
14556,33,3,"190,25",5,1,1,7,Mid-Value,Potential Loyalists
14557,526,6,"700,7",4,1,2,7,Mid-Value,Potential Loyalists
14558,237,3,"835,4",5,1,2,8,High-Value,Potential Loyalists
14559,5,7,"239,35",5,2,1,8,High-Value,Potential Loyalists
14560,104,8,"425,75",5,2,1,8,High-Value,Potential Loyalists
14561,116,9,"1683,9",5,2,3,10,High-Value,Champions
14562,139,3,"390,85",5,1,1,7,Mid-Value,Potential Loyalists
14565,277,1,"81,3",5,1,1,7,Mid-Value,Potential Loyalists
14569,236,2,"206,3",5,1,1,7,Mid-Value,Potential Loyalists
14571,62,4,"234,35000000000002",5,1,1,7,Mid-Value,Potential Loyalists
14575,45,6,"202,5",5,1,1,7,Mid-Value,Potential Loyalists
14577,90,9,"564,1",5,2,1,8,High-Value,Potential Loyalists
14578,582,3,"155,7",4,1,1,6,Mid-Value,Potential Loyalists
14579,221,2,"288,5",5,1,1,7,Mid-Value,Potential Loyalists
14582,768,4,"181,25",3,1,1,5,Low-Value,At Risk Customers
14583,33,4,"100,7",5,1,1,7,Mid-Value,Potential Loyalists
14586,1319,1,"19,65",2,1,1,4,Low-Value,Can't Lose
14587,64,3,"147,25",5,1,1,7,Mid-Value,Potential Loyalists
14589,812,3,"64,39999999999999",3,1,1,5,Low-Value,At Risk Customers
14591,52,3,"91,35",5,1,1,7,Mid-Value,Potential Loyalists
14592,734,1,"60,7",3,1,1,5,Low-Value,At Risk Customers
14593,664,3,"108,1",4,1,1,6,Mid-Value,Potential Loyalists
14596,97,6,"361,6",5,1,1,7,Mid-Value,Potential Loyalists
14598,1200,4,"293,5",2,1,1,4,Low-Value,Can't Lose
14599,1556,1,"9,95",1,1,1,3,Low-Value,Lost
14600,600,5,"694,0",4,1,2,7,Mid-Value,Potential Loyalists
14602,1657,1,"50,2",1,1,1,3,Low-Value,Lost
14603,666,1,"57,05",4,1,1,6,Mid-Value,Potential Loyalists
14604,27,6,"106,0",5,1,1,7,Mid-Value,Potential Loyalists
14605,234,4,"753,55",5,1,2,8,High-Value,Potential Loyalists
14606,291,2,"82,4",5,1,1,7,Mid-Value,Potential Loyalists
14607,1594,1,"48,7",1,1,1,3,Low-Value,Lost
14608,200,4,"183,29999999999998",5,1,1,7,Mid-Value,Potential Loyalists
14610,73,5,"202,8",5,1,1,7,Mid-Value,Potential Loyalists
14611,406,2,"89,85",4,1,1,6,Mid-Value,Potential Loyalists
14614,258,3,"187,95000000000002",5,1,1,7,Mid-Value,Potential Loyalists
14615,267,1,"12,3",5,1,1,7,Mid-Value,Potential Loyalists
14618,13,4,"139,95",5,1,1,7,Mid-Value,Potential Loyalists
14621,577,4,"186,7",4,1,1,6,Mid-Value,Potential Loyalists
14622,784,1,"10,85",3,1,1,5,Low-Value,At Risk Customers
14623,14,5,"258,6",5,1,1,7,Mid-Value,Potential Loyalists
14625,1305,1,"16,7",2,1,1,4,Low-Value,Can't Lose
14626,134,2,"77,3",5,1,1,7,Mid-Value,Potential Loyalists
14627,777,2,"100,4",3,1,1,5,Low-Value,At Risk Customers
14628,1090,1,"117,8",3,1,1,5,Low-Value,At Risk Customers
14630,1203,1,"26,3",2,1,1,4,Low-Value,Can't Lose
14632,560,6,"234,5",4,1,1,6,Mid-Value,Potential Loyalists
14634,888,2,"76,1",3,1,1,5,Low-Value,At Risk Customers
14635,1236,1,"37,4",2,1,1,4,Low-Value,Can't Lose
14638,1235,3,"157,2",2,1,1,4,Low-Value,Can't Lose
14639,1363,2,"63,2",2,1,1,4,Low-Value,Can't Lose
14640,996,1,"43,55",3,1,1,5,Low-Value,At Risk Customers
14644,408,2,"173,9",4,1,1,6,Mid-Value,Potential Loyalists
14645,383,3,"605,15",4,1,1,6,Mid-Value,Potential Loyalists
14646,911,5,"376,54999999999995",3,1,1,5,Low-Value,At Risk Customers
14649,136,1,"15,5",5,1,1,7,Mid-Value,Potential Loyalists
14651,164,1,"88,0",5,1,1,7,Mid-Value,Potential Loyalists
14652,556,3,"229,5",4,1,1,6,Mid-Value,Potential Loyalists
14653,955,2,"74,85",3,1,1,5,Low-Value,At Risk Customers
14655,216,3,"166,29999999999998",5,1,1,7,Mid-Value,Potential Loyalists
14657,1067,3,"75,55",3,1,1,5,Low-Value,At Risk Customers
14658,572,2,"6,0",4,1,1,6,Mid-Value,Potential Loyalists
14659,668,5,"117,5",4,1,1,6,Mid-Value,Potential Loyalists
14660,97,10,"981,0",5,2,2,9,High-Value,Champions
14663,472,1,"24,75",4,1,1,6,Mid-Value,Potential Loyalists
14664,383,7,"607,65",4,2,1,7,Mid-Value,Potential Loyalists
14665,235,1,"8,55",5,1,1,7,Mid-Value,Potential Loyalists
14666,133,2,"66,85",5,1,1,7,Mid-Value,Potential Loyalists
14668,143,5,"258,25",5,1,1,7,Mid-Value,Potential Loyalists
14669,175,4,"333,05",5,1,1,7,Mid-Value,Potential Loyalists
14670,370,1,"91,8",4,1,1,6,Mid-Value,Potential Loyalists
14671,531,1,"48,2",4,1,1,6,Mid-Value,Potential Loyalists
14672,283,1,"35,15",5,1,1,7,Mid-Value,Potential Loyalists
14673,617,5,"234,55",4,1,1,6,Mid-Value,Potential Loyalists
14674,327,1,"14,5",5,1,1,7,Mid-Value,Potential Loyalists
14676,319,2,"86,85",5,1,1,7,Mid-Value,Potential Loyalists
14677,1573,1,"68,7",1,1,1,3,Low-Value,Lost
14678,29,3,"105,9",5,1,1,7,Mid-Value,Potential Loyalists
14679,9,4,"568,15",5,1,1,7,Mid-Value,Potential Loyalists
14680,843,2,"140,39999999999998",3,1,1,5,Low-Value,At Risk Customers
14681,186,2,"243,05",5,1,1,7,Mid-Value,Potential Loyalists
14682,932,1,"41,9",3,1,1,5,Low-Value,At Risk Customers
14684,27,3,"82,4",5,1,1,7,Mid-Value,Potential Loyalists
14686,807,2,"91,85000000000001",3,1,1,5,Low-Value,At Risk Customers
14687,99,5,"238,8",5,1,1,7,Mid-Value,Potential Loyalists
14690,982,2,"83,2",3,1,1,5,Low-Value,At Risk Customers
14691,839,3,"156,0",3,1,1,5,Low-Value,At Risk Customers
14692,356,1,"19,35",5,1,1,7,Mid-Value,Potential Loyalists
14694,479,3,"272,0",4,1,1,6,Mid-Value,Potential Loyalists
14695,164,6,"647,0",5,1,1,7,Mid-Value,Potential Loyalists
14696,254,1,"17,25",5,1,1,7,Mid-Value,Potential Loyalists
14697,22,4,"141,85",5,1,1,7,Mid-Value,Potential Loyalists
14698,1197,2,"73,75",2,1,1,4,Low-Value,Can't Lose
14700,160,1,"206,15",5,1,1,7,Mid-Value,Potential Loyalists
14703,1544,1,"12,35",1,1,1,3,Low-Value,Lost
14704,109,6,"167,45",5,1,1,7,Mid-Value,Potential Loyalists
14705,31,9,"1190,75",5,2,2,9,High-Value,Champions
14707,1631,1,"81,4",1,1,1,3,Low-Value,Lost
14708,1311,2,"57,5",2,1,1,4,Low-Value,Can't Lose
14709,105,7,"355,90000000000003",5,2,1,8,High-Value,Potential Loyalists
14712,829,2,"104,14999999999999",3,1,1,5,Low-Value,At Risk Customers
14714,918,1,"73,3",3,1,1,5,Low-Value,At Risk Customers
14715,385,3,"171,9",4,1,1,6,Mid-Value,Potential Loyalists
14716,33,4,"196,0",5,1,1,7,Mid-Value,Potential Loyalists
14717,238,3,"163,45",5,1,1,7,Mid-Value,Potential Loyalists
14721,438,2,"25,0",4,1,1,6,Mid-Value,Potential Loyalists
14723,1269,1,"1126,0",2,1,2,5,Low-Value,At Risk Customers
14724,5,3,"322,0",5,1,1,7,Mid-Value,Potential Loyalists
14725,1407,2,"84,4",2,1,1,4,Low-Value,Can't Lose
14728,10,6,"373,1",5,1,1,7,Mid-Value,Potential Loyalists
14729,1399,1,"20,75",2,1,1,4,Low-Value,Can't Lose
14731,1406,1,"12,3",2,1,1,4,Low-Value,Can't Lose
14733,444,2,"24,15",4,1,1,6,Mid-Value,Potential Loyalists
14736,404,3,"124,35",4,1,1,6,Mid-Value,Potential Loyalists
14737,586,1,"5,3",4,1,1,6,Mid-Value,Potential Loyalists
14738,258,7,"242,6",5,2,1,8,High-Value,Potential Loyalists
14739,382,2,"158,5",4,1,1,6,Mid-Value,Potential Loyalists
14741,1474,2,"159,95",1,1,1,3,Low-Value,Lost
14742,14,15,"952,0",5,3,2,10,High-Value,Champions
14743,60,3,"69,0",5,1,1,7,Mid-Value,Potential Loyalists
14745,1336,2,"57,349999999999994",2,1,1,4,Low-Value,Can't Lose
14746,73,3,"113,53",5,1,1,7,Mid-Value,Potential Loyalists
14748,1400,1,"10,23",2,1,1,4,Low-Value,Can't Lose
14749,360,8,"431,2",5,2,1,8,High-Value,Potential Loyalists
14750,1815,1,"30,0",1,1,1,3,Low-Value,Lost
14751,980,1,"47,1",3,1,1,5,Low-Value,At Risk Customers
14752,739,3,"368,4",3,1,1,5,Low-Value,At Risk Customers
14753,301,3,"63,31",5,1,1,7,Mid-Value,Potential Loyalists
14758,147,22,"1364,4",5,5,3,13,High-Value,Champions
14761,389,1,"169,2",4,1,1,6,Mid-Value,Potential Loyalists
14765,738,1,"19,95",3,1,1,5,Low-Value,At Risk Customers
14767,158,4,"176,2",5,1,1,7,Mid-Value,Potential Loyalists
14768,939,5,"221,79999999999998",3,1,1,5,Low-Value,At Risk Customers
14769,1328,1,"124,2",2,1,1,4,Low-Value,Can't Lose
14771,173,8,"580,6999999999999",5,2,1,8,High-Value,Potential Loyalists
14772,129,7,"159,2",5,2,1,8,High-Value,Potential Loyalists
14774,41,7,"613,0",5,2,1,8,High-Value,Potential Loyalists
14776,431,4,"157,64999999999998",4,1,1,6,Mid-Value,Potential Loyalists
14782,998,1,"183,0",3,1,1,5,Low-Value,At Risk Customers
14783,389,2,"99,6",4,1,1,6,Mid-Value,Potential Loyalists
14784,481,9,"378,85",4,2,1,7,Mid-Value,Potential Loyalists
14785,183,4,"205,75000000000003",5,1,1,7,Mid-Value,Potential Loyalists
14788,863,4,"257,2",3,1,1,5,Low-Value,At Risk Customers
14790,818,6,"670,4",3,1,2,6,Mid-Value,Potential Loyalists
14792,360,3,"61,38",5,1,1,7,Mid-Value,Potential Loyalists
14793,27,7,"309,95",5,2,1,8,High-Value,Potential Loyalists
14794,1249,1,"22,6",2,1,1,4,Low-Value,Can't Lose
14795,7,11,"728,2",5,2,2,9,High-Value,Champions
14797,1570,4,"347,95",1,1,1,3,Low-Value,Lost
14799,153,3,"108,35",5,1,1,7,Mid-Value,Potential Loyalists
14805,588,3,"229,2",4,1,1,6,Mid-Value,Potential Loyalists
14806,536,2,"178,14999999999998",4,1,1,6,Mid-Value,Potential Loyalists
14809,757,4,"417,5",3,1,1,5,Low-Value,At Risk Customers
14810,157,10,"895,0",5,2,2,9,High-Value,Champions
14811,1160,5,"371,25",2,1,1,4,Low-Value,Can't Lose
14812,1097,1,"64,4",2,1,1,4,Low-Value,Can't Lose
14813,1104,2,"361,95000000000005",2,1,1,4,Low-Value,Can't Lose
14814,134,3,"166,75",5,1,1,7,Mid-Value,Potential Loyalists
14815,315,2,"48,2",5,1,1,7,Mid-Value,Potential Loyalists
14817,71,6,"276,65",5,1,1,7,Mid-Value,Potential Loyalists
14820,46,13,"753,75",5,3,2,10,High-Value,Champions
14821,733,3,"132,15",3,1,1,5,Low-Value,At Risk Customers
14822,1457,1,"42,15",2,1,1,4,Low-Value,Can't Lose
14823,508,7,"449,05",4,2,1,7,Mid-Value,Potential Loyalists
14824,21,6,"383,05",5,1,1,7,Mid-Value,Potential Loyalists
14825,757,1,"43,3",3,1,1,5,Low-Value,At Risk Customers
14826,539,1,"6,35",4,1,1,6,Mid-Value,Potential Loyalists
14828,474,1,"60,7",4,1,1,6,Mid-Value,Potential Loyalists
14832,738,3,"105,80000000000001",3,1,1,5,Low-Value,At Risk Customers
14833,514,4,"260,95",4,1,1,6,Mid-Value,Potential Loyalists
14835,301,3,"117,2",5,1,1,7,Mid-Value,Potential Loyalists
14836,137,7,"357,5",5,2,1,8,High-Value,Potential Loyalists
14838,12,4,"176,15",5,1,1,7,Mid-Value,Potential Loyalists
14840,556,2,"79,39999999999999",4,1,1,6,Mid-Value,Potential Loyalists
14841,934,3,"199,5",3,1,1,5,Low-Value,At Risk Customers
14842,216,1,"16,3",5,1,1,7,Mid-Value,Potential Loyalists
14844,762,3,"163,85000000000002",3,1,1,5,Low-Value,At Risk Customers
14845,1309,1,"103,7",2,1,1,4,Low-Value,Can't Lose
14847,390,2,"119,0",4,1,1,6,Mid-Value,Potential Loyalists
14848,635,2,"41,6",4,1,1,6,Mid-Value,Potential Loyalists
14850,509,1,"12,9",4,1,1,6,Mid-Value,Potential Loyalists
14852,624,4,"391,40000000000003",4,1,1,6,Mid-Value,Potential Loyalists
14853,161,6,"476,65",5,1,1,7,Mid-Value,Potential Loyalists
14854,903,4,"555,2",3,1,1,5,Low-Value,At Risk Customers
14857,630,2,"83,85",4,1,1,6,Mid-Value,Potential Loyalists
14861,1292,2,"60,599999999999994",2,1,1,4,Low-Value,Can't Lose
14862,66,13,"1101,05",5,3,2,10,High-Value,Champions
14863,405,2,"41,75",4,1,1,6,Mid-Value,Potential Loyalists
14864,360,6,"142,70000000000002",5,1,1,7,Mid-Value,Potential Loyalists
14865,19,5,"580,5999999999999",5,1,1,7,Mid-Value,Potential Loyalists
14866,88,2,"884,6500000000001",5,1,2,8,High-Value,Potential Loyalists
14867,942,2,"82,95",3,1,1,5,Low-Value,At Risk Customers
14869,488,1,"24,5",4,1,1,6,Mid-Value,Potential Loyalists
14870,1702,1,"132,75",1,1,1,3,Low-Value,Lost
14871,45,2,"108,05",5,1,1,7,Mid-Value,Potential Loyalists
14872,1,7,"306,4",5,2,1,8,High-Value,Potential Loyalists
14873,162,4,"274,0",5,1,1,7,Mid-Value,Potential Loyalists
14874,607,2,"75,05",4,1,1,6,Mid-Value,Potential Loyalists
14877,571,2,"156,55",4,1,1,6,Mid-Value,Potential Loyalists
14878,137,3,"285,4",5,1,1,7,Mid-Value,Potential Loyalists
14879,109,3,"141,35",5,1,1,7,Mid-Value,Potential Loyalists
14880,236,2,"133,3",5,1,1,7,Mid-Value,Potential Loyalists
14881,748,3,"100,5",3,1,1,5,Low-Value,At Risk Customers
14883,1110,1,"125,8",2,1,1,4,Low-Value,Can't Lose
14885,118,3,"317,20000000000005",5,1,1,7,Mid-Value,Potential Loyalists
14886,867,1,"222,45000000000002",3,1,1,5,Low-Value,At Risk Customers
14887,1211,3,"113,0",2,1,1,4,Low-Value,Can't Lose
14889,665,1,"16,3",4,1,1,6,Mid-Value,Potential Loyalists
14890,1246,2,"27,0",2,1,1,4,Low-Value,Can't Lose
14892,61,8,"569,9",5,2,1,8,High-Value,Potential Loyalists
14897,190,5,"1021,4",5,1,2,8,High-Value,Potential Loyalists
14899,54,5,"343,9",5,1,1,7,Mid-Value,Potential Loyalists
14900,117,1,"68,7",5,1,1,7,Mid-Value,Potential Loyalists
14901,1816,1,"105,55",1,1,1,3,Low-Value,Lost
14902,751,4,"132,65",3,1,1,5,Low-Value,At Risk Customers
14903,787,1,"38,05",3,1,1,5,Low-Value,At Risk Customers
14905,424,5,"903,3499999999999",4,1,2,7,Mid-Value,Potential Loyalists
14906,150,5,"291,25",5,1,1,7,Mid-Value,Potential Loyalists
14907,1274,1,"241,15000000000003",2,1,1,4,Low-Value,Can't Lose
14908,651,3,"192,35",4,1,1,6,Mid-Value,Potential Loyalists
14909,272,2,"328,85",5,1,1,7,Mid-Value,Potential Loyalists
14911,188,3,"87,65",5,1,1,7,Mid-Value,Potential Loyalists
14912,617,1,"104,6",4,1,1,6,Mid-Value,Potential Loyalists
14914,124,8,"661,8",5,2,1,8,High-Value,Potential Loyalists
14918,82,7,"561,5",5,2,1,8,High-Value,Potential Loyalists
14919,1221,2,"144,95",2,1,1,4,Low-Value,Can't Lose
14920,201,2,"262,55",5,1,1,7,Mid-Value,Potential Loyalists
14923,333,4,"215,05",5,1,1,7,Mid-Value,Potential Loyalists
14924,1342,1,"70,4",2,1,1,4,Low-Value,Can't Lose
14925,212,3,"289,5",5,1,1,7,Mid-Value,Potential Loyalists
14926,393,15,"512,05",4,3,1,8,High-Value,Potential Loyalists
14927,362,4,"103,15",5,1,1,7,Mid-Value,Potential Loyalists
14928,10,5,"379,75",5,1,1,7,Mid-Value,Potential Loyalists
14929,810,2,"117,85",3,1,1,5,Low-Value,At Risk Customers
14930,1103,3,"143,10000000000002",2,1,1,4,Low-Value,Can't Lose
14933,47,4,"240,0",5,1,1,7,Mid-Value,Potential Loyalists
14934,548,3,"96,65",4,1,1,6,Mid-Value,Potential Loyalists
14935,48,2,"186,75",5,1,1,7,Mid-Value,Potential Loyalists
14936,32,2,"256,75",5,1,1,7,Mid-Value,Potential Loyalists
14938,1299,1,"49,5",2,1,1,4,Low-Value,Can't Lose
14941,392,1,"15,8",4,1,1,6,Mid-Value,Potential Loyalists
14942,1122,1,"51,150000000000006",2,1,1,4,Low-Value,Can't Lose
14943,17,4,"167,14999999999998",5,1,1,7,Mid-Value,Potential Loyalists
14944,9,5,"213,95",5,1,1,7,Mid-Value,Potential Loyalists
14949,738,2,"87,35",3,1,1,5,Low-Value,At Risk Customers
14954,1538,1,"2,85",1,1,1,3,Low-Value,Lost
14955,148,1,"19,5",5,1,1,7,Mid-Value,Potential Loyalists
14957,1674,1,"44,400000000000006",1,1,1,3,Low-Value,Lost
14958,1823,1,"4,05",1,1,1,3,Low-Value,Lost
14959,339,2,"17,7",5,1,1,7,Mid-Value,Potential Loyalists
14961,1032,1,"85,1",3,1,1,5,Low-Value,At Risk Customers
14962,34,2,"48,25000000000001",5,1,1,7,Mid-Value,Potential Loyalists
14963,128,1,"88,35",5,1,1,7,Mid-Value,Potential Loyalists
14969,181,4,"400,85",5,1,1,7,Mid-Value,Potential Loyalists
14970,508,3,"47,45",4,1,1,6,Mid-Value,Potential Loyalists
14971,171,4,"163,9",5,1,1,7,Mid-Value,Potential Loyalists
14972,1775,1,"4,55",1,1,1,3,Low-Value,Lost
14973,396,3,"264,0",4,1,1,6,Mid-Value,Potential Loyalists
14975,1119,2,"33,55",2,1,1,4,Low-Value,Can't Lose
14976,845,1,"17,2",3,1,1,5,Low-Value,At Risk Customers
14977,1112,2,"329,0",2,1,1,4,Low-Value,Can't Lose
14979,768,1,"199,0",3,1,1,5,Low-Value,At Risk Customers
14981,452,2,"16,5",4,1,1,6,Mid-Value,Potential Loyalists
14984,1293,1,"19,0",2,1,1,4,Low-Value,Can't Lose
14985,275,3,"106,3",5,1,1,7,Mid-Value,Potential Loyalists
14988,26,4,"244,29999999999998",5,1,1,7,Mid-Value,Potential Loyalists
14989,1764,1,"47,05",1,1,1,3,Low-Value,Lost
14992,27,3,"242,25",5,1,1,7,Mid-Value,Potential Loyalists
14993,47,3,"66,1",5,1,1,7,Mid-Value,Potential Loyalists
14997,1511,1,"27,45",1,1,1,3,Low-Value,Lost
14999,178,1,"309,0",5,1,1,7,Mid-Value,Potential Loyalists
15000,50,2,"79,45",5,1,1,7,Mid-Value,Potential Loyalists
15001,57,2,"51,0",5,1,1,7,Mid-Value,Potential Loyalists
15002,143,4,"244,6",5,1,1,7,Mid-Value,Potential Loyalists
15003,116,1,"140,05",5,1,1,7,Mid-Value,Potential Loyalists
15005,583,1,"90,75",4,1,1,6,Mid-Value,Potential Loyalists
15007,111,10,"562,6",5,2,1,8,High-Value,Potential Loyalists
15009,1160,2,"57,55",2,1,1,4,Low-Value,Can't Lose
15010,81,1,"62,8",5,1,1,7,Mid-Value,Potential Loyalists
15011,505,1,"20,3",4,1,1,6,Mid-Value,Potential Loyalists
15014,26,2,"67,6",5,1,1,7,Mid-Value,Potential Loyalists
15015,459,4,"90,8",4,1,1,6,Mid-Value,Potential Loyalists
15018,188,4,"132,95",5,1,1,7,Mid-Value,Potential Loyalists
15019,453,12,"572,9",4,3,1,8,High-Value,Potential Loyalists
15021,1372,1,"43,85",2,1,1,4,Low-Value,Can't Lose
15022,34,6,"432,75",5,1,1,7,Mid-Value,Potential Loyalists
15024,996,3,"65,55",3,1,1,5,Low-Value,At Risk Customers
15026,122,1,"122,8",5,1,1,7,Mid-Value,Potential Loyalists
15027,135,3,"195,95",5,1,1,7,Mid-Value,Potential Loyalists
15028,351,8,"576,3",5,2,1,8,High-Value,Potential Loyalists
15029,390,4,"264,5",4,1,1,6,Mid-Value,Potential Loyalists
15030,150,2,"194,24999999999997",5,1,1,7,Mid-Value,Potential Loyalists
15031,64,4,"61,449999999999996",5,1,1,7,Mid-Value,Potential Loyalists
15032,52,4,"136,85",5,1,1,7,Mid-Value,Potential Loyalists
15033,1712,1,"3,5",1,1,1,3,Low-Value,Lost
15036,1520,2,"106,14999999999999",1,1,1,3,Low-Value,Lost
15037,831,2,"80,55",3,1,1,5,Low-Value,At Risk Customers
15039,84,5,"257,2",5,1,1,7,Mid-Value,Potential Loyalists
15041,1524,1,"9,7",1,1,1,3,Low-Value,Lost
15043,199,3,"281,29999999999995",5,1,1,7,Mid-Value,Potential Loyalists
15044,385,3,"252,89999999999998",4,1,1,6,Mid-Value,Potential Loyalists
15046,38,7,"633,3",5,2,1,8,High-Value,Potential Loyalists
15049,773,1,"29,95",3,1,1,5,Low-Value,At Risk Customers
15050,307,2,"303,4",5,1,1,7,Mid-Value,Potential Loyalists
15051,1192,2,"151,4",2,1,1,4,Low-Value,Can't Lose
15052,441,5,"193,0",4,1,1,6,Mid-Value,Potential Loyalists
15055,70,4,"398,0",5,1,1,7,Mid-Value,Potential Loyalists
15056,12,6,"320,85",5,1,1,7,Mid-Value,Potential Loyalists
15057,483,3,"33,85",4,1,1,6,Mid-Value,Potential Loyalists
15058,262,2,"98,15",5,1,1,7,Mid-Value,Potential Loyalists
15062,1274,3,"164,75",2,1,1,4,Low-Value,Can't Lose
15065,824,1,"106,1",3,1,1,5,Low-Value,At Risk Customers
15066,785,3,"113,25",3,1,1,5,Low-Value,At Risk Customers
15067,318,4,"171,9",5,1,1,7,Mid-Value,Potential Loyalists
15069,94,6,"256,75",5,1,1,7,Mid-Value,Potential Loyalists
15070,862,4,"187,7",3,1,1,5,Low-Value,At Risk Customers
15071,676,5,"187,8",4,1,1,6,Mid-Value,Potential Loyalists
15075,1,3,"252,4",5,1,1,7,Mid-Value,Potential Loyalists
15077,357,3,"161,55",5,1,1,7,Mid-Value,Potential Loyalists
15078,488,2,"26,3",4,1,1,6,Mid-Value,Potential Loyalists
15079,762,2,"81,95",3,1,1,5,Low-Value,At Risk Customers
15081,906,1,"191,55",3,1,1,5,Low-Value,At Risk Customers
15082,596,2,"158,0",4,1,1,6,Mid-Value,Potential Loyalists
15083,1629,1,"27,1",1,1,1,3,Low-Value,Lost
15084,4,5,"141,3",5,1,1,7,Mid-Value,Potential Loyalists
15086,145,2,"207,3",5,1,1,7,Mid-Value,Potential Loyalists
15087,927,3,"89,8",3,1,1,5,Low-Value,At Risk Customers
15088,148,8,"770,5",5,2,2,9,High-Value,Champions
15089,349,2,"178,55",5,1,1,7,Mid-Value,Potential Loyalists
15092,10,15,"1316,25",5,3,2,10,High-Value,Champions
15093,37,5,"816,3",5,1,2,8,High-Value,Potential Loyalists
15096,841,4,"164,35",3,1,1,5,Low-Value,At Risk Customers
15098,257,4,"172,54999999999998",5,1,1,7,Mid-Value,Potential Loyalists
15100,733,3,"100,1",3,1,1,5,Low-Value,At Risk Customers
15102,477,3,"191,5",4,1,1,6,Mid-Value,Potential Loyalists
15103,905,3,"193,95",3,1,1,5,Low-Value,At Risk Customers
15105,1306,3,"210,39999999999998",2,1,1,4,Low-Value,Can't Lose
15106,20,2,"62,099999999999994",5,1,1,7,Mid-Value,Potential Loyalists
15108,564,1,"251,3",4,1,1,6,Mid-Value,Potential Loyalists
15112,179,1,"14,3",5,1,1,7,Mid-Value,Potential Loyalists
15113,63,1,"27,2",5,1,1,7,Mid-Value,Potential Loyalists
15114,63,9,"821,85",5,2,2,9,High-Value,Champions
15116,460,1,"111,7",4,1,1,6,Mid-Value,Potential Loyalists
15117,1,12,"604,75",5,3,1,9,High-Value,Champions
15118,63,1,"33,7",5,1,1,7,Mid-Value,Potential Loyalists
15120,801,5,"119,15",3,1,1,5,Low-Value,At Risk Customers
15122,985,1,"15,95",3,1,1,5,Low-Value,At Risk Customers
15124,290,4,"126,7",5,1,1,7,Mid-Value,Potential Loyalists
15125,117,7,"307,5",5,2,1,8,High-Value,Potential Loyalists
15126,734,2,"36,55",3,1,1,5,Low-Value,At Risk Customers
15129,1509,3,"96,9",1,1,1,3,Low-Value,Lost
15132,925,3,"181,75",3,1,1,5,Low-Value,At Risk Customers
15133,1084,2,"131,29999999999998",3,1,1,5,Low-Value,At Risk Customers
15136,439,3,"204,05",4,1,1,6,Mid-Value,Potential Loyalists
15137,89,11,"407,45",5,2,1,8,High-Value,Potential Loyalists
15138,434,2,"69,1",4,1,1,6,Mid-Value,Potential Loyalists
15142,496,6,"301,65",4,1,1,6,Mid-Value,Potential Loyalists
15143,587,2,"92,9",4,1,1,6,Mid-Value,Potential Loyalists
15144,448,1,"23,0",4,1,1,6,Mid-Value,Potential Loyalists
15147,1023,2,"83,2",3,1,1,5,Low-Value,At Risk Customers
15148,18,16,"867,85",5,3,2,10,High-Value,Champions
15151,1113,2,"485,45",2,1,1,4,Low-Value,Can't Lose
15153,759,4,"471,29999999999995",3,1,1,5,Low-Value,At Risk Customers
15154,833,1,"144,95",3,1,1,5,Low-Value,At Risk Customers
15155,25,3,"273,4",5,1,1,7,Mid-Value,Potential Loyalists
15156,516,3,"145,7",4,1,1,6,Mid-Value,Potential Loyalists
15159,1099,2,"202,89999999999998",2,1,1,4,Low-Value,Can't Lose
15160,13,2,"270,1",5,1,1,7,Mid-Value,Potential Loyalists
15162,18,6,"365,9",5,1,1,7,Mid-Value,Potential Loyalists
15163,267,3,"117,0",5,1,1,7,Mid-Value,Potential Loyalists
15164,14,4,"118,05",5,1,1,7,Mid-Value,Potential Loyalists
15165,983,2,"65,2",3,1,1,5,Low-Value,At Risk Customers
15167,1117,1,"7,8",2,1,1,4,Low-Value,Can't Lose
15168,804,2,"164,5",3,1,1,5,Low-Value,At Risk Customers
15171,384,2,"95,5",4,1,1,6,Mid-Value,Potential Loyalists
15172,1218,1,"204,0",2,1,1,4,Low-Value,Can't Lose
15174,1552,1,"241,0",1,1,1,3,Low-Value,Lost
15178,1107,2,"51,85",2,1,1,4,Low-Value,Can't Lose
15183,427,3,"134,5",4,1,1,6,Mid-Value,Potential Loyalists
15184,206,7,"1125,3",5,2,2,9,High-Value,Champions
15185,419,4,"115,0",4,1,1,6,Mid-Value,Potential Loyalists
15188,24,2,"196,39999999999998",5,1,1,7,Mid-Value,Potential Loyalists
15190,1229,1,"261,1",2,1,1,4,Low-Value,Can't Lose
15192,43,1,"5,75",5,1,1,7,Mid-Value,Potential Loyalists
15193,1375,1,"64,5",2,1,1,4,Low-Value,Can't Lose
15194,938,3,"70,15",3,1,1,5,Low-Value,At Risk Customers
15195,273,3,"167,2",5,1,1,7,Mid-Value,Potential Loyalists
15197,1123,2,"193,25",2,1,1,4,Low-Value,Can't Lose
15198,1611,1,"304,5",1,1,1,3,Low-Value,Lost
15200,36,4,"82,45",5,1,1,7,Mid-Value,Potential Loyalists
15201,153,4,"353,95",5,1,1,7,Mid-Value,Potential Loyalists
15203,145,4,"241,10000000000002",5,1,1,7,Mid-Value,Potential Loyalists
15206,238,6,"314,65000000000003",5,1,1,7,Mid-Value,Potential Loyalists
15207,306,2,"10,6",5,1,1,7,Mid-Value,Potential Loyalists
15208,228,3,"190,39999999999998",5,1,1,7,Mid-Value,Potential Loyalists
15211,1145,5,"147,75",2,1,1,4,Low-Value,Can't Lose
15212,451,2,"79,95",4,1,1,6,Mid-Value,Potential Loyalists
15213,252,7,"159,25",5,2,1,8,High-Value,Potential Loyalists
15214,417,5,"290,7",4,1,1,6,Mid-Value,Potential Loyalists
15217,7,5,"308,45",5,1,1,7,Mid-Value,Potential Loyalists
15218,297,2,"30,05",5,1,1,7,Mid-Value,Potential Loyalists
15219,860,2,"33,3",3,1,1,5,Low-Value,At Risk Customers
15221,585,6,"241,85",4,1,1,6,Mid-Value,Potential Loyalists
15223,179,4,"67,3",5,1,1,7,Mid-Value,Potential Loyalists
15224,1199,2,"45,25",2,1,1,4,Low-Value,Can't Lose
15226,314,2,"38,8",5,1,1,7,Mid-Value,Potential Loyalists
15227,115,1,"11,05",5,1,1,7,Mid-Value,Potential Loyalists
15229,691,2,"105,25",4,1,1,6,Mid-Value,Potential Loyalists
15230,665,1,"135,0",4,1,1,6,Mid-Value,Potential Loyalists
15231,603,3,"61,25",4,1,1,6,Mid-Value,Potential Loyalists
15232,12,5,"287,4",5,1,1,7,Mid-Value,Potential Loyalists
15233,988,1,"9,45",3,1,1,5,Low-Value,At Risk Customers
15234,978,2,"48,3",3,1,1,5,Low-Value,At Risk Customers
15236,1538,2,"110,69999999999999",1,1,1,3,Low-Value,Lost
15237,83,5,"204,25",5,1,1,7,Mid-Value,Potential Loyalists
15238,1198,1,"11,0",2,1,1,4,Low-Value,Can't Lose
15239,517,1,"5,5",4,1,1,6,Mid-Value,Potential Loyalists
15241,159,1,"4,4",5,1,1,7,Mid-Value,Potential Loyalists
15244,769,2,"63,099999999999994",3,1,1,5,Low-Value,At Risk Customers
15247,1624,1,"23,4",1,1,1,3,Low-Value,Lost
15248,981,1,"24,5",3,1,1,5,Low-Value,At Risk Customers
15249,392,3,"273,2",4,1,1,6,Mid-Value,Potential Loyalists
15250,1222,4,"323,7",2,1,1,4,Low-Value,Can't Lose
15251,293,3,"150,89999999999998",5,1,1,7,Mid-Value,Potential Loyalists
15252,855,3,"222,3",3,1,1,5,Low-Value,At Risk Customers
15253,554,3,"430,84999999999997",4,1,1,6,Mid-Value,Potential Loyalists
15254,455,9,"732,8499999999999",4,2,2,8,High-Value,Potential Loyalists
15257,1046,1,"160,6",3,1,1,5,Low-Value,At Risk Customers
15259,1028,2,"172,8",3,1,1,5,Low-Value,At Risk Customers
15261,1180,1,"234,45000000000002",2,1,1,4,Low-Value,Can't Lose
15262,1204,1,"28,75",2,1,1,4,Low-Value,Can't Lose
15264,378,7,"419,35",4,2,1,7,Mid-Value,Potential Loyalists
15267,85,2,"289,3",5,1,1,7,Mid-Value,Potential Loyalists
15270,54,4,"449,2",5,1,1,7,Mid-Value,Potential Loyalists
15272,701,3,"87,85",4,1,1,6,Mid-Value,Potential Loyalists
15275,762,3,"56,3",3,1,1,5,Low-Value,At Risk Customers
15276,757,5,"249,3",3,1,1,5,Low-Value,At Risk Customers
15278,795,1,"21,5",3,1,1,5,Low-Value,At Risk Customers
15279,378,2,"173,4",4,1,1,6,Mid-Value,Potential Loyalists
15280,378,1,"10,0",4,1,1,6,Mid-Value,Potential Loyalists
15281,1253,2,"143,1",2,1,1,4,Low-Value,Can't Lose
15283,249,4,"182,75",5,1,1,7,Mid-Value,Potential Loyalists
15284,13,1,"5,8",5,1,1,7,Mid-Value,Potential Loyalists
15285,70,6,"101,15",5,1,1,7,Mid-Value,Potential Loyalists
15286,179,4,"298,90000000000003",5,1,1,7,Mid-Value,Potential Loyalists
15287,54,7,"199,3",5,2,1,8,High-Value,Potential Loyalists
15288,1523,1,"38,35",1,1,1,3,Low-Value,Lost
15289,27,6,"1084,25",5,1,2,8,High-Value,Potential Loyalists
15290,497,1,"160,4",4,1,1,6,Mid-Value,Potential Loyalists
15292,286,1,"136,4",5,1,1,7,Mid-Value,Potential Loyalists
15293,885,2,"44,9",3,1,1,5,Low-Value,At Risk Customers
15294,646,1,"57,05",4,1,1,6,Mid-Value,Potential Loyalists
15296,63,7,"148,25",5,2,1,8,High-Value,Potential Loyalists
15297,1481,2,"79,05",1,1,1,3,Low-Value,Lost
15298,722,1,"49,4",4,1,1,6,Mid-Value,Potential Loyalists
15300,38,2,"153,42999999999998",5,1,1,7,Mid-Value,Potential Loyalists
15301,43,11,"259,05",5,2,1,8,High-Value,Potential Loyalists
15302,120,1,"86,1",5,1,1,7,Mid-Value,Potential Loyalists
15303,270,2,"85,6",5,1,1,7,Mid-Value,Potential Loyalists
15306,154,5,"193,15",5,1,1,7,Mid-Value,Potential Loyalists
15308,196,4,"261,4",5,1,1,7,Mid-Value,Potential Loyalists
15310,1019,2,"39,3",3,1,1,5,Low-Value,At Risk Customers
15311,148,12,"597,65",5,3,1,9,High-Value,Champions
15312,901,3,"432,6",3,1,1,5,Low-Value,At Risk Customers
15314,122,7,"152,89999999999998",5,2,1,8,High-Value,Potential Loyalists
15316,15,1,"14,5",5,1,1,7,Mid-Value,Potential Loyalists
15317,103,5,"85,3",5,1,1,7,Mid-Value,Potential Loyalists
15318,644,1,"75,8",4,1,1,6,Mid-Value,Potential Loyalists
15319,5,4,"269,76",5,1,1,7,Mid-Value,Potential Loyalists
15322,23,2,"219,9",5,1,1,7,Mid-Value,Potential Loyalists
15324,21,7,"525,85",5,2,1,8,High-Value,Potential Loyalists
15325,241,5,"224,0",5,1,1,7,Mid-Value,Potential Loyalists
15326,768,3,"295,6",3,1,1,5,Low-Value,At Risk Customers
15327,1364,2,"84,1",2,1,1,4,Low-Value,Can't Lose
15328,896,1,"46,3",3,1,1,5,Low-Value,At Risk Customers
15329,24,7,"1011,05",5,2,2,9,High-Value,Champions
15330,4,3,"476,55",5,1,1,7,Mid-Value,Potential Loyalists
15332,323,3,"325,85",5,1,1,7,Mid-Value,Potential Loyalists
15333,145,6,"668,8",5,1,2,8,High-Value,Potential Loyalists
15335,878,5,"306,85",3,1,1,5,Low-Value,At Risk Customers
15337,566,4,"144,0",4,1,1,6,Mid-Value,Potential Loyalists
15338,305,4,"88,15",5,1,1,7,Mid-Value,Potential Loyalists
15340,0,5,"622,4",5,1,1,7,Mid-Value,Potential Loyalists
15341,490,1,"27,900000000000002",4,1,1,6,Mid-Value,Potential Loyalists
15342,1613,1,"16,35",1,1,1,3,Low-Value,Lost
15343,1466,1,"17,5",1,1,1,3,Low-Value,Lost
15344,192,3,"188,95000000000002",5,1,1,7,Mid-Value,Potential Loyalists
15345,509,3,"139,7",4,1,1,6,Mid-Value,Potential Loyalists
15346,218,10,"616,95",5,2,1,8,High-Value,Potential Loyalists
15347,925,4,"424,45",3,1,1,5,Low-Value,At Risk Customers
15348,499,3,"45,2",4,1,1,6,Mid-Value,Potential Loyalists
15350,948,2,"24,049999999999997",3,1,1,5,Low-Value,At Risk Customers
15351,188,4,"244,85000000000002",5,1,1,7,Mid-Value,Potential Loyalists
15352,569,2,"389,35",4,1,1,6,Mid-Value,Potential Loyalists
15353,28,5,"377,6",5,1,1,7,Mid-Value,Potential Loyalists
15354,11,3,"88,0",5,1,1,7,Mid-Value,Potential Loyalists
15355,1468,4,"138,4",1,1,1,3,Low-Value,Lost
15357,769,7,"513,1",3,2,1,6,Mid-Value,Potential Loyalists
15358,12,2,"24,5",5,1,1,7,Mid-Value,Potential Loyalists
15360,65,3,"67,65",5,1,1,7,Mid-Value,Potential Loyalists
15361,1043,3,"201,25",3,1,1,5,Low-Value,At Risk Customers
15362,138,3,"318,7",5,1,1,7,Mid-Value,Potential Loyalists
15364,104,5,"349,2",5,1,1,7,Mid-Value,Potential Loyalists
15365,831,1,"82,2",3,1,1,5,Low-Value,At Risk Customers
15366,1389,2,"129,8",2,1,1,4,Low-Value,Can't Lose
15367,164,4,"129,6",5,1,1,7,Mid-Value,Potential Loyalists
15372,295,1,"35,1",5,1,1,7,Mid-Value,Potential Loyalists
15373,80,6,"662,85",5,1,1,7,Mid-Value,Potential Loyalists
15374,16,3,"170,95",5,1,1,7,Mid-Value,Potential Loyalists
15375,10,14,"1188,2",5,3,2,10,High-Value,Champions
15376,736,6,"650,35",3,1,1,5,Low-Value,At Risk Customers
15377,429,6,"714,45",4,1,2,7,Mid-Value,Potential Loyalists
15378,125,8,"567,3",5,2,1,8,High-Value,Potential Loyalists
15382,1523,1,"16,5",1,1,1,3,Low-Value,Lost
15384,955,2,"69,25",3,1,1,5,Low-Value,At Risk Customers
15386,1309,2,"175,95000000000002",2,1,1,4,Low-Value,Can't Lose
15388,524,2,"99,1",4,1,1,6,Mid-Value,Potential Loyalists
15389,9,3,"24,650000000000002",5,1,1,7,Mid-Value,Potential Loyalists
15390,845,6,"672,0",3,1,2,6,Mid-Value,Potential Loyalists
15391,431,1,"50,4",4,1,1,6,Mid-Value,Potential Loyalists
15392,868,2,"53,9",3,1,1,5,Low-Value,At Risk Customers
15393,858,2,"340,8",3,1,1,5,Low-Value,At Risk Customers
15394,581,3,"839,4",4,1,2,7,Mid-Value,Potential Loyalists
15395,190,4,"723,9",5,1,2,8,High-Value,Potential Loyalists
15396,1202,1,"59,2",2,1,1,4,Low-Value,Can't Lose
15397,200,5,"702,25",5,1,2,8,High-Value,Potential Loyalists
15400,721,3,"107,1",4,1,1,6,Mid-Value,Potential Loyalists
15401,734,4,"168,25",3,1,1,5,Low-Value,At Risk Customers
15403,195,3,"218,59999999999997",5,1,1,7,Mid-Value,Potential Loyalists
15404,802,4,"228,4",3,1,1,5,Low-Value,At Risk Customers
15405,373,3,"363,4",4,1,1,6,Mid-Value,Potential Loyalists
15408,423,1,"44,5",4,1,1,6,Mid-Value,Potential Loyalists
15410,37,1,"30,0",5,1,1,7,Mid-Value,Potential Loyalists
15411,24,3,"314,6",5,1,1,7,Mid-Value,Potential Loyalists
15413,726,4,"195,5",4,1,1,6,Mid-Value,Potential Loyalists
15414,1119,2,"120,80000000000001",2,1,1,4,Low-Value,Can't Lose
15415,850,1,"18,5",3,1,1,5,Low-Value,At Risk Customers
15417,355,6,"138,85",5,1,1,7,Mid-Value,Potential Loyalists
15419,749,2,"14,399999999999999",3,1,1,5,Low-Value,At Risk Customers
15420,555,1,"38,849999999999994",4,1,1,6,Mid-Value,Potential Loyalists
15421,119,4,"154,04999999999998",5,1,1,7,Mid-Value,Potential Loyalists
15423,1266,1,"72,0",2,1,1,4,Low-Value,Can't Lose
15424,136,4,"259,6",5,1,1,7,Mid-Value,Potential Loyalists
15425,496,9,"731,7",4,2,2,8,High-Value,Potential Loyalists
15429,1235,5,"189,64999999999998",2,1,1,4,Low-Value,Can't Lose
15430,44,4,"180,75",5,1,1,7,Mid-Value,Potential Loyalists
15431,115,4,"69,14999999999999",5,1,1,7,Mid-Value,Potential Loyalists
15432,1147,2,"46,15",2,1,1,4,Low-Value,Can't Lose
15433,718,1,"125,7",4,1,1,6,Mid-Value,Potential Loyalists
15434,572,1,"66,8",4,1,1,6,Mid-Value,Potential Loyalists
15435,227,1,"54,0",5,1,1,7,Mid-Value,Potential Loyalists
15437,0,8,"749,8",5,2,2,9,High-Value,Champions
15438,1268,2,"223,10000000000002",2,1,1,4,Low-Value,Can't Lose
15439,417,4,"204,70000000000002",4,1,1,6,Mid-Value,Potential Loyalists
15440,1306,1,"16,75",2,1,1,4,Low-Value,Can't Lose
15441,302,3,"456,75",5,1,1,7,Mid-Value,Potential Loyalists
15442,1012,1,"12,1",3,1,1,5,Low-Value,At Risk Customers
15443,995,1,"1,9",3,1,1,5,Low-Value,At Risk Customers
15445,1310,3,"129,2",2,1,1,4,Low-Value,Can't Lose
15446,739,5,"235,39999999999998",3,1,1,5,Low-Value,At Risk Customers
15447,1233,2,"198,65",2,1,1,4,Low-Value,Can't Lose
15449,876,3,"908,55",3,1,2,6,Mid-Value,Potential Loyalists
15450,102,3,"37,5",5,1,1,7,Mid-Value,Potential Loyalists
15451,570,8,"350,18",4,2,1,7,Mid-Value,Potential Loyalists
15453,338,3,"832,15",5,1,2,8,High-Value,Potential Loyalists
15456,1607,1,"88,6",1,1,1,3,Low-Value,Lost
15457,102,3,"162,35",5,1,1,7,Mid-Value,Potential Loyalists
15458,182,2,"272,0",5,1,1,7,Mid-Value,Potential Loyalists
15461,1046,3,"185,2",3,1,1,5,Low-Value,At Risk Customers
15463,776,2,"44,400000000000006",3,1,1,5,Low-Value,At Risk Customers
15464,71,10,"401,9",5,2,1,8,High-Value,Potential Loyalists
15465,1811,1,"11,7",1,1,1,3,Low-Value,Lost
15466,801,2,"70,65",3,1,1,5,Low-Value,At Risk Customers
15467,735,3,"272,95",3,1,1,5,Low-Value,At Risk Customers
15468,11,5,"325,8",5,1,1,7,Mid-Value,Potential Loyalists
15469,959,3,"101,55",3,1,1,5,Low-Value,At Risk Customers
15470,916,2,"42,5",3,1,1,5,Low-Value,At Risk Customers
15472,124,3,"345,15",5,1,1,7,Mid-Value,Potential Loyalists
15474,567,1,"5,4",4,1,1,6,Mid-Value,Potential Loyalists
15475,1705,1,"45,6",1,1,1,3,Low-Value,Lost
15478,1797,1,"22,0",1,1,1,3,Low-Value,Lost
15479,52,9,"642,5",5,2,1,8,High-Value,Potential Loyalists
15480,18,3,"105,35",5,1,1,7,Mid-Value,Potential Loyalists
15481,555,3,"125,94",4,1,1,6,Mid-Value,Potential Loyalists
15482,76,3,"45,95",5,1,1,7,Mid-Value,Potential Loyalists
15483,417,4,"505,55",4,1,1,6,Mid-Value,Potential Loyalists
15484,698,2,"48,75",4,1,1,6,Mid-Value,Potential Loyalists
15487,362,3,"82,7",5,1,1,7,Mid-Value,Potential Loyalists
15490,1313,1,"813,1500000000001",2,1,2,5,Low-Value,At Risk Customers
15493,421,2,"32,1",4,1,1,6,Mid-Value,Potential Loyalists
15495,1198,14,"777,85",2,3,2,7,Mid-Value,Potential Loyalists
15496,122,4,"140,55",5,1,1,7,Mid-Value,Potential Loyalists
15497,1070,1,"30,65",3,1,1,5,Low-Value,At Risk Customers
15499,135,6,"511,0",5,1,1,7,Mid-Value,Potential Loyalists
15500,29,3,"129,5",5,1,1,7,Mid-Value,Potential Loyalists
15501,444,2,"36,75",4,1,1,6,Mid-Value,Potential Loyalists
15502,60,8,"816,3499999999999",5,2,2,9,High-Value,Champions
15503,868,1,"117,1",3,1,1,5,Low-Value,At Risk Customers
15505,368,3,"247,85",4,1,1,6,Mid-Value,Potential Loyalists
15506,243,1,"35,099999999999994",5,1,1,7,Mid-Value,Potential Loyalists
15508,701,3,"211,95",4,1,1,6,Mid-Value,Potential Loyalists
15509,133,5,"359,1",5,1,1,7,Mid-Value,Potential Loyalists
15510,548,1,"206,0",4,1,1,6,Mid-Value,Potential Loyalists
15511,375,2,"36,650000000000006",4,1,1,6,Mid-Value,Potential Loyalists
15512,796,8,"750,05",3,2,2,7,Mid-Value,Potential Loyalists
15513,874,3,"31,450000000000003",3,1,1,5,Low-Value,At Risk Customers
15514,759,3,"149,5",3,1,1,5,Low-Value,At Risk Customers
15515,421,4,"296,2",4,1,1,6,Mid-Value,Potential Loyalists
15517,608,1,"3,25",4,1,1,6,Mid-Value,Potential Loyalists
15518,819,6,"453,05",3,1,1,5,Low-Value,At Risk Customers
15520,89,5,"232,05",5,1,1,7,Mid-Value,Potential Loyalists
15521,334,3,"224,3",5,1,1,7,Mid-Value,Potential Loyalists
15523,1232,1,"22,65",2,1,1,4,Low-Value,Can't Lose
15525,1530,3,"153,10000000000002",1,1,1,3,Low-Value,Lost
15527,105,2,"76,55",5,1,1,7,Mid-Value,Potential Loyalists
15529,808,2,"61,55",3,1,1,5,Low-Value,At Risk Customers
15533,1292,5,"270,35",2,1,1,4,Low-Value,Can't Lose
15535,643,3,"263,0",4,1,1,6,Mid-Value,Potential Loyalists
15536,47,1,"49,95",5,1,1,7,Mid-Value,Potential Loyalists
15537,968,1,"226,9",3,1,1,5,Low-Value,At Risk Customers
15538,965,1,"96,9",3,1,1,5,Low-Value,At Risk Customers
15543,708,1,"44,25",4,1,1,6,Mid-Value,Potential Loyalists
15544,1115,4,"220,25",2,1,1,4,Low-Value,Can't Lose
15545,342,1,"32,5",5,1,1,7,Mid-Value,Potential Loyalists
15546,550,5,"281,95",4,1,1,6,Mid-Value,Potential Loyalists
15547,1701,1,"12,8",1,1,1,3,Low-Value,Lost
15549,384,4,"121,05000000000001",4,1,1,6,Mid-Value,Potential Loyalists
15550,1628,1,"84,3",1,1,1,3,Low-Value,Lost
15551,1698,1,"47,05",1,1,1,3,Low-Value,Lost
15552,531,2,"20,95",4,1,1,6,Mid-Value,Potential Loyalists
15557,122,3,"196,05",5,1,1,7,Mid-Value,Potential Loyalists
15558,1603,1,"68,55000000000001",1,1,1,3,Low-Value,Lost
15560,844,1,"19,5",3,1,1,5,Low-Value,At Risk Customers
15563,230,2,"49,2",5,1,1,7,Mid-Value,Potential Loyalists
15564,405,7,"419,40000000000003",4,2,1,7,Mid-Value,Potential Loyalists
15565,89,2,"62,55",5,1,1,7,Mid-Value,Potential Loyalists
15567,654,7,"417,0",4,2,1,7,Mid-Value,Potential Loyalists
15568,706,1,"27,1",4,1,1,6,Mid-Value,Potential Loyalists
15570,490,4,"168,75",4,1,1,6,Mid-Value,Potential Loyalists
15575,200,1,"1,5",5,1,1,7,Mid-Value,Potential Loyalists
15576,25,3,"534,9",5,1,1,7,Mid-Value,Potential Loyalists
15577,3,9,"584,45",5,2,1,8,High-Value,Potential Loyalists
15578,397,3,"74,35",4,1,1,6,Mid-Value,Potential Loyalists
15580,391,7,"419,35",4,2,1,7,Mid-Value,Potential Loyalists
15581,5,10,"527,75",5,2,1,8,High-Value,Potential Loyalists
15582,1650,1,"36,9",1,1,1,3,Low-Value,Lost
15583,179,4,"205,5",5,1,1,7,Mid-Value,Potential Loyalists
15584,122,1,"35,099999999999994",5,1,1,7,Mid-Value,Potential Loyalists
15587,1593,1,"15,15",1,1,1,3,Low-Value,Lost
15588,32,3,"230,79999999999998",5,1,1,7,Mid-Value,Potential Loyalists
15589,772,5,"252,1",3,1,1,5,Low-Value,At Risk Customers
15590,1021,2,"62,2",3,1,1,5,Low-Value,At Risk Customers
15593,496,3,"102,94999999999999",4,1,1,6,Mid-Value,Potential Loyalists
15595,855,1,"1,5",3,1,1,5,Low-Value,At Risk Customers
15596,584,4,"372,2",4,1,1,6,Mid-Value,Potential Loyalists
15597,28,5,"398,34999999999997",5,1,1,7,Mid-Value,Potential Loyalists
15598,536,4,"448,09999999999997",4,1,1,6,Mid-Value,Potential Loyalists
15599,299,3,"68,5",5,1,1,7,Mid-Value,Potential Loyalists
15601,84,5,"197,25",5,1,1,7,Mid-Value,Potential Loyalists
15602,122,3,"71,35",5,1,1,7,Mid-Value,Potential Loyalists
15604,1508,1,"17,5",1,1,1,3,Low-Value,Lost
15605,1576,2,"97,15",1,1,1,3,Low-Value,Lost
15606,612,1,"72,6",4,1,1,6,Mid-Value,Potential Loyalists
15607,1219,1,"24,4",2,1,1,4,Low-Value,Can't Lose
15608,885,3,"501,85",3,1,1,5,Low-Value,At Risk Customers
15609,1132,1,"54,2",2,1,1,4,Low-Value,Can't Lose
15610,1605,4,"164,15",1,1,1,3,Low-Value,Lost
15612,368,5,"149,0",4,1,1,6,Mid-Value,Potential Loyalists
15613,946,2,"90,9",3,1,1,5,Low-Value,At Risk Customers
15617,49,6,"314,45",5,1,1,7,Mid-Value,Potential Loyalists
15619,1415,1,"32,15",2,1,1,4,Low-Value,Can't Lose
15620,91,8,"371,8",5,2,1,8,High-Value,Potential Loyalists
15622,22,5,"237,25",5,1,1,7,Mid-Value,Potential Loyalists
15624,619,1,"10,0",4,1,1,6,Mid-Value,Potential Loyalists
15625,1051,1,"44,400000000000006",3,1,1,5,Low-Value,At Risk Customers
15626,707,2,"42,65",4,1,1,6,Mid-Value,Potential Loyalists
15629,412,8,"640,15",4,2,1,7,Mid-Value,Potential Loyalists
15631,595,5,"164,6",4,1,1,6,Mid-Value,Potential Loyalists
15632,136,2,"91,15",5,1,1,7,Mid-Value,Potential Loyalists
15633,752,10,"1046,15",3,2,2,7,Mid-Value,Potential Loyalists
15634,451,2,"125,44999999999999",4,1,1,6,Mid-Value,Potential Loyalists
15636,607,6,"411,15",4,1,1,6,Mid-Value,Potential Loyalists
15637,24,2,"298,95",5,1,1,7,Mid-Value,Potential Loyalists
15640,78,7,"654,6",5,2,1,8,High-Value,Potential Loyalists
15641,1106,1,"68,6",2,1,1,4,Low-Value,Can't Lose
15642,160,3,"34,5",5,1,1,7,Mid-Value,Potential Loyalists
15645,204,5,"137,9",5,1,1,7,Mid-Value,Potential Loyalists
15648,1237,5,"629,4",2,1,1,4,Low-Value,Can't Lose
15649,1085,1,"19,55",3,1,1,5,Low-Value,At Risk Customers
15651,29,5,"361,85",5,1,1,7,Mid-Value,Potential Loyalists
15652,7,6,"649,9",5,1,1,7,Mid-Value,Potential Loyalists
15653,657,2,"38,8",4,1,1,6,Mid-Value,Potential Loyalists
15654,530,4,"108,0",4,1,1,6,Mid-Value,Potential Loyalists
15655,444,5,"400,6",4,1,1,6,Mid-Value,Potential Loyalists
15656,86,2,"249,04999999999998",5,1,1,7,Mid-Value,Potential Loyalists
15657,14,8,"498,0",5,2,1,8,High-Value,Potential Loyalists
15658,35,8,"342,7",5,2,1,8,High-Value,Potential Loyalists
15660,574,3,"132,8",4,1,1,6,Mid-Value,Potential Loyalists
15664,477,5,"178,25000000000003",4,1,1,6,Mid-Value,Potential Loyalists
15665,11,2,"48,95",5,1,1,7,Mid-Value,Potential Loyalists
15667,712,2,"36,0",4,1,1,6,Mid-Value,Potential Loyalists
15668,323,3,"69,35000000000001",5,1,1,7,Mid-Value,Potential Loyalists
15671,1349,2,"69,2",2,1,1,4,Low-Value,Can't Lose
15674,68,4,"87,55",5,1,1,7,Mid-Value,Potential Loyalists
15675,1672,1,"8,0",1,1,1,3,Low-Value,Lost
15678,940,2,"182,2",3,1,1,5,Low-Value,At Risk Customers
15680,102,3,"266,29999999999995",5,1,1,7,Mid-Value,Potential Loyalists
15682,877,2,"67,35000000000001",3,1,1,5,Low-Value,At Risk Customers
15686,76,15,"639,35",5,3,1,9,High-Value,Champions
15687,5,7,"336,65",5,2,1,8,High-Value,Potential Loyalists
15688,781,5,"409,2",3,1,1,5,Low-Value,At Risk Customers
15689,1082,1,"146,3",3,1,1,5,Low-Value,At Risk Customers
15690,1665,1,"5,5",1,1,1,3,Low-Value,Lost
15691,9,3,"329,7",5,1,1,7,Mid-Value,Potential Loyalists
15692,877,3,"442,5",3,1,1,5,Low-Value,At Risk Customers
15693,21,8,"497,95",5,2,1,8,High-Value,Potential Loyalists
15695,535,3,"70,75",4,1,1,6,Mid-Value,Potential Loyalists
15697,84,17,"1292,8",5,4,2,11,High-Value,Champions
15698,679,2,"63,75",4,1,1,6,Mid-Value,Potential Loyalists
15699,602,2,"154,45000000000002",4,1,1,6,Mid-Value,Potential Loyalists
15701,291,1,"16,2",5,1,1,7,Mid-Value,Potential Loyalists
15702,151,1,"77,2",5,1,1,7,Mid-Value,Potential Loyalists
15704,379,9,"451,8",4,2,1,7,Mid-Value,Potential Loyalists
15705,232,2,"103,80000000000001",5,1,1,7,Mid-Value,Potential Loyalists
15706,1146,4,"253,45",2,1,1,4,Low-Value,Can't Lose
15707,262,7,"470,0",5,2,1,8,High-Value,Potential Loyalists
15710,4,4,"199,29999999999998",5,1,1,7,Mid-Value,Potential Loyalists
15711,360,1,"64,5",5,1,1,7,Mid-Value,Potential Loyalists
15712,11,2,"81,85",5,1,1,7,Mid-Value,Potential Loyalists
15713,1290,1,"57,5",2,1,1,4,Low-Value,Can't Lose
15715,357,1,"16,55",5,1,1,7,Mid-Value,Potential Loyalists
15716,873,4,"303,5",3,1,1,5,Low-Value,At Risk Customers
15718,1,4,"503,05",5,1,1,7,Mid-Value,Potential Loyalists
15720,253,4,"369,95",5,1,1,7,Mid-Value,Potential Loyalists
15721,757,5,"429,35",3,1,1,5,Low-Value,At Risk Customers
15723,5,23,"2232,9500000000003",5,5,4,14,High-Value,Champions
15725,279,4,"212,75",5,1,1,7,Mid-Value,Potential Loyalists
15726,9,8,"500,55",5,2,1,8,High-Value,Potential Loyalists
15727,461,3,"456,95",4,1,1,6,Mid-Value,Potential Loyalists
15728,1116,1,"194,70000000000002",2,1,1,4,Low-Value,Can't Lose
15729,1386,1,"109,1",2,1,1,4,Low-Value,Can't Lose
15731,537,1,"33,8",4,1,1,6,Mid-Value,Potential Loyalists
15733,74,1,"16,8",5,1,1,7,Mid-Value,Potential Loyalists
15735,773,4,"408,70000000000005",3,1,1,5,Low-Value,At Risk Customers
15736,35,3,"100,15",5,1,1,7,Mid-Value,Potential Loyalists
15739,797,6,"390,25",3,1,1,5,Low-Value,At Risk Customers
15740,80,9,"1034,25",5,2,2,9,High-Value,Champions
15741,210,2,"165,3",5,1,1,7,Mid-Value,Potential Loyalists
15742,795,3,"269,6",3,1,1,5,Low-Value,At Risk Customers
15743,706,1,"35,95",4,1,1,6,Mid-Value,Potential Loyalists
15745,13,2,"85,64999999999999",5,1,1,7,Mid-Value,Potential Loyalists
15746,22,3,"78,35",5,1,1,7,Mid-Value,Potential Loyalists
15748,487,3,"189,25",4,1,1,6,Mid-Value,Potential Loyalists
15750,452,3,"192,6",4,1,1,6,Mid-Value,Potential Loyalists
15755,1627,1,"123,4",1,1,1,3,Low-Value,Lost
15756,228,1,"30,35",5,1,1,7,Mid-Value,Potential Loyalists
15758,139,3,"240,70000000000002",5,1,1,7,Mid-Value,Potential Loyalists
15760,0,3,"317,45",5,1,1,7,Mid-Value,Potential Loyalists
15761,878,4,"201,35",3,1,1,5,Low-Value,At Risk Customers
15764,114,2,"99,6",5,1,1,7,Mid-Value,Potential Loyalists
15766,450,2,"50,75",4,1,1,6,Mid-Value,Potential Loyalists
15767,33,4,"116,7",5,1,1,7,Mid-Value,Potential Loyalists
15769,640,5,"146,70000000000002",4,1,1,6,Mid-Value,Potential Loyalists
15771,746,1,"60,8",3,1,1,5,Low-Value,At Risk Customers
15772,849,4,"206,45",3,1,1,5,Low-Value,At Risk Customers
15773,824,3,"196,15",3,1,1,5,Low-Value,At Risk Customers
15774,790,3,"68,95",3,1,1,5,Low-Value,At Risk Customers
15775,376,2,"100,7",4,1,1,6,Mid-Value,Potential Loyalists
15777,104,6,"549,15",5,1,1,7,Mid-Value,Potential Loyalists
15778,98,6,"330,55",5,1,1,7,Mid-Value,Potential Loyalists
15780,1032,3,"54,85",3,1,1,5,Low-Value,At Risk Customers
15781,1058,1,"30,25",3,1,1,5,Low-Value,At Risk Customers
15782,414,2,"152,75",4,1,1,6,Mid-Value,Potential Loyalists
15783,151,3,"827,9499999999999",5,1,2,8,High-Value,Potential Loyalists
15785,1111,2,"63,0",2,1,1,4,Low-Value,Can't Lose
15786,1001,1,"139,95",3,1,1,5,Low-Value,At Risk Customers
15787,1554,1,"114,4",1,1,1,3,Low-Value,Lost
15788,14,4,"158,85",5,1,1,7,Mid-Value,Potential Loyalists
15789,1125,4,"383,95",2,1,1,4,Low-Value,Can't Lose
15791,4,13,"949,1500000000001",5,3,2,10,High-Value,Champions
15795,1035,1,"54,8",3,1,1,5,Low-Value,At Risk Customers
15797,942,1,"122,0",3,1,1,5,Low-Value,At Risk Customers
15799,430,3,"91,45",4,1,1,6,Mid-Value,Potential Loyalists
15801,584,2,"34,25",4,1,1,6,Mid-Value,Potential Loyalists
15803,439,1,"22,9",4,1,1,6,Mid-Value,Potential Loyalists
15805,60,2,"69,5",5,1,1,7,Mid-Value,Potential Loyalists
15808,663,3,"169,89999999999998",4,1,1,6,Mid-Value,Potential Loyalists
15809,1626,1,"142,35000000000002",1,1,1,3,Low-Value,Lost
15812,99,5,"285,0",5,1,1,7,Mid-Value,Potential Loyalists
15814,158,1,"234,2",5,1,1,7,Mid-Value,Potential Loyalists
15815,856,2,"70,15",3,1,1,5,Low-Value,At Risk Customers
15816,602,2,"99,55000000000001",4,1,1,6,Mid-Value,Potential Loyalists
15817,872,3,"508,44999999999993",3,1,1,5,Low-Value,At Risk Customers
15819,17,3,"195,0",5,1,1,7,Mid-Value,Potential Loyalists
15820,1466,1,"139,2",1,1,1,3,Low-Value,Lost
15822,1526,1,"16,3",1,1,1,3,Low-Value,Lost
15826,643,3,"134,5",4,1,1,6,Mid-Value,Potential Loyalists
15827,369,3,"82,85",4,1,1,6,Mid-Value,Potential Loyalists
15828,1729,2,"106,9",1,1,1,3,Low-Value,Lost
15830,200,1,"116,0",5,1,1,7,Mid-Value,Potential Loyalists
15832,172,1,"557,8",5,1,1,7,Mid-Value,Potential Loyalists
15833,1243,1,"103,5",2,1,1,4,Low-Value,Can't Lose
15835,1153,3,"58,45",2,1,1,4,Low-Value,Can't Lose
15837,470,1,"88,7",4,1,1,6,Mid-Value,Potential Loyalists
15838,1586,1,"72,7",1,1,1,3,Low-Value,Lost
15839,601,4,"145,25",4,1,1,6,Mid-Value,Potential Loyalists
15840,159,12,"813,15",5,3,2,10,High-Value,Champions
15842,1498,2,"177,65",1,1,1,3,Low-Value,Lost
15844,416,3,"115,45",4,1,1,6,Mid-Value,Potential Loyalists
15846,726,1,"234,4",4,1,1,6,Mid-Value,Potential Loyalists
15847,120,4,"355,59999999999997",5,1,1,7,Mid-Value,Potential Loyalists
15848,162,1,"103,4",5,1,1,7,Mid-Value,Potential Loyalists
15850,663,1,"26,75",4,1,1,6,Mid-Value,Potential Loyalists
15851,73,2,"117,6",5,1,1,7,Mid-Value,Potential Loyalists
15852,1291,1,"70,3",2,1,1,4,Low-Value,Can't Lose
15853,467,5,"345,59999999999997",4,1,1,6,Mid-Value,Potential Loyalists
15856,42,13,"884,9",5,3,2,10,High-Value,Champions
15861,27,6,"130,1",5,1,1,7,Mid-Value,Potential Loyalists
15862,1787,1,"58,4",1,1,1,3,Low-Value,Lost
15865,757,2,"85,0",3,1,1,5,Low-Value,At Risk Customers
15866,169,2,"84,3",5,1,1,7,Mid-Value,Potential Loyalists
15868,237,6,"199,15",5,1,1,7,Mid-Value,Potential Loyalists
15869,201,8,"418,5",5,2,1,8,High-Value,Potential Loyalists
15870,98,9,"796,95",5,2,2,9,High-Value,Champions
15871,31,2,"44,8",5,1,1,7,Mid-Value,Potential Loyalists
15872,63,7,"459,1",5,2,1,8,High-Value,Potential Loyalists
15875,493,1,"36,4",4,1,1,6,Mid-Value,Potential Loyalists
15877,229,3,"183,45",5,1,1,7,Mid-Value,Potential Loyalists
15878,19,1,"83,4",5,1,1,7,Mid-Value,Potential Loyalists
15880,1674,1,"11,0",1,1,1,3,Low-Value,Lost
15883,0,7,"380,84999999999997",5,2,1,8,High-Value,Potential Loyalists
15884,819,4,"182,5",3,1,1,5,Low-Value,At Risk Customers
15885,1005,1,"12,55",3,1,1,5,Low-Value,At Risk Customers
15887,69,2,"132,25",5,1,1,7,Mid-Value,Potential Loyalists
15888,379,9,"530,5",4,2,1,7,Mid-Value,Potential Loyalists
15889,1577,1,"297,1",1,1,1,3,Low-Value,Lost
15891,3,1,"33,1",5,1,1,7,Mid-Value,Potential Loyalists
15892,1526,1,"38,8",1,1,1,3,Low-Value,Lost
15893,875,1,"40,4",3,1,1,5,Low-Value,At Risk Customers
15895,211,3,"315,3",5,1,1,7,Mid-Value,Potential Loyalists
15896,972,3,"192,95000000000002",3,1,1,5,Low-Value,At Risk Customers
15897,1107,4,"147,55",2,1,1,4,Low-Value,Can't Lose
15899,1081,1,"161,2",3,1,1,5,Low-Value,At Risk Customers
15903,518,1,"124,2",4,1,1,6,Mid-Value,Potential Loyalists
15904,942,4,"244,34999999999997",3,1,1,5,Low-Value,At Risk Customers
15905,735,5,"923,9000000000001",3,1,2,6,Mid-Value,Potential Loyalists
15906,811,2,"99,25",3,1,1,5,Low-Value,At Risk Customers
15908,1028,2,"51,35",3,1,1,5,Low-Value,At Risk Customers
15909,434,2,"173,4",4,1,1,6,Mid-Value,Potential Loyalists
15910,123,4,"133,45",5,1,1,7,Mid-Value,Potential Loyalists
15913,973,2,"36,8",3,1,1,5,Low-Value,At Risk Customers
15915,3,1,"46,9",5,1,1,7,Mid-Value,Potential Loyalists
15917,91,11,"511,1",5,2,1,8,High-Value,Potential Loyalists
15918,164,2,"312,70000000000005",5,1,1,7,Mid-Value,Potential Loyalists
15919,1111,1,"124,5",2,1,1,4,Low-Value,Can't Lose
15922,42,6,"168,25",5,1,1,7,Mid-Value,Potential Loyalists
15923,447,5,"264,3",4,1,1,6,Mid-Value,Potential Loyalists
15924,302,3,"109,3",5,1,1,7,Mid-Value,Potential Loyalists
15925,1100,2,"571,0",2,1,1,4,Low-Value,Can't Lose
15927,1176,2,"174,4",2,1,1,4,Low-Value,Can't Lose
15928,1114,3,"191,75",2,1,1,4,Low-Value,Can't Lose
15929,82,6,"716,85",5,1,2,8,High-Value,Potential Loyalists
15930,482,6,"362,45",4,1,1,6,Mid-Value,Potential Loyalists
15931,321,8,"461,4",5,2,1,8,High-Value,Potential Loyalists
15932,1014,3,"85,94999999999999",3,1,1,5,Low-Value,At Risk Customers
15934,32,10,"502,7",5,2,1,8,High-Value,Potential Loyalists
15935,213,7,"691,1",5,2,2,9,High-Value,Champions
15937,188,1,"77,2",5,1,1,7,Mid-Value,Potential Loyalists
15939,53,6,"203,4",5,1,1,7,Mid-Value,Potential Loyalists
15940,223,3,"160,9",5,1,1,7,Mid-Value,Potential Loyalists
15941,11,3,"144,35",5,1,1,7,Mid-Value,Potential Loyalists
15943,270,5,"288,75",5,1,1,7,Mid-Value,Potential Loyalists
15945,793,6,"259,45",3,1,1,5,Low-Value,At Risk Customers
15946,58,1,"19,45",5,1,1,7,Mid-Value,Potential Loyalists
15948,901,8,"1038,25",3,2,2,7,Mid-Value,Potential Loyalists
15950,585,4,"299,65",4,1,1,6,Mid-Value,Potential Loyalists
15951,2,8,"386,15",5,2,1,8,High-Value,Potential Loyalists
15952,166,4,"162,85",5,1,1,7,Mid-Value,Potential Loyalists
15953,1218,2,"109,1",2,1,1,4,Low-Value,Can't Lose
15954,1302,2,"134,9",2,1,1,4,Low-Value,Can't Lose
15956,978,2,"396,3",3,1,1,5,Low-Value,At Risk Customers
15958,415,7,"744,9",4,2,2,8,High-Value,Potential Loyalists
15959,920,1,"43,6",3,1,1,5,Low-Value,At Risk Customers
15961,23,2,"254,5",5,1,1,7,Mid-Value,Potential Loyalists
15963,1405,2,"286,85",2,1,1,4,Low-Value,Can't Lose
15966,1002,3,"297,25",3,1,1,5,Low-Value,At Risk Customers
15971,1392,1,"245,8",2,1,1,4,Low-Value,Can't Lose
15972,592,6,"491,70000000000005",4,1,1,6,Mid-Value,Potential Loyalists
15974,1091,2,"182,85",3,1,1,5,Low-Value,At Risk Customers
15975,113,3,"71,55",5,1,1,7,Mid-Value,Potential Loyalists
15977,428,2,"110,05000000000001",4,1,1,6,Mid-Value,Potential Loyalists
15978,123,1,"92,4",5,1,1,7,Mid-Value,Potential Loyalists
15979,790,2,"37,45",3,1,1,5,Low-Value,At Risk Customers
15980,935,2,"17,6",3,1,1,5,Low-Value,At Risk Customers
15981,474,4,"352,65",4,1,1,6,Mid-Value,Potential Loyalists
15984,49,3,"95,0",5,1,1,7,Mid-Value,Potential Loyalists
15986,24,2,"124,95",5,1,1,7,Mid-Value,Potential Loyalists
15987,186,1,"23,25",5,1,1,7,Mid-Value,Potential Loyalists
15989,969,2,"59,55",3,1,1,5,Low-Value,At Risk Customers
15990,1118,1,"4,4",2,1,1,4,Low-Value,Can't Lose
15991,103,4,"147,65",5,1,1,7,Mid-Value,Potential Loyalists
15992,84,5,"185,6",5,1,1,7,Mid-Value,Potential Loyalists
15993,61,5,"149,89999999999998",5,1,1,7,Mid-Value,Potential Loyalists
15994,159,4,"291,7",5,1,1,7,Mid-Value,Potential Loyalists
15995,17,3,"146,6",5,1,1,7,Mid-Value,Potential Loyalists
15999,1466,2,"167,75",1,1,1,3,Low-Value,Lost
16002,1683,1,"146,10000000000002",1,1,1,3,Low-Value,Lost
16003,1722,1,"7,25",1,1,1,3,Low-Value,Lost
16004,367,5,"151,3",4,1,1,6,Mid-Value,Potential Loyalists
16006,206,6,"949,3",5,1,2,8,High-Value,Potential Loyalists
16007,536,8,"687,1500000000001",4,2,2,8,High-Value,Potential Loyalists
16009,1208,2,"68,5",2,1,1,4,Low-Value,Can't Lose
16011,42,3,"99,9",5,1,1,7,Mid-Value,Potential Loyalists
16013,836,5,"464,65000000000003",3,1,1,5,Low-Value,At Risk Customers
16014,754,4,"249,2",3,1,1,5,Low-Value,At Risk Customers
16018,449,4,"609,6",4,1,1,6,Mid-Value,Potential Loyalists
16020,63,5,"490,9",5,1,1,7,Mid-Value,Potential Loyalists
16022,659,1,"79,0",4,1,1,6,Mid-Value,Potential Loyalists
16023,74,4,"80,3",5,1,1,7,Mid-Value,Potential Loyalists
16026,260,3,"332,9",5,1,1,7,Mid-Value,Potential Loyalists
16027,30,4,"243,64999999999998",5,1,1,7,Mid-Value,Potential Loyalists
16029,667,1,"9,85",4,1,1,6,Mid-Value,Potential Loyalists
16030,83,2,"47,900000000000006",5,1,1,7,Mid-Value,Potential Loyalists
16032,1710,2,"53,650000000000006",1,1,1,3,Low-Value,Lost
16033,540,4,"366,05",4,1,1,6,Mid-Value,Potential Loyalists
16035,271,4,"604,25",5,1,1,7,Mid-Value,Potential Loyalists
16036,1015,1,"31,55",3,1,1,5,Low-Value,At Risk Customers
16038,1666,1,"207,9",1,1,1,3,Low-Value,Lost
16039,780,4,"164,5",3,1,1,5,Low-Value,At Risk Customers
16040,131,5,"57,45",5,1,1,7,Mid-Value,Potential Loyalists
16041,257,5,"225,25",5,1,1,7,Mid-Value,Potential Loyalists
16042,239,7,"566,5",5,2,1,8,High-Value,Potential Loyalists
16043,416,2,"141,35",4,1,1,6,Mid-Value,Potential Loyalists
16044,1150,2,"98,9",2,1,1,4,Low-Value,Can't Lose
16048,270,1,"27,599999999999998",5,1,1,7,Mid-Value,Potential Loyalists
16050,970,1,"5,95",3,1,1,5,Low-Value,At Risk Customers
16052,1252,2,"90,75",2,1,1,4,Low-Value,Can't Lose
16053,633,2,"66,25",4,1,1,6,Mid-Value,Potential Loyalists
16054,1323,2,"216,5",2,1,1,4,Low-Value,Can't Lose
16056,45,5,"115,69999999999999",5,1,1,7,Mid-Value,Potential Loyalists
16059,1225,2,"111,10000000000001",2,1,1,4,Low-Value,Can't Lose
16061,1069,3,"86,8",3,1,1,5,Low-Value,At Risk Customers
16062,978,1,"8,75",3,1,1,5,Low-Value,At Risk Customers
16063,1103,2,"103,30000000000001",2,1,1,4,Low-Value,Can't Lose
16064,628,1,"251,7",4,1,1,6,Mid-Value,Potential Loyalists
16066,932,2,"135,04999999999998",3,1,1,5,Low-Value,At Risk Customers
16067,1729,1,"71,4",1,1,1,3,Low-Value,Lost
16068,152,3,"380,75",5,1,1,7,Mid-Value,Potential Loyalists
16070,1275,3,"687,7",2,1,2,5,Low-Value,At Risk Customers
16071,529,10,"670,0",4,2,2,8,High-Value,Potential Loyalists
16072,303,1,"29,15",5,1,1,7,Mid-Value,Potential Loyalists
16075,630,2,"16,3",4,1,1,6,Mid-Value,Potential Loyalists
16077,297,1,"9,9",5,1,1,7,Mid-Value,Potential Loyalists
16078,924,1,"19,3",3,1,1,5,Low-Value,At Risk Customers
16079,920,1,"117,8",3,1,1,5,Low-Value,At Risk Customers
16080,537,4,"156,4",4,1,1,6,Mid-Value,Potential Loyalists
16082,24,16,"823,95",5,3,2,10,High-Value,Champions
16083,652,3,"86,0",4,1,1,6,Mid-Value,Potential Loyalists
16085,158,1,"263,0",5,1,1,7,Mid-Value,Potential Loyalists
16086,346,5,"546,95",5,1,1,7,Mid-Value,Potential Loyalists
16087,1234,1,"37,3",2,1,1,4,Low-Value,Can't Lose
16088,49,2,"182,34999999999997",5,1,1,7,Mid-Value,Potential Loyalists
16089,11,6,"244,16000000000003",5,1,1,7,Mid-Value,Potential Loyalists
16090,126,5,"364,3",5,1,1,7,Mid-Value,Potential Loyalists
16092,596,1,"126,0",4,1,1,6,Mid-Value,Potential Loyalists
16095,581,3,"633,1500000000001",4,1,1,6,Mid-Value,Potential Loyalists
16096,142,8,"289,40000000000003",5,2,1,8,High-Value,Potential Loyalists
16097,584,2,"62,3",4,1,1,6,Mid-Value,Potential Loyalists
16098,579,1,"7,8",4,1,1,6,Mid-Value,Potential Loyalists
16099,441,2,"201,39999999999998",4,1,1,6,Mid-Value,Potential Loyalists
16100,731,1,"51,7",3,1,1,5,Low-Value,At Risk Customers
16102,186,9,"551,55",5,2,1,8,High-Value,Potential Loyalists
16103,964,1,"19,3",3,1,1,5,Low-Value,At Risk Customers
16104,1005,5,"115,95",3,1,1,5,Low-Value,At Risk Customers
16105,288,1,"24,6",5,1,1,7,Mid-Value,Potential Loyalists
16107,398,2,"44,25",4,1,1,6,Mid-Value,Potential Loyalists
16109,74,3,"139,7",5,1,1,7,Mid-Value,Potential Loyalists
16111,843,4,"100,0",3,1,1,5,Low-Value,At Risk Customers
16112,501,3,"96,2",4,1,1,6,Mid-Value,Potential Loyalists
16116,1242,3,"145,9",2,1,1,4,Low-Value,Can't Lose
16117,1125,1,"34,6",2,1,1,4,Low-Value,Can't Lose
16119,843,1,"51,15",3,1,1,5,Low-Value,At Risk Customers
16121,11,7,"438,4",5,2,1,8,High-Value,Potential Loyalists
16122,23,9,"1005,5",5,2,2,9,High-Value,Champions
16123,339,1,"487,0",5,1,1,7,Mid-Value,Potential Loyalists
16125,1159,2,"103,85",2,1,1,4,Low-Value,Can't Lose
16126,507,3,"101,9",4,1,1,6,Mid-Value,Potential Loyalists
16127,976,1,"52,7",3,1,1,5,Low-Value,At Risk Customers
16128,266,2,"33,3",5,1,1,7,Mid-Value,Potential Loyalists
16129,113,7,"957,85",5,2,2,9,High-Value,Champions
16132,518,3,"86,75",4,1,1,6,Mid-Value,Potential Loyalists
16133,1540,1,"22,05",1,1,1,3,Low-Value,Lost
16135,691,1,"86,4",4,1,1,6,Mid-Value,Potential Loyalists
16136,449,1,"66,35",4,1,1,6,Mid-Value,Potential Loyalists
16137,399,7,"263,25",4,2,1,7,Mid-Value,Potential Loyalists
16138,238,2,"50,25",5,1,1,7,Mid-Value,Potential Loyalists
16139,607,1,"160,9",4,1,1,6,Mid-Value,Potential Loyalists
16140,38,2,"309,45",5,1,1,7,Mid-Value,Potential Loyalists
16141,458,2,"28,35",4,1,1,6,Mid-Value,Potential Loyalists
16142,64,5,"171,05",5,1,1,7,Mid-Value,Potential Loyalists
16143,387,5,"284,15",4,1,1,6,Mid-Value,Potential Loyalists
16145,152,8,"827,6999999999999",5,2,2,9,High-Value,Champions
16146,1441,1,"97,95",2,1,1,4,Low-Value,Can't Lose
16149,1545,1,"105,3",1,1,1,3,Low-Value,Lost
16152,601,4,"196,3",4,1,1,6,Mid-Value,Potential Loyalists
16153,886,1,"9,7",3,1,1,5,Low-Value,At Risk Customers
16154,115,2,"169,2",5,1,1,7,Mid-Value,Potential Loyalists
16157,8,5,"217,75",5,1,1,7,Mid-Value,Potential Loyalists
16158,609,1,"36,25",4,1,1,6,Mid-Value,Potential Loyalists
16160,87,5,"534,9",5,1,1,7,Mid-Value,Potential Loyalists
16161,417,4,"231,9",4,1,1,6,Mid-Value,Potential Loyalists
16162,878,2,"56,8",3,1,1,5,Low-Value,At Risk Customers
16164,397,4,"119,25",4,1,1,6,Mid-Value,Potential Loyalists
16166,1252,2,"248,79999999999998",2,1,1,4,Low-Value,Can't Lose
16168,1200,2,"260,05",2,1,1,4,Low-Value,Can't Lose
16169,332,3,"172,5",5,1,1,7,Mid-Value,Potential Loyalists
16170,43,6,"624,5999999999999",5,1,1,7,Mid-Value,Potential Loyalists
16171,98,3,"349,75",5,1,1,7,Mid-Value,Potential Loyalists
16174,1759,1,"5,3",1,1,1,3,Low-Value,Lost
16175,1153,2,"58,2",2,1,1,4,Low-Value,Can't Lose
16176,778,7,"794,55",3,2,2,7,Mid-Value,Potential Loyalists
16177,693,3,"46,6",4,1,1,6,Mid-Value,Potential Loyalists
16178,67,6,"67,5",5,1,1,7,Mid-Value,Potential Loyalists
16180,95,1,"35,0",5,1,1,7,Mid-Value,Potential Loyalists
16183,73,5,"247,0",5,1,1,7,Mid-Value,Potential Loyalists
16184,98,6,"305,1",5,1,1,7,Mid-Value,Potential Loyalists
16185,1033,1,"69,25",3,1,1,5,Low-Value,At Risk Customers
16186,301,3,"119,05000000000001",5,1,1,7,Mid-Value,Potential Loyalists
16187,780,3,"333,1",3,1,1,5,Low-Value,At Risk Customers
16188,738,2,"209,60000000000002",3,1,1,5,Low-Value,At Risk Customers
16189,1411,1,"33,7",2,1,1,4,Low-Value,Can't Lose
16192,175,3,"91,55000000000001",5,1,1,7,Mid-Value,Potential Loyalists
16193,1049,5,"139,2",3,1,1,5,Low-Value,At Risk Customers
16194,488,7,"309,3",4,2,1,7,Mid-Value,Potential Loyalists
16195,8,1,"51,5",5,1,1,7,Mid-Value,Potential Loyalists
16196,567,13,"1377,85",4,3,3,10,High-Value,Champions
16197,60,3,"87,95",5,1,1,7,Mid-Value,Potential Loyalists
16202,567,4,"145,0",4,1,1,6,Mid-Value,Potential Loyalists
16203,210,6,"357,34999999999997",5,1,1,7,Mid-Value,Potential Loyalists
16204,1106,2,"44,849999999999994",2,1,1,4,Low-Value,Can't Lose
16206,10,1,"12,8",5,1,1,7,Mid-Value,Potential Loyalists
16208,763,4,"160,10000000000002",3,1,1,5,Low-Value,At Risk Customers
16209,111,2,"228,04999999999998",5,1,1,7,Mid-Value,Potential Loyalists
16210,420,3,"247,29999999999998",4,1,1,6,Mid-Value,Potential Loyalists
16213,3,5,"311,8",5,1,1,7,Mid-Value,Potential Loyalists
16215,550,6,"370,6",4,1,1,6,Mid-Value,Potential Loyalists
16216,97,3,"103,45",5,1,1,7,Mid-Value,Potential Loyalists
16217,189,3,"80,5",5,1,1,7,Mid-Value,Potential Loyalists
16218,328,3,"84,89999999999999",5,1,1,7,Mid-Value,Potential Loyalists
16219,894,1,"168,0",3,1,1,5,Low-Value,At Risk Customers
16220,1433,1,"9,5",2,1,1,4,Low-Value,Can't Lose
16221,159,1,"54,2",5,1,1,7,Mid-Value,Potential Loyalists
16222,908,2,"146,0",3,1,1,5,Low-Value,At Risk Customers
16223,913,2,"73,45",3,1,1,5,Low-Value,At Risk Customers
16224,1498,1,"34,45",1,1,1,3,Low-Value,Lost
16225,765,2,"61,9",3,1,1,5,Low-Value,At Risk Customers
16229,878,2,"58,95",3,1,1,5,Low-Value,At Risk Customers
16230,844,2,"58,7",3,1,1,5,Low-Value,At Risk Customers
16231,99,5,"164,5",5,1,1,7,Mid-Value,Potential Loyalists
16232,434,1,"0,8",4,1,1,6,Mid-Value,Potential Loyalists
16235,262,7,"1021,15",5,2,2,9,High-Value,Champions
16236,384,1,"244,5",4,1,1,6,Mid-Value,Potential Loyalists
16240,1170,2,"186,8",2,1,1,4,Low-Value,Can't Lose
16242,7,1,"48,1",5,1,1,7,Mid-Value,Potential Loyalists
16243,392,7,"349,75",4,2,1,7,Mid-Value,Potential Loyalists
16246,973,1,"16,3",3,1,1,5,Low-Value,At Risk Customers
16247,123,6,"393,75",5,1,1,7,Mid-Value,Potential Loyalists
16249,394,3,"187,29999999999998",4,1,1,6,Mid-Value,Potential Loyalists
16250,357,3,"237,85000000000002",5,1,1,7,Mid-Value,Potential Loyalists
16251,617,1,"183,89999999999998",4,1,1,6,Mid-Value,Potential Loyalists
16252,1096,3,"33,0",2,1,1,4,Low-Value,Can't Lose
16253,187,2,"385,9",5,1,1,7,Mid-Value,Potential Loyalists
16257,189,5,"497,2",5,1,1,7,Mid-Value,Potential Loyalists
16261,384,1,"56,7",4,1,1,6,Mid-Value,Potential Loyalists
16262,424,2,"70,6",4,1,1,6,Mid-Value,Potential Loyalists
16263,19,10,"566,8",5,2,1,8,High-Value,Potential Loyalists
16267,236,3,"67,0",5,1,1,7,Mid-Value,Potential Loyalists
16268,481,3,"161,35",4,1,1,6,Mid-Value,Potential Loyalists
16271,210,1,"97,5",5,1,1,7,Mid-Value,Potential Loyalists
16272,439,1,"35,35",4,1,1,6,Mid-Value,Potential Loyalists
16273,898,2,"34,75",3,1,1,5,Low-Value,At Risk Customers
16274,35,3,"140,85",5,1,1,7,Mid-Value,Potential Loyalists
16275,14,8,"525,25",5,2,1,8,High-Value,Potential Loyalists
16276,843,2,"375,09999999999997",3,1,1,5,Low-Value,At Risk Customers
16277,35,2,"282,95",5,1,1,7,Mid-Value,Potential Loyalists
16278,27,10,"386,3",5,2,1,8,High-Value,Potential Loyalists
16279,98,1,"14,8",5,1,1,7,Mid-Value,Potential Loyalists
16280,1075,2,"173,85000000000002",3,1,1,5,Low-Value,At Risk Customers
16283,608,2,"160,95000000000002",4,1,1,6,Mid-Value,Potential Loyalists
16284,623,4,"121,25",4,1,1,6,Mid-Value,Potential Loyalists
16285,844,1,"4,3",3,1,1,5,Low-Value,At Risk Customers
16287,621,2,"182,39999999999998",4,1,1,6,Mid-Value,Potential Loyalists
16289,357,4,"180,5",5,1,1,7,Mid-Value,Potential Loyalists
16290,358,4,"584,0",5,1,1,7,Mid-Value,Potential Loyalists
16292,275,1,"27,5",5,1,1,7,Mid-Value,Potential Loyalists
16296,5,7,"409,4",5,2,1,8,High-Value,Potential Loyalists
16297,386,4,"270,35",4,1,1,6,Mid-Value,Potential Loyalists
16300,172,6,"178,8",5,1,1,7,Mid-Value,Potential Loyalists
16301,440,3,"81,5",4,1,1,6,Mid-Value,Potential Loyalists
16302,1200,4,"209,35000000000002",2,1,1,4,Low-Value,Can't Lose
16303,1534,1,"68,0",1,1,1,3,Low-Value,Lost
16304,147,4,"316,95",5,1,1,7,Mid-Value,Potential Loyalists
16305,1562,2,"64,9",1,1,1,3,Low-Value,Lost
16309,389,3,"114,9",4,1,1,6,Mid-Value,Potential Loyalists
16310,1063,3,"94,75",3,1,1,5,Low-Value,At Risk Customers
16311,191,1,"37,7",5,1,1,7,Mid-Value,Potential Loyalists
16312,1526,1,"24,4",1,1,1,3,Low-Value,Lost
16318,579,3,"157,15",4,1,1,6,Mid-Value,Potential Loyalists
16319,983,3,"148,1",3,1,1,5,Low-Value,At Risk Customers
16320,1449,3,"54,5",2,1,1,4,Low-Value,Can't Lose
16321,165,2,"192,1",5,1,1,7,Mid-Value,Potential Loyalists
16322,894,1,"57,05",3,1,1,5,Low-Value,At Risk Customers
16323,504,1,"74,5",4,1,1,6,Mid-Value,Potential Loyalists
16324,44,3,"64,6",5,1,1,7,Mid-Value,Potential Loyalists
16325,1044,1,"12,2",3,1,1,5,Low-Value,At Risk Customers
16328,178,1,"57,05",5,1,1,7,Mid-Value,Potential Loyalists
16329,542,1,"151,2",4,1,1,6,Mid-Value,Potential Loyalists
16330,980,1,"13,6",3,1,1,5,Low-Value,At Risk Customers
16331,888,1,"102,3",3,1,1,5,Low-Value,At Risk Customers
16332,441,4,"192,15000000000003",4,1,1,6,Mid-Value,Potential Loyalists
16333,879,2,"124,95",3,1,1,5,Low-Value,At Risk Customers
16334,133,7,"578,55",5,2,1,8,High-Value,Potential Loyalists
16335,488,6,"445,85",4,1,1,6,Mid-Value,Potential Loyalists
16337,356,5,"225,95",5,1,1,7,Mid-Value,Potential Loyalists
16338,878,2,"197,5",3,1,1,5,Low-Value,At Risk Customers
16340,1144,1,"216,2",2,1,1,4,Low-Value,Can't Lose
16342,112,1,"51,9",5,1,1,7,Mid-Value,Potential Loyalists
16343,13,5,"277,04999999999995",5,1,1,7,Mid-Value,Potential Loyalists
16344,465,4,"259,25",4,1,1,6,Mid-Value,Potential Loyalists
16345,230,3,"38,5",5,1,1,7,Mid-Value,Potential Loyalists
16346,20,8,"838,35",5,2,2,9,High-Value,Champions
16347,111,3,"102,1",5,1,1,7,Mid-Value,Potential Loyalists
16348,379,4,"164,85",4,1,1,6,Mid-Value,Potential Loyalists
16349,1603,1,"87,1",1,1,1,3,Low-Value,Lost
16350,1749,1,"53,6",1,1,1,3,Low-Value,Lost
16354,25,6,"490,2",5,1,1,7,Mid-Value,Potential Loyalists
16357,178,3,"319,95",5,1,1,7,Mid-Value,Potential Loyalists
16358,274,5,"179,5",5,1,1,7,Mid-Value,Potential Loyalists
16360,60,3,"110,8",5,1,1,7,Mid-Value,Potential Loyalists
16362,1159,3,"173,39999999999998",2,1,1,4,Low-Value,Can't Lose
16363,188,4,"260,95",5,1,1,7,Mid-Value,Potential Loyalists
16364,957,1,"11,2",3,1,1,5,Low-Value,At Risk Customers
16366,11,18,"616,15",5,4,1,10,High-Value,Champions
16367,1139,3,"810,4499999999999",2,1,2,5,Low-Value,At Risk Customers
16368,197,1,"579,9",5,1,1,7,Mid-Value,Potential Loyalists
16369,71,4,"102,73",5,1,1,7,Mid-Value,Potential Loyalists
16370,68,6,"259,6",5,1,1,7,Mid-Value,Potential Loyalists
16371,76,1,"38,45",5,1,1,7,Mid-Value,Potential Loyalists
16373,1694,2,"147,65",1,1,1,3,Low-Value,Lost
16374,233,2,"56,95",5,1,1,7,Mid-Value,Potential Loyalists
16375,836,6,"287,6",3,1,1,5,Low-Value,At Risk Customers
16380,811,2,"273,65",3,1,1,5,Low-Value,At Risk Customers
16381,997,5,"147,1",3,1,1,5,Low-Value,At Risk Customers
16385,20,2,"291,7",5,1,1,7,Mid-Value,Potential Loyalists
16386,1756,1,"21,15",1,1,1,3,Low-Value,Lost
16390,1000,2,"134,89999999999998",3,1,1,5,Low-Value,At Risk Customers
16391,1133,1,"36,8",2,1,1,4,Low-Value,Can't Lose
16392,1131,1,"2,9",2,1,1,4,Low-Value,Can't Lose
16393,73,5,"100,65",5,1,1,7,Mid-Value,Potential Loyalists
16398,126,2,"41,5",5,1,1,7,Mid-Value,Potential Loyalists
16400,1081,3,"237,49999999999997",3,1,1,5,Low-Value,At Risk Customers
16401,939,1,"16,0",3,1,1,5,Low-Value,At Risk Customers
16404,468,2,"104,35",4,1,1,6,Mid-Value,Potential Loyalists
16407,758,3,"73,69999999999999",3,1,1,5,Low-Value,At Risk Customers
16408,122,19,"1575,2",5,4,3,12,High-Value,Champions
16409,250,2,"146,75",5,1,1,7,Mid-Value,Potential Loyalists
16413,278,3,"33,15",5,1,1,7,Mid-Value,Potential Loyalists
16414,19,6,"222,05",5,1,1,7,Mid-Value,Potential Loyalists
16415,51,5,"400,5",5,1,1,7,Mid-Value,Potential Loyalists
16417,29,6,"162,8",5,1,1,7,Mid-Value,Potential Loyalists
16418,464,3,"69,65",4,1,1,6,Mid-Value,Potential Loyalists
16421,738,2,"65,9",3,1,1,5,Low-Value,At Risk Customers
16426,1285,1,"657,6",2,1,1,4,Low-Value,Can't Lose
16427,452,3,"121,0",4,1,1,6,Mid-Value,Potential Loyalists
16428,442,2,"76,9",4,1,1,6,Mid-Value,Potential Loyalists
16433,22,4,"645,95",5,1,1,7,Mid-Value,Potential Loyalists
16434,382,2,"112,2",4,1,1,6,Mid-Value,Potential Loyalists
16436,480,5,"185,85",4,1,1,6,Mid-Value,Potential Loyalists
16439,762,8,"446,5",3,2,1,6,Mid-Value,Potential Loyalists
16440,35,7,"279,35",5,2,1,8,High-Value,Potential Loyalists
16442,308,6,"261,0",5,1,1,7,Mid-Value,Potential Loyalists
16443,1589,1,"232,1",1,1,1,3,Low-Value,Lost
16444,412,9,"766,2",4,2,2,8,High-Value,Potential Loyalists
16445,668,4,"153,4",4,1,1,6,Mid-Value,Potential Loyalists
16447,753,4,"337,35",3,1,1,5,Low-Value,At Risk Customers
16449,55,2,"72,2",5,1,1,7,Mid-Value,Potential Loyalists
16450,17,1,"75,8",5,1,1,7,Mid-Value,Potential Loyalists
16451,627,2,"67,9",4,1,1,6,Mid-Value,Potential Loyalists
16453,843,3,"290,45000000000005",3,1,1,5,Low-Value,At Risk Customers
16455,33,7,"569,1",5,2,1,8,High-Value,Potential Loyalists
16456,299,1,"17,15",5,1,1,7,Mid-Value,Potential Loyalists
16457,235,4,"186,35",5,1,1,7,Mid-Value,Potential Loyalists
16459,771,2,"101,04999999999998",3,1,1,5,Low-Value,At Risk Customers
16461,29,2,"111,4",5,1,1,7,Mid-Value,Potential Loyalists
16465,745,2,"170,55",3,1,1,5,Low-Value,At Risk Customers
16467,53,7,"424,3",5,2,1,8,High-Value,Potential Loyalists
16468,660,1,"48,45",4,1,1,6,Mid-Value,Potential Loyalists
16470,438,5,"459,29999999999995",4,1,1,6,Mid-Value,Potential Loyalists
16471,1167,2,"157,15",2,1,1,4,Low-Value,Can't Lose
16473,1261,2,"176,64999999999998",2,1,1,4,Low-Value,Can't Lose
16474,1239,4,"305,95",2,1,1,4,Low-Value,Can't Lose
16475,839,1,"48,0",3,1,1,5,Low-Value,At Risk Customers
16477,15,6,"270,65",5,1,1,7,Mid-Value,Potential Loyalists
16480,159,10,"343,75",5,2,1,8,High-Value,Potential Loyalists
16482,208,2,"189,45",5,1,1,7,Mid-Value,Potential Loyalists
16483,424,5,"564,1",4,1,1,6,Mid-Value,Potential Loyalists
16485,152,1,"3,8",5,1,1,7,Mid-Value,Potential Loyalists
16487,14,8,"339,8",5,2,1,8,High-Value,Potential Loyalists
16489,577,6,"287,55",4,1,1,6,Mid-Value,Potential Loyalists
16490,1400,1,"50,3",2,1,1,4,Low-Value,Can't Lose
16494,1057,1,"9,05",3,1,1,5,Low-Value,At Risk Customers
16496,816,4,"194,8",3,1,1,5,Low-Value,At Risk Customers
16499,685,2,"179,60000000000002",4,1,1,6,Mid-Value,Potential Loyalists
16500,14,2,"99,0",5,1,1,7,Mid-Value,Potential Loyalists
16501,4,5,"100,65",5,1,1,7,Mid-Value,Potential Loyalists
16502,269,2,"195,04999999999998",5,1,1,7,Mid-Value,Potential Loyalists
16503,1544,1,"52,25",1,1,1,3,Low-Value,Lost
16505,549,5,"328,0",4,1,1,6,Mid-Value,Potential Loyalists
16507,1615,1,"62,6",1,1,1,3,Low-Value,Lost
16508,1397,3,"79,7",2,1,1,4,Low-Value,Can't Lose
16509,377,6,"601,1999999999999",4,1,1,6,Mid-Value,Potential Loyalists
16510,783,3,"72,4",3,1,1,5,Low-Value,At Risk Customers
16511,1320,2,"18,2",2,1,1,4,Low-Value,Can't Lose
16512,365,5,"477,25",5,1,1,7,Mid-Value,Potential Loyalists
16513,969,2,"118,0",3,1,1,5,Low-Value,At Risk Customers
16515,1264,1,"22,6",2,1,1,4,Low-Value,Can't Lose
16516,886,1,"11,5",3,1,1,5,Low-Value,At Risk Customers
16518,741,2,"52,95",3,1,1,5,Low-Value,At Risk Customers
16519,132,1,"188,10000000000002",5,1,1,7,Mid-Value,Potential Loyalists
16526,802,3,"199,39999999999998",3,1,1,5,Low-Value,At Risk Customers
16527,167,4,"148,7",5,1,1,7,Mid-Value,Potential Loyalists
16528,391,2,"138,45",4,1,1,6,Mid-Value,Potential Loyalists
16534,773,3,"116,8",3,1,1,5,Low-Value,At Risk Customers
16535,126,3,"346,4",5,1,1,7,Mid-Value,Potential Loyalists
16538,83,3,"906,95",5,1,2,8,High-Value,Potential Loyalists
16539,1781,1,"81,75",1,1,1,3,Low-Value,Lost
16542,1705,6,"340,28",1,1,1,3,Low-Value,Lost
16543,271,8,"386,25",5,2,1,8,High-Value,Potential Loyalists
16545,370,1,"18,55",4,1,1,6,Mid-Value,Potential Loyalists
16546,380,4,"134,65",4,1,1,6,Mid-Value,Potential Loyalists
16548,136,3,"286,15",5,1,1,7,Mid-Value,Potential Loyalists
16549,1184,1,"7,2",2,1,1,4,Low-Value,Can't Lose
16557,873,3,"461,75",3,1,1,5,Low-Value,At Risk Customers
16558,1606,1,"46,25",1,1,1,3,Low-Value,Lost
16559,752,3,"109,64999999999999",3,1,1,5,Low-Value,At Risk Customers
16560,863,4,"189,39999999999998",3,1,1,5,Low-Value,At Risk Customers
16561,1159,3,"74,9",2,1,1,4,Low-Value,Can't Lose
16564,965,2,"101,1",3,1,1,5,Low-Value,At Risk Customers
16565,455,3,"249,75",4,1,1,6,Mid-Value,Potential Loyalists
16567,943,1,"74,55000000000001",3,1,1,5,Low-Value,At Risk Customers
16568,126,5,"314,8",5,1,1,7,Mid-Value,Potential Loyalists
16569,890,4,"567,35",3,1,1,5,Low-Value,At Risk Customers
16571,850,1,"109,9",3,1,1,5,Low-Value,At Risk Customers
16573,691,1,"57,0",4,1,1,6,Mid-Value,Potential Loyalists
16574,992,1,"29,4",3,1,1,5,Low-Value,At Risk Customers
16575,43,6,"424,7",5,1,1,7,Mid-Value,Potential Loyalists
16576,1473,1,"42,4",1,1,1,3,Low-Value,Lost
16577,344,4,"193,55",5,1,1,7,Mid-Value,Potential Loyalists
16578,11,6,"165,4",5,1,1,7,Mid-Value,Potential Loyalists
16579,948,2,"615,8999999999999",3,1,1,5,Low-Value,At Risk Customers
16580,430,3,"196,05",4,1,1,6,Mid-Value,Potential Loyalists
16582,500,4,"279,0",4,1,1,6,Mid-Value,Potential Loyalists
16583,940,2,"35,35",3,1,1,5,Low-Value,At Risk Customers
16590,683,1,"43,2",4,1,1,6,Mid-Value,Potential Loyalists
16592,1680,1,"9,95",1,1,1,3,Low-Value,Lost
16595,43,2,"135,1",5,1,1,7,Mid-Value,Potential Loyalists
16596,184,7,"239,0",5,2,1,8,High-Value,Potential Loyalists
16598,100,3,"26,75",5,1,1,7,Mid-Value,Potential Loyalists
16600,703,2,"156,55",4,1,1,6,Mid-Value,Potential Loyalists
16602,245,4,"624,8",5,1,1,7,Mid-Value,Potential Loyalists
16603,70,3,"628,1",5,1,1,7,Mid-Value,Potential Loyalists
16604,395,3,"73,0",4,1,1,6,Mid-Value,Potential Loyalists
16607,1200,2,"53,800000000000004",2,1,1,4,Low-Value,Can't Lose
16608,17,3,"57,4",5,1,1,7,Mid-Value,Potential Loyalists
16610,1044,1,"63,2",3,1,1,5,Low-Value,At Risk Customers
16611,259,6,"525,45",5,1,1,7,Mid-Value,Potential Loyalists
16614,513,4,"260,5",4,1,1,6,Mid-Value,Potential Loyalists
16616,1151,4,"366,4",2,1,1,4,Low-Value,Can't Lose
16619,721,9,"440,4",4,2,1,7,Mid-Value,Potential Loyalists
16621,133,3,"59,699999999999996",5,1,1,7,Mid-Value,Potential Loyalists
16622,1651,1,"16,4",1,1,1,3,Low-Value,Lost
16623,54,5,"583,4",5,1,1,7,Mid-Value,Potential Loyalists
16625,721,2,"115,8",4,1,1,6,Mid-Value,Potential Loyalists
16627,501,4,"190,0",4,1,1,6,Mid-Value,Potential Loyalists
16628,34,3,"309,45",5,1,1,7,Mid-Value,Potential Loyalists
16629,90,5,"324,05",5,1,1,7,Mid-Value,Potential Loyalists
16631,1190,2,"162,6",2,1,1,4,Low-Value,Can't Lose
16632,1462,1,"16,8",1,1,1,3,Low-Value,Lost
16635,23,2,"659,65",5,1,1,7,Mid-Value,Potential Loyalists
16639,168,2,"305,99999999999994",5,1,1,7,Mid-Value,Potential Loyalists
16641,130,3,"77,2",5,1,1,7,Mid-Value,Potential Loyalists
16642,157,1,"24,7",5,1,1,7,Mid-Value,Potential Loyalists
16645,1132,1,"17,0",2,1,1,4,Low-Value,Can't Lose
16646,894,1,"67,55",3,1,1,5,Low-Value,At Risk Customers
16647,29,6,"340,6",5,1,1,7,Mid-Value,Potential Loyalists
16648,888,1,"38,9",3,1,1,5,Low-Value,At Risk Customers
16650,652,2,"182,3",4,1,1,6,Mid-Value,Potential Loyalists
16651,22,1,"51,3",5,1,1,7,Mid-Value,Potential Loyalists
16652,629,1,"6,25",4,1,1,6,Mid-Value,Potential Loyalists
16653,19,3,"259,7",5,1,1,7,Mid-Value,Potential Loyalists
16654,343,3,"306,5",5,1,1,7,Mid-Value,Potential Loyalists
16655,311,2,"46,2",5,1,1,7,Mid-Value,Potential Loyalists
16657,1026,1,"21,3",3,1,1,5,Low-Value,At Risk Customers
16661,516,2,"38,3",4,1,1,6,Mid-Value,Potential Loyalists
16665,1585,2,"41,7",1,1,1,3,Low-Value,Lost
16668,117,5,"248,65",5,1,1,7,Mid-Value,Potential Loyalists
16670,15,2,"38,1",5,1,1,7,Mid-Value,Potential Loyalists
16671,34,5,"122,15",5,1,1,7,Mid-Value,Potential Loyalists
16672,739,8,"312,2",3,2,1,6,Mid-Value,Potential Loyalists
16673,434,5,"106,55",4,1,1,6,Mid-Value,Potential Loyalists
16674,1779,1,"276,0",1,1,1,3,Low-Value,Lost
16676,183,3,"91,60000000000001",5,1,1,7,Mid-Value,Potential Loyalists
16677,189,4,"436,05",5,1,1,7,Mid-Value,Potential Loyalists
16678,833,5,"213,8",3,1,1,5,Low-Value,At Risk Customers
16680,48,1,"9,95",5,1,1,7,Mid-Value,Potential Loyalists
16681,735,4,"396,05",3,1,1,5,Low-Value,At Risk Customers
16685,801,3,"168,0",3,1,1,5,Low-Value,At Risk Customers
16687,1231,3,"138,56",2,1,1,4,Low-Value,Can't Lose
16688,36,4,"180,75",5,1,1,7,Mid-Value,Potential Loyalists
16689,818,2,"39,0",3,1,1,5,Low-Value,At Risk Customers
16693,11,3,"214,14999999999998",5,1,1,7,Mid-Value,Potential Loyalists
16695,1678,1,"10,45",1,1,1,3,Low-Value,Lost
16697,664,1,"105,3",4,1,1,6,Mid-Value,Potential Loyalists
16698,598,2,"55,05",4,1,1,6,Mid-Value,Potential Loyalists
16699,437,3,"159,7",4,1,1,6,Mid-Value,Potential Loyalists
16700,716,2,"102,95",4,1,1,6,Mid-Value,Potential Loyalists
16701,1732,1,"7,2",1,1,1,3,Low-Value,Lost
16702,751,4,"112,2",3,1,1,5,Low-Value,At Risk Customers
16704,377,2,"92,25",4,1,1,6,Mid-Value,Potential Loyalists
16705,1660,1,"15,4",1,1,1,3,Low-Value,Lost
16706,243,2,"144,05",5,1,1,7,Mid-Value,Potential Loyalists
16707,440,1,"26,9",4,1,1,6,Mid-Value,Potential Loyalists
16711,201,1,"45,2",5,1,1,7,Mid-Value,Potential Loyalists
16713,531,1,"11,75",4,1,1,6,Mid-Value,Potential Loyalists
16714,903,1,"23,3",3,1,1,5,Low-Value,At Risk Customers
16715,155,2,"55,9",5,1,1,7,Mid-Value,Potential Loyalists
16717,308,1,"24,3",5,1,1,7,Mid-Value,Potential Loyalists
16720,973,4,"148,0",3,1,1,5,Low-Value,At Risk Customers
16721,239,5,"351,45000000000005",5,1,1,7,Mid-Value,Potential Loyalists
16724,68,7,"565,9",5,2,1,8,High-Value,Potential Loyalists
16725,1803,1,"23,95",1,1,1,3,Low-Value,Lost
16726,1245,4,"149,05",2,1,1,4,Low-Value,Can't Lose
16728,67,1,"23,65",5,1,1,7,Mid-Value,Potential Loyalists
16731,1148,2,"220,8",2,1,1,4,Low-Value,Can't Lose
16735,1105,1,"28,650000000000002",2,1,1,4,Low-Value,Can't Lose
16736,1594,1,"289,3",1,1,1,3,Low-Value,Lost
16739,202,1,"33,6",5,1,1,7,Mid-Value,Potential Loyalists
16741,82,5,"297,04999999999995",5,1,1,7,Mid-Value,Potential Loyalists
16743,1481,2,"136,9",1,1,1,3,Low-Value,Lost
16745,931,2,"185,3",3,1,1,5,Low-Value,At Risk Customers
16746,415,2,"37,65",4,1,1,6,Mid-Value,Potential Loyalists
16747,950,2,"60,15",3,1,1,5,Low-Value,At Risk Customers
16750,224,2,"107,69999999999999",5,1,1,7,Mid-Value,Potential Loyalists
16752,8,3,"259,7",5,1,1,7,Mid-Value,Potential Loyalists
16753,117,6,"397,05",5,1,1,7,Mid-Value,Potential Loyalists
16754,297,3,"289,5",5,1,1,7,Mid-Value,Potential Loyalists
16756,166,11,"469,55",5,2,1,8,High-Value,Potential Loyalists
16759,229,4,"153,25",5,1,1,7,Mid-Value,Potential Loyalists
16760,361,1,"28,25",5,1,1,7,Mid-Value,Potential Loyalists
16763,1537,1,"2,95",1,1,1,3,Low-Value,Lost
16765,774,2,"59,65",3,1,1,5,Low-Value,At Risk Customers
16766,1753,1,"12,65",1,1,1,3,Low-Value,Lost
16767,110,4,"113,3",5,1,1,7,Mid-Value,Potential Loyalists
16768,940,1,"43,4",3,1,1,5,Low-Value,At Risk Customers
16770,574,4,"382,9",4,1,1,6,Mid-Value,Potential Loyalists
16772,138,4,"110,38",5,1,1,7,Mid-Value,Potential Loyalists
16773,1614,1,"98,0",1,1,1,3,Low-Value,Lost
16774,314,11,"389,0",5,2,1,8,High-Value,Potential Loyalists
16775,92,6,"444,8",5,1,1,7,Mid-Value,Potential Loyalists
16776,105,10,"525,6",5,2,1,8,High-Value,Potential Loyalists
16777,1447,1,"42,15",2,1,1,4,Low-Value,Can't Lose
16778,1282,2,"266,25",2,1,1,4,Low-Value,Can't Lose
16779,691,4,"208,70000000000002",4,1,1,6,Mid-Value,Potential Loyalists
16780,727,1,"14,7",4,1,1,6,Mid-Value,Potential Loyalists
16781,173,4,"709,2",5,1,2,8,High-Value,Potential Loyalists
16783,385,12,"701,7",4,3,2,9,High-Value,Champions
16784,20,13,"742,7",5,3,2,10,High-Value,Champions
16788,715,1,"71,6",4,1,1,6,Mid-Value,Potential Loyalists
16789,877,1,"96,9",3,1,1,5,Low-Value,At Risk Customers
16790,98,1,"12,4",5,1,1,7,Mid-Value,Potential Loyalists
16792,311,6,"484,25",5,1,1,7,Mid-Value,Potential Loyalists
16793,199,4,"415,7",5,1,1,7,Mid-Value,Potential Loyalists
16794,124,5,"292,74999999999994",5,1,1,7,Mid-Value,Potential Loyalists
16799,1103,1,"89,9",2,1,1,4,Low-Value,Can't Lose
16802,255,6,"424,65",5,1,1,7,Mid-Value,Potential Loyalists
16803,644,4,"398,09999999999997",4,1,1,6,Mid-Value,Potential Loyalists
16805,497,2,"77,35",4,1,1,6,Mid-Value,Potential Loyalists
16806,648,2,"190,89999999999998",4,1,1,6,Mid-Value,Potential Loyalists
16808,1538,1,"23,05",1,1,1,3,Low-Value,Lost
16809,324,8,"983,45",5,2,2,9,High-Value,Champions
16811,372,7,"674,1",4,2,2,8,High-Value,Potential Loyalists
16812,784,3,"160,1",3,1,1,5,Low-Value,At Risk Customers
16813,854,1,"262,20000000000005",3,1,1,5,Low-Value,At Risk Customers
16814,157,1,"228,0",5,1,1,7,Mid-Value,Potential Loyalists
16819,959,1,"124,2",3,1,1,5,Low-Value,At Risk Customers
16820,241,5,"421,2",5,1,1,7,Mid-Value,Potential Loyalists
16821,112,2,"324,54999999999995",5,1,1,7,Mid-Value,Potential Loyalists
16825,246,3,"323,15",5,1,1,7,Mid-Value,Potential Loyalists
16827,778,3,"171,25",3,1,1,5,Low-Value,At Risk Customers
16829,109,5,"180,71",5,1,1,7,Mid-Value,Potential Loyalists
16831,1110,1,"67,45",2,1,1,4,Low-Value,Can't Lose
16832,869,1,"40,1",3,1,1,5,Low-Value,At Risk Customers
16833,1103,1,"20,0",2,1,1,4,Low-Value,Can't Lose
16834,207,8,"283,70000000000005",5,2,1,8,High-Value,Potential Loyalists
16837,609,6,"668,65",4,1,2,7,Mid-Value,Potential Loyalists
16839,1041,10,"339,13",3,2,1,6,Mid-Value,Potential Loyalists
16840,12,4,"239,65",5,1,1,7,Mid-Value,Potential Loyalists
16841,886,2,"304,40000000000003",3,1,1,5,Low-Value,At Risk Customers
16842,1372,1,"68,6",2,1,1,4,Low-Value,Can't Lose
16843,60,8,"764,75",5,2,2,9,High-Value,Champions
16844,218,1,"157,0",5,1,1,7,Mid-Value,Potential Loyalists
16848,590,2,"58,95",4,1,1,6,Mid-Value,Potential Loyalists
16849,211,2,"44,25",5,1,1,7,Mid-Value,Potential Loyalists
16850,374,13,"894,0",4,3,2,9,High-Value,Champions
16854,885,1,"30,599999999999998",3,1,1,5,Low-Value,At Risk Customers
16856,486,6,"358,8",4,1,1,6,Mid-Value,Potential Loyalists
16860,378,2,"108,05",4,1,1,6,Mid-Value,Potential Loyalists
16861,595,2,"376,9",4,1,1,6,Mid-Value,Potential Loyalists
16862,29,12,"697,75",5,3,2,10,High-Value,Champions
16863,95,4,"1203,5",5,1,2,8,High-Value,Potential Loyalists
16864,107,1,"68,0",5,1,1,7,Mid-Value,Potential Loyalists
16865,230,1,"56,699999999999996",5,1,1,7,Mid-Value,Potential Loyalists
16866,241,3,"529,85",5,1,1,7,Mid-Value,Potential Loyalists
16867,809,1,"51,3",3,1,1,5,Low-Value,At Risk Customers
16868,794,2,"43,699999999999996",3,1,1,5,Low-Value,At Risk Customers
16869,475,3,"162,05",4,1,1,6,Mid-Value,Potential Loyalists
16870,301,2,"43,8",5,1,1,7,Mid-Value,Potential Loyalists
16871,1005,6,"173,25",3,1,1,5,Low-Value,At Risk Customers
16872,188,5,"365,7",5,1,1,7,Mid-Value,Potential Loyalists
16875,246,2,"389,79999999999995",5,1,1,7,Mid-Value,Potential Loyalists
16877,231,3,"127,9",5,1,1,7,Mid-Value,Potential Loyalists
16878,1170,2,"114,19999999999999",2,1,1,4,Low-Value,Can't Lose
16880,161,6,"365,79999999999995",5,1,1,7,Mid-Value,Potential Loyalists
16881,496,4,"359,4",4,1,1,6,Mid-Value,Potential Loyalists
16882,578,2,"202,3",4,1,1,6,Mid-Value,Potential Loyalists
16884,431,1,"7,7",4,1,1,6,Mid-Value,Potential Loyalists
16885,829,1,"4,1",3,1,1,5,Low-Value,At Risk Customers
16886,369,11,"1215,15",4,2,2,8,High-Value,Potential Loyalists
16890,1578,2,"137,2",1,1,1,3,Low-Value,Lost
16891,1244,3,"148,2",2,1,1,4,Low-Value,Can't Lose
16892,2,3,"134,0",5,1,1,7,Mid-Value,Potential Loyalists
16893,531,1,"129,9",4,1,1,6,Mid-Value,Potential Loyalists
16894,1240,3,"131,5",2,1,1,4,Low-Value,Can't Lose
16898,206,5,"302,8",5,1,1,7,Mid-Value,Potential Loyalists
16899,1173,1,"287,1",2,1,1,4,Low-Value,Can't Lose
16900,2,1,"65,9",5,1,1,7,Mid-Value,Potential Loyalists
16901,69,1,"42,15",5,1,1,7,Mid-Value,Potential Loyalists
16902,974,3,"187,5",3,1,1,5,Low-Value,At Risk Customers
16904,872,5,"486,35",3,1,1,5,Low-Value,At Risk Customers
16905,485,2,"308,8",4,1,1,6,Mid-Value,Potential Loyalists
16906,198,4,"133,75",5,1,1,7,Mid-Value,Potential Loyalists
16907,329,4,"109,4",5,1,1,7,Mid-Value,Potential Loyalists
16908,672,3,"265,0",4,1,1,6,Mid-Value,Potential Loyalists
16909,7,2,"157,10000000000002",5,1,1,7,Mid-Value,Potential Loyalists
16911,45,2,"194,7",5,1,1,7,Mid-Value,Potential Loyalists
16912,11,3,"75,9",5,1,1,7,Mid-Value,Potential Loyalists
16913,1173,1,"30,7",2,1,1,4,Low-Value,Can't Lose
16914,1106,1,"8,1",2,1,1,4,Low-Value,Can't Lose
16915,19,4,"323,35",5,1,1,7,Mid-Value,Potential Loyalists
16916,1410,1,"24,2",2,1,1,4,Low-Value,Can't Lose
16917,1723,1,"22,75",1,1,1,3,Low-Value,Lost
16918,901,1,"84,9",3,1,1,5,Low-Value,At Risk Customers
16919,33,9,"487,85",5,2,1,8,High-Value,Potential Loyalists
16920,998,2,"407,3",3,1,1,5,Low-Value,At Risk Customers
16922,1329,2,"12,0",2,1,1,4,Low-Value,Can't Lose
16923,1561,1,"17,9",1,1,1,3,Low-Value,Lost
16924,1823,1,"17,9",1,1,1,3,Low-Value,Lost
16925,136,1,"63,4",5,1,1,7,Mid-Value,Potential Loyalists
16928,312,2,"167,7",5,1,1,7,Mid-Value,Potential Loyalists
16929,22,2,"131,35",5,1,1,7,Mid-Value,Potential Loyalists
16930,107,10,"282,65",5,2,1,8,High-Value,Potential Loyalists
16931,19,6,"275,35",5,1,1,7,Mid-Value,Potential Loyalists
16932,824,2,"67,95",3,1,1,5,Low-Value,At Risk Customers
16934,118,5,"658,4",5,1,1,7,Mid-Value,Potential Loyalists
16935,87,2,"52,300000000000004",5,1,1,7,Mid-Value,Potential Loyalists
16936,753,2,"81,3",3,1,1,5,Low-Value,At Risk Customers
16937,785,1,"30,8",3,1,1,5,Low-Value,At Risk Customers
16939,1539,1,"123,75",1,1,1,3,Low-Value,Lost
16940,858,3,"151,0",3,1,1,5,Low-Value,At Risk Customers
16941,52,3,"499,5",5,1,1,7,Mid-Value,Potential Loyalists
16942,1397,3,"136,10000000000002",2,1,1,4,Low-Value,Can't Lose
16943,73,4,"83,5",5,1,1,7,Mid-Value,Potential Loyalists
16944,1335,1,"19,25",2,1,1,4,Low-Value,Can't Lose
16945,466,5,"217,85000000000002",4,1,1,6,Mid-Value,Potential Loyalists
16947,1433,2,"149,6",2,1,1,4,Low-Value,Can't Lose
16948,502,2,"185,75",4,1,1,6,Mid-Value,Potential Loyalists
16950,148,1,"183,4",5,1,1,7,Mid-Value,Potential Loyalists
16951,937,1,"242,8",3,1,1,5,Low-Value,At Risk Customers
16953,102,8,"383,3",5,2,1,8,High-Value,Potential Loyalists
16955,1431,1,"49,75",2,1,1,4,Low-Value,Can't Lose
16958,1811,2,"171,90000000000003",1,1,1,3,Low-Value,Lost
16961,406,6,"540,1",4,1,1,6,Mid-Value,Potential Loyalists
16964,802,2,"145,35",3,1,1,5,Low-Value,At Risk Customers
16966,7,4,"152,45",5,1,1,7,Mid-Value,Potential Loyalists
16967,340,2,"26,95",5,1,1,7,Mid-Value,Potential Loyalists
16968,544,1,"22,8",4,1,1,6,Mid-Value,Potential Loyalists
16969,17,3,"98,35",5,1,1,7,Mid-Value,Potential Loyalists
16970,1345,1,"6,65",2,1,1,4,Low-Value,Can't Lose
16971,665,5,"426,09999999999997",4,1,1,6,Mid-Value,Potential Loyalists
16976,80,3,"105,55000000000001",5,1,1,7,Mid-Value,Potential Loyalists
16977,601,3,"222,15",4,1,1,6,Mid-Value,Potential Loyalists
16979,1478,1,"42,3",1,1,1,3,Low-Value,Lost
16980,891,2,"112,55000000000001",3,1,1,5,Low-Value,At Risk Customers
16981,509,1,"57,0",4,1,1,6,Mid-Value,Potential Loyalists
16984,26,10,"904,4",5,2,2,9,High-Value,Champions
16985,491,2,"102,3",4,1,1,6,Mid-Value,Potential Loyalists
16986,843,2,"96,3",3,1,1,5,Low-Value,At Risk Customers
16987,1434,1,"36,55",2,1,1,4,Low-Value,Can't Lose
16989,1263,2,"202,3",2,1,1,4,Low-Value,Can't Lose
16990,83,8,"363,85",5,2,1,8,High-Value,Potential Loyalists
16991,860,3,"137,0",3,1,1,5,Low-Value,At Risk Customers
16992,864,2,"91,99999999999999",3,1,1,5,Low-Value,At Risk Customers
16993,43,4,"201,4",5,1,1,7,Mid-Value,Potential Loyalists
16994,264,3,"76,95",5,1,1,7,Mid-Value,Potential Loyalists
16996,162,4,"82,0",5,1,1,7,Mid-Value,Potential Loyalists
17001,735,1,"34,6",3,1,1,5,Low-Value,At Risk Customers
17005,546,1,"43,650000000000006",4,1,1,6,Mid-Value,Potential Loyalists
17006,280,3,"45,15",5,1,1,7,Mid-Value,Potential Loyalists
17007,1291,3,"177,7",2,1,1,4,Low-Value,Can't Lose
17010,281,3,"59,5",5,1,1,7,Mid-Value,Potential Loyalists
17012,636,3,"135,6",4,1,1,6,Mid-Value,Potential Loyalists
17013,1303,3,"350,4",2,1,1,4,Low-Value,Can't Lose
17016,577,1,"278,9",4,1,1,6,Mid-Value,Potential Loyalists
17018,1078,2,"75,0",3,1,1,5,Low-Value,At Risk Customers
17019,71,8,"224,35000000000002",5,2,1,8,High-Value,Potential Loyalists
17020,11,4,"281,85",5,1,1,7,Mid-Value,Potential Loyalists
17021,580,5,"201,95",4,1,1,6,Mid-Value,Potential Loyalists
17022,1537,1,"12,95",1,1,1,3,Low-Value,Lost
17023,281,2,"77,35",5,1,1,7,Mid-Value,Potential Loyalists
17025,111,5,"235,9",5,1,1,7,Mid-Value,Potential Loyalists
17028,192,6,"234,8",5,1,1,7,Mid-Value,Potential Loyalists
17029,39,3,"95,44999999999999",5,1,1,7,Mid-Value,Potential Loyalists
17030,1665,2,"18,0",1,1,1,3,Low-Value,Lost
17031,100,6,"246,7",5,1,1,7,Mid-Value,Potential Loyalists
17032,107,3,"327,1",5,1,1,7,Mid-Value,Potential Loyalists
17033,92,2,"95,0",5,1,1,7,Mid-Value,Potential Loyalists
17034,36,2,"165,9",5,1,1,7,Mid-Value,Potential Loyalists
17035,249,3,"205,04999999999998",5,1,1,7,Mid-Value,Potential Loyalists
17036,1168,4,"136,15",2,1,1,4,Low-Value,Can't Lose
17037,767,1,"72,3",3,1,1,5,Low-Value,At Risk Customers
17038,488,2,"139,3",4,1,1,6,Mid-Value,Potential Loyalists
17039,850,3,"204,35000000000002",3,1,1,5,Low-Value,At Risk Customers
17041,349,2,"45,35",5,1,1,7,Mid-Value,Potential Loyalists
17042,925,3,"242,1",3,1,1,5,Low-Value,At Risk Customers
17044,778,1,"17,35",3,1,1,5,Low-Value,At Risk Customers
17046,333,1,"13,0",5,1,1,7,Mid-Value,Potential Loyalists
17047,693,2,"161,95",4,1,1,6,Mid-Value,Potential Loyalists
17048,783,4,"292,55",3,1,1,5,Low-Value,At Risk Customers
17049,82,4,"237,0",5,1,1,7,Mid-Value,Potential Loyalists
17050,184,4,"248,2",5,1,1,7,Mid-Value,Potential Loyalists
17053,1617,1,"207,9",1,1,1,3,Low-Value,Lost
17056,1046,4,"343,05",3,1,1,5,Low-Value,At Risk Customers
17057,224,4,"147,75",5,1,1,7,Mid-Value,Potential Loyalists
17060,874,3,"136,05",3,1,1,5,Low-Value,At Risk Customers
17061,475,3,"194,85",4,1,1,6,Mid-Value,Potential Loyalists
17062,0,6,"215,03",5,1,1,7,Mid-Value,Potential Loyalists
17063,365,6,"222,15",5,1,1,7,Mid-Value,Potential Loyalists
17064,225,11,"780,2",5,2,2,9,High-Value,Champions
17066,214,6,"217,0",5,1,1,7,Mid-Value,Potential Loyalists
17068,1026,1,"13,9",3,1,1,5,Low-Value,At Risk Customers
17069,161,6,"317,95",5,1,1,7,Mid-Value,Potential Loyalists
17071,1364,1,"26,85",2,1,1,4,Low-Value,Can't Lose
17072,713,4,"193,05",4,1,1,6,Mid-Value,Potential Loyalists
17073,781,2,"229,60000000000002",3,1,1,5,Low-Value,At Risk Customers
17074,752,3,"312,2",3,1,1,5,Low-Value,At Risk Customers
17075,66,1,"23,95",5,1,1,7,Mid-Value,Potential Loyalists
17076,258,7,"691,8",5,2,2,9,High-Value,Champions
17077,1263,1,"2,6",2,1,1,4,Low-Value,Can't Lose
17078,40,3,"124,05",5,1,1,7,Mid-Value,Potential Loyalists
17079,1780,1,"30,25",1,1,1,3,Low-Value,Lost
17081,512,1,"87,1",4,1,1,6,Mid-Value,Potential Loyalists
17082,62,6,"429,4",5,1,1,7,Mid-Value,Potential Loyalists
17083,20,5,"332,5",5,1,1,7,Mid-Value,Potential Loyalists
17084,26,1,"50,4",5,1,1,7,Mid-Value,Potential Loyalists
17086,1331,3,"551,05",2,1,1,4,Low-Value,Can't Lose
17087,146,10,"235,65",5,2,1,8,High-Value,Potential Loyalists
17089,11,15,"1410,0",5,3,3,11,High-Value,Champions
17090,129,1,"349,79999999999995",5,1,1,7,Mid-Value,Potential Loyalists
17092,531,2,"187,35",4,1,1,6,Mid-Value,Potential Loyalists
17093,38,5,"254,95",5,1,1,7,Mid-Value,Potential Loyalists
17094,208,2,"70,2",5,1,1,7,Mid-Value,Potential Loyalists
17095,1622,1,"38,7",1,1,1,3,Low-Value,Lost
17097,287,5,"282,6",5,1,1,7,Mid-Value,Potential Loyalists
17098,59,3,"184,54999999999998",5,1,1,7,Mid-Value,Potential Loyalists
17099,559,3,"203,0",4,1,1,6,Mid-Value,Potential Loyalists
17100,64,4,"283,40000000000003",5,1,1,7,Mid-Value,Potential Loyalists
17101,1180,1,"20,95",2,1,1,4,Low-Value,Can't Lose
17102,522,4,"447,15",4,1,1,6,Mid-Value,Potential Loyalists
17104,1651,1,"169,8",1,1,1,3,Low-Value,Lost
17105,1667,1,"23,4",1,1,1,3,Low-Value,Lost
17107,271,1,"8,6",5,1,1,7,Mid-Value,Potential Loyalists
17113,380,1,"23,4",4,1,1,6,Mid-Value,Potential Loyalists
17115,742,5,"311,1",3,1,1,5,Low-Value,At Risk Customers
17116,39,1,"41,65",5,1,1,7,Mid-Value,Potential Loyalists
17117,51,4,"163,9",5,1,1,7,Mid-Value,Potential Loyalists
17119,795,1,"30,0",3,1,1,5,Low-Value,At Risk Customers
17120,146,2,"38,15",5,1,1,7,Mid-Value,Potential Loyalists
17121,1510,2,"98,05",1,1,1,3,Low-Value,Lost
17123,1296,1,"106,2",2,1,1,4,Low-Value,Can't Lose
17129,61,3,"87,35000000000001",5,1,1,7,Mid-Value,Potential Loyalists
17130,33,6,"591,0",5,1,1,7,Mid-Value,Potential Loyalists
17134,389,3,"154,64999999999998",4,1,1,6,Mid-Value,Potential Loyalists
17135,755,1,"13,1",3,1,1,5,Low-Value,At Risk Customers
17136,793,3,"411,35",3,1,1,5,Low-Value,At Risk Customers
17139,1169,3,"64,2",2,1,1,4,Low-Value,Can't Lose
17140,125,4,"287,4",5,1,1,7,Mid-Value,Potential Loyalists
17142,1477,2,"600,3",1,1,1,3,Low-Value,Lost
17143,1800,1,"48,9",1,1,1,3,Low-Value,Lost
17144,463,1,"18,9",4,1,1,6,Mid-Value,Potential Loyalists
17145,1285,1,"51,449999999999996",2,1,1,4,Low-Value,Can't Lose
17146,462,1,"12,9",4,1,1,6,Mid-Value,Potential Loyalists
17148,900,2,"141,55",3,1,1,5,Low-Value,At Risk Customers
17151,1598,1,"57,449999999999996",1,1,1,3,Low-Value,Lost
17159,117,4,"334,85",5,1,1,7,Mid-Value,Potential Loyalists
17160,74,10,"243,14999999999998",5,2,1,8,High-Value,Potential Loyalists
17161,22,4,"108,05",5,1,1,7,Mid-Value,Potential Loyalists
17163,533,2,"189,75",4,1,1,6,Mid-Value,Potential Loyalists
17164,12,6,"344,85",5,1,1,7,Mid-Value,Potential Loyalists
17165,231,2,"60,699999999999996",5,1,1,7,Mid-Value,Potential Loyalists
17166,1166,4,"341,95",2,1,1,4,Low-Value,Can't Lose
17167,561,1,"37,8",4,1,1,6,Mid-Value,Potential Loyalists
17168,1484,2,"276,4",1,1,1,3,Low-Value,Lost
17171,581,2,"292,2",4,1,1,6,Mid-Value,Potential Loyalists
17172,189,2,"41,95",5,1,1,7,Mid-Value,Potential Loyalists
17174,238,2,"74,7",5,1,1,7,Mid-Value,Potential Loyalists
17175,383,5,"495,4",4,1,1,6,Mid-Value,Potential Loyalists
17176,59,2,"76,55000000000001",5,1,1,7,Mid-Value,Potential Loyalists
17177,1180,4,"202,8",2,1,1,4,Low-Value,Can't Lose
17179,189,11,"589,6",5,2,1,8,High-Value,Potential Loyalists
17183,42,2,"141,35000000000002",5,1,1,7,Mid-Value,Potential Loyalists
17184,998,1,"103,4",3,1,1,5,Low-Value,At Risk Customers
17185,193,5,"274,85",5,1,1,7,Mid-Value,Potential Loyalists
17186,446,4,"124,85",4,1,1,6,Mid-Value,Potential Loyalists
17187,194,5,"501,70000000000005",5,1,1,7,Mid-Value,Potential Loyalists
17189,249,4,"171,95",5,1,1,7,Mid-Value,Potential Loyalists
17190,208,1,"87,7",5,1,1,7,Mid-Value,Potential Loyalists
17191,149,6,"203,45",5,1,1,7,Mid-Value,Potential Loyalists
17196,146,3,"99,39999999999999",5,1,1,7,Mid-Value,Potential Loyalists
17198,1174,2,"53,45",2,1,1,4,Low-Value,Can't Lose
17200,183,2,"29,45",5,1,1,7,Mid-Value,Potential Loyalists
17201,212,1,"33,6",5,1,1,7,Mid-Value,Potential Loyalists
17202,749,2,"82,3",3,1,1,5,Low-Value,At Risk Customers
17203,126,6,"341,8",5,1,1,7,Mid-Value,Potential Loyalists
17205,824,1,"17,55",3,1,1,5,Low-Value,At Risk Customers
17208,167,3,"374,75",5,1,1,7,Mid-Value,Potential Loyalists
17209,485,1,"33,65",4,1,1,6,Mid-Value,Potential Loyalists
17210,797,5,"217,5",3,1,1,5,Low-Value,At Risk Customers
17211,1180,3,"421,7",2,1,1,4,Low-Value,Can't Lose
17213,1219,2,"81,8",2,1,1,4,Low-Value,Can't Lose
17214,399,4,"399,15",4,1,1,6,Mid-Value,Potential Loyalists
17215,1375,3,"220,85",2,1,1,4,Low-Value,Can't Lose
17217,105,4,"103,0",5,1,1,7,Mid-Value,Potential Loyalists
17220,537,6,"379,8",4,1,1,6,Mid-Value,Potential Loyalists
17221,1060,5,"678,3",3,1,2,6,Mid-Value,Potential Loyalists
17223,53,6,"516,65",5,1,1,7,Mid-Value,Potential Loyalists
17224,1260,2,"212,20000000000002",2,1,1,4,Low-Value,Can't Lose
17225,1466,2,"100,1",1,1,1,3,Low-Value,Lost
17226,1499,1,"8,9",1,1,1,3,Low-Value,Lost
17227,247,1,"8,4",5,1,1,7,Mid-Value,Potential Loyalists
17228,853,2,"59,8",3,1,1,5,Low-Value,At Risk Customers
17229,73,1,"24,2",5,1,1,7,Mid-Value,Potential Loyalists
17232,277,2,"150,0",5,1,1,7,Mid-Value,Potential Loyalists
17233,8,2,"30,3",5,1,1,7,Mid-Value,Potential Loyalists
17234,84,2,"87,6",5,1,1,7,Mid-Value,Potential Loyalists
17236,355,2,"16,1",5,1,1,7,Mid-Value,Potential Loyalists
17239,575,1,"475,3",4,1,1,6,Mid-Value,Potential Loyalists
17241,534,4,"237,60000000000002",4,1,1,6,Mid-Value,Potential Loyalists
17242,1599,1,"148,3",1,1,1,3,Low-Value,Lost
17243,369,1,"49,6",4,1,1,6,Mid-Value,Potential Loyalists
17244,1706,1,"42,15",1,1,1,3,Low-Value,Lost
17245,241,1,"28,950000000000003",5,1,1,7,Mid-Value,Potential Loyalists
17247,1636,1,"232,1",1,1,1,3,Low-Value,Lost
17249,897,1,"78,8",3,1,1,5,Low-Value,At Risk Customers
17252,56,5,"668,1",5,1,2,8,High-Value,Potential Loyalists
17253,519,3,"124,1",4,1,1,6,Mid-Value,Potential Loyalists
17255,39,13,"546,05",5,3,1,9,High-Value,Champions
17257,619,4,"88,3",4,1,1,6,Mid-Value,Potential Loyalists
17258,395,5,"166,3",4,1,1,6,Mid-Value,Potential Loyalists
17262,1695,1,"26,2",1,1,1,3,Low-Value,Lost
17264,199,1,"86,1",5,1,1,7,Mid-Value,Potential Loyalists
17267,1626,1,"74,5",1,1,1,3,Low-Value,Lost
17268,112,1,"51,3",5,1,1,7,Mid-Value,Potential Loyalists
17270,1664,2,"92,2",1,1,1,3,Low-Value,Lost
17272,603,1,"78,15",4,1,1,6,Mid-Value,Potential Loyalists
17273,439,1,"76,3",4,1,1,6,Mid-Value,Potential Loyalists
17274,363,5,"174,65",5,1,1,7,Mid-Value,Potential Loyalists
17278,1649,1,"88,94999999999999",1,1,1,3,Low-Value,Lost
17279,409,5,"338,2",4,1,1,6,Mid-Value,Potential Loyalists
17280,811,2,"63,55",3,1,1,5,Low-Value,At Risk Customers
17281,1106,3,"261,4",2,1,1,4,Low-Value,Can't Lose
17284,1096,4,"175,1",2,1,1,4,Low-Value,Can't Lose
17287,615,1,"154,64999999999998",4,1,1,6,Mid-Value,Potential Loyalists
17288,203,3,"268,95",5,1,1,7,Mid-Value,Potential Loyalists
17290,1097,4,"152,05",2,1,1,4,Low-Value,Can't Lose
17291,825,4,"354,75",3,1,1,5,Low-Value,At Risk Customers
17293,991,4,"257,2",3,1,1,5,Low-Value,At Risk Customers
17294,28,4,"143,6",5,1,1,7,Mid-Value,Potential Loyalists
17297,55,5,"705,55",5,1,2,8,High-Value,Potential Loyalists
17299,13,2,"44,150000000000006",5,1,1,7,Mid-Value,Potential Loyalists
17301,564,1,"15,0",4,1,1,6,Mid-Value,Potential Loyalists
17302,392,1,"33,5",4,1,1,6,Mid-Value,Potential Loyalists
17303,52,1,"63,2",5,1,1,7,Mid-Value,Potential Loyalists
17304,109,3,"120,25",5,1,1,7,Mid-Value,Potential Loyalists
17306,1468,8,"406,5",1,2,1,4,Low-Value,Can't Lose
17307,1117,1,"82,8",2,1,1,4,Low-Value,Can't Lose
17308,269,2,"71,05000000000001",5,1,1,7,Mid-Value,Potential Loyalists
17310,700,1,"13,15",4,1,1,6,Mid-Value,Potential Loyalists
17311,256,1,"6,6",5,1,1,7,Mid-Value,Potential Loyalists
17313,211,5,"568,75",5,1,1,7,Mid-Value,Potential Loyalists
17315,944,1,"52,650000000000006",3,1,1,5,Low-Value,At Risk Customers
17316,396,4,"513,35",4,1,1,6,Mid-Value,Potential Loyalists
17319,1298,2,"185,4",2,1,1,4,Low-Value,Can't Lose
17320,1,5,"315,6",5,1,1,7,Mid-Value,Potential Loyalists
17321,143,1,"13,5",5,1,1,7,Mid-Value,Potential Loyalists
17322,360,2,"91,9",5,1,1,7,Mid-Value,Potential Loyalists
17325,1,4,"278,5",5,1,1,7,Mid-Value,Potential Loyalists
17327,1668,1,"53,05",1,1,1,3,Low-Value,Lost
17328,973,1,"29,1",3,1,1,5,Low-Value,At Risk Customers
17330,163,3,"204,6",5,1,1,7,Mid-Value,Potential Loyalists
17331,7,3,"126,39999999999999",5,1,1,7,Mid-Value,Potential Loyalists
17332,54,9,"635,1",5,2,1,8,High-Value,Potential Loyalists
17333,796,2,"43,050000000000004",3,1,1,5,Low-Value,At Risk Customers
17335,362,2,"96,05",5,1,1,7,Mid-Value,Potential Loyalists
17336,1029,3,"185,9",3,1,1,5,Low-Value,At Risk Customers
17337,23,2,"80,80000000000001",5,1,1,7,Mid-Value,Potential Loyalists
17338,988,1,"27,5",3,1,1,5,Low-Value,At Risk Customers
17340,87,3,"114,14999999999999",5,1,1,7,Mid-Value,Potential Loyalists
17341,570,2,"97,4",4,1,1,6,Mid-Value,Potential Loyalists
17345,381,2,"314,05",4,1,1,6,Mid-Value,Potential Loyalists
17347,491,4,"392,04999999999995",4,1,1,6,Mid-Value,Potential Loyalists
17349,1126,1,"30,7",2,1,1,4,Low-Value,Can't Lose
17350,437,1,"127,95",4,1,1,6,Mid-Value,Potential Loyalists
17352,253,11,"423,84999999999997",5,2,1,8,High-Value,Potential Loyalists
17355,41,4,"94,5",5,1,1,7,Mid-Value,Potential Loyalists
17356,52,8,"434,1",5,2,1,8,High-Value,Potential Loyalists
17357,91,1,"16,3",5,1,1,7,Mid-Value,Potential Loyalists
17359,865,3,"836,3000000000001",3,1,2,6,Mid-Value,Potential Loyalists
17361,35,1,"19,5",5,1,1,7,Mid-Value,Potential Loyalists
17362,233,3,"107,05000000000001",5,1,1,7,Mid-Value,Potential Loyalists
17363,191,3,"230,2",5,1,1,7,Mid-Value,Potential Loyalists
17364,414,3,"248,9",4,1,1,6,Mid-Value,Potential Loyalists
17365,504,6,"534,25",4,1,1,6,Mid-Value,Potential Loyalists
17367,409,1,"7,9",4,1,1,6,Mid-Value,Potential Loyalists
17369,204,1,"34,1",5,1,1,7,Mid-Value,Potential Loyalists
17373,649,2,"17,9",4,1,1,6,Mid-Value,Potential Loyalists
17374,335,4,"477,9",5,1,1,7,Mid-Value,Potential Loyalists
17375,341,2,"98,60000000000001",5,1,1,7,Mid-Value,Potential Loyalists
17376,64,6,"369,9",5,1,1,7,Mid-Value,Potential Loyalists
17377,875,1,"125,0",3,1,1,5,Low-Value,At Risk Customers
17378,808,3,"300,25",3,1,1,5,Low-Value,At Risk Customers
17380,362,2,"20,2",5,1,1,7,Mid-Value,Potential Loyalists
17381,1473,3,"384,1",1,1,1,3,Low-Value,Lost
17382,1711,1,"5,45",1,1,1,3,Low-Value,Lost
17384,549,4,"261,05",4,1,1,6,Mid-Value,Potential Loyalists
17386,365,9,"654,1",5,2,1,8,High-Value,Potential Loyalists
17387,253,2,"38,6",5,1,1,7,Mid-Value,Potential Loyalists
17389,188,16,"1042,2",5,3,2,10,High-Value,Champions
17390,927,1,"40,4",3,1,1,5,Low-Value,At Risk Customers
17391,214,5,"330,15",5,1,1,7,Mid-Value,Potential Loyalists
17392,46,7,"449,15",5,2,1,8,High-Value,Potential Loyalists
17393,3,1,"41,2",5,1,1,7,Mid-Value,Potential Loyalists
17397,1391,1,"45,75",2,1,1,4,Low-Value,Can't Lose
17400,1485,1,"139,2",1,1,1,3,Low-Value,Lost
17402,151,9,"611,05",5,2,1,8,High-Value,Potential Loyalists
17404,516,2,"299,2",4,1,1,6,Mid-Value,Potential Loyalists
17406,749,1,"15,4",3,1,1,5,Low-Value,At Risk Customers
17407,154,8,"386,95000000000005",5,2,1,8,High-Value,Potential Loyalists
17408,938,4,"200,9",3,1,1,5,Low-Value,At Risk Customers
17409,609,2,"101,2",4,1,1,6,Mid-Value,Potential Loyalists
17410,34,4,"201,75",5,1,1,7,Mid-Value,Potential Loyalists
17411,874,1,"98,9",3,1,1,5,Low-Value,At Risk Customers
17412,451,6,"458,5",4,1,1,6,Mid-Value,Potential Loyalists
17415,28,3,"75,85000000000001",5,1,1,7,Mid-Value,Potential Loyalists
17416,1043,1,"32,5",3,1,1,5,Low-Value,At Risk Customers
17418,761,5,"478,84999999999997",3,1,1,5,Low-Value,At Risk Customers
17420,103,2,"124,8",5,1,1,7,Mid-Value,Potential Loyalists
17423,301,2,"101,15",5,1,1,7,Mid-Value,Potential Loyalists
17424,152,11,"342,2",5,2,1,8,High-Value,Potential Loyalists
17426,38,7,"533,95",5,2,1,8,High-Value,Potential Loyalists
17427,998,2,"117,2",3,1,1,5,Low-Value,At Risk Customers
17428,1751,1,"148,05",1,1,1,3,Low-Value,Lost
17430,683,2,"62,400000000000006",4,1,1,6,Mid-Value,Potential Loyalists
17431,251,3,"76,4",5,1,1,7,Mid-Value,Potential Loyalists
17432,398,5,"320,05",4,1,1,6,Mid-Value,Potential Loyalists
17434,1179,4,"110,8",2,1,1,4,Low-Value,Can't Lose
17435,123,4,"312,45",5,1,1,7,Mid-Value,Potential Loyalists
17438,462,3,"332,5",4,1,1,6,Mid-Value,Potential Loyalists
17440,89,1,"35,7",5,1,1,7,Mid-Value,Potential Loyalists
17441,1344,2,"54,85",2,1,1,4,Low-Value,Can't Lose
17442,296,1,"27,0",5,1,1,7,Mid-Value,Potential Loyalists
17443,1253,3,"125,75000000000001",2,1,1,4,Low-Value,Can't Lose
17446,229,2,"32,25",5,1,1,7,Mid-Value,Potential Loyalists
17447,42,5,"271,0",5,1,1,7,Mid-Value,Potential Loyalists
17448,531,1,"191,3",4,1,1,6,Mid-Value,Potential Loyalists
17449,1718,1,"36,65",1,1,1,3,Low-Value,Lost
17450,54,11,"351,55",5,2,1,8,High-Value,Potential Loyalists
17451,764,1,"5,75",3,1,1,5,Low-Value,At Risk Customers
17452,122,10,"493,35",5,2,1,8,High-Value,Potential Loyalists
17453,949,1,"1,3",3,1,1,5,Low-Value,At Risk Customers
17457,56,6,"639,95",5,1,1,7,Mid-Value,Potential Loyalists
17458,638,3,"332,20000000000005",4,1,1,6,Mid-Value,Potential Loyalists
17459,1368,2,"49,7",2,1,1,4,Low-Value,Can't Lose
17460,549,1,"55,349999999999994",4,1,1,6,Mid-Value,Potential Loyalists
17463,837,2,"151,15",3,1,1,5,Low-Value,At Risk Customers
17464,14,5,"168,4",5,1,1,7,Mid-Value,Potential Loyalists
17465,86,5,"157,85",5,1,1,7,Mid-Value,Potential Loyalists
17466,218,1,"36,65",5,1,1,7,Mid-Value,Potential Loyalists
17467,49,2,"119,55",5,1,1,7,Mid-Value,Potential Loyalists
17470,1476,3,"228,39999999999998",1,1,1,3,Low-Value,Lost
17472,504,1,"25,5",4,1,1,6,Mid-Value,Potential Loyalists
17475,210,1,"73,3",5,1,1,7,Mid-Value,Potential Loyalists
17476,1557,1,"11,35",1,1,1,3,Low-Value,Lost
17479,185,4,"195,1",5,1,1,7,Mid-Value,Potential Loyalists
17481,897,2,"116,19999999999999",3,1,1,5,Low-Value,At Risk Customers
17482,850,1,"4,15",3,1,1,5,Low-Value,At Risk Customers
17485,1780,1,"96,75",1,1,1,3,Low-Value,Lost
17487,206,5,"322,05",5,1,1,7,Mid-Value,Potential Loyalists
17489,31,2,"216,25",5,1,1,7,Mid-Value,Potential Loyalists
17494,1436,1,"24,35",2,1,1,4,Low-Value,Can't Lose
17496,74,4,"592,8",5,1,1,7,Mid-Value,Potential Loyalists
17497,21,3,"290,3",5,1,1,7,Mid-Value,Potential Loyalists
17500,1099,3,"166,5",2,1,1,4,Low-Value,Can't Lose
17501,406,8,"366,2",4,2,1,7,Mid-Value,Potential Loyalists
17502,239,1,"24,05",5,1,1,7,Mid-Value,Potential Loyalists
17505,429,2,"78,4",4,1,1,6,Mid-Value,Potential Loyalists
17507,1,8,"826,45",5,2,2,9,High-Value,Champions
17508,27,9,"1393,6",5,2,3,10,High-Value,Champions
17509,661,2,"133,55",4,1,1,6,Mid-Value,Potential Loyalists
17513,42,5,"164,75",5,1,1,7,Mid-Value,Potential Loyalists
17514,144,1,"29,6",5,1,1,7,Mid-Value,Potential Loyalists
17515,1305,1,"27,6",2,1,1,4,Low-Value,Can't Lose
17517,985,1,"57,05",3,1,1,5,Low-Value,At Risk Customers
17518,1044,1,"135,45000000000002",3,1,1,5,Low-Value,At Risk Customers
17519,1332,2,"66,4",2,1,1,4,Low-Value,Can't Lose
17520,157,6,"526,05",5,1,1,7,Mid-Value,Potential Loyalists
17521,484,14,"507,35",4,3,1,8,High-Value,Potential Loyalists
17522,354,5,"294,55",5,1,1,7,Mid-Value,Potential Loyalists
17523,847,3,"139,3",3,1,1,5,Low-Value,At Risk Customers
17524,759,4,"415,95000000000005",3,1,1,5,Low-Value,At Risk Customers
17527,1029,2,"89,1",3,1,1,5,Low-Value,At Risk Customers
17528,766,1,"7,75",3,1,1,5,Low-Value,At Risk Customers
17529,1819,1,"2,2",1,1,1,3,Low-Value,Lost
17530,1551,1,"32,85",1,1,1,3,Low-Value,Lost
17531,257,1,"40,65",5,1,1,7,Mid-Value,Potential Loyalists
17532,56,2,"69,7",5,1,1,7,Mid-Value,Potential Loyalists
17534,811,3,"523,05",3,1,1,5,Low-Value,At Risk Customers
17535,13,6,"183,5",5,1,1,7,Mid-Value,Potential Loyalists
17536,1110,1,"18,1",2,1,1,4,Low-Value,Can't Lose
17537,3,5,"168,95",5,1,1,7,Mid-Value,Potential Loyalists
17540,782,1,"19,4",3,1,1,5,Low-Value,At Risk Customers
17541,130,6,"195,95",5,1,1,7,Mid-Value,Potential Loyalists
17542,170,5,"63,85",5,1,1,7,Mid-Value,Potential Loyalists
17546,50,2,"279,65",5,1,1,7,Mid-Value,Potential Loyalists
17547,7,3,"268,4",5,1,1,7,Mid-Value,Potential Loyalists
17548,86,3,"60,9",5,1,1,7,Mid-Value,Potential Loyalists
17549,288,1,"15,35",5,1,1,7,Mid-Value,Potential Loyalists
17550,291,3,"107,55000000000001",5,1,1,7,Mid-Value,Potential Loyalists
17551,164,9,"591,3",5,2,1,8,High-Value,Potential Loyalists
17552,25,3,"149,8",5,1,1,7,Mid-Value,Potential Loyalists
17553,791,8,"376,8",3,2,1,6,Mid-Value,Potential Loyalists
17556,253,4,"170,6",5,1,1,7,Mid-Value,Potential Loyalists
17557,377,1,"36,8",4,1,1,6,Mid-Value,Potential Loyalists
17560,250,1,"68,2",5,1,1,7,Mid-Value,Potential Loyalists
17562,98,9,"472,3",5,2,1,8,High-Value,Potential Loyalists
17563,842,1,"22,9",3,1,1,5,Low-Value,At Risk Customers
17564,612,1,"5,8",4,1,1,6,Mid-Value,Potential Loyalists
17567,1143,3,"66,1",2,1,1,4,Low-Value,Can't Lose
17568,3,8,"306,65000000000003",5,2,1,8,High-Value,Potential Loyalists
17570,1197,3,"136,35",2,1,1,4,Low-Value,Can't Lose
17571,13,10,"757,55",5,2,2,9,High-Value,Champions
17572,78,3,"411,2",5,1,1,7,Mid-Value,Potential Loyalists
17574,1743,1,"31,9",1,1,1,3,Low-Value,Lost
17575,70,1,"91,15",5,1,1,7,Mid-Value,Potential Loyalists
17577,271,2,"55,550000000000004",5,1,1,7,Mid-Value,Potential Loyalists
17578,1639,1,"102,6",1,1,1,3,Low-Value,Lost
17579,239,1,"23,75",5,1,1,7,Mid-Value,Potential Loyalists
17582,614,3,"75,05",4,1,1,6,Mid-Value,Potential Loyalists
17584,34,4,"190,1",5,1,1,7,Mid-Value,Potential Loyalists
17585,143,1,"53,400000000000006",5,1,1,7,Mid-Value,Potential Loyalists
17586,958,1,"24,4",3,1,1,5,Low-Value,At Risk Customers
17589,541,1,"39,9",4,1,1,6,Mid-Value,Potential Loyalists
17590,5,8,"593,8",5,2,1,8,High-Value,Potential Loyalists
17591,55,8,"455,5",5,2,1,8,High-Value,Potential Loyalists
17593,721,4,"155,54999999999998",4,1,1,6,Mid-Value,Potential Loyalists
17594,1463,2,"157,89999999999998",1,1,1,3,Low-Value,Lost
17595,492,4,"147,8",4,1,1,6,Mid-Value,Potential Loyalists
17598,1292,1,"134,7",2,1,1,4,Low-Value,Can't Lose
17599,266,3,"309,0",5,1,1,7,Mid-Value,Potential Loyalists
17602,19,4,"968,9499999999999",5,1,2,8,High-Value,Potential Loyalists
17603,628,1,"44,9",4,1,1,6,Mid-Value,Potential Loyalists
17604,399,3,"103,05",4,1,1,6,Mid-Value,Potential Loyalists
17605,586,2,"58,3",4,1,1,6,Mid-Value,Potential Loyalists
17606,1113,3,"69,0",2,1,1,4,Low-Value,Can't Lose
17607,123,2,"41,1",5,1,1,7,Mid-Value,Potential Loyalists
17608,886,4,"189,9",3,1,1,5,Low-Value,At Risk Customers
17610,739,1,"8,25",3,1,1,5,Low-Value,At Risk Customers
17611,307,3,"125,0",5,1,1,7,Mid-Value,Potential Loyalists
17612,312,1,"11,45",5,1,1,7,Mid-Value,Potential Loyalists
17614,1317,1,"86,9",2,1,1,4,Low-Value,Can't Lose
17615,201,6,"265,6",5,1,1,7,Mid-Value,Potential Loyalists
17617,493,2,"190,70000000000002",4,1,1,6,Mid-Value,Potential Loyalists
17619,434,2,"183,4",4,1,1,6,Mid-Value,Potential Loyalists
17620,606,3,"149,1",4,1,1,6,Mid-Value,Potential Loyalists
17623,85,5,"496,2",5,1,1,7,Mid-Value,Potential Loyalists
17625,1449,2,"269,25",2,1,1,4,Low-Value,Can't Lose
17626,517,1,"31,650000000000002",4,1,1,6,Mid-Value,Potential Loyalists
17627,433,1,"42,45",4,1,1,6,Mid-Value,Potential Loyalists
17629,335,7,"219,8",5,2,1,8,High-Value,Potential Loyalists
17630,577,2,"583,6",4,1,1,6,Mid-Value,Potential Loyalists
17637,267,3,"104,89999999999999",5,1,1,7,Mid-Value,Potential Loyalists
17638,192,6,"289,3",5,1,1,7,Mid-Value,Potential Loyalists
17640,236,3,"289,2",5,1,1,7,Mid-Value,Potential Loyalists
17642,63,5,"444,90000000000003",5,1,1,7,Mid-Value,Potential Loyalists
17647,367,7,"698,5",4,2,2,8,High-Value,Potential Loyalists
17649,732,12,"777,65",3,3,2,8,High-Value,Potential Loyalists
17650,155,2,"204,70000000000002",5,1,1,7,Mid-Value,Potential Loyalists
17651,1370,1,"15,8",2,1,1,4,Low-Value,Can't Lose
17652,743,3,"61,25",3,1,1,5,Low-Value,At Risk Customers
17653,73,8,"506,05",5,2,1,8,High-Value,Potential Loyalists
17654,40,4,"300,29999999999995",5,1,1,7,Mid-Value,Potential Loyalists
17655,109,6,"600,4000000000001",5,1,1,7,Mid-Value,Potential Loyalists
17657,119,2,"75,35",5,1,1,7,Mid-Value,Potential Loyalists
17658,1783,1,"114,7",1,1,1,3,Low-Value,Lost
17660,1058,2,"75,14999999999999",3,1,1,5,Low-Value,At Risk Customers
17662,1322,1,"25,650000000000002",2,1,1,4,Low-Value,Can't Lose
17664,120,7,"385,95",5,2,1,8,High-Value,Potential Loyalists
17668,926,2,"13,75",3,1,1,5,Low-Value,At Risk Customers
17671,423,7,"442,4",4,2,1,7,Mid-Value,Potential Loyalists
17673,202,1,"22,4",5,1,1,7,Mid-Value,Potential Loyalists
17676,826,4,"164,3",3,1,1,5,Low-Value,At Risk Customers
17679,510,1,"45,0",4,1,1,6,Mid-Value,Potential Loyalists
17681,949,1,"103,5",3,1,1,5,Low-Value,At Risk Customers
17682,399,1,"26,6",4,1,1,6,Mid-Value,Potential Loyalists
17684,3,3,"113,3",5,1,1,7,Mid-Value,Potential Loyalists
17685,141,5,"374,84999999999997",5,1,1,7,Mid-Value,Potential Loyalists
17686,410,7,"457,25",4,2,1,7,Mid-Value,Potential Loyalists
17687,73,3,"57,4",5,1,1,7,Mid-Value,Potential Loyalists
17688,24,2,"49,35",5,1,1,7,Mid-Value,Potential Loyalists
17689,981,3,"116,85000000000001",3,1,1,5,Low-Value,At Risk Customers
17690,883,4,"275,5",3,1,1,5,Low-Value,At Risk Customers
17694,18,6,"312,54999999999995",5,1,1,7,Mid-Value,Potential Loyalists
17695,40,2,"36,5",5,1,1,7,Mid-Value,Potential Loyalists
17697,934,2,"46,75",3,1,1,5,Low-Value,At Risk Customers
17699,552,4,"147,4",4,1,1,6,Mid-Value,Potential Loyalists
17702,394,4,"501,50000000000006",4,1,1,6,Mid-Value,Potential Loyalists
17703,380,1,"21,1",4,1,1,6,Mid-Value,Potential Loyalists
17705,1824,1,"5,75",1,1,1,3,Low-Value,Lost
17707,896,3,"305,55",3,1,1,5,Low-Value,At Risk Customers
17708,9,7,"545,7",5,2,1,8,High-Value,Potential Loyalists
17710,493,11,"658,55",4,2,1,7,Mid-Value,Potential Loyalists
17715,477,1,"39,8",4,1,1,6,Mid-Value,Potential Loyalists
17716,1040,2,"39,7",3,1,1,5,Low-Value,At Risk Customers
17717,1045,1,"13,2",3,1,1,5,Low-Value,At Risk Customers
17719,124,3,"264,7",5,1,1,7,Mid-Value,Potential Loyalists
17723,39,5,"345,5",5,1,1,7,Mid-Value,Potential Loyalists
17724,769,3,"253,45",3,1,1,5,Low-Value,At Risk Customers
17725,138,7,"150,85",5,2,1,8,High-Value,Potential Loyalists
17729,1,4,"315,45",5,1,1,7,Mid-Value,Potential Loyalists
17731,401,3,"56,75",4,1,1,6,Mid-Value,Potential Loyalists
17732,199,3,"51,3",5,1,1,7,Mid-Value,Potential Loyalists
17733,502,2,"103,60000000000001",4,1,1,6,Mid-Value,Potential Loyalists
17734,215,1,"63,1",5,1,1,7,Mid-Value,Potential Loyalists
17737,97,4,"177,45",5,1,1,7,Mid-Value,Potential Loyalists
17738,173,1,"27,9",5,1,1,7,Mid-Value,Potential Loyalists
17739,1059,1,"40,7",3,1,1,5,Low-Value,At Risk Customers
17741,7,1,"30,2",5,1,1,7,Mid-Value,Potential Loyalists
17743,363,2,"146,5",5,1,1,7,Mid-Value,Potential Loyalists
17744,258,3,"58,05",5,1,1,7,Mid-Value,Potential Loyalists
17745,1690,3,"106,8",1,1,1,3,Low-Value,Lost
17746,1547,1,"19,4",1,1,1,3,Low-Value,Lost
17747,14,1,"147,2",5,1,1,7,Mid-Value,Potential Loyalists
17748,789,1,"88,5",3,1,1,5,Low-Value,At Risk Customers
17749,346,3,"212,2",5,1,1,7,Mid-Value,Potential Loyalists
17750,20,6,"261,67",5,1,1,7,Mid-Value,Potential Loyalists
17751,175,3,"147,9",5,1,1,7,Mid-Value,Potential Loyalists
17753,360,6,"333,05",5,1,1,7,Mid-Value,Potential Loyalists
17754,542,2,"196,75",4,1,1,6,Mid-Value,Potential Loyalists
17756,42,5,"335,4",5,1,1,7,Mid-Value,Potential Loyalists
17757,48,7,"188,5",5,2,1,8,High-Value,Potential Loyalists
17758,1670,1,"30,0",1,1,1,3,Low-Value,Lost
17759,417,3,"137,65",4,1,1,6,Mid-Value,Potential Loyalists
17760,67,4,"156,64999999999998",5,1,1,7,Mid-Value,Potential Loyalists
17761,74,5,"624,8499999999999",5,1,1,7,Mid-Value,Potential Loyalists
17762,794,3,"172,55",3,1,1,5,Low-Value,At Risk Customers
17765,185,3,"315,65000000000003",5,1,1,7,Mid-Value,Potential Loyalists
17766,238,3,"76,85",5,1,1,7,Mid-Value,Potential Loyalists
17768,217,4,"345,65",5,1,1,7,Mid-Value,Potential Loyalists
17770,11,11,"801,2",5,2,2,9,High-Value,Champions
17771,204,6,"428,75",5,1,1,7,Mid-Value,Potential Loyalists
17773,132,3,"78,4",5,1,1,7,Mid-Value,Potential Loyalists
17777,1054,2,"250,0",3,1,1,5,Low-Value,At Risk Customers
17779,735,3,"371,6",3,1,1,5,Low-Value,At Risk Customers
17781,158,3,"198,85000000000002",5,1,1,7,Mid-Value,Potential Loyalists
17782,979,1,"5,5",3,1,1,5,Low-Value,At Risk Customers
17783,447,4,"139,5",4,1,1,6,Mid-Value,Potential Loyalists
17785,924,4,"73,35",3,1,1,5,Low-Value,At Risk Customers
17786,945,3,"245,70000000000002",3,1,1,5,Low-Value,At Risk Customers
17789,138,4,"320,95000000000005",5,1,1,7,Mid-Value,Potential Loyalists
17790,97,4,"158,65",5,1,1,7,Mid-Value,Potential Loyalists
17793,892,5,"253,7",3,1,1,5,Low-Value,At Risk Customers
17794,456,5,"212,3",4,1,1,6,Mid-Value,Potential Loyalists
17801,757,8,"840,7",3,2,2,7,Mid-Value,Potential Loyalists
17803,605,2,"134,4",4,1,1,6,Mid-Value,Potential Loyalists
17806,1013,4,"82,80000000000001",3,1,1,5,Low-Value,At Risk Customers
17807,956,1,"89,85",3,1,1,5,Low-Value,At Risk Customers
17808,250,1,"18,75",5,1,1,7,Mid-Value,Potential Loyalists
17809,1650,1,"340,20000000000005",1,1,1,3,Low-Value,Lost
17811,949,1,"43,15",3,1,1,5,Low-Value,At Risk Customers
17813,1079,4,"192,05",3,1,1,5,Low-Value,At Risk Customers
17814,1574,3,"67,45",1,1,1,3,Low-Value,Lost
17815,55,7,"373,25",5,2,1,8,High-Value,Potential Loyalists
17816,223,2,"21,299999999999997",5,1,1,7,Mid-Value,Potential Loyalists
17817,546,3,"240,35000000000002",4,1,1,6,Mid-Value,Potential Loyalists
17818,534,3,"438,0",4,1,1,6,Mid-Value,Potential Loyalists
17819,7,4,"200,45",5,1,1,7,Mid-Value,Potential Loyalists
17820,914,2,"147,75",3,1,1,5,Low-Value,At Risk Customers
17821,55,3,"180,65",5,1,1,7,Mid-Value,Potential Loyalists
17822,453,4,"94,35000000000001",4,1,1,6,Mid-Value,Potential Loyalists
17823,394,4,"494,65",4,1,1,6,Mid-Value,Potential Loyalists
17825,70,3,"136,7",5,1,1,7,Mid-Value,Potential Loyalists
17826,102,4,"75,80000000000001",5,1,1,7,Mid-Value,Potential Loyalists
17828,401,4,"90,25",4,1,1,6,Mid-Value,Potential Loyalists
17829,1156,1,"3,35",2,1,1,4,Low-Value,Can't Lose
17830,1469,3,"116,8",1,1,1,3,Low-Value,Lost
17831,197,3,"61,45",5,1,1,7,Mid-Value,Potential Loyalists
17832,1459,1,"241,0",2,1,1,4,Low-Value,Can't Lose
17833,325,14,"1126,45",5,3,2,10,High-Value,Champions
17835,67,2,"44,5",5,1,1,7,Mid-Value,Potential Loyalists
17837,776,5,"240,64999999999998",3,1,1,5,Low-Value,At Risk Customers
17838,699,1,"72,75",4,1,1,6,Mid-Value,Potential Loyalists
17840,620,7,"451,94999999999993",4,2,1,7,Mid-Value,Potential Loyalists
17841,323,6,"300,7",5,1,1,7,Mid-Value,Potential Loyalists
17843,987,2,"83,64999999999999",3,1,1,5,Low-Value,At Risk Customers
17846,17,4,"212,1",5,1,1,7,Mid-Value,Potential Loyalists
17853,388,8,"849,65",4,2,2,8,High-Value,Potential Loyalists
17855,88,3,"63,3",5,1,1,7,Mid-Value,Potential Loyalists
17856,556,5,"319,9",4,1,1,6,Mid-Value,Potential Loyalists
17858,1446,1,"56,5",2,1,1,4,Low-Value,Can't Lose
17860,445,2,"168,6",4,1,1,6,Mid-Value,Potential Loyalists
17862,389,4,"434,25",4,1,1,6,Mid-Value,Potential Loyalists
17863,842,2,"117,19999999999999",3,1,1,5,Low-Value,At Risk Customers
17866,486,2,"77,25",4,1,1,6,Mid-Value,Potential Loyalists
17867,772,4,"523,9",3,1,1,5,Low-Value,At Risk Customers
17868,292,4,"225,7",5,1,1,7,Mid-Value,Potential Loyalists
17869,910,3,"461,90000000000003",3,1,1,5,Low-Value,At Risk Customers
17873,498,1,"15,5",4,1,1,6,Mid-Value,Potential Loyalists
17874,348,2,"34,35",5,1,1,7,Mid-Value,Potential Loyalists
17875,605,2,"76,0",4,1,1,6,Mid-Value,Potential Loyalists
17876,108,2,"24,15",5,1,1,7,Mid-Value,Potential Loyalists
17877,155,1,"20,5",5,1,1,7,Mid-Value,Potential Loyalists
17878,813,1,"116,6",3,1,1,5,Low-Value,At Risk Customers
17879,5,8,"270,1",5,2,1,8,High-Value,Potential Loyalists
17884,426,5,"276,8",4,1,1,6,Mid-Value,Potential Loyalists
17885,549,3,"168,85",4,1,1,6,Mid-Value,Potential Loyalists
17886,346,1,"60,9",5,1,1,7,Mid-Value,Potential Loyalists
17887,452,3,"61,95",4,1,1,6,Mid-Value,Potential Loyalists
17889,894,1,"36,8",3,1,1,5,Low-Value,At Risk Customers
17890,1264,2,"192,65",2,1,1,4,Low-Value,Can't Lose
17891,140,6,"255,75",5,1,1,7,Mid-Value,Potential Loyalists
17892,4,8,"958,45",5,2,2,9,High-Value,Champions
17893,1775,1,"127,2",1,1,1,3,Low-Value,Lost
17896,45,1,"48,05",5,1,1,7,Mid-Value,Potential Loyalists
17897,1062,1,"21,45",3,1,1,5,Low-Value,At Risk Customers
17898,260,2,"219,89999999999998",5,1,1,7,Mid-Value,Potential Loyalists
17899,59,4,"651,7499999999999",5,1,1,7,Mid-Value,Potential Loyalists
17901,110,4,"57,75",5,1,1,7,Mid-Value,Potential Loyalists
17903,91,2,"22,15",5,1,1,7,Mid-Value,Potential Loyalists
17904,685,1,"125,65",4,1,1,6,Mid-Value,Potential Loyalists
17905,73,3,"87,05",5,1,1,7,Mid-Value,Potential Loyalists
17906,1103,1,"11,8",2,1,1,4,Low-Value,Can't Lose
17907,889,2,"25,000000000000004",3,1,1,5,Low-Value,At Risk Customers
17908,83,1,"42,0",5,1,1,7,Mid-Value,Potential Loyalists
17910,780,8,"329,1",3,2,1,6,Mid-Value,Potential Loyalists
17913,1340,1,"97,95",2,1,1,4,Low-Value,Can't Lose
17914,748,1,"48,2",3,1,1,5,Low-Value,At Risk Customers
17916,301,2,"195,10000000000002",5,1,1,7,Mid-Value,Potential Loyalists
17919,49,12,"700,4",5,3,2,10,High-Value,Champions
17920,806,2,"45,400000000000006",3,1,1,5,Low-Value,At Risk Customers
17921,740,4,"131,7",3,1,1,5,Low-Value,At Risk Customers
17922,659,1,"28,15",4,1,1,6,Mid-Value,Potential Loyalists
17923,2,2,"55,5",5,1,1,7,Mid-Value,Potential Loyalists
17925,459,6,"199,4",4,1,1,6,Mid-Value,Potential Loyalists
17927,41,7,"551,3000000000001",5,2,1,8,High-Value,Potential Loyalists
17928,577,2,"31,15",4,1,1,6,Mid-Value,Potential Loyalists
17932,38,3,"297,9",5,1,1,7,Mid-Value,Potential Loyalists
17933,2,1,"91,0",5,1,1,7,Mid-Value,Potential Loyalists
17936,1492,1,"38,95",1,1,1,3,Low-Value,Lost
17938,48,7,"330,6",5,2,1,8,High-Value,Potential Loyalists
17939,586,1,"116,6",4,1,1,6,Mid-Value,Potential Loyalists
17941,1143,3,"118,05",2,1,1,4,Low-Value,Can't Lose
17945,108,11,"366,85",5,2,1,8,High-Value,Potential Loyalists
17946,92,6,"295,9",5,1,1,7,Mid-Value,Potential Loyalists
17947,94,1,"95,9",5,1,1,7,Mid-Value,Potential Loyalists
17948,9,4,"108,45",5,1,1,7,Mid-Value,Potential Loyalists
17949,1525,2,"49,55",1,1,1,3,Low-Value,Lost
17950,71,8,"1049,25",5,2,2,9,High-Value,Champions
17951,70,7,"598,1500000000001",5,2,1,8,High-Value,Potential Loyalists
17952,786,4,"269,55",3,1,1,5,Low-Value,At Risk Customers
17953,120,5,"714,1",5,1,2,8,High-Value,Potential Loyalists
17954,163,3,"156,25",5,1,1,7,Mid-Value,Potential Loyalists
17955,1699,1,"27,55",1,1,1,3,Low-Value,Lost
17956,12,16,"1182,6",5,3,2,10,High-Value,Champions
17959,21,7,"295,75",5,2,1,8,High-Value,Potential Loyalists
17960,434,7,"475,65",4,2,1,7,Mid-Value,Potential Loyalists
17961,544,4,"257,85",4,1,1,6,Mid-Value,Potential Loyalists
17962,1717,1,"17,9",1,1,1,3,Low-Value,Lost
17964,901,2,"67,15",3,1,1,5,Low-Value,At Risk Customers
17965,573,5,"253,1",4,1,1,6,Mid-Value,Potential Loyalists
17966,149,4,"288,85",5,1,1,7,Mid-Value,Potential Loyalists
17967,75,10,"441,2",5,2,1,8,High-Value,Potential Loyalists
17968,784,4,"277,8",3,1,1,5,Low-Value,At Risk Customers
17969,41,3,"183,45",5,1,1,7,Mid-Value,Potential Loyalists
17970,1650,1,"48,75",1,1,1,3,Low-Value,Lost
17971,376,1,"180,25",4,1,1,6,Mid-Value,Potential Loyalists
17972,1203,2,"30,35",2,1,1,4,Low-Value,Can't Lose
17974,1629,1,"133,0",1,1,1,3,Low-Value,Lost
17976,1326,1,"18,35",2,1,1,4,Low-Value,Can't Lose
17977,150,4,"420,3",5,1,1,7,Mid-Value,Potential Loyalists
17978,567,6,"518,3",4,1,1,6,Mid-Value,Potential Loyalists
17979,1218,4,"189,95",2,1,1,4,Low-Value,Can't Lose
17981,1152,4,"144,5",2,1,1,4,Low-Value,Can't Lose
17982,444,4,"213,85",4,1,1,6,Mid-Value,Potential Loyalists
17984,1060,2,"123,30000000000001",3,1,1,5,Low-Value,At Risk Customers
17986,495,1,"12,149999999999999",4,1,1,6,Mid-Value,Potential Loyalists
17987,858,3,"151,4",3,1,1,5,Low-Value,At Risk Customers
17988,1106,3,"251,29999999999998",2,1,1,4,Low-Value,Can't Lose
17990,892,3,"391,05",3,1,1,5,Low-Value,At Risk Customers
17992,242,4,"145,85",5,1,1,7,Mid-Value,Potential Loyalists
17994,585,5,"344,95",4,1,1,6,Mid-Value,Potential Loyalists
17995,1621,1,"14,0",1,1,1,3,Low-Value,Lost
17998,1492,1,"51,85",1,1,1,3,Low-Value,Lost
17999,1509,3,"28,950000000000003",1,1,1,3,Low-Value,Lost
18001,779,3,"77,9",3,1,1,5,Low-Value,At Risk Customers
18005,245,3,"86,64999999999999",5,1,1,7,Mid-Value,Potential Loyalists
18006,369,5,"128,15",4,1,1,6,Mid-Value,Potential Loyalists
18007,1009,3,"172,85",3,1,1,5,Low-Value,At Risk Customers
18008,1280,1,"51,9",2,1,1,4,Low-Value,Can't Lose
18010,605,4,"100,55",4,1,1,6,Mid-Value,Potential Loyalists
18011,74,4,"157,70000000000002",5,1,1,7,Mid-Value,Potential Loyalists
18012,91,6,"286,25",5,1,1,7,Mid-Value,Potential Loyalists
18013,242,9,"466,4",5,2,1,8,High-Value,Potential Loyalists
18014,444,2,"58,15",4,1,1,6,Mid-Value,Potential Loyalists
18015,192,2,"355,90000000000003",5,1,1,7,Mid-Value,Potential Loyalists
18016,1029,1,"7,3",3,1,1,5,Low-Value,At Risk Customers
18020,1155,1,"46,0",2,1,1,4,Low-Value,Can't Lose
18021,405,2,"301,0",4,1,1,6,Mid-Value,Potential Loyalists
18022,1505,2,"185,65",1,1,1,3,Low-Value,Lost
18025,348,2,"66,65",5,1,1,7,Mid-Value,Potential Loyalists
18027,1247,1,"205,79999999999998",2,1,1,4,Low-Value,Can't Lose
18028,1085,1,"5,75",3,1,1,5,Low-Value,At Risk Customers
18029,406,1,"31,35",4,1,1,6,Mid-Value,Potential Loyalists
18030,1491,1,"46,8",1,1,1,3,Low-Value,Lost
18031,560,4,"119,47999999999999",4,1,1,6,Mid-Value,Potential Loyalists
18032,90,5,"684,4",5,1,2,8,High-Value,Potential Loyalists
18033,89,8,"320,55",5,2,1,8,High-Value,Potential Loyalists
18034,560,2,"35,800000000000004",4,1,1,6,Mid-Value,Potential Loyalists
18036,789,6,"416,85",3,1,1,5,Low-Value,At Risk Customers
18037,511,5,"793,25",4,1,2,7,Mid-Value,Potential Loyalists
18038,618,3,"402,7",4,1,1,6,Mid-Value,Potential Loyalists
18039,388,4,"509,44999999999993",4,1,1,6,Mid-Value,Potential Loyalists
18041,66,4,"159,55",5,1,1,7,Mid-Value,Potential Loyalists
18043,293,8,"237,85000000000002",5,2,1,8,High-Value,Potential Loyalists
18044,521,1,"17,9",4,1,1,6,Mid-Value,Potential Loyalists
18048,32,3,"142,35",5,1,1,7,Mid-Value,Potential Loyalists
18050,41,3,"83,6",5,1,1,7,Mid-Value,Potential Loyalists
18051,550,1,"48,599999999999994",4,1,1,6,Mid-Value,Potential Loyalists
18053,552,1,"88,80000000000001",4,1,1,6,Mid-Value,Potential Loyalists
18055,530,2,"90,5",4,1,1,6,Mid-Value,Potential Loyalists
18056,546,4,"293,8",4,1,1,6,Mid-Value,Potential Loyalists
18057,408,5,"172,5",4,1,1,6,Mid-Value,Potential Loyalists
18060,114,5,"181,0",5,1,1,7,Mid-Value,Potential Loyalists
18061,1455,5,"305,8",2,1,1,4,Low-Value,Can't Lose
18062,1470,1,"112,2",1,1,1,3,Low-Value,Lost
18064,976,6,"284,18",3,1,1,5,Low-Value,At Risk Customers
18066,1489,4,"242,5",1,1,1,3,Low-Value,Lost
18067,35,3,"51,800000000000004",5,1,1,7,Mid-Value,Potential Loyalists
18068,125,3,"181,6",5,1,1,7,Mid-Value,Potential Loyalists
18071,737,4,"77,35000000000001",3,1,1,5,Low-Value,At Risk Customers
18072,9,4,"435,70000000000005",5,1,1,7,Mid-Value,Potential Loyalists
18073,51,5,"102,55",5,1,1,7,Mid-Value,Potential Loyalists
18074,919,1,"3,5",3,1,1,5,Low-Value,At Risk Customers
18076,881,1,"579,9",3,1,1,5,Low-Value,At Risk Customers
18077,460,3,"182,05",4,1,1,6,Mid-Value,Potential Loyalists
18078,47,6,"235,75",5,1,1,7,Mid-Value,Potential Loyalists
18079,25,3,"109,95",5,1,1,7,Mid-Value,Potential Loyalists
18080,182,4,"241,59999999999997",5,1,1,7,Mid-Value,Potential Loyalists
18083,353,3,"82,2",5,1,1,7,Mid-Value,Potential Loyalists
18084,27,5,"181,54999999999998",5,1,1,7,Mid-Value,Potential Loyalists
18086,855,3,"411,05",3,1,1,5,Low-Value,At Risk Customers
18087,208,2,"34,3",5,1,1,7,Mid-Value,Potential Loyalists
18089,258,1,"15,6",5,1,1,7,Mid-Value,Potential Loyalists
18090,1023,1,"11,6",3,1,1,5,Low-Value,At Risk Customers
18093,51,5,"310,04999999999995",5,1,1,7,Mid-Value,Potential Loyalists
18094,539,1,"24,6",4,1,1,6,Mid-Value,Potential Loyalists
18097,1348,2,"69,75",2,1,1,4,Low-Value,Can't Lose
18100,738,1,"42,3",3,1,1,5,Low-Value,At Risk Customers
18101,536,1,"80,55000000000001",4,1,1,6,Mid-Value,Potential Loyalists
18103,510,2,"233,29999999999998",4,1,1,6,Mid-Value,Potential Loyalists
18104,207,3,"236,7",5,1,1,7,Mid-Value,Potential Loyalists
18106,3,6,"385,05",5,1,1,7,Mid-Value,Potential Loyalists
18107,51,11,"627,85",5,2,1,8,High-Value,Potential Loyalists
18108,981,5,"86,65",3,1,1,5,Low-Value,At Risk Customers
18110,552,2,"106,9",4,1,1,6,Mid-Value,Potential Loyalists
18113,423,2,"124,4",4,1,1,6,Mid-Value,Potential Loyalists
18118,241,5,"151,85",5,1,1,7,Mid-Value,Potential Loyalists
18119,55,2,"47,099999999999994",5,1,1,7,Mid-Value,Potential Loyalists
18121,1690,1,"96,9",1,1,1,3,Low-Value,Lost
18122,1533,3,"96,6",1,1,1,3,Low-Value,Lost
18123,1398,1,"45,5",2,1,1,4,Low-Value,Can't Lose
18124,192,3,"217,45",5,1,1,7,Mid-Value,Potential Loyalists
18125,553,3,"285,85",4,1,1,6,Mid-Value,Potential Loyalists
18126,107,6,"534,0",5,1,1,7,Mid-Value,Potential Loyalists
18127,169,1,"155,7",5,1,1,7,Mid-Value,Potential Loyalists
18128,126,1,"18,8",5,1,1,7,Mid-Value,Potential Loyalists
18131,398,3,"162,45",4,1,1,6,Mid-Value,Potential Loyalists
18132,402,1,"9,7",4,1,1,6,Mid-Value,Potential Loyalists
18133,1716,1,"34,2",1,1,1,3,Low-Value,Lost
18135,132,1,"4,4",5,1,1,7,Mid-Value,Potential Loyalists
18137,10,11,"284,1",5,2,1,8,High-Value,Potential Loyalists
18139,913,4,"142,5",3,1,1,5,Low-Value,At Risk Customers
18141,35,2,"75,95",5,1,1,7,Mid-Value,Potential Loyalists
18145,742,6,"390,0",3,1,1,5,Low-Value,At Risk Customers
18146,373,1,"15,0",4,1,1,6,Mid-Value,Potential Loyalists
18147,235,2,"31,5",5,1,1,7,Mid-Value,Potential Loyalists
18153,921,1,"41,8",3,1,1,5,Low-Value,At Risk Customers
18154,448,5,"105,5",4,1,1,6,Mid-Value,Potential Loyalists
18155,1048,4,"417,35",3,1,1,5,Low-Value,At Risk Customers
18156,836,2,"102,6",3,1,1,5,Low-Value,At Risk Customers
18158,101,2,"41,7",5,1,1,7,Mid-Value,Potential Loyalists
18161,633,3,"112,55",4,1,1,6,Mid-Value,Potential Loyalists
18162,876,2,"70,15",3,1,1,5,Low-Value,At Risk Customers
18164,323,8,"424,1",5,2,1,8,High-Value,Potential Loyalists
18165,1298,2,"646,05",2,1,1,4,Low-Value,Can't Lose
18168,257,3,"141,5",5,1,1,7,Mid-Value,Potential Loyalists
18169,1347,2,"109,95",2,1,1,4,Low-Value,Can't Lose
18170,159,1,"30,8",5,1,1,7,Mid-Value,Potential Loyalists
18173,629,6,"228,75",4,1,1,6,Mid-Value,Potential Loyalists
18174,173,4,"295,25",5,1,1,7,Mid-Value,Potential Loyalists
18176,75,1,"6,55",5,1,1,7,Mid-Value,Potential Loyalists
18177,52,5,"124,05",5,1,1,7,Mid-Value,Potential Loyalists
18179,148,8,"280,09999999999997",5,2,1,8,High-Value,Potential Loyalists
18180,958,1,"40,4",3,1,1,5,Low-Value,At Risk Customers
18181,311,4,"588,6",5,1,1,7,Mid-Value,Potential Loyalists
18182,162,4,"220,8",5,1,1,7,Mid-Value,Potential Loyalists
18183,509,4,"384,8",4,1,1,6,Mid-Value,Potential Loyalists
18184,420,5,"196,0",4,1,1,6,Mid-Value,Potential Loyalists
18185,592,3,"200,25",4,1,1,6,Mid-Value,Potential Loyalists
18187,67,4,"102,19999999999999",5,1,1,7,Mid-Value,Potential Loyalists
18188,738,4,"489,95",3,1,1,5,Low-Value,At Risk Customers
18189,9,5,"223,10000000000002",5,1,1,7,Mid-Value,Potential Loyalists
18190,817,3,"161,64999999999998",3,1,1,5,Low-Value,At Risk Customers
18191,953,2,"17,35",3,1,1,5,Low-Value,At Risk Customers
18192,656,1,"34,35",4,1,1,6,Mid-Value,Potential Loyalists
18195,382,13,"645,5",4,3,1,8,High-Value,Potential Loyalists
18197,336,2,"20,55",5,1,1,7,Mid-Value,Potential Loyalists
18198,1400,2,"80,80000000000001",2,1,1,4,Low-Value,Can't Lose
18201,789,7,"133,2",3,2,1,6,Mid-Value,Potential Loyalists
18202,1526,1,"12,4",1,1,1,3,Low-Value,Lost
18203,12,11,"635,4",5,2,1,8,High-Value,Potential Loyalists
18206,1344,1,"48,1",2,1,1,4,Low-Value,Can't Lose
18208,474,5,"236,85",4,1,1,6,Mid-Value,Potential Loyalists
18212,17,1,"52,2",5,1,1,7,Mid-Value,Potential Loyalists
18213,1452,2,"248,39999999999998",2,1,1,4,Low-Value,Can't Lose
18217,543,2,"75,4",4,1,1,6,Mid-Value,Potential Loyalists
18219,34,5,"221,3",5,1,1,7,Mid-Value,Potential Loyalists
18220,1451,1,"20,05",2,1,1,4,Low-Value,Can't Lose
18222,69,4,"96,5",5,1,1,7,Mid-Value,Potential Loyalists
18223,286,7,"535,9",5,2,1,8,High-Value,Potential Loyalists
18225,276,5,"348,2",5,1,1,7,Mid-Value,Potential Loyalists
18226,882,1,"376,95000000000005",3,1,1,5,Low-Value,At Risk Customers
18229,271,3,"69,05",5,1,1,7,Mid-Value,Potential Loyalists
18230,696,2,"52,25",4,1,1,6,Mid-Value,Potential Loyalists
18231,32,5,"253,64999999999998",5,1,1,7,Mid-Value,Potential Loyalists
18232,61,6,"833,5",5,1,2,8,High-Value,Potential Loyalists
18233,1345,1,"84,9",2,1,1,4,Low-Value,Can't Lose
18234,480,2,"69,30000000000001",4,1,1,6,Mid-Value,Potential Loyalists
18235,144,5,"126,9",5,1,1,7,Mid-Value,Potential Loyalists
18236,63,3,"70,45",5,1,1,7,Mid-Value,Potential Loyalists
18237,859,2,"131,8",3,1,1,5,Low-Value,At Risk Customers
18238,1410,2,"111,9",2,1,1,4,Low-Value,Can't Lose
18239,97,5,"109,2",5,1,1,7,Mid-Value,Potential Loyalists
18240,11,2,"70,94999999999999",5,1,1,7,Mid-Value,Potential Loyalists
18241,862,2,"297,9",3,1,1,5,Low-Value,At Risk Customers
18243,1191,1,"49,15",2,1,1,4,Low-Value,Can't Lose
18245,388,1,"73,4",4,1,1,6,Mid-Value,Potential Loyalists
18248,1146,3,"175,75",2,1,1,4,Low-Value,Can't Lose
18250,248,7,"420,05",5,2,1,8,High-Value,Potential Loyalists
18251,99,2,"23,2",5,1,1,7,Mid-Value,Potential Loyalists
18252,252,7,"265,1",5,2,1,8,High-Value,Potential Loyalists
18253,939,1,"100,2",3,1,1,5,Low-Value,At Risk Customers
18255,395,4,"338,65",4,1,1,6,Mid-Value,Potential Loyalists
18257,18,5,"431,45",5,1,1,7,Mid-Value,Potential Loyalists
18258,273,3,"193,0",5,1,1,7,Mid-Value,Potential Loyalists
18259,87,5,"274,25",5,1,1,7,Mid-Value,Potential Loyalists
18260,49,3,"74,39999999999999",5,1,1,7,Mid-Value,Potential Loyalists
18261,41,5,"191,85000000000002",5,1,1,7,Mid-Value,Potential Loyalists
18263,684,2,"28,049999999999997",4,1,1,6,Mid-Value,Potential Loyalists
18264,1270,1,"62,8",2,1,1,4,Low-Value,Can't Lose
18265,1606,2,"177,45",1,1,1,3,Low-Value,Lost
18266,393,5,"444,7",4,1,1,6,Mid-Value,Potential Loyalists
18267,140,6,"593,85",5,1,1,7,Mid-Value,Potential Loyalists
18268,1468,2,"213,64999999999998",1,1,1,3,Low-Value,Lost
18269,454,7,"589,35",4,2,1,7,Mid-Value,Potential Loyalists
18270,87,7,"366,35",5,2,1,8,High-Value,Potential Loyalists
18271,76,7,"262,8",5,2,1,8,High-Value,Potential Loyalists
18273,241,4,"238,05",5,1,1,7,Mid-Value,Potential Loyalists
18274,5,1,"178,0",5,1,1,7,Mid-Value,Potential Loyalists
18276,1343,2,"75,30000000000001",2,1,1,4,Low-Value,Can't Lose
18278,124,3,"302,8",5,1,1,7,Mid-Value,Potential Loyalists
18279,191,8,"534,34",5,2,1,8,High-Value,Potential Loyalists
18280,1603,1,"38,9",1,1,1,3,Low-Value,Lost
18282,444,5,"171,75",4,1,1,6,Mid-Value,Potential Loyalists
18283,146,3,"123,85",5,1,1,7,Mid-Value,Potential Loyalists
18286,221,1,"102,2",5,1,1,7,Mid-Value,Potential Loyalists
18287,554,2,"364,45",4,1,1,6,Mid-Value,Potential Loyalists
18292,153,4,"315,2",5,1,1,7,Mid-Value,Potential Loyalists
18294,301,5,"275,95",5,1,1,7,Mid-Value,Potential Loyalists
18295,32,2,"122,1",5,1,1,7,Mid-Value,Potential Loyalists
18296,798,1,"250,7",3,1,1,5,Low-Value,At Risk Customers
18299,88,4,"218,64999999999998",5,1,1,7,Mid-Value,Potential Loyalists
18301,33,4,"255,8",5,1,1,7,Mid-Value,Potential Loyalists
18302,359,1,"26,3",5,1,1,7,Mid-Value,Potential Loyalists
18303,598,4,"159,7",4,1,1,6,Mid-Value,Potential Loyalists
18305,872,3,"357,1",3,1,1,5,Low-Value,At Risk Customers
18306,209,2,"251,1",5,1,1,7,Mid-Value,Potential Loyalists
18307,626,1,"7,5",4,1,1,6,Mid-Value,Potential Loyalists
18312,788,4,"122,4",3,1,1,5,Low-Value,At Risk Customers
18314,1573,1,"12,1",1,1,1,3,Low-Value,Lost
18315,15,2,"533,25",5,1,1,7,Mid-Value,Potential Loyalists
18318,767,4,"129,3",3,1,1,5,Low-Value,At Risk Customers
18320,1513,1,"22,25",1,1,1,3,Low-Value,Lost
18321,1535,1,"19,6",1,1,1,3,Low-Value,Lost
18322,546,3,"72,7",4,1,1,6,Mid-Value,Potential Loyalists
18323,823,5,"294,6",3,1,1,5,Low-Value,At Risk Customers
18326,734,1,"21,2",3,1,1,5,Low-Value,At Risk Customers
18327,579,1,"398,0",4,1,1,6,Mid-Value,Potential Loyalists
18328,1340,2,"524,1",2,1,1,4,Low-Value,Can't Lose
18329,580,1,"76,94999999999999",4,1,1,6,Mid-Value,Potential Loyalists
18330,502,5,"95,1",4,1,1,6,Mid-Value,Potential Loyalists
18331,117,4,"188,15000000000003",5,1,1,7,Mid-Value,Potential Loyalists
18334,1614,1,"13,35",1,1,1,3,Low-Value,Lost
18335,1778,1,"21,3",1,1,1,3,Low-Value,Lost
18336,35,11,"724,66",5,2,2,9,High-Value,Champions
18337,381,3,"346,4",4,1,1,6,Mid-Value,Potential Loyalists
18338,451,4,"96,3",4,1,1,6,Mid-Value,Potential Loyalists
18339,449,3,"148,14999999999998",4,1,1,6,Mid-Value,Potential Loyalists
18340,10,3,"62,05",5,1,1,7,Mid-Value,Potential Loyalists
18341,914,1,"203,39999999999998",3,1,1,5,Low-Value,At Risk Customers
18343,88,2,"49,199999999999996",5,1,1,7,Mid-Value,Potential Loyalists
18346,1004,2,"191,95",3,1,1,5,Low-Value,At Risk Customers
18347,77,3,"122,95",5,1,1,7,Mid-Value,Potential Loyalists
18349,5,1,"18,9",5,1,1,7,Mid-Value,Potential Loyalists
18351,1151,7,"102,58",2,2,1,5,Low-Value,At Risk Customers
18352,142,3,"46,0",5,1,1,7,Mid-Value,Potential Loyalists
18353,1337,1,"69,9",2,1,1,4,Low-Value,Can't Lose
18355,144,3,"129,4",5,1,1,7,Mid-Value,Potential Loyalists
18356,34,7,"262,25",5,2,1,8,High-Value,Potential Loyalists
18361,601,6,"495,8",4,1,1,6,Mid-Value,Potential Loyalists
18363,1156,3,"281,4",2,1,1,4,Low-Value,Can't Lose
18367,1693,2,"29,15",1,1,1,3,Low-Value,Lost
18369,127,6,"178,1",5,1,1,7,Mid-Value,Potential Loyalists
18370,409,1,"8,1",4,1,1,6,Mid-Value,Potential Loyalists
18372,64,9,"1022,9",5,2,2,9,High-Value,Champions
18375,206,3,"115,15",5,1,1,7,Mid-Value,Potential Loyalists
18376,246,3,"239,1",5,1,1,7,Mid-Value,Potential Loyalists
18379,1417,2,"53,949999999999996",2,1,1,4,Low-Value,Can't Lose
18380,228,1,"24,1",5,1,1,7,Mid-Value,Potential Loyalists
18381,1342,1,"49,35",2,1,1,4,Low-Value,Can't Lose
18382,1542,1,"22,25",1,1,1,3,Low-Value,Lost
18384,8,5,"318,0",5,1,1,7,Mid-Value,Potential Loyalists
18385,25,7,"428,0",5,2,1,8,High-Value,Potential Loyalists
18386,140,2,"228,05",5,1,1,7,Mid-Value,Potential Loyalists
18387,1630,1,"96,75",1,1,1,3,Low-Value,Lost
18389,35,4,"288,09999999999997",5,1,1,7,Mid-Value,Potential Loyalists
18391,1049,3,"95,55",3,1,1,5,Low-Value,At Risk Customers
18392,534,4,"170,4",4,1,1,6,Mid-Value,Potential Loyalists
18393,167,11,"607,0",5,2,1,8,High-Value,Potential Loyalists
18396,421,3,"87,0",4,1,1,6,Mid-Value,Potential Loyalists
18397,29,4,"355,3",5,1,1,7,Mid-Value,Potential Loyalists
18398,781,3,"691,55",3,1,2,6,Mid-Value,Potential Loyalists
18399,223,5,"391,54999999999995",5,1,1,7,Mid-Value,Potential Loyalists
18401,81,2,"863,75",5,1,2,8,High-Value,Potential Loyalists
18402,613,1,"50,4",4,1,1,6,Mid-Value,Potential Loyalists
18403,1694,1,"10,9",1,1,1,3,Low-Value,Lost
18404,183,2,"71,7",5,1,1,7,Mid-Value,Potential Loyalists
18405,1716,1,"32,3",1,1,1,3,Low-Value,Lost
18406,731,1,"23,6",3,1,1,5,Low-Value,At Risk Customers
18411,407,3,"191,55",4,1,1,6,Mid-Value,Potential Loyalists
18412,492,9,"892,9",4,2,2,8,High-Value,Potential Loyalists
18413,188,1,"51,900000000000006",5,1,1,7,Mid-Value,Potential Loyalists
18414,117,1,"20,9",5,1,1,7,Mid-Value,Potential Loyalists
18416,1075,2,"146,75",3,1,1,5,Low-Value,At Risk Customers
18420,475,4,"191,31",4,1,1,6,Mid-Value,Potential Loyalists
18421,156,1,"60,5",5,1,1,7,Mid-Value,Potential Loyalists
18422,620,5,"143,25",4,1,1,6,Mid-Value,Potential Loyalists
18423,762,3,"348,95",3,1,1,5,Low-Value,At Risk Customers
18424,1252,2,"134,1",2,1,1,4,Low-Value,Can't Lose
18425,814,2,"288,85",3,1,1,5,Low-Value,At Risk Customers
18426,1512,3,"60,8",1,1,1,3,Low-Value,Lost
18428,768,1,"36,75",3,1,1,5,Low-Value,At Risk Customers
18429,71,1,"14,0",5,1,1,7,Mid-Value,Potential Loyalists
18431,8,4,"327,7",5,1,1,7,Mid-Value,Potential Loyalists
18432,1771,2,"31,9",1,1,1,3,Low-Value,Lost
18433,1016,1,"44,6",3,1,1,5,Low-Value,At Risk Customers
18434,1112,3,"340,34999999999997",2,1,1,4,Low-Value,Can't Lose
18436,227,9,"564,65",5,2,1,8,High-Value,Potential Loyalists
18440,1488,2,"32,699999999999996",1,1,1,3,Low-Value,Lost
18443,767,1,"58,6",3,1,1,5,Low-Value,At Risk Customers
18445,167,2,"61,43000000000001",5,1,1,7,Mid-Value,Potential Loyalists
18446,16,3,"159,6",5,1,1,7,Mid-Value,Potential Loyalists
18447,795,3,"46,0",3,1,1,5,Low-Value,At Risk Customers
18448,681,1,"24,8",4,1,1,6,Mid-Value,Potential Loyalists
18451,404,3,"159,45",4,1,1,6,Mid-Value,Potential Loyalists
18453,40,6,"351,1",5,1,1,7,Mid-Value,Potential Loyalists
18454,935,4,"298,4",3,1,1,5,Low-Value,At Risk Customers
18456,1472,3,"563,55",1,1,1,3,Low-Value,Lost
18458,922,4,"208,45",3,1,1,5,Low-Value,At Risk Customers
18459,363,2,"31,35",5,1,1,7,Mid-Value,Potential Loyalists
18462,798,1,"12,2",3,1,1,5,Low-Value,At Risk Customers
18463,879,1,"46,6",3,1,1,5,Low-Value,At Risk Customers
18465,195,2,"55,7",5,1,1,7,Mid-Value,Potential Loyalists
18471,8,3,"179,9",5,1,1,7,Mid-Value,Potential Loyalists
18472,788,2,"37,1",3,1,1,5,Low-Value,At Risk Customers
18476,1436,3,"41,3",2,1,1,4,Low-Value,Can't Lose
18477,258,6,"216,65000000000003",5,1,1,7,Mid-Value,Potential Loyalists
18478,700,6,"1123,5",4,1,2,7,Mid-Value,Potential Loyalists
18479,1365,1,"29,2",2,1,1,4,Low-Value,Can't Lose
18480,879,1,"115,80000000000001",3,1,1,5,Low-Value,At Risk Customers
18482,214,4,"88,75",5,1,1,7,Mid-Value,Potential Loyalists
18483,34,2,"305,1",5,1,1,7,Mid-Value,Potential Loyalists
18484,1170,2,"41,5",2,1,1,4,Low-Value,Can't Lose
18485,389,4,"615,65",4,1,1,6,Mid-Value,Potential Loyalists
18486,767,2,"15,85",3,1,1,5,Low-Value,At Risk Customers
18488,591,4,"166,75",4,1,1,6,Mid-Value,Potential Loyalists
18489,123,1,"4,55",5,1,1,7,Mid-Value,Potential Loyalists
18491,611,2,"56,45",4,1,1,6,Mid-Value,Potential Loyalists
18494,59,5,"240,6",5,1,1,7,Mid-Value,Potential Loyalists
18495,172,1,"133,0",5,1,1,7,Mid-Value,Potential Loyalists
18496,45,4,"154,9",5,1,1,7,Mid-Value,Potential Loyalists
18497,113,2,"128,5",5,1,1,7,Mid-Value,Potential Loyalists
18498,1323,2,"33,05",2,1,1,4,Low-Value,Can't Lose
18500,552,1,"47,4",4,1,1,6,Mid-Value,Potential Loyalists
18502,1109,1,"40,65",2,1,1,4,Low-Value,Can't Lose
18503,56,7,"373,2",5,2,1,8,High-Value,Potential Loyalists
18506,886,4,"444,95",3,1,1,5,Low-Value,At Risk Customers
18507,327,1,"47,25",5,1,1,7,Mid-Value,Potential Loyalists
18508,442,2,"46,55",4,1,1,6,Mid-Value,Potential Loyalists
18511,172,3,"93,39999999999999",5,1,1,7,Mid-Value,Potential Loyalists
18512,7,2,"20,0",5,1,1,7,Mid-Value,Potential Loyalists
18513,178,2,"1142,35",5,1,2,8,High-Value,Potential Loyalists
18514,345,2,"61,6",5,1,1,7,Mid-Value,Potential Loyalists
18517,103,5,"385,65000000000003",5,1,1,7,Mid-Value,Potential Loyalists
18518,923,2,"243,1",3,1,1,5,Low-Value,At Risk Customers
18519,482,1,"131,65",4,1,1,6,Mid-Value,Potential Loyalists
18520,249,4,"134,4",5,1,1,7,Mid-Value,Potential Loyalists
18521,145,1,"57,75",5,1,1,7,Mid-Value,Potential Loyalists
18522,584,2,"471,95",4,1,1,6,Mid-Value,Potential Loyalists
18523,9,2,"494,2",5,1,1,7,Mid-Value,Potential Loyalists
18524,22,9,"442,4",5,2,1,8,High-Value,Potential Loyalists
18525,1634,1,"36,35",1,1,1,3,Low-Value,Lost
18529,188,1,"129,45",5,1,1,7,Mid-Value,Potential Loyalists
18530,90,8,"471,75",5,2,1,8,High-Value,Potential Loyalists
18531,387,1,"3,5",4,1,1,6,Mid-Value,Potential Loyalists
18532,365,2,"582,1",5,1,1,7,Mid-Value,Potential Loyalists
18534,1386,2,"46,65",2,1,1,4,Low-Value,Can't Lose
18535,491,1,"59,3",4,1,1,6,Mid-Value,Potential Loyalists
18537,894,2,"33,15",3,1,1,5,Low-Value,At Risk Customers
18538,1238,1,"96,0",2,1,1,4,Low-Value,Can't Lose
18540,370,5,"347,3",4,1,1,6,Mid-Value,Potential Loyalists
18541,1268,1,"1460,8",2,1,3,6,Mid-Value,Potential Loyalists
18543,535,5,"388,8",4,1,1,6,Mid-Value,Potential Loyalists
18544,557,3,"200,0",4,1,1,6,Mid-Value,Potential Loyalists
18545,41,7,"192,4",5,2,1,8,High-Value,Potential Loyalists
18549,1278,3,"383,95000000000005",2,1,1,4,Low-Value,Can't Lose
18550,619,3,"203,85000000000002",4,1,1,6,Mid-Value,Potential Loyalists
18551,931,3,"87,25",3,1,1,5,Low-Value,At Risk Customers
18552,248,3,"70,95",5,1,1,7,Mid-Value,Potential Loyalists
18555,152,1,"19,0",5,1,1,7,Mid-Value,Potential Loyalists
18558,295,5,"169,65",5,1,1,7,Mid-Value,Potential Loyalists
18560,1560,1,"60,75",1,1,1,3,Low-Value,Lost
18562,52,2,"141,8",5,1,1,7,Mid-Value,Potential Loyalists
18567,260,3,"133,65",5,1,1,7,Mid-Value,Potential Loyalists
18568,1546,2,"125,7",1,1,1,3,Low-Value,Lost
18569,517,2,"453,5",4,1,1,6,Mid-Value,Potential Loyalists
18573,199,6,"336,75",5,1,1,7,Mid-Value,Potential Loyalists
18574,505,2,"125,9",4,1,1,6,Mid-Value,Potential Loyalists
18575,301,2,"79,8",5,1,1,7,Mid-Value,Potential Loyalists
18576,62,6,"609,8",5,1,1,7,Mid-Value,Potential Loyalists
18577,1138,3,"82,3",2,1,1,4,Low-Value,Can't Lose
18579,300,4,"338,6",5,1,1,7,Mid-Value,Potential Loyalists
18580,1560,1,"10,55",1,1,1,3,Low-Value,Lost
18585,696,3,"492,35",4,1,1,6,Mid-Value,Potential Loyalists
18586,14,7,"348,5",5,2,1,8,High-Value,Potential Loyalists
18588,280,4,"148,45",5,1,1,7,Mid-Value,Potential Loyalists
18589,705,2,"52,800000000000004",4,1,1,6,Mid-Value,Potential Loyalists
18590,770,5,"149,05",3,1,1,5,Low-Value,At Risk Customers
18593,869,4,"389,4",3,1,1,5,Low-Value,At Risk Customers
18595,504,2,"341,7",4,1,1,6,Mid-Value,Potential Loyalists
18596,866,4,"196,3",3,1,1,5,Low-Value,At Risk Customers
18597,1057,1,"199,0",3,1,1,5,Low-Value,At Risk Customers
18599,540,2,"106,30000000000001",4,1,1,6,Mid-Value,Potential Loyalists
18600,906,1,"168,6",3,1,1,5,Low-Value,At Risk Customers
18601,425,2,"151,45",4,1,1,6,Mid-Value,Potential Loyalists
18602,476,4,"223,4",4,1,1,6,Mid-Value,Potential Loyalists
18603,110,5,"256,0",5,1,1,7,Mid-Value,Potential Loyalists
18606,34,3,"199,0",5,1,1,7,Mid-Value,Potential Loyalists
18609,773,4,"80,85",3,1,1,5,Low-Value,At Risk Customers
18610,54,3,"281,25",5,1,1,7,Mid-Value,Potential Loyalists
18611,411,11,"766,3",4,2,2,8,High-Value,Potential Loyalists
18612,707,3,"45,849999999999994",4,1,1,6,Mid-Value,Potential Loyalists
18613,27,6,"1065,45",5,1,2,8,High-Value,Potential Loyalists
18615,14,7,"294,1",5,2,1,8,High-Value,Potential Loyalists
18617,14,1,"46,1",5,1,1,7,Mid-Value,Potential Loyalists
18620,668,4,"167,35",4,1,1,6,Mid-Value,Potential Loyalists
18621,88,3,"68,2",5,1,1,7,Mid-Value,Potential Loyalists
18622,114,2,"61,9",5,1,1,7,Mid-Value,Potential Loyalists
18623,56,1,"156,3",5,1,1,7,Mid-Value,Potential Loyalists
18627,61,9,"755,5",5,2,2,9,High-Value,Champions
18628,162,2,"77,85",5,1,1,7,Mid-Value,Potential Loyalists
18630,561,6,"772,0",4,1,2,7,Mid-Value,Potential Loyalists
18633,58,3,"204,54999999999998",5,1,1,7,Mid-Value,Potential Loyalists
18634,319,1,"19,75",5,1,1,7,Mid-Value,Potential Loyalists
18635,14,4,"214,0",5,1,1,7,Mid-Value,Potential Loyalists
18636,1364,2,"60,8",2,1,1,4,Low-Value,Can't Lose
18640,313,2,"22,9",5,1,1,7,Mid-Value,Potential Loyalists
18641,845,2,"80,0",3,1,1,5,Low-Value,At Risk Customers
18642,379,2,"238,5",4,1,1,6,Mid-Value,Potential Loyalists
18644,382,4,"215,35",4,1,1,6,Mid-Value,Potential Loyalists
18645,62,5,"304,15",5,1,1,7,Mid-Value,Potential Loyalists
18648,37,1,"136,4",5,1,1,7,Mid-Value,Potential Loyalists
18650,132,5,"270,1",5,1,1,7,Mid-Value,Potential Loyalists
18651,213,1,"46,9",5,1,1,7,Mid-Value,Potential Loyalists
18653,839,2,"80,7",3,1,1,5,Low-Value,At Risk Customers
18655,227,8,"782,85",5,2,2,9,High-Value,Champions
18657,95,4,"1676,15",5,1,3,9,High-Value,Champions
18659,695,2,"125,05",4,1,1,6,Mid-Value,Potential Loyalists
18660,742,2,"411,34999999999997",3,1,1,5,Low-Value,At Risk Customers
18661,385,5,"497,54999999999995",4,1,1,6,Mid-Value,Potential Loyalists
18663,1106,2,"24,8",2,1,1,4,Low-Value,Can't Lose
18664,162,5,"365,95",5,1,1,7,Mid-Value,Potential Loyalists
18665,1123,1,"237,0",2,1,1,4,Low-Value,Can't Lose
18667,388,3,"222,64999999999998",4,1,1,6,Mid-Value,Potential Loyalists
18668,75,2,"358,2",5,1,1,7,Mid-Value,Potential Loyalists
18671,940,1,"945,0",3,1,2,6,Mid-Value,Potential Loyalists
18672,540,2,"106,15",4,1,1,6,Mid-Value,Potential Loyalists
18674,820,3,"146,95",3,1,1,5,Low-Value,At Risk Customers
18675,424,3,"273,7",4,1,1,6,Mid-Value,Potential Loyalists
18676,1025,2,"88,9",3,1,1,5,Low-Value,At Risk Customers
18677,1134,3,"120,6",2,1,1,4,Low-Value,Can't Lose
18679,770,4,"118,3",3,1,1,5,Low-Value,At Risk Customers
18681,384,7,"478,05",4,2,1,7,Mid-Value,Potential Loyalists
18682,400,3,"158,1",4,1,1,6,Mid-Value,Potential Loyalists
18683,220,1,"29,3",5,1,1,7,Mid-Value,Potential Loyalists
18684,1229,2,"388,70000000000005",2,1,1,4,Low-Value,Can't Lose
18687,6,2,"61,15",5,1,1,7,Mid-Value,Potential Loyalists
18689,536,4,"259,5",4,1,1,6,Mid-Value,Potential Loyalists
18690,73,2,"56,65",5,1,1,7,Mid-Value,Potential Loyalists
18691,278,2,"46,6",5,1,1,7,Mid-Value,Potential Loyalists
18692,84,4,"143,95",5,1,1,7,Mid-Value,Potential Loyalists
18694,1462,1,"171,0",1,1,1,3,Low-Value,Lost
18695,850,4,"226,35000000000002",3,1,1,5,Low-Value,At Risk Customers
18696,13,9,"222,45",5,2,1,8,High-Value,Potential Loyalists
18697,865,6,"191,7",3,1,1,5,Low-Value,At Risk Customers
18698,421,4,"154,65",4,1,1,6,Mid-Value,Potential Loyalists
18699,698,2,"300,40000000000003",4,1,1,6,Mid-Value,Potential Loyalists
18701,908,3,"219,75000000000003",3,1,1,5,Low-Value,At Risk Customers
18708,865,3,"253,39999999999998",3,1,1,5,Low-Value,At Risk Customers
18710,460,6,"770,9",4,1,2,7,Mid-Value,Potential Loyalists
18712,7,6,"313,1",5,1,1,7,Mid-Value,Potential Loyalists
18713,738,3,"335,3",3,1,1,5,Low-Value,At Risk Customers
18715,812,5,"345,45",3,1,1,5,Low-Value,At Risk Customers
18717,236,1,"18,35",5,1,1,7,Mid-Value,Potential Loyalists
18718,108,10,"1111,9",5,2,2,9,High-Value,Champions
18720,1573,1,"20,6",1,1,1,3,Low-Value,Lost
18722,82,11,"722,6",5,2,2,9,High-Value,Champions
18724,19,4,"83,69999999999999",5,1,1,7,Mid-Value,Potential Loyalists
18725,1355,1,"53,65",2,1,1,4,Low-Value,Can't Lose
18726,439,1,"21,5",4,1,1,6,Mid-Value,Potential Loyalists
18727,696,1,"416,8",4,1,1,6,Mid-Value,Potential Loyalists
18730,337,4,"254,79999999999998",5,1,1,7,Mid-Value,Potential Loyalists
18731,160,4,"186,25",5,1,1,7,Mid-Value,Potential Loyalists
18733,353,5,"274,8",5,1,1,7,Mid-Value,Potential Loyalists
18734,132,2,"217,65000000000003",5,1,1,7,Mid-Value,Potential Loyalists
18735,893,3,"503,5",3,1,1,5,Low-Value,At Risk Customers
18736,118,1,"5,85",5,1,1,7,Mid-Value,Potential Loyalists
18737,430,4,"287,65000000000003",4,1,1,6,Mid-Value,Potential Loyalists
18738,488,5,"197,55",4,1,1,6,Mid-Value,Potential Loyalists
18739,1782,1,"41,85",1,1,1,3,Low-Value,Lost
18740,1404,1,"23,8",2,1,1,4,Low-Value,Can't Lose
18743,18,6,"576,35",5,1,1,7,Mid-Value,Potential Loyalists
18744,125,7,"242,15",5,2,1,8,High-Value,Potential Loyalists
18745,769,2,"213,1",3,1,1,5,Low-Value,At Risk Customers
18747,1716,1,"13,45",1,1,1,3,Low-Value,Lost
18748,42,12,"700,75",5,3,2,10,High-Value,Champions
18749,145,4,"290,3",5,1,1,7,Mid-Value,Potential Loyalists
18750,422,1,"31,6",4,1,1,6,Mid-Value,Potential Loyalists
18752,1023,3,"193,15",3,1,1,5,Low-Value,At Risk Customers
18753,132,5,"319,25",5,1,1,7,Mid-Value,Potential Loyalists
18754,248,4,"155,25",5,1,1,7,Mid-Value,Potential Loyalists
18756,366,9,"321,0",4,2,1,7,Mid-Value,Potential Loyalists
18758,378,5,"271,25",4,1,1,6,Mid-Value,Potential Loyalists
18760,174,2,"610,95",5,1,1,7,Mid-Value,Potential Loyalists
18761,192,3,"227,45",5,1,1,7,Mid-Value,Potential Loyalists
18762,1667,1,"314,0",1,1,1,3,Low-Value,Lost
18763,413,6,"309,4",4,1,1,6,Mid-Value,Potential Loyalists
18764,133,14,"621,95",5,3,1,9,High-Value,Champions
18765,89,2,"76,80000000000001",5,1,1,7,Mid-Value,Potential Loyalists
18766,63,4,"156,0",5,1,1,7,Mid-Value,Potential Loyalists
18769,1592,1,"165,7",1,1,1,3,Low-Value,Lost
18770,30,9,"535,8000000000001",5,2,1,8,High-Value,Potential Loyalists
18771,788,2,"150,7",3,1,1,5,Low-Value,At Risk Customers
18772,1189,1,"86,3",2,1,1,4,Low-Value,Can't Lose
18774,148,6,"299,45",5,1,1,7,Mid-Value,Potential Loyalists
18775,507,2,"100,35",4,1,1,6,Mid-Value,Potential Loyalists
18777,85,6,"127,9",5,1,1,7,Mid-Value,Potential Loyalists
18778,53,2,"59,1",5,1,1,7,Mid-Value,Potential Loyalists
18779,866,3,"142,1",3,1,1,5,Low-Value,At Risk Customers
18780,34,13,"1081,5",5,3,2,10,High-Value,Champions
18782,1762,1,"14,85",1,1,1,3,Low-Value,Lost
18784,582,4,"212,54999999999998",4,1,1,6,Mid-Value,Potential Loyalists
18785,1107,5,"295,15000000000003",2,1,1,4,Low-Value,Can't Lose
18786,131,4,"145,9",5,1,1,7,Mid-Value,Potential Loyalists
18787,341,4,"621,6",5,1,1,7,Mid-Value,Potential Loyalists
18789,61,3,"46,599999999999994",5,1,1,7,Mid-Value,Potential Loyalists
18792,2,1,"90,7",5,1,1,7,Mid-Value,Potential Loyalists
18793,418,5,"497,95",4,1,1,6,Mid-Value,Potential Loyalists
18794,579,7,"292,25",4,2,1,7,Mid-Value,Potential Loyalists
18797,18,16,"1274,7",5,3,2,10,High-Value,Champions
18798,587,1,"23,85",4,1,1,6,Mid-Value,Potential Loyalists
18799,1393,2,"98,19999999999999",2,1,1,4,Low-Value,Can't Lose
18800,1286,2,"116,45",2,1,1,4,Low-Value,Can't Lose
18802,140,5,"267,8",5,1,1,7,Mid-Value,Potential Loyalists
18804,51,5,"715,6500000000001",5,1,2,8,High-Value,Potential Loyalists
18806,556,2,"118,44999999999999",4,1,1,6,Mid-Value,Potential Loyalists
18812,1407,1,"9,8",2,1,1,4,Low-Value,Can't Lose
18814,316,3,"73,1",5,1,1,7,Mid-Value,Potential Loyalists
18815,130,4,"285,6",5,1,1,7,Mid-Value,Potential Loyalists
18816,882,1,"56,7",3,1,1,5,Low-Value,At Risk Customers
18817,313,4,"517,5",5,1,1,7,Mid-Value,Potential Loyalists
18818,25,4,"309,7",5,1,1,7,Mid-Value,Potential Loyalists
18821,529,5,"241,8",4,1,1,6,Mid-Value,Potential Loyalists
18822,692,3,"72,05",4,1,1,6,Mid-Value,Potential Loyalists
18823,1378,1,"29,1",2,1,1,4,Low-Value,Can't Lose
18825,1100,2,"22,4",2,1,1,4,Low-Value,Can't Lose
18827,1163,2,"209,3",2,1,1,4,Low-Value,Can't Lose
18828,329,2,"4,45",5,1,1,7,Mid-Value,Potential Loyalists
18829,418,1,"69,6",4,1,1,6,Mid-Value,Potential Loyalists
18830,110,3,"217,45",5,1,1,7,Mid-Value,Potential Loyalists
18832,871,1,"38,099999999999994",3,1,1,5,Low-Value,At Risk Customers
18833,1537,1,"57,85",1,1,1,3,Low-Value,Lost
18834,357,3,"84,7",5,1,1,7,Mid-Value,Potential Loyalists
18837,407,2,"44,9",4,1,1,6,Mid-Value,Potential Loyalists
18838,73,7,"330,25",5,2,1,8,High-Value,Potential Loyalists
18840,7,17,"1923,3000000000002",5,4,3,12,High-Value,Champions
18841,152,5,"281,85",5,1,1,7,Mid-Value,Potential Loyalists
18843,372,2,"251,2",4,1,1,6,Mid-Value,Potential Loyalists
18845,47,5,"115,95",5,1,1,7,Mid-Value,Potential Loyalists
18846,365,2,"123,6",5,1,1,7,Mid-Value,Potential Loyalists
18847,111,4,"144,25",5,1,1,7,Mid-Value,Potential Loyalists
18851,340,1,"16,2",5,1,1,7,Mid-Value,Potential Loyalists
18853,1453,1,"254,4",2,1,1,4,Low-Value,Can't Lose
18854,410,2,"35,2",4,1,1,6,Mid-Value,Potential Loyalists
18855,1517,3,"226,0",1,1,1,3,Low-Value,Lost
18856,609,2,"29,150000000000002",4,1,1,6,Mid-Value,Potential Loyalists
18859,161,6,"511,05",5,1,1,7,Mid-Value,Potential Loyalists
18860,1506,1,"29,05",1,1,1,3,Low-Value,Lost
18862,434,2,"10,75",4,1,1,6,Mid-Value,Potential Loyalists
18863,665,2,"100,5",4,1,1,6,Mid-Value,Potential Loyalists
18865,285,3,"121,65",5,1,1,7,Mid-Value,Potential Loyalists
18866,735,4,"218,45000000000002",3,1,1,5,Low-Value,At Risk Customers
18867,1,7,"224,60000000000002",5,2,1,8,High-Value,Potential Loyalists
18868,60,5,"211,0",5,1,1,7,Mid-Value,Potential Loyalists
18869,19,9,"527,75",5,2,1,8,High-Value,Potential Loyalists
18872,31,10,"636,5",5,2,1,8,High-Value,Potential Loyalists
18877,362,7,"282,3",5,2,1,8,High-Value,Potential Loyalists
18878,825,4,"187,05",3,1,1,5,Low-Value,At Risk Customers
18880,1335,1,"16,15",2,1,1,4,Low-Value,Can't Lose
18881,1245,1,"36,1",2,1,1,4,Low-Value,Can't Lose
18883,229,6,"525,8",5,1,1,7,Mid-Value,Potential Loyalists
18884,547,10,"648,5999999999999",4,2,1,7,Mid-Value,Potential Loyalists
18885,172,1,"51,9",5,1,1,7,Mid-Value,Potential Loyalists
18886,367,4,"219,29999999999998",4,1,1,6,Mid-Value,Potential Loyalists
18887,772,3,"98,1",3,1,1,5,Low-Value,At Risk Customers
18889,1299,3,"304,25",2,1,1,4,Low-Value,Can't Lose
18890,935,3,"43,0",3,1,1,5,Low-Value,At Risk Customers
18893,219,2,"83,8",5,1,1,7,Mid-Value,Potential Loyalists
18895,230,2,"114,6",5,1,1,7,Mid-Value,Potential Loyalists
18896,344,3,"92,65",5,1,1,7,Mid-Value,Potential Loyalists
18897,473,2,"196,8",4,1,1,6,Mid-Value,Potential Loyalists
18898,1039,2,"105,2",3,1,1,5,Low-Value,At Risk Customers
18900,15,1,"18,6",5,1,1,7,Mid-Value,Potential Loyalists
18904,1344,1,"109,1",2,1,1,4,Low-Value,Can't Lose
18905,152,5,"1583,5",5,1,3,9,High-Value,Champions
18906,114,2,"30,55",5,1,1,7,Mid-Value,Potential Loyalists
18907,127,7,"712,25",5,2,2,9,High-Value,Champions
18909,1462,1,"153,6",1,1,1,3,Low-Value,Lost
18910,1250,1,"36,7",2,1,1,4,Low-Value,Can't Lose
18911,677,4,"239,65",4,1,1,6,Mid-Value,Potential Loyalists
18912,799,2,"40,55",3,1,1,5,Low-Value,At Risk Customers
18913,297,1,"12,3",5,1,1,7,Mid-Value,Potential Loyalists
18914,12,11,"393,1",5,2,1,8,High-Value,Potential Loyalists
18918,1049,4,"273,7",3,1,1,5,Low-Value,At Risk Customers
18920,61,3,"170,39999999999998",5,1,1,7,Mid-Value,Potential Loyalists
18921,1137,1,"125,15",2,1,1,4,Low-Value,Can't Lose
18923,497,5,"135,75",4,1,1,6,Mid-Value,Potential Loyalists
18927,329,3,"162,05",5,1,1,7,Mid-Value,Potential Loyalists
18929,823,3,"386,4",3,1,1,5,Low-Value,At Risk Customers
18931,419,6,"330,85",4,1,1,6,Mid-Value,Potential Loyalists
18933,649,1,"55,5",4,1,1,6,Mid-Value,Potential Loyalists
18934,1070,2,"29,05",3,1,1,5,Low-Value,At Risk Customers
18935,963,2,"305,34999999999997",3,1,1,5,Low-Value,At Risk Customers
18937,796,1,"113,25",3,1,1,5,Low-Value,At Risk Customers
18939,714,3,"107,5",4,1,1,6,Mid-Value,Potential Loyalists
18940,144,4,"324,55",5,1,1,7,Mid-Value,Potential Loyalists
18943,186,11,"504,55",5,2,1,8,High-Value,Potential Loyalists
18945,476,3,"61,95",4,1,1,6,Mid-Value,Potential Loyalists
18946,60,5,"638,05",5,1,1,7,Mid-Value,Potential Loyalists
18947,538,2,"133,15",4,1,1,6,Mid-Value,Potential Loyalists
18948,1292,1,"158,0",2,1,1,4,Low-Value,Can't Lose
18949,739,1,"196,7",3,1,1,5,Low-Value,At Risk Customers
18950,749,6,"329,95",3,1,1,5,Low-Value,At Risk Customers
18951,43,2,"98,30000000000001",5,1,1,7,Mid-Value,Potential Loyalists
18952,735,5,"718,6",3,1,2,6,Mid-Value,Potential Loyalists
18955,812,2,"53,9",3,1,1,5,Low-Value,At Risk Customers
18957,654,1,"3,3",4,1,1,6,Mid-Value,Potential Loyalists
18958,503,4,"189,95",4,1,1,6,Mid-Value,Potential Loyalists
18959,1034,1,"26,15",3,1,1,5,Low-Value,At Risk Customers
18960,1134,2,"460,85",2,1,1,4,Low-Value,Can't Lose
18961,14,2,"70,6",5,1,1,7,Mid-Value,Potential Loyalists
18962,766,1,"71,55",3,1,1,5,Low-Value,At Risk Customers
18963,1186,4,"232,35",2,1,1,4,Low-Value,Can't Lose
18964,327,2,"100,7",5,1,1,7,Mid-Value,Potential Loyalists
18966,1299,3,"219,14999999999998",2,1,1,4,Low-Value,Can't Lose
18968,50,3,"170,9",5,1,1,7,Mid-Value,Potential Loyalists
18969,11,7,"753,6",5,2,2,9,High-Value,Champions
18971,897,1,"5,2",3,1,1,5,Low-Value,At Risk Customers
18973,783,3,"224,85000000000002",3,1,1,5,Low-Value,At Risk Customers
18974,36,4,"267,84999999999997",5,1,1,7,Mid-Value,Potential Loyalists
18975,760,3,"68,7",3,1,1,5,Low-Value,At Risk Customers
18978,691,3,"61,0",4,1,1,6,Mid-Value,Potential Loyalists
18979,857,1,"34,0",3,1,1,5,Low-Value,At Risk Customers
18981,94,3,"75,7",5,1,1,7,Mid-Value,Potential Loyalists
18982,93,2,"102,94999999999999",5,1,1,7,Mid-Value,Potential Loyalists
18983,1642,1,"24,8",1,1,1,3,Low-Value,Lost
18984,171,11,"500,05",5,2,1,8,High-Value,Potential Loyalists
18987,876,3,"156,70000000000002",3,1,1,5,Low-Value,At Risk Customers
18989,797,3,"78,95",3,1,1,5,Low-Value,At Risk Customers
18992,1012,1,"31,6",3,1,1,5,Low-Value,At Risk Customers
18993,190,4,"141,89999999999998",5,1,1,7,Mid-Value,Potential Loyalists
18994,439,6,"498,1",4,1,1,6,Mid-Value,Potential Loyalists
18996,54,10,"478,25",5,2,1,8,High-Value,Potential Loyalists
18998,658,2,"208,85",4,1,1,6,Mid-Value,Potential Loyalists
19003,148,4,"804,1999999999999",5,1,2,8,High-Value,Potential Loyalists
19004,98,6,"379,2",5,1,1,7,Mid-Value,Potential Loyalists
19006,1624,1,"65,1",1,1,1,3,Low-Value,Lost
19011,187,4,"207,89999999999998",5,1,1,7,Mid-Value,Potential Loyalists
19012,77,9,"392,05",5,2,1,8,High-Value,Potential Loyalists
19013,1229,1,"33,0",2,1,1,4,Low-Value,Can't Lose
19014,1142,1,"27,65",2,1,1,4,Low-Value,Can't Lose
19016,1153,1,"27,1",2,1,1,4,Low-Value,Can't Lose
19019,619,3,"55,3",4,1,1,6,Mid-Value,Potential Loyalists
19021,609,3,"199,14999999999998",4,1,1,6,Mid-Value,Potential Loyalists
19023,939,1,"11,75",3,1,1,5,Low-Value,At Risk Customers
19024,526,2,"138,7",4,1,1,6,Mid-Value,Potential Loyalists
19025,752,1,"172,2",3,1,1,5,Low-Value,At Risk Customers
19030,1699,1,"29,099999999999998",1,1,1,3,Low-Value,Lost
19031,140,7,"797,3499999999999",5,2,2,9,High-Value,Champions
19032,328,2,"100,5",5,1,1,7,Mid-Value,Potential Loyalists
19033,63,7,"350,95",5,2,1,8,High-Value,Potential Loyalists
19034,28,6,"615,85",5,1,1,7,Mid-Value,Potential Loyalists
19035,733,5,"290,3",3,1,1,5,Low-Value,At Risk Customers
19036,119,9,"419,55",5,2,1,8,High-Value,Potential Loyalists
19037,14,4,"275,0",5,1,1,7,Mid-Value,Potential Loyalists
19040,970,2,"302,5",3,1,1,5,Low-Value,At Risk Customers
19042,1785,1,"13,2",1,1,1,3,Low-Value,Lost
19043,639,1,"80,55000000000001",4,1,1,6,Mid-Value,Potential Loyalists
19044,246,5,"407,85",5,1,1,7,Mid-Value,Potential Loyalists
19047,788,3,"311,65000000000003",3,1,1,5,Low-Value,At Risk Customers
19049,328,1,"93,8",5,1,1,7,Mid-Value,Potential Loyalists
19051,224,6,"343,55",5,1,1,7,Mid-Value,Potential Loyalists
19052,63,2,"75,5",5,1,1,7,Mid-Value,Potential Loyalists
19054,328,3,"46,45",5,1,1,7,Mid-Value,Potential Loyalists
19055,407,2,"61,15",4,1,1,6,Mid-Value,Potential Loyalists
19056,638,1,"12,9",4,1,1,6,Mid-Value,Potential Loyalists
19057,153,8,"576,15",5,2,1,8,High-Value,Potential Loyalists
19058,495,1,"216,25",4,1,1,6,Mid-Value,Potential Loyalists
19059,18,1,"19,0",5,1,1,7,Mid-Value,Potential Loyalists
19060,277,1,"18,9",5,1,1,7,Mid-Value,Potential Loyalists
19061,544,2,"135,75",4,1,1,6,Mid-Value,Potential Loyalists
19063,332,1,"7,5",5,1,1,7,Mid-Value,Potential Loyalists
19066,1151,1,"11,6",2,1,1,4,Low-Value,Can't Lose
19068,438,3,"115,30000000000001",4,1,1,6,Mid-Value,Potential Loyalists
19069,755,2,"151,0",3,1,1,5,Low-Value,At Risk Customers
19071,305,2,"68,4",5,1,1,7,Mid-Value,Potential Loyalists
19072,790,2,"145,79999999999998",3,1,1,5,Low-Value,At Risk Customers
19073,655,1,"16,8",4,1,1,6,Mid-Value,Potential Loyalists
19074,258,6,"362,3",5,1,1,7,Mid-Value,Potential Loyalists
19075,423,2,"36,5",4,1,1,6,Mid-Value,Potential Loyalists
19077,8,5,"413,55",5,1,1,7,Mid-Value,Potential Loyalists
19079,16,2,"85,45",5,1,1,7,Mid-Value,Potential Loyalists
19080,654,5,"293,29999999999995",4,1,1,6,Mid-Value,Potential Loyalists
19082,362,3,"50,849999999999994",5,1,1,7,Mid-Value,Potential Loyalists
19085,1089,1,"92,05",3,1,1,5,Low-Value,At Risk Customers
19086,324,3,"56,15",5,1,1,7,Mid-Value,Potential Loyalists
19087,30,7,"242,85",5,2,1,8,High-Value,Potential Loyalists
19088,878,4,"1891,35",3,1,3,7,Mid-Value,Potential Loyalists
19090,1121,1,"76,0",2,1,1,4,Low-Value,Can't Lose
19093,1088,1,"15,1",3,1,1,5,Low-Value,At Risk Customers
19094,1039,1,"23,3",3,1,1,5,Low-Value,At Risk Customers
19096,1123,5,"111,9",2,1,1,4,Low-Value,Can't Lose
19098,41,1,"5,7",5,1,1,7,Mid-Value,Potential Loyalists
19103,1310,3,"259,55",2,1,1,4,Low-Value,Can't Lose
19107,491,6,"175,3",4,1,1,6,Mid-Value,Potential Loyalists
19108,200,1,"17,4",5,1,1,7,Mid-Value,Potential Loyalists
19110,1572,1,"177,6",1,1,1,3,Low-Value,Lost
19112,1064,4,"192,2",3,1,1,5,Low-Value,At Risk Customers
19113,372,2,"490,65000000000003",4,1,1,6,Mid-Value,Potential Loyalists
19114,570,3,"234,75",4,1,1,6,Mid-Value,Potential Loyalists
19117,947,3,"132,6",3,1,1,5,Low-Value,At Risk Customers
19119,352,2,"257,54999999999995",5,1,1,7,Mid-Value,Potential Loyalists
19121,56,11,"442,59999999999997",5,2,1,8,High-Value,Potential Loyalists
19122,193,6,"167,75",5,1,1,7,Mid-Value,Potential Loyalists
19127,295,2,"106,8",5,1,1,7,Mid-Value,Potential Loyalists
19128,321,1,"79,0",5,1,1,7,Mid-Value,Potential Loyalists
19129,767,1,"114,4",3,1,1,5,Low-Value,At Risk Customers
19130,126,3,"117,55",5,1,1,7,Mid-Value,Potential Loyalists
19131,1368,1,"3,3",2,1,1,4,Low-Value,Can't Lose
19132,719,5,"234,35",4,1,1,6,Mid-Value,Potential Loyalists
19134,798,3,"391,2",3,1,1,5,Low-Value,At Risk Customers
19136,49,1,"13,6",5,1,1,7,Mid-Value,Potential Loyalists
19137,137,7,"406,25",5,2,1,8,High-Value,Potential Loyalists
19139,187,1,"6,5",5,1,1,7,Mid-Value,Potential Loyalists
19143,1577,1,"86,4",1,1,1,3,Low-Value,Lost
19144,373,4,"158,95000000000002",4,1,1,6,Mid-Value,Potential Loyalists
19145,1621,1,"81,8",1,1,1,3,Low-Value,Lost
19147,692,2,"145,0",4,1,1,6,Mid-Value,Potential Loyalists
19149,414,5,"320,95",4,1,1,6,Mid-Value,Potential Loyalists
19151,2,3,"217,95000000000002",5,1,1,7,Mid-Value,Potential Loyalists
19152,603,12,"880,25",4,3,2,9,High-Value,Champions
19153,939,1,"103,3",3,1,1,5,Low-Value,At Risk Customers
19154,132,9,"1320,1",5,2,2,9,High-Value,Champions
19155,877,1,"42,6",3,1,1,5,Low-Value,At Risk Customers
19156,42,2,"16,4",5,1,1,7,Mid-Value,Potential Loyalists
19158,57,8,"1110,5",5,2,2,9,High-Value,Champions
19159,31,1,"118,9",5,1,1,7,Mid-Value,Potential Loyalists
19160,515,3,"82,35",4,1,1,6,Mid-Value,Potential Loyalists
19161,206,9,"568,9",5,2,1,8,High-Value,Potential Loyalists
19162,825,10,"672,65",3,2,2,7,Mid-Value,Potential Loyalists
19164,693,2,"52,95",4,1,1,6,Mid-Value,Potential Loyalists
19165,1813,1,"10,45",1,1,1,3,Low-Value,Lost
19167,37,1,"11,0",5,1,1,7,Mid-Value,Potential Loyalists
19171,262,3,"202,75",5,1,1,7,Mid-Value,Potential Loyalists
19173,1739,1,"51,15",1,1,1,3,Low-Value,Lost
19175,610,1,"44,35",4,1,1,6,Mid-Value,Potential Loyalists
19177,886,2,"124,8",3,1,1,5,Low-Value,At Risk Customers
19178,1664,1,"54,3",1,1,1,3,Low-Value,Lost
19179,16,3,"485,05",5,1,1,7,Mid-Value,Potential Loyalists
19180,199,2,"26,5",5,1,1,7,Mid-Value,Potential Loyalists
19181,196,3,"212,2",5,1,1,7,Mid-Value,Potential Loyalists
19183,1705,1,"10,5",1,1,1,3,Low-Value,Lost
19185,392,1,"23,1",4,1,1,6,Mid-Value,Potential Loyalists
19187,280,6,"235,1",5,1,1,7,Mid-Value,Potential Loyalists
19190,549,5,"751,0999999999999",4,1,2,7,Mid-Value,Potential Loyalists
19191,25,3,"157,89999999999998",5,1,1,7,Mid-Value,Potential Loyalists
19192,399,2,"286,9",4,1,1,6,Mid-Value,Potential Loyalists
19194,133,3,"230,55",5,1,1,7,Mid-Value,Potential Loyalists
19197,744,4,"146,3",3,1,1,5,Low-Value,At Risk Customers
19199,1776,1,"339,0",1,1,1,3,Low-Value,Lost
19200,232,6,"410,85",5,1,1,7,Mid-Value,Potential Loyalists
19201,624,3,"104,45",4,1,1,6,Mid-Value,Potential Loyalists
19202,122,4,"99,19999999999999",5,1,1,7,Mid-Value,Potential Loyalists
19203,157,3,"125,5",5,1,1,7,Mid-Value,Potential Loyalists
19205,78,1,"42,4",5,1,1,7,Mid-Value,Potential Loyalists
19206,368,1,"98,6",4,1,1,6,Mid-Value,Potential Loyalists
19207,881,3,"308,34999999999997",3,1,1,5,Low-Value,At Risk Customers
19208,1436,1,"20,1",2,1,1,4,Low-Value,Can't Lose
19210,22,3,"200,79999999999998",5,1,1,7,Mid-Value,Potential Loyalists
19212,12,5,"288,3",5,1,1,7,Mid-Value,Potential Loyalists
19214,864,6,"487,9",3,1,1,5,Low-Value,At Risk Customers
19215,690,1,"12,7",4,1,1,6,Mid-Value,Potential Loyalists
19216,1692,1,"382,6",1,1,1,3,Low-Value,Lost
19218,735,1,"43,5",3,1,1,5,Low-Value,At Risk Customers
19219,302,2,"31,349999999999998",5,1,1,7,Mid-Value,Potential Loyalists
19220,377,6,"66,85",4,1,1,6,Mid-Value,Potential Loyalists
19221,1016,1,"5,7",3,1,1,5,Low-Value,At Risk Customers
19223,402,2,"88,39999999999999",4,1,1,6,Mid-Value,Potential Loyalists
19224,571,4,"120,5",4,1,1,6,Mid-Value,Potential Loyalists
19226,1673,3,"536,4",1,1,1,3,Low-Value,Lost
19227,1641,1,"90,8",1,1,1,3,Low-Value,Lost
19228,91,2,"242,2",5,1,1,7,Mid-Value,Potential Loyalists
19230,460,3,"710,7",4,1,2,7,Mid-Value,Potential Loyalists
19232,967,1,"65,4",3,1,1,5,Low-Value,At Risk Customers
19233,88,2,"38,0",5,1,1,7,Mid-Value,Potential Loyalists
19235,63,10,"769,85",5,2,2,9,High-Value,Champions
19238,559,2,"48,8",4,1,1,6,Mid-Value,Potential Loyalists
19240,825,1,"37,5",3,1,1,5,Low-Value,At Risk Customers
19244,615,1,"65,6",4,1,1,6,Mid-Value,Potential Loyalists
19246,918,1,"29,6",3,1,1,5,Low-Value,At Risk Customers
19248,602,3,"153,45",4,1,1,6,Mid-Value,Potential Loyalists
19250,300,2,"50,45",5,1,1,7,Mid-Value,Potential Loyalists
19251,1214,3,"127,35",2,1,1,4,Low-Value,Can't Lose
19252,299,2,"118,0",5,1,1,7,Mid-Value,Potential Loyalists
19253,333,1,"21,55",5,1,1,7,Mid-Value,Potential Loyalists
19254,881,2,"101,35",3,1,1,5,Low-Value,At Risk Customers
19255,126,2,"125,8",5,1,1,7,Mid-Value,Potential Loyalists
19256,367,2,"90,14999999999999",4,1,1,6,Mid-Value,Potential Loyalists
19257,907,3,"135,85",3,1,1,5,Low-Value,At Risk Customers
19259,818,5,"156,1",3,1,1,5,Low-Value,At Risk Customers
19260,465,4,"152,2",4,1,1,6,Mid-Value,Potential Loyalists
19261,157,5,"388,25",5,1,1,7,Mid-Value,Potential Loyalists
19262,603,2,"119,80000000000001",4,1,1,6,Mid-Value,Potential Loyalists
19264,256,4,"839,1999999999999",5,1,2,8,High-Value,Potential Loyalists
19268,920,1,"60,9",3,1,1,5,Low-Value,At Risk Customers
19269,1765,1,"66,7",1,1,1,3,Low-Value,Lost
19270,50,8,"268,35",5,2,1,8,High-Value,Potential Loyalists
19271,203,3,"123,5",5,1,1,7,Mid-Value,Potential Loyalists
19274,106,12,"1123,3",5,3,2,10,High-Value,Champions
19275,572,1,"29,700000000000003",4,1,1,6,Mid-Value,Potential Loyalists
19278,615,1,"42,15",4,1,1,6,Mid-Value,Potential Loyalists
19279,733,1,"56,6",3,1,1,5,Low-Value,At Risk Customers
19280,407,6,"372,2",4,1,1,6,Mid-Value,Potential Loyalists
19281,431,2,"51,75",4,1,1,6,Mid-Value,Potential Loyalists
19283,74,3,"43,45",5,1,1,7,Mid-Value,Potential Loyalists
19284,495,2,"378,8",4,1,1,6,Mid-Value,Potential Loyalists
19286,424,6,"286,55",4,1,1,6,Mid-Value,Potential Loyalists
19288,1662,1,"125,4",1,1,1,3,Low-Value,Lost
19289,727,3,"101,05",4,1,1,6,Mid-Value,Potential Loyalists
19290,31,6,"270,85",5,1,1,7,Mid-Value,Potential Loyalists
19291,147,5,"234,10000000000002",5,1,1,7,Mid-Value,Potential Loyalists
19295,836,5,"501,09999999999997",3,1,1,5,Low-Value,At Risk Customers
19297,1454,1,"28,7",2,1,1,4,Low-Value,Can't Lose
19298,921,2,"207,0",3,1,1,5,Low-Value,At Risk Customers
19299,247,3,"186,15",5,1,1,7,Mid-Value,Potential Loyalists
19300,1425,1,"37,0",2,1,1,4,Low-Value,Can't Lose
19301,10,9,"499,25",5,2,1,8,High-Value,Potential Loyalists
19302,412,4,"163,1",4,1,1,6,Mid-Value,Potential Loyalists
19303,663,5,"273,40000000000003",4,1,1,6,Mid-Value,Potential Loyalists
19306,27,3,"146,15",5,1,1,7,Mid-Value,Potential Loyalists
19307,766,3,"316,1",3,1,1,5,Low-Value,At Risk Customers
19308,368,4,"162,35",4,1,1,6,Mid-Value,Potential Loyalists
19309,925,1,"14,9",3,1,1,5,Low-Value,At Risk Customers
19310,526,6,"372,0",4,1,1,6,Mid-Value,Potential Loyalists
19311,1801,1,"46,8",1,1,1,3,Low-Value,Lost
19312,958,2,"72,6",3,1,1,5,Low-Value,At Risk Customers
19314,1260,2,"331,1",2,1,1,4,Low-Value,Can't Lose
19315,649,1,"82,4",4,1,1,6,Mid-Value,Potential Loyalists
19316,1517,1,"24,2",1,1,1,3,Low-Value,Lost
19317,787,1,"60,05",3,1,1,5,Low-Value,At Risk Customers
19320,290,1,"62,7",5,1,1,7,Mid-Value,Potential Loyalists
19321,518,2,"122,8",4,1,1,6,Mid-Value,Potential Loyalists
19322,1485,1,"58,6",1,1,1,3,Low-Value,Lost
19323,168,1,"5,4",5,1,1,7,Mid-Value,Potential Loyalists
19324,99,8,"355,7",5,2,1,8,High-Value,Potential Loyalists
19325,446,4,"204,70000000000002",4,1,1,6,Mid-Value,Potential Loyalists
19326,193,5,"208,7",5,1,1,7,Mid-Value,Potential Loyalists
19327,768,4,"349,24999999999994",3,1,1,5,Low-Value,At Risk Customers
19328,3,10,"491,25",5,2,1,8,High-Value,Potential Loyalists
19329,267,1,"70,35",5,1,1,7,Mid-Value,Potential Loyalists
19331,874,5,"127,2",3,1,1,5,Low-Value,At Risk Customers
19333,109,8,"381,20000000000005",5,2,1,8,High-Value,Potential Loyalists
19334,1425,2,"98,3",2,1,1,4,Low-Value,Can't Lose
19335,220,3,"35,6",5,1,1,7,Mid-Value,Potential Loyalists
19336,98,4,"254,00000000000003",5,1,1,7,Mid-Value,Potential Loyalists
19339,1263,2,"45,1",2,1,1,4,Low-Value,Can't Lose
19341,1096,3,"121,05",2,1,1,4,Low-Value,Can't Lose
19342,537,2,"195,2",4,1,1,6,Mid-Value,Potential Loyalists
19344,89,10,"806,7",5,2,2,9,High-Value,Champions
19346,1137,3,"208,55",2,1,1,4,Low-Value,Can't Lose
19347,18,4,"113,6",5,1,1,7,Mid-Value,Potential Loyalists
19348,379,2,"74,8",4,1,1,6,Mid-Value,Potential Loyalists
19349,977,3,"167,95",3,1,1,5,Low-Value,At Risk Customers
19351,929,4,"392,0",3,1,1,5,Low-Value,At Risk Customers
19352,11,6,"111,9",5,1,1,7,Mid-Value,Potential Loyalists
19354,70,6,"370,5",5,1,1,7,Mid-Value,Potential Loyalists
19355,748,2,"28,700000000000003",3,1,1,5,Low-Value,At Risk Customers
19356,155,10,"699,45",5,2,2,9,High-Value,Champions
19361,1447,1,"13,3",2,1,1,4,Low-Value,Can't Lose
19362,342,1,"88,8",5,1,1,7,Mid-Value,Potential Loyalists
19363,505,1,"16,2",4,1,1,6,Mid-Value,Potential Loyalists
19365,955,10,"428,5",3,2,1,6,Mid-Value,Potential Loyalists
19366,521,1,"1,4",4,1,1,6,Mid-Value,Potential Loyalists
19367,1036,2,"47,1",3,1,1,5,Low-Value,At Risk Customers
19368,175,3,"763,65",5,1,2,8,High-Value,Potential Loyalists
19369,11,2,"469,04999999999995",5,1,1,7,Mid-Value,Potential Loyalists
19371,1358,1,"113,10000000000001",2,1,1,4,Low-Value,Can't Lose
19374,19,2,"204,05",5,1,1,7,Mid-Value,Potential Loyalists
19375,998,2,"28,65",3,1,1,5,Low-Value,At Risk Customers
19377,494,2,"32,1",4,1,1,6,Mid-Value,Potential Loyalists
19378,788,13,"877,4999999999999",3,3,2,8,High-Value,Potential Loyalists
19379,5,2,"78,65",5,1,1,7,Mid-Value,Potential Loyalists
19381,32,6,"475,05",5,1,1,7,Mid-Value,Potential Loyalists
19382,798,9,"488,45",3,2,1,6,Mid-Value,Potential Loyalists
19383,554,9,"1115,3999999999999",4,2,2,8,High-Value,Potential Loyalists
19385,115,1,"12,1",5,1,1,7,Mid-Value,Potential Loyalists
19386,398,2,"54,1",4,1,1,6,Mid-Value,Potential Loyalists
19387,57,2,"213,3",5,1,1,7,Mid-Value,Potential Loyalists
19388,799,8,"490,05",3,2,1,6,Mid-Value,Potential Loyalists
19389,388,4,"221,95",4,1,1,6,Mid-Value,Potential Loyalists
19390,41,3,"375,7",5,1,1,7,Mid-Value,Potential Loyalists
19391,1235,1,"77,25",2,1,1,4,Low-Value,Can't Lose
19392,752,1,"58,2",3,1,1,5,Low-Value,At Risk Customers
19393,8,4,"772,35",5,1,2,8,High-Value,Potential Loyalists
19394,1589,1,"36,75",1,1,1,3,Low-Value,Lost
19395,688,1,"34,1",4,1,1,6,Mid-Value,Potential Loyalists
19398,391,2,"103,25",4,1,1,6,Mid-Value,Potential Loyalists
19400,820,2,"46,2",3,1,1,5,Low-Value,At Risk Customers
19401,103,4,"103,6",5,1,1,7,Mid-Value,Potential Loyalists
19403,48,13,"440,9",5,3,1,9,High-Value,Champions
19404,1697,1,"34,4",1,1,1,3,Low-Value,Lost
19406,918,6,"310,15",3,1,1,5,Low-Value,At Risk Customers
19407,592,2,"114,5",4,1,1,6,Mid-Value,Potential Loyalists
19410,445,1,"11,7",4,1,1,6,Mid-Value,Potential Loyalists
19412,430,1,"54,95",4,1,1,6,Mid-Value,Potential Loyalists
19413,340,9,"387,8",5,2,1,8,High-Value,Potential Loyalists
19414,1009,2,"114,4",3,1,1,5,Low-Value,At Risk Customers
19417,197,3,"282,95",5,1,1,7,Mid-Value,Potential Loyalists
19419,112,10,"957,55",5,2,2,9,High-Value,Champions
19420,393,5,"285,6",4,1,1,6,Mid-Value,Potential Loyalists
19423,739,2,"60,099999999999994",3,1,1,5,Low-Value,At Risk Customers
19425,1760,1,"61,5",1,1,1,3,Low-Value,Lost
19426,1348,3,"118,55000000000001",2,1,1,4,Low-Value,Can't Lose
19431,311,5,"296,9",5,1,1,7,Mid-Value,Potential Loyalists
19432,1509,2,"34,05",1,1,1,3,Low-Value,Lost
19434,853,1,"20,46",3,1,1,5,Low-Value,At Risk Customers
19436,13,5,"263,1",5,1,1,7,Mid-Value,Potential Loyalists
19437,6,3,"303,84999999999997",5,1,1,7,Mid-Value,Potential Loyalists
19438,109,6,"188,64999999999998",5,1,1,7,Mid-Value,Potential Loyalists
19440,1732,1,"98,85000000000001",1,1,1,3,Low-Value,Lost
19441,548,6,"598,4499999999999",4,1,1,6,Mid-Value,Potential Loyalists
19445,169,3,"119,15",5,1,1,7,Mid-Value,Potential Loyalists
19447,7,2,"44,15",5,1,1,7,Mid-Value,Potential Loyalists
19448,129,3,"118,19999999999999",5,1,1,7,Mid-Value,Potential Loyalists
19449,1768,2,"28,349999999999998",1,1,1,3,Low-Value,Lost
19450,1085,1,"63,1",3,1,1,5,Low-Value,At Risk Customers
19451,903,2,"63,75",3,1,1,5,Low-Value,At Risk Customers
19453,1271,2,"47,85",2,1,1,4,Low-Value,Can't Lose
19454,29,11,"1120,4",5,2,2,9,High-Value,Champions
19455,14,4,"383,8",5,1,1,7,Mid-Value,Potential Loyalists
19456,913,4,"270,15",3,1,1,5,Low-Value,At Risk Customers
19457,493,2,"152,5",4,1,1,6,Mid-Value,Potential Loyalists
19459,966,3,"333,95",3,1,1,5,Low-Value,At Risk Customers
19460,193,9,"1039,5",5,2,2,9,High-Value,Champions
19461,27,3,"109,1",5,1,1,7,Mid-Value,Potential Loyalists
19463,208,4,"89,4",5,1,1,7,Mid-Value,Potential Loyalists
19465,387,6,"391,7",4,1,1,6,Mid-Value,Potential Loyalists
19466,20,5,"131,85",5,1,1,7,Mid-Value,Potential Loyalists
19467,219,3,"49,0",5,1,1,7,Mid-Value,Potential Loyalists
19470,460,1,"58,55",4,1,1,6,Mid-Value,Potential Loyalists
19472,32,4,"455,4",5,1,1,7,Mid-Value,Potential Loyalists
19474,33,12,"804,4",5,3,2,10,High-Value,Champions
19475,37,8,"596,35",5,2,1,8,High-Value,Potential Loyalists
19476,376,8,"945,5500000000001",4,2,2,8,High-Value,Potential Loyalists
19477,1241,2,"66,95",2,1,1,4,Low-Value,Can't Lose
19481,103,2,"169,60000000000002",5,1,1,7,Mid-Value,Potential Loyalists
19482,8,1,"71,55000000000001",5,1,1,7,Mid-Value,Potential Loyalists
19483,462,4,"156,75",4,1,1,6,Mid-Value,Potential Loyalists
19484,203,4,"111,95",5,1,1,7,Mid-Value,Potential Loyalists
19485,988,4,"116,7",3,1,1,5,Low-Value,At Risk Customers
19488,455,1,"42,4",4,1,1,6,Mid-Value,Potential Loyalists
19491,10,4,"1148,5",5,1,2,8,High-Value,Potential Loyalists
19493,14,3,"88,45",5,1,1,7,Mid-Value,Potential Loyalists
19495,38,1,"40,65",5,1,1,7,Mid-Value,Potential Loyalists
19496,123,7,"479,55",5,2,1,8,High-Value,Potential Loyalists
19497,495,6,"287,3",4,1,1,6,Mid-Value,Potential Loyalists
19498,407,4,"305,0",4,1,1,6,Mid-Value,Potential Loyalists
19499,179,3,"338,3",5,1,1,7,Mid-Value,Potential Loyalists
19500,33,4,"125,0",5,1,1,7,Mid-Value,Potential Loyalists
19503,78,6,"131,64999999999998",5,1,1,7,Mid-Value,Potential Loyalists
19504,555,1,"87,7",4,1,1,6,Mid-Value,Potential Loyalists
19506,266,2,"29,95",5,1,1,7,Mid-Value,Potential Loyalists
19507,206,5,"646,65",5,1,1,7,Mid-Value,Potential Loyalists
19509,460,18,"1103,0",4,4,2,10,High-Value,Champions
19510,770,3,"48,15",3,1,1,5,Low-Value,At Risk Customers
19513,1036,7,"614,65",3,2,1,6,Mid-Value,Potential Loyalists
19516,153,4,"263,55",5,1,1,7,Mid-Value,Potential Loyalists
19519,432,2,"45,05",4,1,1,6,Mid-Value,Potential Loyalists
19520,1326,1,"29,95",2,1,1,4,Low-Value,Can't Lose
19521,154,4,"93,69999999999999",5,1,1,7,Mid-Value,Potential Loyalists
19522,1234,3,"256,45",2,1,1,4,Low-Value,Can't Lose
19523,500,1,"53,4",4,1,1,6,Mid-Value,Potential Loyalists
19524,543,3,"84,35",4,1,1,6,Mid-Value,Potential Loyalists
19526,38,9,"650,1",5,2,1,8,High-Value,Potential Loyalists
19527,398,2,"64,0",4,1,1,6,Mid-Value,Potential Loyalists
19528,870,2,"292,5",3,1,1,5,Low-Value,At Risk Customers
19529,538,1,"13,2",4,1,1,6,Mid-Value,Potential Loyalists
19530,581,3,"186,10000000000002",4,1,1,6,Mid-Value,Potential Loyalists
19531,28,5,"175,14999999999998",5,1,1,7,Mid-Value,Potential Loyalists
19533,318,3,"192,15",5,1,1,7,Mid-Value,Potential Loyalists
19534,264,5,"428,55",5,1,1,7,Mid-Value,Potential Loyalists
19536,144,2,"105,80000000000001",5,1,1,7,Mid-Value,Potential Loyalists
19537,16,2,"330,4",5,1,1,7,Mid-Value,Potential Loyalists
19538,1620,2,"229,95",1,1,1,3,Low-Value,Lost
19540,451,3,"226,8",4,1,1,6,Mid-Value,Potential Loyalists
19542,549,2,"242,9",4,1,1,6,Mid-Value,Potential Loyalists
19543,1616,1,"405,7",1,1,1,3,Low-Value,Lost
19544,610,1,"1,35",4,1,1,6,Mid-Value,Potential Loyalists
19546,182,12,"1199,1",5,3,2,10,High-Value,Champions
19547,157,12,"495,75",5,3,1,9,High-Value,Champions
19548,368,9,"737,5",4,2,2,8,High-Value,Potential Loyalists
19550,706,2,"99,3",4,1,1,6,Mid-Value,Potential Loyalists
19552,252,2,"115,25",5,1,1,7,Mid-Value,Potential Loyalists
19554,98,1,"19,5",5,1,1,7,Mid-Value,Potential Loyalists
19555,551,5,"439,8",4,1,1,6,Mid-Value,Potential Loyalists
19556,745,3,"98,95",3,1,1,5,Low-Value,At Risk Customers
19557,273,4,"126,55000000000001",5,1,1,7,Mid-Value,Potential Loyalists
19558,798,1,"17,7",3,1,1,5,Low-Value,At Risk Customers
19560,416,3,"93,75",4,1,1,6,Mid-Value,Potential Loyalists
19562,154,6,"747,4",5,1,2,8,High-Value,Potential Loyalists
19564,530,1,"29,1",4,1,1,6,Mid-Value,Potential Loyalists
19568,705,4,"240,45000000000002",4,1,1,6,Mid-Value,Potential Loyalists
19569,1069,1,"47,25",3,1,1,5,Low-Value,At Risk Customers
19570,315,6,"236,5",5,1,1,7,Mid-Value,Potential Loyalists
19572,74,3,"57,60000000000001",5,1,1,7,Mid-Value,Potential Loyalists
19575,663,1,"100,1",4,1,1,6,Mid-Value,Potential Loyalists
19576,1815,1,"442,2",1,1,1,3,Low-Value,Lost
19577,624,1,"4,85",4,1,1,6,Mid-Value,Potential Loyalists
19578,227,2,"115,0",5,1,1,7,Mid-Value,Potential Loyalists
19579,750,4,"343,34999999999997",3,1,1,5,Low-Value,At Risk Customers
19581,780,1,"15,7",3,1,1,5,Low-Value,At Risk Customers
19584,33,5,"407,79999999999995",5,1,1,7,Mid-Value,Potential Loyalists
19585,128,5,"93,9",5,1,1,7,Mid-Value,Potential Loyalists
19586,0,2,"92,9",5,1,1,7,Mid-Value,Potential Loyalists
19587,686,1,"91,0",4,1,1,6,Mid-Value,Potential Loyalists
19588,80,1,"11,75",5,1,1,7,Mid-Value,Potential Loyalists
19590,367,5,"454,9",4,1,1,6,Mid-Value,Potential Loyalists
19591,200,1,"19,9",5,1,1,7,Mid-Value,Potential Loyalists
19594,56,1,"19,9",5,1,1,7,Mid-Value,Potential Loyalists
19595,19,4,"394,45",5,1,1,7,Mid-Value,Potential Loyalists
19596,30,2,"97,30000000000001",5,1,1,7,Mid-Value,Potential Loyalists
19598,1440,1,"27,55",2,1,1,4,Low-Value,Can't Lose
19599,2,5,"837,6",5,1,2,8,High-Value,Potential Loyalists
19600,334,3,"43,15",5,1,1,7,Mid-Value,Potential Loyalists
19603,53,7,"1346,4",5,2,3,10,High-Value,Champions
19604,905,3,"138,8",3,1,1,5,Low-Value,At Risk Customers
19606,1682,1,"53,849999999999994",1,1,1,3,Low-Value,Lost
19607,366,5,"275,25",4,1,1,6,Mid-Value,Potential Loyalists
19608,385,5,"314,35",4,1,1,6,Mid-Value,Potential Loyalists
19609,225,6,"306,15",5,1,1,7,Mid-Value,Potential Loyalists
19610,33,1,"27,7",5,1,1,7,Mid-Value,Potential Loyalists
19611,1748,2,"156,29999999999998",1,1,1,3,Low-Value,Lost
19613,673,1,"73,9",4,1,1,6,Mid-Value,Potential Loyalists
19614,1599,2,"110,45",1,1,1,3,Low-Value,Lost
19616,0,2,"62,050000000000004",5,1,1,7,Mid-Value,Potential Loyalists
19617,1785,1,"12,9",1,1,1,3,Low-Value,Lost
19618,81,10,"562,45",5,2,1,8,High-Value,Potential Loyalists
19620,144,1,"213,25",5,1,1,7,Mid-Value,Potential Loyalists
19621,13,2,"102,4",5,1,1,7,Mid-Value,Potential Loyalists
19622,514,1,"88,8",4,1,1,6,Mid-Value,Potential Loyalists
19626,957,2,"163,35",3,1,1,5,Low-Value,At Risk Customers
19628,1138,4,"206,8",2,1,1,4,Low-Value,Can't Lose
19629,7,5,"212,65",5,1,1,7,Mid-Value,Potential Loyalists
19630,901,3,"45,2",3,1,1,5,Low-Value,At Risk Customers
19631,1129,1,"3,15",2,1,1,4,Low-Value,Can't Lose
19633,850,4,"255,04999999999998",3,1,1,5,Low-Value,At Risk Customers
19634,1161,2,"122,25",2,1,1,4,Low-Value,Can't Lose
19635,779,1,"48,45",3,1,1,5,Low-Value,At Risk Customers
19636,1336,4,"153,55",2,1,1,4,Low-Value,Can't Lose
19637,153,4,"732,85",5,1,2,8,High-Value,Potential Loyalists
19638,409,7,"438,6",4,2,1,7,Mid-Value,Potential Loyalists
19640,104,4,"114,35",5,1,1,7,Mid-Value,Potential Loyalists
19641,1385,1,"52,8",2,1,1,4,Low-Value,Can't Lose
19642,769,3,"41,349999999999994",3,1,1,5,Low-Value,At Risk Customers
19643,895,2,"167,55",3,1,1,5,Low-Value,At Risk Customers
19644,42,3,"148,89999999999998",5,1,1,7,Mid-Value,Potential Loyalists
19645,122,1,"5,1",5,1,1,7,Mid-Value,Potential Loyalists
19646,731,2,"441,75",3,1,1,5,Low-Value,At Risk Customers
19648,1005,3,"165,6",3,1,1,5,Low-Value,At Risk Customers
19650,1026,2,"54,6",3,1,1,5,Low-Value,At Risk Customers
19651,37,5,"302,05",5,1,1,7,Mid-Value,Potential Loyalists
19653,906,1,"65,1",3,1,1,5,Low-Value,At Risk Customers
19654,624,2,"71,30000000000001",4,1,1,6,Mid-Value,Potential Loyalists
19656,153,1,"128,8",5,1,1,7,Mid-Value,Potential Loyalists
19657,62,2,"104,6",5,1,1,7,Mid-Value,Potential Loyalists
19659,1819,1,"199,0",1,1,1,3,Low-Value,Lost
19660,14,4,"178,5",5,1,1,7,Mid-Value,Potential Loyalists
19661,131,2,"207,6",5,1,1,7,Mid-Value,Potential Loyalists
19663,129,7,"679,85",5,2,2,9,High-Value,Champions
19665,1480,1,"231,75",1,1,1,3,Low-Value,Lost
19666,1217,1,"8,1",2,1,1,4,Low-Value,Can't Lose
19667,619,3,"77,65",4,1,1,6,Mid-Value,Potential Loyalists
19668,522,3,"82,9",4,1,1,6,Mid-Value,Potential Loyalists
19669,29,10,"471,7",5,2,1,8,High-Value,Potential Loyalists
19670,14,10,"537,75",5,2,1,8,High-Value,Potential Loyalists
19671,107,2,"107,85",5,1,1,7,Mid-Value,Potential Loyalists
19672,437,3,"225,75",4,1,1,6,Mid-Value,Potential Loyalists
19673,825,3,"137,65",3,1,1,5,Low-Value,At Risk Customers
19675,1369,2,"416,35",2,1,1,4,Low-Value,Can't Lose
19676,130,4,"603,55",5,1,1,7,Mid-Value,Potential Loyalists
19678,1078,1,"41,8",3,1,1,5,Low-Value,At Risk Customers
19679,160,2,"37,75",5,1,1,7,Mid-Value,Potential Loyalists
19680,601,2,"82,0",4,1,1,6,Mid-Value,Potential Loyalists
19681,28,2,"387,45",5,1,1,7,Mid-Value,Potential Loyalists
19682,1606,1,"27,9",1,1,1,3,Low-Value,Lost
19683,510,5,"117,2",4,1,1,6,Mid-Value,Potential Loyalists
19684,132,4,"434,95",5,1,1,7,Mid-Value,Potential Loyalists
19685,529,7,"728,55",4,2,2,8,High-Value,Potential Loyalists
19687,435,3,"178,6",4,1,1,6,Mid-Value,Potential Loyalists
19689,274,2,"296,3",5,1,1,7,Mid-Value,Potential Loyalists
19690,1802,2,"86,2",1,1,1,3,Low-Value,Lost
19691,1529,2,"25,2",1,1,1,3,Low-Value,Lost
19693,124,1,"242,25",5,1,1,7,Mid-Value,Potential Loyalists
19695,1323,2,"121,7",2,1,1,4,Low-Value,Can't Lose
19696,1110,2,"118,3",2,1,1,4,Low-Value,Can't Lose
19699,431,3,"242,25",4,1,1,6,Mid-Value,Potential Loyalists
19700,758,6,"181,75",3,1,1,5,Low-Value,At Risk Customers
19701,518,6,"239,45000000000002",4,1,1,6,Mid-Value,Potential Loyalists
19702,347,4,"159,45",5,1,1,7,Mid-Value,Potential Loyalists
19703,1022,1,"11,75",3,1,1,5,Low-Value,At Risk Customers
19704,168,1,"251,35",5,1,1,7,Mid-Value,Potential Loyalists
19705,340,11,"672,5",5,2,2,9,High-Value,Champions
19706,5,9,"2212,3",5,2,4,11,High-Value,Champions
19707,514,2,"111,75",4,1,1,6,Mid-Value,Potential Loyalists
19708,1202,1,"9,55",2,1,1,4,Low-Value,Can't Lose
19709,225,1,"31,950000000000003",5,1,1,7,Mid-Value,Potential Loyalists
19710,626,1,"17,9",4,1,1,6,Mid-Value,Potential Loyalists
19711,251,2,"118,60000000000001",5,1,1,7,Mid-Value,Potential Loyalists
19712,423,4,"356,85",4,1,1,6,Mid-Value,Potential Loyalists
19713,1020,3,"234,60000000000002",3,1,1,5,Low-Value,At Risk Customers
19714,1412,2,"35,6",2,1,1,4,Low-Value,Can't Lose
19717,133,2,"150,0",5,1,1,7,Mid-Value,Potential Loyalists
19718,158,4,"289,4",5,1,1,7,Mid-Value,Potential Loyalists
19719,1136,3,"228,75",2,1,1,4,Low-Value,Can't Lose
19720,89,2,"87,44999999999999",5,1,1,7,Mid-Value,Potential Loyalists
19721,650,2,"166,45",4,1,1,6,Mid-Value,Potential Loyalists
19722,14,2,"121,05",5,1,1,7,Mid-Value,Potential Loyalists
19724,113,7,"520,6",5,2,1,8,High-Value,Potential Loyalists
19726,179,3,"172,9",5,1,1,7,Mid-Value,Potential Loyalists
19727,1085,1,"11,7",3,1,1,5,Low-Value,At Risk Customers
19728,374,2,"234,10000000000002",4,1,1,6,Mid-Value,Potential Loyalists
19729,518,1,"117,2",4,1,1,6,Mid-Value,Potential Loyalists
19730,1352,1,"16,3",2,1,1,4,Low-Value,Can't Lose
19731,87,4,"212,25",5,1,1,7,Mid-Value,Potential Loyalists
19732,23,1,"100,3",5,1,1,7,Mid-Value,Potential Loyalists
19733,1137,3,"132,05",2,1,1,4,Low-Value,Can't Lose
19734,819,4,"107,55",3,1,1,5,Low-Value,At Risk Customers
19735,1477,1,"156,2",1,1,1,3,Low-Value,Lost
19737,94,1,"9,65",5,1,1,7,Mid-Value,Potential Loyalists
19738,946,3,"92,5",3,1,1,5,Low-Value,At Risk Customers
19739,1755,1,"81,5",1,1,1,3,Low-Value,Lost
19743,179,3,"195,65",5,1,1,7,Mid-Value,Potential Loyalists
19745,165,5,"283,4",5,1,1,7,Mid-Value,Potential Loyalists
19746,892,4,"676,65",3,1,2,6,Mid-Value,Potential Loyalists
19747,806,1,"55,95",3,1,1,5,Low-Value,At Risk Customers
19749,550,5,"300,05",4,1,1,6,Mid-Value,Potential Loyalists
19750,133,5,"487,4",5,1,1,7,Mid-Value,Potential Loyalists
19752,134,4,"573,3000000000001",5,1,1,7,Mid-Value,Potential Loyalists
19753,316,4,"125,39999999999999",5,1,1,7,Mid-Value,Potential Loyalists
19754,73,1,"95,65",5,1,1,7,Mid-Value,Potential Loyalists
19756,741,3,"220,85000000000002",3,1,1,5,Low-Value,At Risk Customers
19757,973,2,"43,35",3,1,1,5,Low-Value,At Risk Customers
19758,354,5,"390,4",5,1,1,7,Mid-Value,Potential Loyalists
19760,936,6,"217,14999999999998",3,1,1,5,Low-Value,At Risk Customers
19761,477,4,"504,79999999999995",4,1,1,6,Mid-Value,Potential Loyalists
19762,1415,1,"10,23",2,1,1,4,Low-Value,Can't Lose
19764,642,1,"40,9",4,1,1,6,Mid-Value,Potential Loyalists
19765,769,2,"27,1",3,1,1,5,Low-Value,At Risk Customers
19767,1097,1,"25,9",2,1,1,4,Low-Value,Can't Lose
19770,857,1,"14,6",3,1,1,5,Low-Value,At Risk Customers
19771,173,3,"70,4",5,1,1,7,Mid-Value,Potential Loyalists
19772,7,9,"1184,9",5,2,2,9,High-Value,Champions
19773,1159,1,"6,45",2,1,1,4,Low-Value,Can't Lose
19775,126,3,"212,7",5,1,1,7,Mid-Value,Potential Loyalists
19778,683,3,"590,35",4,1,1,6,Mid-Value,Potential Loyalists
19779,1107,3,"167,79999999999998",2,1,1,4,Low-Value,Can't Lose
19780,188,8,"483,35",5,2,1,8,High-Value,Potential Loyalists
19781,104,3,"83,15",5,1,1,7,Mid-Value,Potential Loyalists
19785,505,2,"125,69999999999999",4,1,1,6,Mid-Value,Potential Loyalists
19786,160,2,"118,44999999999999",5,1,1,7,Mid-Value,Potential Loyalists
19788,16,7,"487,55",5,2,1,8,High-Value,Potential Loyalists
19789,178,1,"18,2",5,1,1,7,Mid-Value,Potential Loyalists
19790,1262,2,"151,45",2,1,1,4,Low-Value,Can't Lose
19792,491,3,"35,2",4,1,1,6,Mid-Value,Potential Loyalists
19793,1761,1,"9,15",1,1,1,3,Low-Value,Lost
19794,972,2,"134,85",3,1,1,5,Low-Value,At Risk Customers
19795,234,6,"352,95",5,1,1,7,Mid-Value,Potential Loyalists
19797,1474,1,"34,0",1,1,1,3,Low-Value,Lost
19798,1366,1,"171,0",2,1,1,4,Low-Value,Can't Lose
19799,182,4,"70,0",5,1,1,7,Mid-Value,Potential Loyalists
19800,1105,6,"457,79999999999995",2,1,1,4,Low-Value,Can't Lose
19801,333,4,"587,7",5,1,1,7,Mid-Value,Potential Loyalists
19802,1040,4,"126,4",3,1,1,5,Low-Value,At Risk Customers
19803,432,1,"26,95",4,1,1,6,Mid-Value,Potential Loyalists
19804,857,2,"68,8",3,1,1,5,Low-Value,At Risk Customers
19806,91,5,"153,5",5,1,1,7,Mid-Value,Potential Loyalists
19808,1357,3,"112,95",2,1,1,4,Low-Value,Can't Lose
19809,922,3,"579,75",3,1,1,5,Low-Value,At Risk Customers
19810,633,3,"123,3",4,1,1,6,Mid-Value,Potential Loyalists
19813,743,10,"551,73",3,2,1,6,Mid-Value,Potential Loyalists
19815,17,4,"250,14999999999998",5,1,1,7,Mid-Value,Potential Loyalists
19817,167,1,"171,14999999999998",5,1,1,7,Mid-Value,Potential Loyalists
19820,1600,2,"171,1",1,1,1,3,Low-Value,Lost
19821,186,2,"115,25",5,1,1,7,Mid-Value,Potential Loyalists
19822,52,1,"44,1",5,1,1,7,Mid-Value,Potential Loyalists
19823,981,2,"79,75",3,1,1,5,Low-Value,At Risk Customers
19824,1199,3,"522,6999999999999",2,1,1,4,Low-Value,Can't Lose
19825,297,3,"207,9",5,1,1,7,Mid-Value,Potential Loyalists
19826,524,3,"154,75",4,1,1,6,Mid-Value,Potential Loyalists
19828,57,5,"229,9",5,1,1,7,Mid-Value,Potential Loyalists
19829,1100,2,"28,35",2,1,1,4,Low-Value,Can't Lose
19830,87,5,"303,75",5,1,1,7,Mid-Value,Potential Loyalists
19834,962,2,"32,55",3,1,1,5,Low-Value,At Risk Customers
19835,731,2,"219,2",3,1,1,5,Low-Value,At Risk Customers
19837,589,4,"320,8",4,1,1,6,Mid-Value,Potential Loyalists
19838,126,4,"134,6",5,1,1,7,Mid-Value,Potential Loyalists
19840,395,2,"17,05",4,1,1,6,Mid-Value,Potential Loyalists
19841,1050,4,"58,25",3,1,1,5,Low-Value,At Risk Customers
19842,160,5,"183,45",5,1,1,7,Mid-Value,Potential Loyalists
19848,118,8,"930,55",5,2,2,9,High-Value,Champions
19849,73,5,"317,34999999999997",5,1,1,7,Mid-Value,Potential Loyalists
19850,1251,4,"238,45",2,1,1,4,Low-Value,Can't Lose
19851,1410,1,"27,4",2,1,1,4,Low-Value,Can't Lose
19852,119,2,"10,05",5,1,1,7,Mid-Value,Potential Loyalists
19854,396,6,"401,85",4,1,1,6,Mid-Value,Potential Loyalists
19855,479,4,"315,7",4,1,1,6,Mid-Value,Potential Loyalists
19856,964,1,"6,15",3,1,1,5,Low-Value,At Risk Customers
19858,485,2,"17,6",4,1,1,6,Mid-Value,Potential Loyalists
19859,141,4,"332,55",5,1,1,7,Mid-Value,Potential Loyalists
19860,904,2,"160,59999999999997",3,1,1,5,Low-Value,At Risk Customers
19863,1438,1,"35,25",2,1,1,4,Low-Value,Can't Lose
19868,798,2,"121,19999999999999",3,1,1,5,Low-Value,At Risk Customers
19869,372,4,"299,3",4,1,1,6,Mid-Value,Potential Loyalists
19873,1161,1,"29,95",2,1,1,4,Low-Value,Can't Lose
19875,1482,1,"28,1",1,1,1,3,Low-Value,Lost
19876,209,5,"260,54999999999995",5,1,1,7,Mid-Value,Potential Loyalists
19877,771,1,"30,45",3,1,1,5,Low-Value,At Risk Customers
19878,517,1,"48,6",4,1,1,6,Mid-Value,Potential Loyalists
19879,389,1,"53,3",4,1,1,6,Mid-Value,Potential Loyalists
19880,1481,1,"55,6",1,1,1,3,Low-Value,Lost
19881,48,2,"82,05",5,1,1,7,Mid-Value,Potential Loyalists
19882,133,2,"91,2",5,1,1,7,Mid-Value,Potential Loyalists
19883,444,5,"405,7",4,1,1,6,Mid-Value,Potential Loyalists
19884,434,1,"15,95",4,1,1,6,Mid-Value,Potential Loyalists
19885,459,4,"75,75",4,1,1,6,Mid-Value,Potential Loyalists
19887,703,1,"34,75",4,1,1,6,Mid-Value,Potential Loyalists
19892,420,2,"32,85",4,1,1,6,Mid-Value,Potential Loyalists
19894,718,6,"307,15",4,1,1,6,Mid-Value,Potential Loyalists
19896,537,4,"462,5",4,1,1,6,Mid-Value,Potential Loyalists
19898,1165,2,"36,05",2,1,1,4,Low-Value,Can't Lose
19900,391,1,"40,55",4,1,1,6,Mid-Value,Potential Loyalists
19903,14,15,"917,25",5,3,2,10,High-Value,Champions
19906,1778,1,"39,2",1,1,1,3,Low-Value,Lost
19908,125,10,"523,9",5,2,1,8,High-Value,Potential Loyalists
19910,64,14,"748,35",5,3,2,10,High-Value,Champions
19911,469,3,"78,5",4,1,1,6,Mid-Value,Potential Loyalists
19913,265,3,"182,3",5,1,1,7,Mid-Value,Potential Loyalists
19914,680,3,"275,90000000000003",4,1,1,6,Mid-Value,Potential Loyalists
19916,412,3,"57,6",4,1,1,6,Mid-Value,Potential Loyalists
19917,108,6,"181,55",5,1,1,7,Mid-Value,Potential Loyalists
19920,908,3,"535,1",3,1,1,5,Low-Value,At Risk Customers
19921,863,4,"141,85",3,1,1,5,Low-Value,At Risk Customers
19922,1687,1,"288,9",1,1,1,3,Low-Value,Lost
19923,573,3,"253,5",4,1,1,6,Mid-Value,Potential Loyalists
19925,276,1,"8,1",5,1,1,7,Mid-Value,Potential Loyalists
19927,1134,2,"25,05",2,1,1,4,Low-Value,Can't Lose
19928,752,1,"61,3",3,1,1,5,Low-Value,At Risk Customers
19929,911,2,"128,5",3,1,1,5,Low-Value,At Risk Customers
19930,109,18,"1035,95",5,4,2,11,High-Value,Champions
19932,392,5,"256,7",4,1,1,6,Mid-Value,Potential Loyalists
19933,164,2,"156,5",5,1,1,7,Mid-Value,Potential Loyalists
19934,425,6,"470,85",4,1,1,6,Mid-Value,Potential Loyalists
19935,1249,2,"55,699999999999996",2,1,1,4,Low-Value,Can't Lose
19936,57,5,"204,55",5,1,1,7,Mid-Value,Potential Loyalists
19937,215,8,"1080,3500000000001",5,2,2,9,High-Value,Champions
19938,12,3,"162,7",5,1,1,7,Mid-Value,Potential Loyalists
19939,615,2,"127,5",4,1,1,6,Mid-Value,Potential Loyalists
19940,199,5,"326,4",5,1,1,7,Mid-Value,Potential Loyalists
19945,79,3,"144,39999999999998",5,1,1,7,Mid-Value,Potential Loyalists
19946,20,8,"301,2",5,2,1,8,High-Value,Potential Loyalists
19950,188,8,"399,25",5,2,1,8,High-Value,Potential Loyalists
19952,1783,1,"20,95",1,1,1,3,Low-Value,Lost
19953,1285,1,"126,4",2,1,1,4,Low-Value,Can't Lose
19954,116,3,"209,5",5,1,1,7,Mid-Value,Potential Loyalists
19955,612,5,"213,8",4,1,1,6,Mid-Value,Potential Loyalists
19956,231,9,"423,5",5,2,1,8,High-Value,Potential Loyalists
19959,60,5,"277,25",5,1,1,7,Mid-Value,Potential Loyalists
19960,1017,1,"10,6",3,1,1,5,Low-Value,At Risk Customers
19961,195,3,"66,05",5,1,1,7,Mid-Value,Potential Loyalists
19964,1205,2,"50,1",2,1,1,4,Low-Value,Can't Lose
19965,73,9,"618,4",5,2,1,8,High-Value,Potential Loyalists
19966,755,2,"97,0",3,1,1,5,Low-Value,At Risk Customers
19967,1652,1,"17,35",1,1,1,3,Low-Value,Lost
19968,161,2,"144,7",5,1,1,7,Mid-Value,Potential Loyalists
19970,789,1,"63,05",3,1,1,5,Low-Value,At Risk Customers
19972,152,9,"403,45",5,2,1,8,High-Value,Potential Loyalists
19973,1480,4,"477,3",1,1,1,3,Low-Value,Lost
19974,70,3,"175,75",5,1,1,7,Mid-Value,Potential Loyalists
19975,429,3,"112,65",4,1,1,6,Mid-Value,Potential Loyalists
19978,647,2,"67,0",4,1,1,6,Mid-Value,Potential Loyalists
19979,229,5,"693,3",5,1,2,8,High-Value,Potential Loyalists
19980,113,3,"215,8",5,1,1,7,Mid-Value,Potential Loyalists
19982,1515,2,"139,95",1,1,1,3,Low-Value,Lost
19983,731,2,"74,44999999999999",3,1,1,5,Low-Value,At Risk Customers
19987,294,2,"85,05000000000001",5,1,1,7,Mid-Value,Potential Loyalists
19988,1215,2,"46,45",2,1,1,4,Low-Value,Can't Lose
19989,395,2,"50,8",4,1,1,6,Mid-Value,Potential Loyalists
19991,1714,1,"62,3",1,1,1,3,Low-Value,Lost
19992,116,2,"198,99999999999997",5,1,1,7,Mid-Value,Potential Loyalists
19993,755,2,"227,45000000000002",3,1,1,5,Low-Value,At Risk Customers
19994,841,2,"64,5",3,1,1,5,Low-Value,At Risk Customers
19996,490,3,"356,4",4,1,1,6,Mid-Value,Potential Loyalists
19997,745,5,"447,8",3,1,1,5,Low-Value,At Risk Customers
19998,700,5,"143,85",4,1,1,6,Mid-Value,Potential Loyalists
19999,1806,1,"10,75",1,1,1,3,Low-Value,Lost
20000,92,4,"303,79999999999995",5,1,1,7,Mid-Value,Potential Loyalists
20002,1591,1,"5,85",1,1,1,3,Low-Value,Lost
20005,192,1,"507,15000000000003",5,1,1,7,Mid-Value,Potential Loyalists
20009,604,5,"330,20000000000005",4,1,1,6,Mid-Value,Potential Loyalists
20010,784,3,"382,7",3,1,1,5,Low-Value,At Risk Customers
20011,507,1,"20,46",4,1,1,6,Mid-Value,Potential Loyalists
20012,372,2,"69,60000000000001",4,1,1,6,Mid-Value,Potential Loyalists
20014,266,1,"17,5",5,1,1,7,Mid-Value,Potential Loyalists
20015,896,2,"77,89999999999999",3,1,1,5,Low-Value,At Risk Customers
20016,419,2,"30,0",4,1,1,6,Mid-Value,Potential Loyalists
20018,963,4,"259,05",3,1,1,5,Low-Value,At Risk Customers
20020,92,1,"42,45",5,1,1,7,Mid-Value,Potential Loyalists
20022,1107,2,"71,8",2,1,1,4,Low-Value,Can't Lose
20024,378,1,"59,2",4,1,1,6,Mid-Value,Potential Loyalists
20025,1404,2,"39,55",2,1,1,4,Low-Value,Can't Lose
20026,600,3,"138,15",4,1,1,6,Mid-Value,Potential Loyalists
20027,1219,2,"271,8",2,1,1,4,Low-Value,Can't Lose
20029,1054,3,"45,349999999999994",3,1,1,5,Low-Value,At Risk Customers
20030,122,11,"492,3",5,2,1,8,High-Value,Potential Loyalists
20031,530,4,"153,45",4,1,1,6,Mid-Value,Potential Loyalists
20032,1240,2,"381,55",2,1,1,4,Low-Value,Can't Lose
20033,14,3,"282,95",5,1,1,7,Mid-Value,Potential Loyalists
20036,763,5,"308,6",3,1,1,5,Low-Value,At Risk Customers
20038,141,7,"766,25",5,2,2,9,High-Value,Champions
20039,144,2,"74,0",5,1,1,7,Mid-Value,Potential Loyalists
20041,223,1,"24,2",5,1,1,7,Mid-Value,Potential Loyalists
20042,1159,2,"62,0",2,1,1,4,Low-Value,Can't Lose
20043,67,5,"214,4",5,1,1,7,Mid-Value,Potential Loyalists
20044,158,1,"86,1",5,1,1,7,Mid-Value,Potential Loyalists
20045,762,3,"157,4",3,1,1,5,Low-Value,At Risk Customers
20048,243,1,"68,0",5,1,1,7,Mid-Value,Potential Loyalists
20049,1465,1,"68,7",1,1,1,3,Low-Value,Lost
20050,182,1,"35,0",5,1,1,7,Mid-Value,Potential Loyalists
20052,713,2,"43,349999999999994",4,1,1,6,Mid-Value,Potential Loyalists
20053,1775,1,"14,1",1,1,1,3,Low-Value,Lost
20054,270,1,"147,14999999999998",5,1,1,7,Mid-Value,Potential Loyalists
20055,74,4,"364,95",5,1,1,7,Mid-Value,Potential Loyalists
20056,171,4,"278,85",5,1,1,7,Mid-Value,Potential Loyalists
20061,376,3,"161,75",4,1,1,6,Mid-Value,Potential Loyalists
20062,76,2,"27,95",5,1,1,7,Mid-Value,Potential Loyalists
20063,291,5,"203,6",5,1,1,7,Mid-Value,Potential Loyalists
20065,10,3,"345,95",5,1,1,7,Mid-Value,Potential Loyalists
20066,378,3,"99,5",4,1,1,6,Mid-Value,Potential Loyalists
20067,817,1,"26,35",3,1,1,5,Low-Value,At Risk Customers
20069,635,6,"325,5",4,1,1,6,Mid-Value,Potential Loyalists
20070,529,6,"699,65",4,1,2,7,Mid-Value,Potential Loyalists
20072,278,1,"15,8",5,1,1,7,Mid-Value,Potential Loyalists
20073,238,3,"101,75",5,1,1,7,Mid-Value,Potential Loyalists
20075,754,1,"98,7",3,1,1,5,Low-Value,At Risk Customers
20078,77,5,"356,7",5,1,1,7,Mid-Value,Potential Loyalists
20079,19,2,"38,699999999999996",5,1,1,7,Mid-Value,Potential Loyalists
20081,363,3,"120,25",5,1,1,7,Mid-Value,Potential Loyalists
20082,482,3,"387,45",4,1,1,6,Mid-Value,Potential Loyalists
20084,1604,1,"57,0",1,1,1,3,Low-Value,Lost
20085,54,2,"37,8",5,1,1,7,Mid-Value,Potential Loyalists
20086,883,4,"216,6",3,1,1,5,Low-Value,At Risk Customers
20090,56,7,"327,2",5,2,1,8,High-Value,Potential Loyalists
20091,245,3,"93,15",5,1,1,7,Mid-Value,Potential Loyalists
20092,35,10,"1371,35",5,2,3,10,High-Value,Champions
20094,637,3,"178,95000000000002",4,1,1,6,Mid-Value,Potential Loyalists
20095,1274,5,"284,40000000000003",2,1,1,4,Low-Value,Can't Lose
20096,378,1,"54,5",4,1,1,6,Mid-Value,Potential Loyalists
20097,187,5,"95,85",5,1,1,7,Mid-Value,Potential Loyalists
20098,329,5,"119,54999999999998",5,1,1,7,Mid-Value,Potential Loyalists
20100,11,7,"153,1",5,2,1,8,High-Value,Potential Loyalists
20101,213,2,"206,2",5,1,1,7,Mid-Value,Potential Loyalists
20102,1428,1,"10,05",2,1,1,4,Low-Value,Can't Lose
20103,193,8,"602,3000000000001",5,2,1,8,High-Value,Potential Loyalists
20105,1342,1,"30,3",2,1,1,4,Low-Value,Can't Lose
20107,934,2,"66,9",3,1,1,5,Low-Value,At Risk Customers
20111,55,7,"369,5",5,2,1,8,High-Value,Potential Loyalists
20112,1686,2,"193,75",1,1,1,3,Low-Value,Lost
20113,539,1,"95,9",4,1,1,6,Mid-Value,Potential Loyalists
20114,173,6,"225,25",5,1,1,7,Mid-Value,Potential Loyalists
20115,1819,1,"53,8",1,1,1,3,Low-Value,Lost
20118,118,5,"183,14999999999998",5,1,1,7,Mid-Value,Potential Loyalists
20119,983,2,"142,1",3,1,1,5,Low-Value,At Risk Customers
20121,181,1,"224,85",5,1,1,7,Mid-Value,Potential Loyalists
20123,379,2,"48,75",4,1,1,6,Mid-Value,Potential Loyalists
20126,786,5,"211,0",3,1,1,5,Low-Value,At Risk Customers
20127,786,5,"377,04999999999995",3,1,1,5,Low-Value,At Risk Customers
20128,17,5,"120,5",5,1,1,7,Mid-Value,Potential Loyalists
20129,177,1,"41,7",5,1,1,7,Mid-Value,Potential Loyalists
20132,1564,3,"209,6",1,1,1,3,Low-Value,Lost
20133,14,12,"867,3499999999999",5,3,2,10,High-Value,Champions
20135,215,2,"225,55",5,1,1,7,Mid-Value,Potential Loyalists
20142,546,5,"598,0999999999999",4,1,1,6,Mid-Value,Potential Loyalists
20143,1345,2,"82,75",2,1,1,4,Low-Value,Can't Lose
20144,857,1,"60,300000000000004",3,1,1,5,Low-Value,At Risk Customers
20145,1184,1,"120,4",2,1,1,4,Low-Value,Can't Lose
20147,775,1,"52,8",3,1,1,5,Low-Value,At Risk Customers
20148,1144,2,"71,7",2,1,1,4,Low-Value,Can't Lose
20149,378,4,"128,2",4,1,1,6,Mid-Value,Potential Loyalists
20150,726,1,"3,3",4,1,1,6,Mid-Value,Potential Loyalists
20152,408,5,"520,7",4,1,1,6,Mid-Value,Potential Loyalists
20155,461,1,"100,75",4,1,1,6,Mid-Value,Potential Loyalists
20157,302,7,"229,0",5,2,1,8,High-Value,Potential Loyalists
20158,751,2,"134,60000000000002",3,1,1,5,Low-Value,At Risk Customers
20159,1698,1,"95,9",1,1,1,3,Low-Value,Lost
20160,101,6,"293,1",5,1,1,7,Mid-Value,Potential Loyalists
20162,924,1,"141,6",3,1,1,5,Low-Value,At Risk Customers
20165,197,2,"247,5",5,1,1,7,Mid-Value,Potential Loyalists
20166,938,2,"177,0",3,1,1,5,Low-Value,At Risk Customers
20168,334,1,"8,35",5,1,1,7,Mid-Value,Potential Loyalists
20169,127,2,"102,30000000000001",5,1,1,7,Mid-Value,Potential Loyalists
20171,1155,1,"30,45",2,1,1,4,Low-Value,Can't Lose
20172,912,1,"18,4",3,1,1,5,Low-Value,At Risk Customers
20173,762,3,"71,66",3,1,1,5,Low-Value,At Risk Customers
20174,347,4,"105,55",5,1,1,7,Mid-Value,Potential Loyalists
20176,675,3,"383,59999999999997",4,1,1,6,Mid-Value,Potential Loyalists
20177,508,6,"287,8",4,1,1,6,Mid-Value,Potential Loyalists
20178,696,3,"104,5",4,1,1,6,Mid-Value,Potential Loyalists
20179,9,4,"117,75",5,1,1,7,Mid-Value,Potential Loyalists
20180,542,2,"50,15",4,1,1,6,Mid-Value,Potential Loyalists
20182,132,2,"65,8",5,1,1,7,Mid-Value,Potential Loyalists
20184,407,5,"301,55",4,1,1,6,Mid-Value,Potential Loyalists
20185,796,6,"377,45",3,1,1,5,Low-Value,At Risk Customers
20187,269,6,"197,79999999999998",5,1,1,7,Mid-Value,Potential Loyalists
20189,754,3,"76,85",3,1,1,5,Low-Value,At Risk Customers
20190,411,1,"16,75",4,1,1,6,Mid-Value,Potential Loyalists
20191,390,5,"208,8",4,1,1,6,Mid-Value,Potential Loyalists
20192,712,1,"135,5",4,1,1,6,Mid-Value,Potential Loyalists
20198,1491,1,"61,9",1,1,1,3,Low-Value,Lost
20199,505,4,"269,94999999999993",4,1,1,6,Mid-Value,Potential Loyalists
20200,834,4,"213,05",3,1,1,5,Low-Value,At Risk Customers
20201,62,3,"55,6",5,1,1,7,Mid-Value,Potential Loyalists
20202,1470,6,"206,85",1,1,1,3,Low-Value,Lost
20204,576,7,"369,15",4,2,1,7,Mid-Value,Potential Loyalists
20206,1422,2,"71,9",2,1,1,4,Low-Value,Can't Lose
20207,1236,1,"187,05",2,1,1,4,Low-Value,Can't Lose
20209,1173,1,"68,15",2,1,1,4,Low-Value,Can't Lose
20211,231,4,"310,6",5,1,1,7,Mid-Value,Potential Loyalists
20212,82,3,"132,1",5,1,1,7,Mid-Value,Potential Loyalists
20218,157,2,"237,5",5,1,1,7,Mid-Value,Potential Loyalists
20219,902,1,"76,1",3,1,1,5,Low-Value,At Risk Customers
20220,1482,1,"72,8",1,1,1,3,Low-Value,Lost
20221,70,2,"142,85",5,1,1,7,Mid-Value,Potential Loyalists
20222,870,12,"627,25",3,3,1,7,Mid-Value,Potential Loyalists
20223,966,2,"147,45",3,1,1,5,Low-Value,At Risk Customers
20224,1232,2,"75,8",2,1,1,4,Low-Value,Can't Lose
20225,258,2,"318,3",5,1,1,7,Mid-Value,Potential Loyalists
20226,117,5,"121,3",5,1,1,7,Mid-Value,Potential Loyalists
20227,171,12,"877,75",5,3,2,10,High-Value,Champions
20228,671,7,"973,35",4,2,2,8,High-Value,Potential Loyalists
20229,86,1,"30,5",5,1,1,7,Mid-Value,Potential Loyalists
20230,233,4,"122,75",5,1,1,7,Mid-Value,Potential Loyalists
20231,14,4,"211,5",5,1,1,7,Mid-Value,Potential Loyalists
20232,74,3,"831,8",5,1,2,8,High-Value,Potential Loyalists
20233,600,3,"78,9",4,1,1,6,Mid-Value,Potential Loyalists
20235,83,4,"140,95",5,1,1,7,Mid-Value,Potential Loyalists
20240,1202,3,"220,0",2,1,1,4,Low-Value,Can't Lose
20241,0,3,"565,6",5,1,1,7,Mid-Value,Potential Loyalists
20242,655,4,"263,55",4,1,1,6,Mid-Value,Potential Loyalists
20243,49,4,"69,9",5,1,1,7,Mid-Value,Potential Loyalists
20244,924,2,"174,6",3,1,1,5,Low-Value,At Risk Customers
20246,34,4,"280,2",5,1,1,7,Mid-Value,Potential Loyalists
20248,608,1,"81,15",4,1,1,6,Mid-Value,Potential Loyalists
20249,398,7,"270,75",4,2,1,7,Mid-Value,Potential Loyalists
20252,883,4,"246,1",3,1,1,5,Low-Value,At Risk Customers
20255,178,2,"150,2",5,1,1,7,Mid-Value,Potential Loyalists
20257,1539,1,"9,95",1,1,1,3,Low-Value,Lost
20260,151,3,"402,8",5,1,1,7,Mid-Value,Potential Loyalists
20261,1088,4,"149,9",3,1,1,5,Low-Value,At Risk Customers
20263,67,3,"402,75",5,1,1,7,Mid-Value,Potential Loyalists
20264,987,1,"28,7",3,1,1,5,Low-Value,At Risk Customers
20265,119,5,"407,9",5,1,1,7,Mid-Value,Potential Loyalists
20266,467,3,"94,85",4,1,1,6,Mid-Value,Potential Loyalists
20267,24,3,"272,4",5,1,1,7,Mid-Value,Potential Loyalists
20269,189,3,"453,05",5,1,1,7,Mid-Value,Potential Loyalists
20270,309,1,"94,2",5,1,1,7,Mid-Value,Potential Loyalists
20271,20,6,"929,75",5,1,2,8,High-Value,Potential Loyalists
20278,255,1,"15,6",5,1,1,7,Mid-Value,Potential Loyalists
20280,605,4,"248,20000000000002",4,1,1,6,Mid-Value,Potential Loyalists
20283,452,2,"84,80000000000001",4,1,1,6,Mid-Value,Potential Loyalists
20284,30,3,"376,8",5,1,1,7,Mid-Value,Potential Loyalists
20285,96,8,"448,5",5,2,1,8,High-Value,Potential Loyalists
20286,412,2,"58,5",4,1,1,6,Mid-Value,Potential Loyalists
20292,1215,1,"15,35",2,1,1,4,Low-Value,Can't Lose
20293,356,7,"300,05",5,2,1,8,High-Value,Potential Loyalists
20294,238,3,"197,1",5,1,1,7,Mid-Value,Potential Loyalists
20296,57,7,"398,44999999999993",5,2,1,8,High-Value,Potential Loyalists
20297,87,6,"488,4",5,1,1,7,Mid-Value,Potential Loyalists
20298,489,7,"403,65",4,2,1,7,Mid-Value,Potential Loyalists
20299,33,2,"108,75",5,1,1,7,Mid-Value,Potential Loyalists
20300,1640,2,"321,6",1,1,1,3,Low-Value,Lost
20301,1385,1,"18,9",2,1,1,4,Low-Value,Can't Lose
20302,420,4,"536,9",4,1,1,6,Mid-Value,Potential Loyalists
20303,946,1,"24,35",3,1,1,5,Low-Value,At Risk Customers
20304,1124,2,"46,1",2,1,1,4,Low-Value,Can't Lose
20305,145,1,"95,65",5,1,1,7,Mid-Value,Potential Loyalists
20306,8,3,"156,05",5,1,1,7,Mid-Value,Potential Loyalists
20307,1538,1,"10,5",1,1,1,3,Low-Value,Lost
20308,253,2,"120,19999999999999",5,1,1,7,Mid-Value,Potential Loyalists
20309,151,5,"296,15",5,1,1,7,Mid-Value,Potential Loyalists
20311,453,2,"106,75",4,1,1,6,Mid-Value,Potential Loyalists
20312,1351,1,"54,75",2,1,1,4,Low-Value,Can't Lose
20313,10,4,"146,05",5,1,1,7,Mid-Value,Potential Loyalists
20315,317,1,"10,35",5,1,1,7,Mid-Value,Potential Loyalists
20319,81,5,"212,4",5,1,1,7,Mid-Value,Potential Loyalists
20320,44,1,"22,75",5,1,1,7,Mid-Value,Potential Loyalists
20321,87,6,"323,0",5,1,1,7,Mid-Value,Potential Loyalists
20322,39,6,"260,1",5,1,1,7,Mid-Value,Potential Loyalists
20326,176,3,"165,45",5,1,1,7,Mid-Value,Potential Loyalists
20328,436,3,"210,3",4,1,1,6,Mid-Value,Potential Loyalists
20330,18,3,"167,35000000000002",5,1,1,7,Mid-Value,Potential Loyalists
20332,148,5,"193,95",5,1,1,7,Mid-Value,Potential Loyalists
20333,1743,1,"37,7",1,1,1,3,Low-Value,Lost
20334,1372,3,"90,39999999999999",2,1,1,4,Low-Value,Can't Lose
20336,495,1,"18,3",4,1,1,6,Mid-Value,Potential Loyalists
20337,1089,3,"105,55",3,1,1,5,Low-Value,At Risk Customers
20338,138,7,"334,20000000000005",5,2,1,8,High-Value,Potential Loyalists
20339,277,2,"18,65",5,1,1,7,Mid-Value,Potential Loyalists
20340,468,1,"165,3",4,1,1,6,Mid-Value,Potential Loyalists
20341,976,2,"179,2",3,1,1,5,Low-Value,At Risk Customers
20342,542,5,"231,04999999999998",4,1,1,6,Mid-Value,Potential Loyalists
20346,1063,2,"42,65",3,1,1,5,Low-Value,At Risk Customers
20347,24,2,"321,45",5,1,1,7,Mid-Value,Potential Loyalists
20348,146,1,"27,8",5,1,1,7,Mid-Value,Potential Loyalists
20349,61,3,"51,75",5,1,1,7,Mid-Value,Potential Loyalists
20350,110,9,"381,2",5,2,1,8,High-Value,Potential Loyalists
20351,297,3,"78,0",5,1,1,7,Mid-Value,Potential Loyalists
20352,54,3,"294,20000000000005",5,1,1,7,Mid-Value,Potential Loyalists
20355,654,5,"303,25",4,1,1,6,Mid-Value,Potential Loyalists
20356,319,4,"73,3",5,1,1,7,Mid-Value,Potential Loyalists
20358,21,1,"151,4",5,1,1,7,Mid-Value,Potential Loyalists
20359,435,2,"74,2",4,1,1,6,Mid-Value,Potential Loyalists
20360,36,2,"82,55",5,1,1,7,Mid-Value,Potential Loyalists
20361,501,4,"197,1",4,1,1,6,Mid-Value,Potential Loyalists
20362,372,4,"308,7",4,1,1,6,Mid-Value,Potential Loyalists
20364,789,4,"307,25",3,1,1,5,Low-Value,At Risk Customers
20365,276,4,"169,95000000000002",5,1,1,7,Mid-Value,Potential Loyalists
20367,144,3,"120,9",5,1,1,7,Mid-Value,Potential Loyalists
20368,18,9,"666,3",5,2,2,9,High-Value,Champions
20369,1179,2,"509,05",2,1,1,4,Low-Value,Can't Lose
20370,431,4,"153,65",4,1,1,6,Mid-Value,Potential Loyalists
20371,1071,1,"34,1",3,1,1,5,Low-Value,At Risk Customers
20372,719,4,"157,5",4,1,1,6,Mid-Value,Potential Loyalists
20373,1221,1,"40,0",2,1,1,4,Low-Value,Can't Lose
20374,895,3,"93,2",3,1,1,5,Low-Value,At Risk Customers
20375,1730,1,"99,15",1,1,1,3,Low-Value,Lost
20376,388,1,"171,0",4,1,1,6,Mid-Value,Potential Loyalists
20377,623,2,"130,25",4,1,1,6,Mid-Value,Potential Loyalists
20378,17,7,"361,1",5,2,1,8,High-Value,Potential Loyalists
20380,269,2,"112,44999999999999",5,1,1,7,Mid-Value,Potential Loyalists
20381,1076,1,"10,45",3,1,1,5,Low-Value,At Risk Customers
20382,1211,1,"17,25",2,1,1,4,Low-Value,Can't Lose
20383,1408,1,"300,0",2,1,1,4,Low-Value,Can't Lose
20385,971,7,"672,45",3,2,2,7,Mid-Value,Potential Loyalists
20386,417,2,"51,7",4,1,1,6,Mid-Value,Potential Loyalists
20388,368,1,"580,75",4,1,1,6,Mid-Value,Potential Loyalists
20390,900,5,"564,4",3,1,1,5,Low-Value,At Risk Customers
20391,548,1,"46,9",4,1,1,6,Mid-Value,Potential Loyalists
20392,214,3,"101,9",5,1,1,7,Mid-Value,Potential Loyalists
20394,572,2,"54,0",4,1,1,6,Mid-Value,Potential Loyalists
20395,948,3,"176,5",3,1,1,5,Low-Value,At Risk Customers
20396,1244,1,"54,150000000000006",2,1,1,4,Low-Value,Can't Lose
20397,829,1,"4,6",3,1,1,5,Low-Value,At Risk Customers
20398,1511,1,"72,55",1,1,1,3,Low-Value,Lost
20399,1105,1,"29,7",2,1,1,4,Low-Value,Can't Lose
20400,541,2,"283,25",4,1,1,6,Mid-Value,Potential Loyalists
20402,793,3,"336,6",3,1,1,5,Low-Value,At Risk Customers
20406,504,2,"103,0",4,1,1,6,Mid-Value,Potential Loyalists
20410,129,2,"76,6",5,1,1,7,Mid-Value,Potential Loyalists
20411,1224,1,"79,1",2,1,1,4,Low-Value,Can't Lose
20413,1156,1,"135,0",2,1,1,4,Low-Value,Can't Lose
20414,7,15,"903,55",5,3,2,10,High-Value,Champions
20415,1456,1,"16,95",2,1,1,4,Low-Value,Can't Lose
20416,1723,1,"11,55",1,1,1,3,Low-Value,Lost
20417,278,1,"108,4",5,1,1,7,Mid-Value,Potential Loyalists
20420,623,4,"235,85000000000002",4,1,1,6,Mid-Value,Potential Loyalists
20422,833,9,"433,7",3,2,1,6,Mid-Value,Potential Loyalists
20423,13,13,"431,81",5,3,1,9,High-Value,Champions
20424,923,1,"32,7",3,1,1,5,Low-Value,At Risk Customers
20425,712,2,"211,2",4,1,1,6,Mid-Value,Potential Loyalists
20426,1424,1,"53,05",2,1,1,4,Low-Value,Can't Lose
20427,570,2,"83,1",4,1,1,6,Mid-Value,Potential Loyalists
20428,411,1,"34,35",4,1,1,6,Mid-Value,Potential Loyalists
20431,808,4,"191,85",3,1,1,5,Low-Value,At Risk Customers
20432,179,7,"514,75",5,2,1,8,High-Value,Potential Loyalists
20433,1371,1,"43,2",2,1,1,4,Low-Value,Can't Lose
20434,61,3,"71,85",5,1,1,7,Mid-Value,Potential Loyalists
20435,1154,4,"135,9",2,1,1,4,Low-Value,Can't Lose
20436,530,3,"86,2",4,1,1,6,Mid-Value,Potential Loyalists
20439,207,4,"300,7",5,1,1,7,Mid-Value,Potential Loyalists
20440,1470,1,"57,0",1,1,1,3,Low-Value,Lost
20441,319,6,"311,25",5,1,1,7,Mid-Value,Potential Loyalists
20442,438,3,"113,8",4,1,1,6,Mid-Value,Potential Loyalists
20443,1394,2,"70,15",2,1,1,4,Low-Value,Can't Lose
20445,387,1,"232,6",4,1,1,6,Mid-Value,Potential Loyalists
20448,38,3,"91,4",5,1,1,7,Mid-Value,Potential Loyalists
20449,766,2,"23,05",3,1,1,5,Low-Value,At Risk Customers
20453,140,3,"94,25",5,1,1,7,Mid-Value,Potential Loyalists
20454,1335,3,"95,4",2,1,1,4,Low-Value,Can't Lose
20456,1157,1,"6,4",2,1,1,4,Low-Value,Can't Lose
20457,358,6,"384,5",5,1,1,7,Mid-Value,Potential Loyalists
20458,1130,3,"165,45000000000002",2,1,1,4,Low-Value,Can't Lose
20461,169,10,"592,75",5,2,1,8,High-Value,Potential Loyalists
20463,1334,3,"83,0",2,1,1,4,Low-Value,Can't Lose
20466,776,2,"32,35",3,1,1,5,Low-Value,At Risk Customers
20467,20,3,"115,95",5,1,1,7,Mid-Value,Potential Loyalists
20468,11,4,"103,2",5,1,1,7,Mid-Value,Potential Loyalists
20469,1020,1,"115,0",3,1,1,5,Low-Value,At Risk Customers
20470,21,3,"212,45",5,1,1,7,Mid-Value,Potential Loyalists
20472,956,2,"64,65",3,1,1,5,Low-Value,At Risk Customers
20473,967,3,"440,1",3,1,1,5,Low-Value,At Risk Customers
20474,403,3,"118,3",4,1,1,6,Mid-Value,Potential Loyalists
20475,25,11,"726,15",5,2,2,9,High-Value,Champions
20476,508,4,"90,75",4,1,1,6,Mid-Value,Potential Loyalists
20477,527,2,"142,35",4,1,1,6,Mid-Value,Potential Loyalists
20478,1149,3,"67,85",2,1,1,4,Low-Value,Can't Lose
20479,1628,1,"64,5",1,1,1,3,Low-Value,Lost
20481,748,4,"305,6",3,1,1,5,Low-Value,At Risk Customers
20482,455,1,"17,85",4,1,1,6,Mid-Value,Potential Loyalists
20483,1812,1,"72,75",1,1,1,3,Low-Value,Lost
20484,5,12,"576,7",5,3,1,9,High-Value,Champions
20485,409,2,"25,6",4,1,1,6,Mid-Value,Potential Loyalists
20487,825,3,"73,65",3,1,1,5,Low-Value,At Risk Customers
20491,61,4,"673,4",5,1,2,8,High-Value,Potential Loyalists
20492,504,6,"816,3",4,1,2,7,Mid-Value,Potential Loyalists
20493,836,2,"252,10000000000002",3,1,1,5,Low-Value,At Risk Customers
20494,963,1,"40,95",3,1,1,5,Low-Value,At Risk Customers
20495,1653,1,"21,5",1,1,1,3,Low-Value,Lost
20497,28,3,"222,6",5,1,1,7,Mid-Value,Potential Loyalists
20500,1488,1,"19,5",1,1,1,3,Low-Value,Lost
20502,125,5,"222,75",5,1,1,7,Mid-Value,Potential Loyalists
20504,1728,2,"82,65",1,1,1,3,Low-Value,Lost
20505,249,2,"125,9",5,1,1,7,Mid-Value,Potential Loyalists
20507,393,2,"102,5",4,1,1,6,Mid-Value,Potential Loyalists
20508,166,4,"226,45000000000002",5,1,1,7,Mid-Value,Potential Loyalists
20510,370,4,"130,35",4,1,1,6,Mid-Value,Potential Loyalists
20511,22,1,"16,8",5,1,1,7,Mid-Value,Potential Loyalists
20513,1704,1,"67,35",1,1,1,3,Low-Value,Lost
20514,1501,2,"190,5",1,1,1,3,Low-Value,Lost
20516,770,1,"12,0",3,1,1,5,Low-Value,At Risk Customers
20519,11,3,"90,8",5,1,1,7,Mid-Value,Potential Loyalists
20520,1401,1,"27,2",2,1,1,4,Low-Value,Can't Lose
20521,151,8,"908,5500000000001",5,2,2,9,High-Value,Champions
20522,1736,1,"96,3",1,1,1,3,Low-Value,Lost
20526,1145,1,"47,65",2,1,1,4,Low-Value,Can't Lose
20527,167,1,"6,6000000000000005",5,1,1,7,Mid-Value,Potential Loyalists
20529,27,2,"122,75",5,1,1,7,Mid-Value,Potential Loyalists
20530,9,2,"234,0",5,1,1,7,Mid-Value,Potential Loyalists
20531,762,7,"268,0",3,2,1,6,Mid-Value,Potential Loyalists
20532,640,3,"215,7",4,1,1,6,Mid-Value,Potential Loyalists
20533,895,2,"28,299999999999997",3,1,1,5,Low-Value,At Risk Customers
20534,1499,3,"209,8",1,1,1,3,Low-Value,Lost
20535,156,2,"41,8",5,1,1,7,Mid-Value,Potential Loyalists
20536,234,2,"228,04999999999998",5,1,1,7,Mid-Value,Potential Loyalists
20537,1311,1,"22,3",2,1,1,4,Low-Value,Can't Lose
20538,246,1,"47,95",5,1,1,7,Mid-Value,Potential Loyalists
20539,341,1,"72,5",5,1,1,7,Mid-Value,Potential Loyalists
20540,570,4,"395,35",4,1,1,6,Mid-Value,Potential Loyalists
20541,784,5,"880,75",3,1,2,6,Mid-Value,Potential Loyalists
20542,365,9,"512,4",5,2,1,8,High-Value,Potential Loyalists
20543,1120,2,"69,45",2,1,1,4,Low-Value,Can't Lose
20544,1104,2,"143,2",2,1,1,4,Low-Value,Can't Lose
20545,434,1,"54,8",4,1,1,6,Mid-Value,Potential Loyalists
20546,866,1,"27,9",3,1,1,5,Low-Value,At Risk Customers
20547,507,2,"295,70000000000005",4,1,1,6,Mid-Value,Potential Loyalists
20551,717,2,"180,9",4,1,1,6,Mid-Value,Potential Loyalists
20552,1013,2,"109,7",3,1,1,5,Low-Value,At Risk Customers
20553,892,2,"43,25",3,1,1,5,Low-Value,At Risk Customers
20554,774,2,"39,2",3,1,1,5,Low-Value,At Risk Customers
20555,17,7,"851,75",5,2,2,9,High-Value,Champions
20557,5,6,"496,4",5,1,1,7,Mid-Value,Potential Loyalists
20558,58,4,"628,5",5,1,1,7,Mid-Value,Potential Loyalists
20559,59,5,"216,3",5,1,1,7,Mid-Value,Potential Loyalists
20560,37,2,"23,55",5,1,1,7,Mid-Value,Potential Loyalists
20562,785,4,"124,75",3,1,1,5,Low-Value,At Risk Customers
20563,8,6,"248,15",5,1,1,7,Mid-Value,Potential Loyalists
20564,733,4,"208,05",3,1,1,5,Low-Value,At Risk Customers
20566,144,4,"362,85",5,1,1,7,Mid-Value,Potential Loyalists
20567,289,4,"123,9",5,1,1,7,Mid-Value,Potential Loyalists
20568,122,7,"284,65000000000003",5,2,1,8,High-Value,Potential Loyalists
20569,1144,1,"62,25",2,1,1,4,Low-Value,Can't Lose
20571,130,4,"209,60000000000002",5,1,1,7,Mid-Value,Potential Loyalists
20573,121,6,"167,39999999999998",5,1,1,7,Mid-Value,Potential Loyalists
20575,139,2,"58,15",5,1,1,7,Mid-Value,Potential Loyalists
20576,631,2,"80,85",4,1,1,6,Mid-Value,Potential Loyalists
20577,599,2,"140,95",4,1,1,6,Mid-Value,Potential Loyalists
20578,118,3,"35,3",5,1,1,7,Mid-Value,Potential Loyalists
20581,23,2,"179,7",5,1,1,7,Mid-Value,Potential Loyalists
20583,443,5,"215,4",4,1,1,6,Mid-Value,Potential Loyalists
20585,378,4,"206,29999999999998",4,1,1,6,Mid-Value,Potential Loyalists
20586,70,8,"240,9",5,2,1,8,High-Value,Potential Loyalists
20587,1146,4,"239,9",2,1,1,4,Low-Value,Can't Lose
20588,125,3,"97,8",5,1,1,7,Mid-Value,Potential Loyalists
20589,1478,2,"621,6",1,1,1,3,Low-Value,Lost
20590,446,4,"437,7",4,1,1,6,Mid-Value,Potential Loyalists
20592,91,5,"602,3",5,1,1,7,Mid-Value,Potential Loyalists
20593,787,3,"86,85000000000001",3,1,1,5,Low-Value,At Risk Customers
20596,257,1,"30,45",5,1,1,7,Mid-Value,Potential Loyalists
20597,873,3,"217,75",3,1,1,5,Low-Value,At Risk Customers
20599,170,8,"421,5",5,2,1,8,High-Value,Potential Loyalists
20600,412,4,"184,2",4,1,1,6,Mid-Value,Potential Loyalists
20602,4,3,"424,55000000000007",5,1,1,7,Mid-Value,Potential Loyalists
20604,977,2,"71,6",3,1,1,5,Low-Value,At Risk Customers
20606,675,5,"285,8",4,1,1,6,Mid-Value,Potential Loyalists
20609,907,2,"192,6",3,1,1,5,Low-Value,At Risk Customers
20611,1055,1,"17,7",3,1,1,5,Low-Value,At Risk Customers
20612,530,2,"150,1",4,1,1,6,Mid-Value,Potential Loyalists
20614,857,7,"695,5999999999999",3,2,2,7,Mid-Value,Potential Loyalists
20615,402,4,"368,20000000000005",4,1,1,6,Mid-Value,Potential Loyalists
20617,80,3,"120,2",5,1,1,7,Mid-Value,Potential Loyalists
20620,1116,1,"138,5",2,1,1,4,Low-Value,Can't Lose
20625,41,4,"180,05",5,1,1,7,Mid-Value,Potential Loyalists
20627,620,1,"33,7",4,1,1,6,Mid-Value,Potential Loyalists
20630,572,2,"15,850000000000001",4,1,1,6,Mid-Value,Potential Loyalists
20631,873,2,"237,0",3,1,1,5,Low-Value,At Risk Customers
20633,134,3,"285,55",5,1,1,7,Mid-Value,Potential Loyalists
20634,782,4,"166,0",3,1,1,5,Low-Value,At Risk Customers
20635,368,2,"642,1500000000001",4,1,1,6,Mid-Value,Potential Loyalists
20638,305,11,"882,55",5,2,2,9,High-Value,Champions
20639,1124,3,"319,5",2,1,1,4,Low-Value,Can't Lose
20640,498,4,"1222,3",4,1,2,7,Mid-Value,Potential Loyalists
20641,56,11,"746,65",5,2,2,9,High-Value,Champions
20643,439,7,"481,15",4,2,1,7,Mid-Value,Potential Loyalists
20644,494,4,"233,95000000000002",4,1,1,6,Mid-Value,Potential Loyalists
20649,242,1,"82,8",5,1,1,7,Mid-Value,Potential Loyalists
20650,423,2,"63,650000000000006",4,1,1,6,Mid-Value,Potential Loyalists
20651,140,2,"139,1",5,1,1,7,Mid-Value,Potential Loyalists
20652,677,2,"10,6",4,1,1,6,Mid-Value,Potential Loyalists
20654,373,4,"169,85",4,1,1,6,Mid-Value,Potential Loyalists
20655,116,1,"2,2",5,1,1,7,Mid-Value,Potential Loyalists
20657,76,1,"35,55",5,1,1,7,Mid-Value,Potential Loyalists
20659,800,2,"29,549999999999997",3,1,1,5,Low-Value,At Risk Customers
20662,309,3,"44,849999999999994",5,1,1,7,Mid-Value,Potential Loyalists
20663,806,3,"154,25",3,1,1,5,Low-Value,At Risk Customers
20666,565,2,"153,45",4,1,1,6,Mid-Value,Potential Loyalists
20668,340,3,"181,8",5,1,1,7,Mid-Value,Potential Loyalists
20669,953,4,"600,4",3,1,1,5,Low-Value,At Risk Customers
20670,231,3,"49,349999999999994",5,1,1,7,Mid-Value,Potential Loyalists
20671,55,6,"270,7",5,1,1,7,Mid-Value,Potential Loyalists
20673,534,1,"102,9",4,1,1,6,Mid-Value,Potential Loyalists
20674,254,2,"201,8",5,1,1,7,Mid-Value,Potential Loyalists
20675,418,3,"119,0",4,1,1,6,Mid-Value,Potential Loyalists
20677,893,5,"379,15000000000003",3,1,1,5,Low-Value,At Risk Customers
20679,516,4,"168,8",4,1,1,6,Mid-Value,Potential Loyalists
20680,353,7,"202,8",5,2,1,8,High-Value,Potential Loyalists
20683,820,2,"76,35000000000001",3,1,1,5,Low-Value,At Risk Customers
20685,39,7,"819,85",5,2,2,9,High-Value,Champions
20686,5,5,"439,2",5,1,1,7,Mid-Value,Potential Loyalists
20688,1628,1,"100,6",1,1,1,3,Low-Value,Lost
20689,146,4,"126,94999999999999",5,1,1,7,Mid-Value,Potential Loyalists
20690,512,3,"116,0",4,1,1,6,Mid-Value,Potential Loyalists
20691,1609,1,"90,0",1,1,1,3,Low-Value,Lost
20694,1488,3,"200,45",1,1,1,3,Low-Value,Lost
20695,577,2,"139,85",4,1,1,6,Mid-Value,Potential Loyalists
20697,101,2,"94,10000000000001",5,1,1,7,Mid-Value,Potential Loyalists
20700,1147,1,"24,95",2,1,1,4,Low-Value,Can't Lose
20701,930,3,"101,2",3,1,1,5,Low-Value,At Risk Customers
20703,1536,1,"22,45",1,1,1,3,Low-Value,Lost
20704,917,2,"117,7",3,1,1,5,Low-Value,At Risk Customers
20706,1387,2,"51,599999999999994",2,1,1,4,Low-Value,Can't Lose
20707,335,1,"11,4",5,1,1,7,Mid-Value,Potential Loyalists
20708,257,7,"441,8",5,2,1,8,High-Value,Potential Loyalists
20709,546,2,"601,95",4,1,1,6,Mid-Value,Potential Loyalists
20710,206,1,"43,05",5,1,1,7,Mid-Value,Potential Loyalists
20712,602,4,"128,35000000000002",4,1,1,6,Mid-Value,Potential Loyalists
20713,476,3,"418,9",4,1,1,6,Mid-Value,Potential Loyalists
20715,1341,1,"4,05",2,1,1,4,Low-Value,Can't Lose
20717,1609,2,"110,45",1,1,1,3,Low-Value,Lost
20718,1548,1,"96,75",1,1,1,3,Low-Value,Lost
20719,1107,5,"226,1",2,1,1,4,Low-Value,Can't Lose
20720,186,7,"393,95",5,2,1,8,High-Value,Potential Loyalists
20721,8,16,"1038,7",5,3,2,10,High-Value,Champions
20722,592,3,"137,8",4,1,1,6,Mid-Value,Potential Loyalists
20725,393,5,"207,75",4,1,1,6,Mid-Value,Potential Loyalists
20726,60,2,"74,3",5,1,1,7,Mid-Value,Potential Loyalists
20727,861,3,"228,54999999999998",3,1,1,5,Low-Value,At Risk Customers
20728,564,3,"170,25",4,1,1,6,Mid-Value,Potential Loyalists
20729,269,5,"496,95000000000005",5,1,1,7,Mid-Value,Potential Loyalists
20731,13,7,"429,85",5,2,1,8,High-Value,Potential Loyalists
20732,1292,2,"142,70000000000002",2,1,1,4,Low-Value,Can't Lose
20733,91,3,"84,95",5,1,1,7,Mid-Value,Potential Loyalists
20734,1810,1,"62,1",1,1,1,3,Low-Value,Lost
20736,269,6,"347,3",5,1,1,7,Mid-Value,Potential Loyalists
20737,944,3,"103,5",3,1,1,5,Low-Value,At Risk Customers
20738,958,4,"183,64999999999998",3,1,1,5,Low-Value,At Risk Customers
20740,166,2,"207,25",5,1,1,7,Mid-Value,Potential Loyalists
20741,1137,1,"50,3",2,1,1,4,Low-Value,Can't Lose
20744,57,5,"157,0",5,1,1,7,Mid-Value,Potential Loyalists
20745,1211,2,"72,65",2,1,1,4,Low-Value,Can't Lose
20746,180,5,"232,8",5,1,1,7,Mid-Value,Potential Loyalists
20747,439,2,"108,35",4,1,1,6,Mid-Value,Potential Loyalists
20748,146,3,"184,3",5,1,1,7,Mid-Value,Potential Loyalists
20751,80,5,"249,54999999999998",5,1,1,7,Mid-Value,Potential Loyalists
20752,111,9,"396,55",5,2,1,8,High-Value,Potential Loyalists
20753,752,4,"183,2",3,1,1,5,Low-Value,At Risk Customers
20755,122,1,"52,0",5,1,1,7,Mid-Value,Potential Loyalists
20756,1005,1,"56,8",3,1,1,5,Low-Value,At Risk Customers
20757,41,3,"117,5",5,1,1,7,Mid-Value,Potential Loyalists
20758,1094,1,"108,0",3,1,1,5,Low-Value,At Risk Customers
20760,1197,1,"24,2",2,1,1,4,Low-Value,Can't Lose
20762,118,2,"133,05",5,1,1,7,Mid-Value,Potential Loyalists
20763,900,1,"156,05",3,1,1,5,Low-Value,At Risk Customers
20764,644,1,"13,9",4,1,1,6,Mid-Value,Potential Loyalists
20765,214,7,"518,6",5,2,1,8,High-Value,Potential Loyalists
20772,628,2,"45,599999999999994",4,1,1,6,Mid-Value,Potential Loyalists
20773,21,4,"212,45",5,1,1,7,Mid-Value,Potential Loyalists
20776,780,4,"301,85",3,1,1,5,Low-Value,At Risk Customers
20778,52,2,"24,15",5,1,1,7,Mid-Value,Potential Loyalists
20782,20,12,"722,7",5,3,2,10,High-Value,Champions
20783,218,4,"549,3",5,1,1,7,Mid-Value,Potential Loyalists
20785,935,2,"94,7",3,1,1,5,Low-Value,At Risk Customers
20786,219,3,"425,20000000000005",5,1,1,7,Mid-Value,Potential Loyalists
20787,1597,1,"75,9",1,1,1,3,Low-Value,Lost
20796,1324,1,"134,85",2,1,1,4,Low-Value,Can't Lose
20798,376,4,"207,7",4,1,1,6,Mid-Value,Potential Loyalists
20799,167,10,"820,85",5,2,2,9,High-Value,Champions
20800,1432,2,"65,0",2,1,1,4,Low-Value,Can't Lose
20801,78,7,"280,1",5,2,1,8,High-Value,Potential Loyalists
20802,817,2,"96,25",3,1,1,5,Low-Value,At Risk Customers
20803,97,11,"680,55",5,2,2,9,High-Value,Champions
20804,943,3,"86,5",3,1,1,5,Low-Value,At Risk Customers
20806,10,3,"87,85000000000001",5,1,1,7,Mid-Value,Potential Loyalists
20807,806,6,"190,29999999999998",3,1,1,5,Low-Value,At Risk Customers
20809,277,2,"70,05000000000001",5,1,1,7,Mid-Value,Potential Loyalists
20811,107,11,"435,0",5,2,1,8,High-Value,Potential Loyalists
20813,56,8,"340,05",5,2,1,8,High-Value,Potential Loyalists
20814,248,6,"362,93",5,1,1,7,Mid-Value,Potential Loyalists
20815,244,6,"169,9",5,1,1,7,Mid-Value,Potential Loyalists
20816,42,2,"129,8",5,1,1,7,Mid-Value,Potential Loyalists
20818,1486,2,"356,4",1,1,1,3,Low-Value,Lost
20820,832,5,"253,95",3,1,1,5,Low-Value,At Risk Customers
20821,519,3,"107,85",4,1,1,6,Mid-Value,Potential Loyalists
20822,175,1,"34,2",5,1,1,7,Mid-Value,Potential Loyalists
20823,745,1,"353,4",3,1,1,5,Low-Value,At Risk Customers
20824,65,1,"10,15",5,1,1,7,Mid-Value,Potential Loyalists
20826,123,2,"96,35",5,1,1,7,Mid-Value,Potential Loyalists
20827,1176,2,"128,6",2,1,1,4,Low-Value,Can't Lose
20830,1265,5,"139,05",2,1,1,4,Low-Value,Can't Lose
20833,417,6,"125,8",4,1,1,6,Mid-Value,Potential Loyalists
20836,545,2,"251,05",4,1,1,6,Mid-Value,Potential Loyalists
20837,390,2,"306,15000000000003",4,1,1,6,Mid-Value,Potential Loyalists
20838,832,2,"153,85",3,1,1,5,Low-Value,At Risk Customers
20839,208,7,"612,0",5,2,1,8,High-Value,Potential Loyalists
20841,584,1,"115,9",4,1,1,6,Mid-Value,Potential Loyalists
20842,126,2,"142,14999999999998",5,1,1,7,Mid-Value,Potential Loyalists
20844,1056,1,"25,95",3,1,1,5,Low-Value,At Risk Customers
20845,810,5,"521,15",3,1,1,5,Low-Value,At Risk Customers
20846,115,3,"337,9",5,1,1,7,Mid-Value,Potential Loyalists
20848,1528,1,"63,2",1,1,1,3,Low-Value,Lost
20852,15,1,"270,0",5,1,1,7,Mid-Value,Potential Loyalists
20853,743,3,"338,84999999999997",3,1,1,5,Low-Value,At Risk Customers
20855,187,1,"2,85",5,1,1,7,Mid-Value,Potential Loyalists
20858,533,2,"47,0",4,1,1,6,Mid-Value,Potential Loyalists
20860,778,4,"202,2",3,1,1,5,Low-Value,At Risk Customers
20861,874,2,"41,65",3,1,1,5,Low-Value,At Risk Customers
20864,89,5,"246,1",5,1,1,7,Mid-Value,Potential Loyalists
20865,1435,1,"209,8",2,1,1,4,Low-Value,Can't Lose
20867,1719,1,"34,4",1,1,1,3,Low-Value,Lost
20868,767,3,"178,45",3,1,1,5,Low-Value,At Risk Customers
20869,748,6,"360,8",3,1,1,5,Low-Value,At Risk Customers
20873,628,2,"65,80000000000001",4,1,1,6,Mid-Value,Potential Loyalists
20874,108,4,"200,2",5,1,1,7,Mid-Value,Potential Loyalists
20875,899,3,"96,85",3,1,1,5,Low-Value,At Risk Customers
20876,599,2,"40,2",4,1,1,6,Mid-Value,Potential Loyalists
20878,343,8,"544,05",5,2,1,8,High-Value,Potential Loyalists
20880,741,8,"351,35",3,2,1,6,Mid-Value,Potential Loyalists
20881,269,4,"506,75",5,1,1,7,Mid-Value,Potential Loyalists
20882,10,4,"177,55",5,1,1,7,Mid-Value,Potential Loyalists
20888,481,1,"165,95",4,1,1,6,Mid-Value,Potential Loyalists
20890,986,1,"55,75",3,1,1,5,Low-Value,At Risk Customers
20891,691,4,"1594,95",4,1,3,8,High-Value,Potential Loyalists
20892,578,2,"48,65",4,1,1,6,Mid-Value,Potential Loyalists
20893,279,2,"180,25000000000003",5,1,1,7,Mid-Value,Potential Loyalists
20894,823,3,"85,95",3,1,1,5,Low-Value,At Risk Customers
20895,234,9,"596,75",5,2,1,8,High-Value,Potential Loyalists
20896,578,1,"15,2",4,1,1,6,Mid-Value,Potential Loyalists
20898,127,3,"283,2",5,1,1,7,Mid-Value,Potential Loyalists
20899,1752,1,"104,2",1,1,1,3,Low-Value,Lost
20900,556,1,"92,5",4,1,1,6,Mid-Value,Potential Loyalists
20902,29,5,"446,15",5,1,1,7,Mid-Value,Potential Loyalists
20903,1379,1,"48,4",2,1,1,4,Low-Value,Can't Lose
20904,132,4,"144,14999999999998",5,1,1,7,Mid-Value,Potential Loyalists
20905,64,4,"269,3",5,1,1,7,Mid-Value,Potential Loyalists
20908,586,3,"958,4499999999999",4,1,2,7,Mid-Value,Potential Loyalists
20909,149,7,"352,3",5,2,1,8,High-Value,Potential Loyalists
20910,1574,1,"1,2",1,1,1,3,Low-Value,Lost
20912,1082,1,"42,95",3,1,1,5,Low-Value,At Risk Customers
20914,1772,1,"2,2",1,1,1,3,Low-Value,Lost
20915,133,3,"160,2",5,1,1,7,Mid-Value,Potential Loyalists
20916,167,9,"300,6",5,2,1,8,High-Value,Potential Loyalists
20919,47,6,"498,15",5,1,1,7,Mid-Value,Potential Loyalists
20920,413,4,"187,25",4,1,1,6,Mid-Value,Potential Loyalists
20921,32,13,"682,5",5,3,2,10,High-Value,Champions
20922,699,4,"129,95",4,1,1,6,Mid-Value,Potential Loyalists
20923,710,4,"179,25",4,1,1,6,Mid-Value,Potential Loyalists
20925,47,9,"409,6",5,2,1,8,High-Value,Potential Loyalists
20928,48,3,"31,35",5,1,1,7,Mid-Value,Potential Loyalists
20932,127,3,"149,5",5,1,1,7,Mid-Value,Potential Loyalists
20934,792,3,"240,6",3,1,1,5,Low-Value,At Risk Customers
20936,858,4,"143,0",3,1,1,5,Low-Value,At Risk Customers
20938,82,5,"568,1999999999999",5,1,1,7,Mid-Value,Potential Loyalists
20939,537,1,"167,85000000000002",4,1,1,6,Mid-Value,Potential Loyalists
20940,854,2,"389,5",3,1,1,5,Low-Value,At Risk Customers
20941,1445,2,"21,55",2,1,1,4,Low-Value,Can't Lose
20943,718,3,"465,9",4,1,1,6,Mid-Value,Potential Loyalists
20945,246,6,"619,7",5,1,1,7,Mid-Value,Potential Loyalists
20947,67,5,"257,5",5,1,1,7,Mid-Value,Potential Loyalists
20949,4,5,"556,05",5,1,1,7,Mid-Value,Potential Loyalists
20952,138,3,"456,9",5,1,1,7,Mid-Value,Potential Loyalists
20953,330,6,"153,85000000000002",5,1,1,7,Mid-Value,Potential Loyalists
20959,95,4,"87,95",5,1,1,7,Mid-Value,Potential Loyalists
20962,375,8,"355,15",4,2,1,7,Mid-Value,Potential Loyalists
20964,1561,2,"211,15",1,1,1,3,Low-Value,Lost
20967,186,4,"199,25",5,1,1,7,Mid-Value,Potential Loyalists
20968,532,8,"304,1",4,2,1,7,Mid-Value,Potential Loyalists
20970,302,2,"41,45",5,1,1,7,Mid-Value,Potential Loyalists
20971,196,11,"1044,65",5,2,2,9,High-Value,Champions
20973,442,1,"5,5",4,1,1,6,Mid-Value,Potential Loyalists
20974,790,1,"58,1",3,1,1,5,Low-Value,At Risk Customers
20978,276,6,"450,75",5,1,1,7,Mid-Value,Potential Loyalists
20980,13,2,"41,85",5,1,1,7,Mid-Value,Potential Loyalists
20982,7,2,"31,6",5,1,1,7,Mid-Value,Potential Loyalists
20983,536,3,"76,30000000000001",4,1,1,6,Mid-Value,Potential Loyalists
20985,1179,2,"759,4000000000001",2,1,2,5,Low-Value,At Risk Customers
20987,747,1,"124,94999999999999",3,1,1,5,Low-Value,At Risk Customers
20989,383,4,"854,6499999999999",4,1,2,7,Mid-Value,Potential Loyalists
20990,36,9,"307,65000000000003",5,2,1,8,High-Value,Potential Loyalists
20991,1476,2,"67,0",1,1,1,3,Low-Value,Lost
20995,465,5,"313,25",4,1,1,6,Mid-Value,Potential Loyalists
20996,515,1,"92,1",4,1,1,6,Mid-Value,Potential Loyalists
21001,27,4,"255,79999999999998",5,1,1,7,Mid-Value,Potential Loyalists
21002,1344,2,"121,69999999999999",2,1,1,4,Low-Value,Can't Lose
21003,88,5,"140,05",5,1,1,7,Mid-Value,Potential Loyalists
21004,417,6,"196,15",4,1,1,6,Mid-Value,Potential Loyalists
21008,39,3,"76,94999999999999",5,1,1,7,Mid-Value,Potential Loyalists
21010,1548,2,"367,09999999999997",1,1,1,3,Low-Value,Lost
21011,259,6,"309,3",5,1,1,7,Mid-Value,Potential Loyalists
21012,60,1,"2,9",5,1,1,7,Mid-Value,Potential Loyalists
21013,207,3,"202,4",5,1,1,7,Mid-Value,Potential Loyalists
21014,335,6,"207,15",5,1,1,7,Mid-Value,Potential Loyalists
21015,49,5,"427,4",5,1,1,7,Mid-Value,Potential Loyalists
21016,889,1,"192,2",3,1,1,5,Low-Value,At Risk Customers
21017,271,4,"360,35",5,1,1,7,Mid-Value,Potential Loyalists
21019,127,8,"184,3",5,2,1,8,High-Value,Potential Loyalists
21021,1240,4,"490,15",2,1,1,4,Low-Value,Can't Lose
21024,1267,1,"20,7",2,1,1,4,Low-Value,Can't Lose
21025,26,8,"630,95",5,2,1,8,High-Value,Potential Loyalists
21026,648,1,"57,5",4,1,1,6,Mid-Value,Potential Loyalists
21027,181,2,"55,0",5,1,1,7,Mid-Value,Potential Loyalists
21029,323,6,"455,54999999999995",5,1,1,7,Mid-Value,Potential Loyalists
21030,286,5,"185,85000000000002",5,1,1,7,Mid-Value,Potential Loyalists
21031,370,5,"402,65",4,1,1,6,Mid-Value,Potential Loyalists
21032,1052,2,"165,75",3,1,1,5,Low-Value,At Risk Customers
21036,550,3,"91,05000000000001",4,1,1,6,Mid-Value,Potential Loyalists
21037,376,1,"151,2",4,1,1,6,Mid-Value,Potential Loyalists
21039,836,2,"81,45",3,1,1,5,Low-Value,At Risk Customers
21040,33,1,"7,5",5,1,1,7,Mid-Value,Potential Loyalists
21045,953,2,"72,94999999999999",3,1,1,5,Low-Value,At Risk Customers
21046,1662,1,"10,7",1,1,1,3,Low-Value,Lost
21047,526,3,"118,3",4,1,1,6,Mid-Value,Potential Loyalists
21048,679,1,"8,1",4,1,1,6,Mid-Value,Potential Loyalists
21053,18,4,"494,45000000000005",5,1,1,7,Mid-Value,Potential Loyalists
21054,17,3,"219,45000000000002",5,1,1,7,Mid-Value,Potential Loyalists
21056,393,3,"177,9",4,1,1,6,Mid-Value,Potential Loyalists
21058,165,16,"569,9",5,3,1,9,High-Value,Champions
21059,1144,3,"384,0",2,1,1,4,Low-Value,Can't Lose
21060,1282,2,"40,150000000000006",2,1,1,4,Low-Value,Can't Lose
21062,600,3,"61,1",4,1,1,6,Mid-Value,Potential Loyalists
21063,1104,2,"87,9",2,1,1,4,Low-Value,Can't Lose
21064,509,7,"225,35",4,2,1,7,Mid-Value,Potential Loyalists
21065,221,2,"53,25",5,1,1,7,Mid-Value,Potential Loyalists
21067,1531,1,"28,95",1,1,1,3,Low-Value,Lost
21068,69,2,"82,30000000000001",5,1,1,7,Mid-Value,Potential Loyalists
21071,1000,3,"159,95",3,1,1,5,Low-Value,At Risk Customers
21072,1522,1,"15,5",1,1,1,3,Low-Value,Lost
21073,228,3,"296,65",5,1,1,7,Mid-Value,Potential Loyalists
21074,748,3,"76,3",3,1,1,5,Low-Value,At Risk Customers
21075,169,6,"225,60000000000002",5,1,1,7,Mid-Value,Potential Loyalists
21076,31,3,"103,55",5,1,1,7,Mid-Value,Potential Loyalists
21078,191,4,"469,05",5,1,1,7,Mid-Value,Potential Loyalists
21079,698,3,"49,3",4,1,1,6,Mid-Value,Potential Loyalists
21082,179,3,"182,75",5,1,1,7,Mid-Value,Potential Loyalists
21083,104,5,"231,70000000000002",5,1,1,7,Mid-Value,Potential Loyalists
21088,1167,2,"43,099999999999994",2,1,1,4,Low-Value,Can't Lose
21089,764,2,"44,75",3,1,1,5,Low-Value,At Risk Customers
21090,891,3,"166,15",3,1,1,5,Low-Value,At Risk Customers
21094,1373,2,"49,7",2,1,1,4,Low-Value,Can't Lose
21096,541,1,"8,1",4,1,1,6,Mid-Value,Potential Loyalists
21097,409,2,"154,8",4,1,1,6,Mid-Value,Potential Loyalists
21101,116,8,"423,95",5,2,1,8,High-Value,Potential Loyalists
21104,163,1,"23,6",5,1,1,7,Mid-Value,Potential Loyalists
21106,276,3,"89,85",5,1,1,7,Mid-Value,Potential Loyalists
21112,105,4,"109,4",5,1,1,7,Mid-Value,Potential Loyalists
21113,413,2,"59,5",4,1,1,6,Mid-Value,Potential Loyalists
21114,816,3,"83,9",3,1,1,5,Low-Value,At Risk Customers
21115,1454,1,"32,15",2,1,1,4,Low-Value,Can't Lose
21116,120,4,"78,15",5,1,1,7,Mid-Value,Potential Loyalists
21118,211,2,"30,0",5,1,1,7,Mid-Value,Potential Loyalists
21119,248,12,"691,35",5,3,2,10,High-Value,Champions
21121,1314,1,"150,0",2,1,1,4,Low-Value,Can't Lose
21122,3,6,"328,9",5,1,1,7,Mid-Value,Potential Loyalists
21123,304,2,"48,45",5,1,1,7,Mid-Value,Potential Loyalists
21126,1348,1,"37,4",2,1,1,4,Low-Value,Can't Lose
21131,110,2,"63,849999999999994",5,1,1,7,Mid-Value,Potential Loyalists
21132,879,6,"238,0",3,1,1,5,Low-Value,At Risk Customers
21133,77,9,"637,15",5,2,1,8,High-Value,Potential Loyalists
21136,960,1,"119,25",3,1,1,5,Low-Value,At Risk Customers
21138,596,3,"66,75",4,1,1,6,Mid-Value,Potential Loyalists
21140,392,2,"81,9",4,1,1,6,Mid-Value,Potential Loyalists
21141,1638,1,"39,3",1,1,1,3,Low-Value,Lost
21142,1040,2,"203,45",3,1,1,5,Low-Value,At Risk Customers
21143,361,2,"31,200000000000003",5,1,1,7,Mid-Value,Potential Loyalists
21146,953,3,"378,95000000000005",3,1,1,5,Low-Value,At Risk Customers
21147,168,7,"292,0",5,2,1,8,High-Value,Potential Loyalists
21148,1584,1,"26,4",1,1,1,3,Low-Value,Lost
21150,94,9,"444,1",5,2,1,8,High-Value,Potential Loyalists
21151,701,3,"179,05",4,1,1,6,Mid-Value,Potential Loyalists
21153,145,1,"75,6",5,1,1,7,Mid-Value,Potential Loyalists
21155,26,3,"98,05",5,1,1,7,Mid-Value,Potential Loyalists
21156,138,4,"469,45",5,1,1,7,Mid-Value,Potential Loyalists
21158,29,1,"105,4",5,1,1,7,Mid-Value,Potential Loyalists
21159,3,9,"670,35",5,2,2,9,High-Value,Champions
21160,1457,6,"531,4",2,1,1,4,Low-Value,Can't Lose
21161,13,11,"2105,65",5,2,4,11,High-Value,Champions
21162,66,2,"54,55",5,1,1,7,Mid-Value,Potential Loyalists
21163,1536,1,"100,9",1,1,1,3,Low-Value,Lost
21164,710,4,"182,03",4,1,1,6,Mid-Value,Potential Loyalists
21166,809,3,"38,55",3,1,1,5,Low-Value,At Risk Customers
21168,183,2,"189,4",5,1,1,7,Mid-Value,Potential Loyalists
21169,28,11,"582,9499999999999",5,2,1,8,High-Value,Potential Loyalists
21170,158,2,"45,5",5,1,1,7,Mid-Value,Potential Loyalists
21174,366,2,"62,8",4,1,1,6,Mid-Value,Potential Loyalists
21175,1618,1,"47,099999999999994",1,1,1,3,Low-Value,Lost
21176,67,2,"65,2",5,1,1,7,Mid-Value,Potential Loyalists
21177,288,2,"133,85",5,1,1,7,Mid-Value,Potential Loyalists
21178,1144,2,"426,3",2,1,1,4,Low-Value,Can't Lose
21179,306,4,"691,8",5,1,2,8,High-Value,Potential Loyalists
21181,773,12,"742,0",3,3,2,8,High-Value,Potential Loyalists
21182,220,1,"68,7",5,1,1,7,Mid-Value,Potential Loyalists
21187,392,8,"558,0",4,2,1,7,Mid-Value,Potential Loyalists
21190,470,1,"112,85",4,1,1,6,Mid-Value,Potential Loyalists
21191,32,7,"457,55",5,2,1,8,High-Value,Potential Loyalists
21192,59,6,"159,75",5,1,1,7,Mid-Value,Potential Loyalists
21195,556,1,"23,5",4,1,1,6,Mid-Value,Potential Loyalists
21198,561,2,"70,3",4,1,1,6,Mid-Value,Potential Loyalists
21199,1738,1,"6,35",1,1,1,3,Low-Value,Lost
21200,759,5,"1639,2",3,1,3,7,Mid-Value,Potential Loyalists
21201,665,1,"37,9",4,1,1,6,Mid-Value,Potential Loyalists
21206,528,3,"280,2",4,1,1,6,Mid-Value,Potential Loyalists
21207,839,2,"218,7",3,1,1,5,Low-Value,At Risk Customers
21208,48,6,"248,20000000000002",5,1,1,7,Mid-Value,Potential Loyalists
21210,1463,1,"54,95",1,1,1,3,Low-Value,Lost
21212,1201,1,"7,7",2,1,1,4,Low-Value,Can't Lose
21213,245,4,"398,15",5,1,1,7,Mid-Value,Potential Loyalists
21215,533,3,"1052,8",4,1,2,7,Mid-Value,Potential Loyalists
21217,131,13,"1060,6",5,3,2,10,High-Value,Champions
21218,644,8,"245,8",4,2,1,7,Mid-Value,Potential Loyalists
21220,171,6,"255,95",5,1,1,7,Mid-Value,Potential Loyalists
21221,528,6,"358,05",4,1,1,6,Mid-Value,Potential Loyalists
21222,1023,1,"42,1",3,1,1,5,Low-Value,At Risk Customers
21225,653,3,"573,9",4,1,1,6,Mid-Value,Potential Loyalists
21226,54,6,"291,35",5,1,1,7,Mid-Value,Potential Loyalists
21229,717,2,"61,5",4,1,1,6,Mid-Value,Potential Loyalists
21231,80,8,"184,7",5,2,1,8,High-Value,Potential Loyalists
21232,1271,1,"70,80000000000001",2,1,1,4,Low-Value,Can't Lose
21233,152,6,"548,75",5,1,1,7,Mid-Value,Potential Loyalists
21238,167,2,"250,4",5,1,1,7,Mid-Value,Potential Loyalists
21239,1447,1,"33,4",2,1,1,4,Low-Value,Can't Lose
21241,26,3,"183,2",5,1,1,7,Mid-Value,Potential Loyalists
21242,977,2,"94,0",3,1,1,5,Low-Value,At Risk Customers
21243,4,4,"112,15",5,1,1,7,Mid-Value,Potential Loyalists
21244,381,7,"473,54999999999995",4,2,1,7,Mid-Value,Potential Loyalists
21245,817,11,"824,4499999999999",3,2,2,7,Mid-Value,Potential Loyalists
21246,756,1,"118,8",3,1,1,5,Low-Value,At Risk Customers
21247,644,1,"38,65",4,1,1,6,Mid-Value,Potential Loyalists
21248,58,3,"130,3",5,1,1,7,Mid-Value,Potential Loyalists
21249,630,4,"353,2",4,1,1,6,Mid-Value,Potential Loyalists
21252,1274,1,"31,6",2,1,1,4,Low-Value,Can't Lose
21253,395,2,"100,39999999999999",4,1,1,6,Mid-Value,Potential Loyalists
21256,731,2,"47,55",3,1,1,5,Low-Value,At Risk Customers
21258,53,1,"61,3",5,1,1,7,Mid-Value,Potential Loyalists
21259,153,3,"109,35",5,1,1,7,Mid-Value,Potential Loyalists
21262,703,1,"17,55",4,1,1,6,Mid-Value,Potential Loyalists
21264,766,2,"60,449999999999996",3,1,1,5,Low-Value,At Risk Customers
21265,661,4,"209,89999999999998",4,1,1,6,Mid-Value,Potential Loyalists
21266,97,2,"36,95",5,1,1,7,Mid-Value,Potential Loyalists
21267,1263,1,"147,45",2,1,1,4,Low-Value,Can't Lose
21270,85,9,"362,8",5,2,1,8,High-Value,Potential Loyalists
21271,1617,1,"46,25",1,1,1,3,Low-Value,Lost
21272,408,4,"158,5",4,1,1,6,Mid-Value,Potential Loyalists
21273,651,1,"76,1",4,1,1,6,Mid-Value,Potential Loyalists
21274,684,5,"176,45",4,1,1,6,Mid-Value,Potential Loyalists
21275,151,7,"385,79999999999995",5,2,1,8,High-Value,Potential Loyalists
21277,937,1,"78,0",3,1,1,5,Low-Value,At Risk Customers
21278,376,5,"404,85",4,1,1,6,Mid-Value,Potential Loyalists
21279,1242,1,"48,1",2,1,1,4,Low-Value,Can't Lose
21280,16,3,"465,25000000000006",5,1,1,7,Mid-Value,Potential Loyalists
21281,466,5,"433,2",4,1,1,6,Mid-Value,Potential Loyalists
21282,22,3,"218,35000000000002",5,1,1,7,Mid-Value,Potential Loyalists
21285,1419,1,"25,2",2,1,1,4,Low-Value,Can't Lose
21288,91,2,"10,5",5,1,1,7,Mid-Value,Potential Loyalists
21289,1382,1,"64,95",2,1,1,4,Low-Value,Can't Lose
21290,1425,2,"27,95",2,1,1,4,Low-Value,Can't Lose
21291,717,1,"289,95",4,1,1,6,Mid-Value,Potential Loyalists
21292,150,1,"268,95000000000005",5,1,1,7,Mid-Value,Potential Loyalists
21293,505,3,"97,25",4,1,1,6,Mid-Value,Potential Loyalists
21296,388,5,"582,2",4,1,1,6,Mid-Value,Potential Loyalists
21297,14,9,"602,7",5,2,1,8,High-Value,Potential Loyalists
21303,1701,1,"51,3",1,1,1,3,Low-Value,Lost
21304,162,5,"121,1",5,1,1,7,Mid-Value,Potential Loyalists
21305,1400,3,"390,25",2,1,1,4,Low-Value,Can't Lose
21306,639,2,"45,5",4,1,1,6,Mid-Value,Potential Loyalists
21309,378,2,"207,5",4,1,1,6,Mid-Value,Potential Loyalists
21311,15,4,"213,4",5,1,1,7,Mid-Value,Potential Loyalists
21312,22,5,"140,75",5,1,1,7,Mid-Value,Potential Loyalists
21313,125,8,"366,25",5,2,1,8,High-Value,Potential Loyalists
21314,740,7,"586,95",3,2,1,6,Mid-Value,Potential Loyalists
21315,138,5,"396,0",5,1,1,7,Mid-Value,Potential Loyalists
21316,1503,2,"54,400000000000006",1,1,1,3,Low-Value,Lost
21319,1638,1,"15,4",1,1,1,3,Low-Value,Lost
21321,886,5,"341,95000000000005",3,1,1,5,Low-Value,At Risk Customers
21322,1106,2,"251,6",2,1,1,4,Low-Value,Can't Lose
21323,535,2,"77,7",4,1,1,6,Mid-Value,Potential Loyalists
21325,162,3,"123,25",5,1,1,7,Mid-Value,Potential Loyalists
21327,1108,1,"31,9",2,1,1,4,Low-Value,Can't Lose
21328,390,5,"664,4",4,1,2,7,Mid-Value,Potential Loyalists
21329,867,4,"104,0",3,1,1,5,Low-Value,At Risk Customers
21331,23,5,"528,3",5,1,1,7,Mid-Value,Potential Loyalists
21332,1627,1,"79,35",1,1,1,3,Low-Value,Lost
21334,527,3,"208,1",4,1,1,6,Mid-Value,Potential Loyalists
21335,4,7,"318,0",5,2,1,8,High-Value,Potential Loyalists
21338,295,2,"41,849999999999994",5,1,1,7,Mid-Value,Potential Loyalists
21339,17,1,"70,0",5,1,1,7,Mid-Value,Potential Loyalists
21340,34,3,"235,6",5,1,1,7,Mid-Value,Potential Loyalists
21341,1626,1,"19,75",1,1,1,3,Low-Value,Lost
21343,10,3,"374,00000000000006",5,1,1,7,Mid-Value,Potential Loyalists
21344,1514,1,"144,65",1,1,1,3,Low-Value,Lost
21345,244,5,"220,3",5,1,1,7,Mid-Value,Potential Loyalists
21346,322,4,"466,8",5,1,1,7,Mid-Value,Potential Loyalists
21347,238,2,"43,8",5,1,1,7,Mid-Value,Potential Loyalists
21349,96,4,"673,85",5,1,2,8,High-Value,Potential Loyalists
21353,960,1,"115,05000000000001",3,1,1,5,Low-Value,At Risk Customers
21354,237,5,"451,1",5,1,1,7,Mid-Value,Potential Loyalists
21355,151,1,"23,75",5,1,1,7,Mid-Value,Potential Loyalists
21356,1228,2,"109,95",2,1,1,4,Low-Value,Can't Lose
21357,192,4,"228,6",5,1,1,7,Mid-Value,Potential Loyalists
21358,546,2,"202,45",4,1,1,6,Mid-Value,Potential Loyalists
21360,67,2,"145,0",5,1,1,7,Mid-Value,Potential Loyalists
21362,739,3,"119,7",3,1,1,5,Low-Value,At Risk Customers
21365,62,5,"454,5",5,1,1,7,Mid-Value,Potential Loyalists
21366,1433,1,"60,25",2,1,1,4,Low-Value,Can't Lose
21367,437,1,"8,5",4,1,1,6,Mid-Value,Potential Loyalists
21368,509,1,"59,5",4,1,1,6,Mid-Value,Potential Loyalists
21369,392,1,"175,4",4,1,1,6,Mid-Value,Potential Loyalists
21374,659,1,"53,7",4,1,1,6,Mid-Value,Potential Loyalists
21375,753,2,"163,55",3,1,1,5,Low-Value,At Risk Customers
21376,43,7,"401,55",5,2,1,8,High-Value,Potential Loyalists
21377,160,5,"708,0999999999999",5,1,2,8,High-Value,Potential Loyalists
21380,229,1,"6,45",5,1,1,7,Mid-Value,Potential Loyalists
21382,53,3,"78,35",5,1,1,7,Mid-Value,Potential Loyalists
21384,378,4,"288,8",4,1,1,6,Mid-Value,Potential Loyalists
21385,86,2,"311,35",5,1,1,7,Mid-Value,Potential Loyalists
21390,754,4,"121,4",3,1,1,5,Low-Value,At Risk Customers
21392,444,3,"137,9",4,1,1,6,Mid-Value,Potential Loyalists
21393,221,7,"542,6",5,2,1,8,High-Value,Potential Loyalists
21394,1300,4,"164,85",2,1,1,4,Low-Value,Can't Lose
21395,148,7,"830,5999999999999",5,2,2,9,High-Value,Champions
21396,442,5,"144,60000000000002",4,1,1,6,Mid-Value,Potential Loyalists
21397,498,3,"50,7",4,1,1,6,Mid-Value,Potential Loyalists
21399,176,2,"140,05",5,1,1,7,Mid-Value,Potential Loyalists
21401,196,2,"240,75",5,1,1,7,Mid-Value,Potential Loyalists
21402,395,7,"498,9",4,2,1,7,Mid-Value,Potential Loyalists
21403,549,2,"108,5",4,1,1,6,Mid-Value,Potential Loyalists
21405,27,1,"65,8",5,1,1,7,Mid-Value,Potential Loyalists
21406,768,9,"470,55",3,2,1,6,Mid-Value,Potential Loyalists
21407,428,8,"221,75",4,2,1,7,Mid-Value,Potential Loyalists
21408,551,2,"176,10000000000002",4,1,1,6,Mid-Value,Potential Loyalists
21411,11,13,"650,3",5,3,1,9,High-Value,Champions
21412,33,8,"425,55",5,2,1,8,High-Value,Potential Loyalists
21413,1333,1,"28,3",2,1,1,4,Low-Value,Can't Lose
21415,1592,5,"191,5",1,1,1,3,Low-Value,Lost
21418,23,9,"885,7",5,2,2,9,High-Value,Champions
21420,1515,2,"79,5",1,1,1,3,Low-Value,Lost
21422,1028,1,"97,85",3,1,1,5,Low-Value,At Risk Customers
21424,851,3,"76,4",3,1,1,5,Low-Value,At Risk Customers
21426,152,3,"167,55",5,1,1,7,Mid-Value,Potential Loyalists
21427,1264,1,"28,5",2,1,1,4,Low-Value,Can't Lose
21428,428,2,"91,35",4,1,1,6,Mid-Value,Potential Loyalists
21432,1154,1,"33,0",2,1,1,4,Low-Value,Can't Lose
21433,774,3,"266,65",3,1,1,5,Low-Value,At Risk Customers
21435,535,1,"21,5",4,1,1,6,Mid-Value,Potential Loyalists
21436,637,2,"24,650000000000002",4,1,1,6,Mid-Value,Potential Loyalists
21437,865,1,"80,3",3,1,1,5,Low-Value,At Risk Customers
21439,1232,3,"319,4",2,1,1,4,Low-Value,Can't Lose
21440,507,2,"59,3",4,1,1,6,Mid-Value,Potential Loyalists
21441,162,2,"277,20000000000005",5,1,1,7,Mid-Value,Potential Loyalists
21442,54,4,"367,25",5,1,1,7,Mid-Value,Potential Loyalists
21443,794,1,"9,55",3,1,1,5,Low-Value,At Risk Customers
21444,1306,1,"42,1",2,1,1,4,Low-Value,Can't Lose
21445,864,5,"265,25",3,1,1,5,Low-Value,At Risk Customers
21446,179,15,"1447,15",5,3,3,11,High-Value,Champions
21447,17,3,"145,55",5,1,1,7,Mid-Value,Potential Loyalists
21448,1299,1,"26,8",2,1,1,4,Low-Value,Can't Lose
21449,768,11,"306,05",3,2,1,6,Mid-Value,Potential Loyalists
21450,617,3,"37,75",4,1,1,6,Mid-Value,Potential Loyalists
21451,830,2,"94,3",3,1,1,5,Low-Value,At Risk Customers
21453,81,1,"6,45",5,1,1,7,Mid-Value,Potential Loyalists
21456,264,1,"20,2",5,1,1,7,Mid-Value,Potential Loyalists
21461,779,2,"322,75",3,1,1,5,Low-Value,At Risk Customers
21462,169,4,"96,7",5,1,1,7,Mid-Value,Potential Loyalists
21463,1179,2,"148,45",2,1,1,4,Low-Value,Can't Lose
21465,413,5,"133,8",4,1,1,6,Mid-Value,Potential Loyalists
21468,200,2,"87,10000000000001",5,1,1,7,Mid-Value,Potential Loyalists
21471,667,2,"111,5",4,1,1,6,Mid-Value,Potential Loyalists
21472,922,1,"42,900000000000006",3,1,1,5,Low-Value,At Risk Customers
21473,292,2,"63,5",5,1,1,7,Mid-Value,Potential Loyalists
21477,1328,2,"148,25",2,1,1,4,Low-Value,Can't Lose
21479,959,1,"21,9",3,1,1,5,Low-Value,At Risk Customers
21480,5,6,"601,7",5,1,1,7,Mid-Value,Potential Loyalists
21481,1006,1,"37,8",3,1,1,5,Low-Value,At Risk Customers
21482,759,4,"217,70000000000002",3,1,1,5,Low-Value,At Risk Customers
21484,170,3,"1075,95",5,1,2,8,High-Value,Potential Loyalists
21487,220,1,"56,3",5,1,1,7,Mid-Value,Potential Loyalists
21488,52,1,"96,1",5,1,1,7,Mid-Value,Potential Loyalists
21489,610,1,"10,25",4,1,1,6,Mid-Value,Potential Loyalists
21493,1272,1,"38,5",2,1,1,4,Low-Value,Can't Lose
21494,441,5,"374,45",4,1,1,6,Mid-Value,Potential Loyalists
21497,164,4,"965,1999999999999",5,1,2,8,High-Value,Potential Loyalists
21498,405,2,"15,95",4,1,1,6,Mid-Value,Potential Loyalists
21499,1758,1,"17,1",1,1,1,3,Low-Value,Lost
21500,113,6,"512,75",5,1,1,7,Mid-Value,Potential Loyalists
21501,1049,1,"16,65",3,1,1,5,Low-Value,At Risk Customers
21502,1012,2,"211,55",3,1,1,5,Low-Value,At Risk Customers
21504,335,2,"28,7",5,1,1,7,Mid-Value,Potential Loyalists
21506,150,3,"210,04999999999998",5,1,1,7,Mid-Value,Potential Loyalists
21507,121,1,"8,6",5,1,1,7,Mid-Value,Potential Loyalists
21508,260,4,"320,8",5,1,1,7,Mid-Value,Potential Loyalists
21509,140,7,"590,8499999999999",5,2,1,8,High-Value,Potential Loyalists
21510,468,1,"67,5",4,1,1,6,Mid-Value,Potential Loyalists
21511,18,6,"873,35",5,1,2,8,High-Value,Potential Loyalists
21512,578,3,"28,9",4,1,1,6,Mid-Value,Potential Loyalists
21514,38,4,"70,55",5,1,1,7,Mid-Value,Potential Loyalists
21516,324,1,"48,1",5,1,1,7,Mid-Value,Potential Loyalists
21519,1684,1,"22,8",1,1,1,3,Low-Value,Lost
21520,677,2,"28,6",4,1,1,6,Mid-Value,Potential Loyalists
21521,814,4,"81,35",3,1,1,5,Low-Value,At Risk Customers
21522,235,8,"375,1",5,2,1,8,High-Value,Potential Loyalists
21523,1068,1,"37,85",3,1,1,5,Low-Value,At Risk Customers
21524,1012,1,"54,6",3,1,1,5,Low-Value,At Risk Customers
21525,1017,1,"41,3",3,1,1,5,Low-Value,At Risk Customers
21526,5,5,"328,84999999999997",5,1,1,7,Mid-Value,Potential Loyalists
21527,244,2,"45,3",5,1,1,7,Mid-Value,Potential Loyalists
21528,49,1,"23,45",5,1,1,7,Mid-Value,Potential Loyalists
21530,1116,4,"123,64999999999999",2,1,1,4,Low-Value,Can't Lose
21531,447,9,"352,2",4,2,1,7,Mid-Value,Potential Loyalists
21532,1064,2,"158,05",3,1,1,5,Low-Value,At Risk Customers
21533,194,4,"128,2",5,1,1,7,Mid-Value,Potential Loyalists
21535,256,2,"25,35",5,1,1,7,Mid-Value,Potential Loyalists
21536,472,4,"280,5",4,1,1,6,Mid-Value,Potential Loyalists
21537,196,6,"354,85",5,1,1,7,Mid-Value,Potential Loyalists
21538,130,3,"118,05",5,1,1,7,Mid-Value,Potential Loyalists
21539,439,2,"161,0",4,1,1,6,Mid-Value,Potential Loyalists
21540,847,3,"150,7",3,1,1,5,Low-Value,At Risk Customers
21541,134,4,"124,35",5,1,1,7,Mid-Value,Potential Loyalists
21543,38,3,"156,25",5,1,1,7,Mid-Value,Potential Loyalists
21544,1498,2,"465,90000000000003",1,1,1,3,Low-Value,Lost
21545,1383,1,"11,3",2,1,1,4,Low-Value,Can't Lose
21548,14,6,"233,7",5,1,1,7,Mid-Value,Potential Loyalists
21549,1683,1,"25,799999999999997",1,1,1,3,Low-Value,Lost
21550,265,3,"201,99999999999997",5,1,1,7,Mid-Value,Potential Loyalists
21552,453,1,"67,8",4,1,1,6,Mid-Value,Potential Loyalists
21553,935,2,"44,8",3,1,1,5,Low-Value,At Risk Customers
21555,113,5,"311,44",5,1,1,7,Mid-Value,Potential Loyalists
21556,824,4,"205,3",3,1,1,5,Low-Value,At Risk Customers
21557,482,4,"371,29999999999995",4,1,1,6,Mid-Value,Potential Loyalists
21559,1022,1,"161,8",3,1,1,5,Low-Value,At Risk Customers
21560,952,1,"17,95",3,1,1,5,Low-Value,At Risk Customers
21561,255,4,"324,65",5,1,1,7,Mid-Value,Potential Loyalists
21563,471,1,"12,6",4,1,1,6,Mid-Value,Potential Loyalists
21565,24,16,"745,15",5,3,2,10,High-Value,Champions
21566,204,5,"144,3",5,1,1,7,Mid-Value,Potential Loyalists
21567,370,8,"543,87",4,2,1,7,Mid-Value,Potential Loyalists
21568,1693,1,"193,75",1,1,1,3,Low-Value,Lost
21570,823,3,"108,05",3,1,1,5,Low-Value,At Risk Customers
21571,609,5,"525,2",4,1,1,6,Mid-Value,Potential Loyalists
21574,201,1,"100,8",5,1,1,7,Mid-Value,Potential Loyalists
21576,1177,2,"48,45",2,1,1,4,Low-Value,Can't Lose
21580,434,1,"35,75",4,1,1,6,Mid-Value,Potential Loyalists
21582,207,5,"176,3",5,1,1,7,Mid-Value,Potential Loyalists
21585,38,2,"45,55",5,1,1,7,Mid-Value,Potential Loyalists
21588,152,4,"491,15",5,1,1,7,Mid-Value,Potential Loyalists
21589,1586,1,"50,5",1,1,1,3,Low-Value,Lost
21590,149,3,"251,70000000000002",5,1,1,7,Mid-Value,Potential Loyalists
21591,327,3,"93,6",5,1,1,7,Mid-Value,Potential Loyalists
21595,1433,1,"14,0",2,1,1,4,Low-Value,Can't Lose
21598,1557,1,"57,4",1,1,1,3,Low-Value,Lost
21599,176,9,"913,1",5,2,2,9,High-Value,Champions
21601,1425,1,"18,7",2,1,1,4,Low-Value,Can't Lose
21604,1141,2,"39,8",2,1,1,4,Low-Value,Can't Lose
21606,1702,1,"141,0",1,1,1,3,Low-Value,Lost
21607,204,4,"247,25",5,1,1,7,Mid-Value,Potential Loyalists
21608,271,2,"126,75",5,1,1,7,Mid-Value,Potential Loyalists
21609,1121,1,"486,6",2,1,1,4,Low-Value,Can't Lose
21610,17,6,"302,2",5,1,1,7,Mid-Value,Potential Loyalists
21612,165,2,"78,8",5,1,1,7,Mid-Value,Potential Loyalists
21613,784,3,"294,5",3,1,1,5,Low-Value,At Risk Customers
21614,1251,2,"41,7",2,1,1,4,Low-Value,Can't Lose
21615,1465,1,"25,6",1,1,1,3,Low-Value,Lost
21617,409,3,"48,0",4,1,1,6,Mid-Value,Potential Loyalists
21619,288,2,"223,9",5,1,1,7,Mid-Value,Potential Loyalists
21620,391,6,"370,35",4,1,1,6,Mid-Value,Potential Loyalists
21622,663,2,"39,9",4,1,1,6,Mid-Value,Potential Loyalists
21623,225,9,"507,84999999999997",5,2,1,8,High-Value,Potential Loyalists
21624,375,11,"337,6",4,2,1,7,Mid-Value,Potential Loyalists
21626,266,5,"312,55",5,1,1,7,Mid-Value,Potential Loyalists
21627,1623,1,"105,8",1,1,1,3,Low-Value,Lost
21630,470,4,"384,45",4,1,1,6,Mid-Value,Potential Loyalists
21631,1501,1,"142,2",1,1,1,3,Low-Value,Lost
21632,615,5,"179,05",4,1,1,6,Mid-Value,Potential Loyalists
21634,143,4,"262,2",5,1,1,7,Mid-Value,Potential Loyalists
21635,93,6,"1306,3",5,1,2,8,High-Value,Potential Loyalists
21637,626,5,"268,8",4,1,1,6,Mid-Value,Potential Loyalists
21638,181,2,"43,900000000000006",5,1,1,7,Mid-Value,Potential Loyalists
21639,47,7,"440,85",5,2,1,8,High-Value,Potential Loyalists
21640,820,1,"70,7",3,1,1,5,Low-Value,At Risk Customers
21641,217,3,"90,85",5,1,1,7,Mid-Value,Potential Loyalists
21642,1265,2,"35,8",2,1,1,4,Low-Value,Can't Lose
21643,318,4,"348,4",5,1,1,7,Mid-Value,Potential Loyalists
21644,1191,1,"10,0",2,1,1,4,Low-Value,Can't Lose
21645,550,2,"69,15",4,1,1,6,Mid-Value,Potential Loyalists
21646,661,4,"307,5",4,1,1,6,Mid-Value,Potential Loyalists
21648,24,5,"377,05000000000007",5,1,1,7,Mid-Value,Potential Loyalists
21650,431,4,"341,4",4,1,1,6,Mid-Value,Potential Loyalists
21651,1494,2,"61,5",1,1,1,3,Low-Value,Lost
21655,1630,2,"63,1",1,1,1,3,Low-Value,Lost
21657,1385,2,"167,65",2,1,1,4,Low-Value,Can't Lose
21658,41,9,"300,77",5,2,1,8,High-Value,Potential Loyalists
21659,257,3,"369,05",5,1,1,7,Mid-Value,Potential Loyalists
21660,248,7,"1208,0",5,2,2,9,High-Value,Champions
21661,67,5,"260,0",5,1,1,7,Mid-Value,Potential Loyalists
21662,141,4,"114,75",5,1,1,7,Mid-Value,Potential Loyalists
21663,372,2,"189,39999999999998",4,1,1,6,Mid-Value,Potential Loyalists
21664,406,4,"322,0",4,1,1,6,Mid-Value,Potential Loyalists
21667,377,1,"316,8",4,1,1,6,Mid-Value,Potential Loyalists
21670,87,9,"491,5",5,2,1,8,High-Value,Potential Loyalists
21671,1380,1,"29,1",2,1,1,4,Low-Value,Can't Lose
21672,740,8,"569,75",3,2,1,6,Mid-Value,Potential Loyalists
21673,47,1,"17,5",5,1,1,7,Mid-Value,Potential Loyalists
21674,601,4,"231,0",4,1,1,6,Mid-Value,Potential Loyalists
21675,7,1,"282,75",5,1,1,7,Mid-Value,Potential Loyalists
21677,1572,1,"11,5",1,1,1,3,Low-Value,Lost
21678,267,2,"195,85",5,1,1,7,Mid-Value,Potential Loyalists
21681,66,5,"161,5",5,1,1,7,Mid-Value,Potential Loyalists
21682,612,4,"115,5",4,1,1,6,Mid-Value,Potential Loyalists
21683,432,1,"9,3",4,1,1,6,Mid-Value,Potential Loyalists
21684,180,3,"383,4",5,1,1,7,Mid-Value,Potential Loyalists
21685,1632,2,"48,0",1,1,1,3,Low-Value,Lost
21686,244,3,"114,69999999999999",5,1,1,7,Mid-Value,Potential Loyalists
21687,600,2,"53,7",4,1,1,6,Mid-Value,Potential Loyalists
21688,116,2,"162,95",5,1,1,7,Mid-Value,Potential Loyalists
21690,236,1,"28,7",5,1,1,7,Mid-Value,Potential Loyalists
21692,666,5,"307,45",4,1,1,6,Mid-Value,Potential Loyalists
21696,33,9,"957,2",5,2,2,9,High-Value,Champions
21698,1792,1,"174,75",1,1,1,3,Low-Value,Lost
21701,447,7,"215,3",4,2,1,7,Mid-Value,Potential Loyalists
21702,235,2,"42,25",5,1,1,7,Mid-Value,Potential Loyalists
21703,239,6,"140,20000000000002",5,1,1,7,Mid-Value,Potential Loyalists
21705,836,2,"94,85",3,1,1,5,Low-Value,At Risk Customers
21706,150,6,"536,1999999999999",5,1,1,7,Mid-Value,Potential Loyalists
21707,84,3,"248,55",5,1,1,7,Mid-Value,Potential Loyalists
21709,928,2,"159,39999999999998",3,1,1,5,Low-Value,At Risk Customers
21710,792,2,"61,5",3,1,1,5,Low-Value,At Risk Customers
21711,364,1,"34,1",5,1,1,7,Mid-Value,Potential Loyalists
21712,121,4,"581,3",5,1,1,7,Mid-Value,Potential Loyalists
21713,145,7,"329,05",5,2,1,8,High-Value,Potential Loyalists
21714,755,4,"705,65",3,1,2,6,Mid-Value,Potential Loyalists
21718,232,1,"4,4",5,1,1,7,Mid-Value,Potential Loyalists
21719,53,8,"199,75",5,2,1,8,High-Value,Potential Loyalists
21720,365,7,"443,40000000000003",5,2,1,8,High-Value,Potential Loyalists
21722,243,4,"50,8",5,1,1,7,Mid-Value,Potential Loyalists
21723,245,5,"56,0",5,1,1,7,Mid-Value,Potential Loyalists
21724,824,2,"46,7",3,1,1,5,Low-Value,At Risk Customers
21726,368,3,"101,9",4,1,1,6,Mid-Value,Potential Loyalists
21727,176,3,"294,45",5,1,1,7,Mid-Value,Potential Loyalists
21728,1688,1,"209,6",1,1,1,3,Low-Value,Lost
21729,175,9,"406,55",5,2,1,8,High-Value,Potential Loyalists
21732,314,1,"3,1",5,1,1,7,Mid-Value,Potential Loyalists
21734,156,3,"82,5",5,1,1,7,Mid-Value,Potential Loyalists
21735,2,6,"713,1",5,1,2,8,High-Value,Potential Loyalists
21738,773,5,"329,85",3,1,1,5,Low-Value,At Risk Customers
21739,82,1,"6,55",5,1,1,7,Mid-Value,Potential Loyalists
21741,351,3,"151,45",5,1,1,7,Mid-Value,Potential Loyalists
21742,70,5,"148,5",5,1,1,7,Mid-Value,Potential Loyalists
21743,807,2,"116,4",3,1,1,5,Low-Value,At Risk Customers
21744,26,3,"65,5",5,1,1,7,Mid-Value,Potential Loyalists
21745,1624,2,"76,0",1,1,1,3,Low-Value,Lost
21748,452,3,"121,69999999999999",4,1,1,6,Mid-Value,Potential Loyalists
21749,904,2,"58,8",3,1,1,5,Low-Value,At Risk Customers
21750,209,4,"495,35",5,1,1,7,Mid-Value,Potential Loyalists
21751,841,5,"808,0",3,1,2,6,Mid-Value,Potential Loyalists
21752,111,3,"225,95",5,1,1,7,Mid-Value,Potential Loyalists
21754,329,3,"178,65",5,1,1,7,Mid-Value,Potential Loyalists
21755,922,1,"18,7",3,1,1,5,Low-Value,At Risk Customers
21756,1207,1,"10,1",2,1,1,4,Low-Value,Can't Lose
21757,1683,1,"15,95",1,1,1,3,Low-Value,Lost
21758,636,1,"162,6",4,1,1,6,Mid-Value,Potential Loyalists
21759,62,1,"12,25",5,1,1,7,Mid-Value,Potential Loyalists
21760,118,1,"40,7",5,1,1,7,Mid-Value,Potential Loyalists
21761,13,1,"61,6",5,1,1,7,Mid-Value,Potential Loyalists
21764,10,9,"312,0",5,2,1,8,High-Value,Potential Loyalists
21765,240,2,"25,4",5,1,1,7,Mid-Value,Potential Loyalists
21766,1499,1,"209,5",1,1,1,3,Low-Value,Lost
21767,1475,1,"121,0",1,1,1,3,Low-Value,Lost
21768,498,4,"583,5",4,1,1,6,Mid-Value,Potential Loyalists
21769,701,7,"991,65",4,2,2,8,High-Value,Potential Loyalists
21773,150,2,"96,8",5,1,1,7,Mid-Value,Potential Loyalists
21774,417,4,"153,6",4,1,1,6,Mid-Value,Potential Loyalists
21775,449,13,"539,5",4,3,1,8,High-Value,Potential Loyalists
21776,61,8,"1068,35",5,2,2,9,High-Value,Champions
21778,1538,3,"537,5",1,1,1,3,Low-Value,Lost
21781,412,2,"25,85",4,1,1,6,Mid-Value,Potential Loyalists
21785,423,5,"190,2",4,1,1,6,Mid-Value,Potential Loyalists
21786,19,4,"197,45",5,1,1,7,Mid-Value,Potential Loyalists
21787,160,1,"43,2",5,1,1,7,Mid-Value,Potential Loyalists
21788,420,2,"116,29999999999998",4,1,1,6,Mid-Value,Potential Loyalists
21789,1621,3,"79,80000000000001",1,1,1,3,Low-Value,Lost
21790,48,7,"415,95",5,2,1,8,High-Value,Potential Loyalists
21791,894,4,"141,7",3,1,1,5,Low-Value,At Risk Customers
21794,69,1,"19,7",5,1,1,7,Mid-Value,Potential Loyalists
21796,669,4,"268,6",4,1,1,6,Mid-Value,Potential Loyalists
21798,309,3,"163,8",5,1,1,7,Mid-Value,Potential Loyalists
21799,1179,1,"28,55",2,1,1,4,Low-Value,Can't Lose
21800,405,2,"147,4",4,1,1,6,Mid-Value,Potential Loyalists
21801,1263,1,"122,8",2,1,1,4,Low-Value,Can't Lose
21802,38,6,"634,95",5,1,1,7,Mid-Value,Potential Loyalists
21803,1632,2,"53,849999999999994",1,1,1,3,Low-Value,Lost
21804,487,2,"22,55",4,1,1,6,Mid-Value,Potential Loyalists
21806,427,5,"428,9",4,1,1,6,Mid-Value,Potential Loyalists
21807,12,2,"52,0",5,1,1,7,Mid-Value,Potential Loyalists
21808,5,6,"696,6",5,1,2,8,High-Value,Potential Loyalists
21810,67,2,"92,5",5,1,1,7,Mid-Value,Potential Loyalists
21811,66,3,"92,7",5,1,1,7,Mid-Value,Potential Loyalists
21812,666,6,"144,85",4,1,1,6,Mid-Value,Potential Loyalists
21814,14,3,"264,55",5,1,1,7,Mid-Value,Potential Loyalists
21815,1385,1,"59,6",2,1,1,4,Low-Value,Can't Lose
21816,362,1,"135,0",5,1,1,7,Mid-Value,Potential Loyalists
21817,3,3,"233,10000000000002",5,1,1,7,Mid-Value,Potential Loyalists
21818,978,1,"41,3",3,1,1,5,Low-Value,At Risk Customers
21820,959,2,"69,25",3,1,1,5,Low-Value,At Risk Customers
21823,244,1,"164,05",5,1,1,7,Mid-Value,Potential Loyalists
21824,512,1,"597,0",4,1,1,6,Mid-Value,Potential Loyalists
21826,221,1,"36,65",5,1,1,7,Mid-Value,Potential Loyalists
21827,454,9,"201,70000000000002",4,2,1,7,Mid-Value,Potential Loyalists
21829,1447,1,"25,5",2,1,1,4,Low-Value,Can't Lose
21831,820,2,"472,3",3,1,1,5,Low-Value,At Risk Customers
21832,501,2,"91,35",4,1,1,6,Mid-Value,Potential Loyalists
21833,398,4,"237,45",4,1,1,6,Mid-Value,Potential Loyalists
21835,1761,1,"17,55",1,1,1,3,Low-Value,Lost
21836,1070,5,"396,1",3,1,1,5,Low-Value,At Risk Customers
21837,188,5,"251,15",5,1,1,7,Mid-Value,Potential Loyalists
21838,91,6,"147,8",5,1,1,7,Mid-Value,Potential Loyalists
21839,383,8,"174,2",4,2,1,7,Mid-Value,Potential Loyalists
21840,20,5,"211,3",5,1,1,7,Mid-Value,Potential Loyalists
21841,489,1,"37,5",4,1,1,6,Mid-Value,Potential Loyalists
21842,1003,1,"20,45",3,1,1,5,Low-Value,At Risk Customers
21843,263,4,"211,10000000000002",5,1,1,7,Mid-Value,Potential Loyalists
21847,155,5,"289,45",5,1,1,7,Mid-Value,Potential Loyalists
21848,795,1,"21,05",3,1,1,5,Low-Value,At Risk Customers
21849,953,5,"254,65",3,1,1,5,Low-Value,At Risk Customers
21850,157,6,"242,55",5,1,1,7,Mid-Value,Potential Loyalists
21851,390,1,"57,150000000000006",4,1,1,6,Mid-Value,Potential Loyalists
21852,1435,1,"42,1",2,1,1,4,Low-Value,Can't Lose
21854,1347,3,"50,6",2,1,1,4,Low-Value,Can't Lose
21855,209,4,"387,8",5,1,1,7,Mid-Value,Potential Loyalists
21859,316,5,"162,39999999999998",5,1,1,7,Mid-Value,Potential Loyalists
21862,313,3,"151,0",5,1,1,7,Mid-Value,Potential Loyalists
21867,115,3,"431,85",5,1,1,7,Mid-Value,Potential Loyalists
21868,1617,1,"62,1",1,1,1,3,Low-Value,Lost
21869,127,2,"137,7",5,1,1,7,Mid-Value,Potential Loyalists
21871,854,3,"123,94999999999999",3,1,1,5,Low-Value,At Risk Customers
21873,37,6,"239,8",5,1,1,7,Mid-Value,Potential Loyalists
21874,530,1,"23,9",4,1,1,6,Mid-Value,Potential Loyalists
21875,572,2,"54,150000000000006",4,1,1,6,Mid-Value,Potential Loyalists
21879,57,5,"522,8",5,1,1,7,Mid-Value,Potential Loyalists
21881,922,2,"181,4",3,1,1,5,Low-Value,At Risk Customers
21882,85,5,"235,29999999999998",5,1,1,7,Mid-Value,Potential Loyalists
21884,1111,1,"26,8",2,1,1,4,Low-Value,Can't Lose
21885,393,3,"118,45",4,1,1,6,Mid-Value,Potential Loyalists
21887,372,3,"94,19999999999999",4,1,1,6,Mid-Value,Potential Loyalists
21889,546,3,"297,25",4,1,1,6,Mid-Value,Potential Loyalists
21890,98,6,"434,25",5,1,1,7,Mid-Value,Potential Loyalists
21891,985,1,"42,45",3,1,1,5,Low-Value,At Risk Customers
21893,383,7,"362,35",4,2,1,7,Mid-Value,Potential Loyalists
21894,1642,1,"60,2",1,1,1,3,Low-Value,Lost
21895,203,5,"381,8",5,1,1,7,Mid-Value,Potential Loyalists
21896,1230,2,"110,2",2,1,1,4,Low-Value,Can't Lose
21897,1465,1,"149,05",1,1,1,3,Low-Value,Lost
21898,14,4,"181,1",5,1,1,7,Mid-Value,Potential Loyalists
21899,949,1,"9,5",3,1,1,5,Low-Value,At Risk Customers
21901,458,10,"418,15000000000003",4,2,1,7,Mid-Value,Potential Loyalists
21902,1175,1,"6,1",2,1,1,4,Low-Value,Can't Lose
21904,194,7,"845,1",5,2,2,9,High-Value,Champions
21905,223,4,"451,45",5,1,1,7,Mid-Value,Potential Loyalists
21907,957,3,"127,64999999999999",3,1,1,5,Low-Value,At Risk Customers
21908,29,6,"337,0",5,1,1,7,Mid-Value,Potential Loyalists
21911,183,2,"152,54999999999998",5,1,1,7,Mid-Value,Potential Loyalists
21912,399,6,"171,75",4,1,1,6,Mid-Value,Potential Loyalists
21914,350,3,"688,75",5,1,2,8,High-Value,Potential Loyalists
21915,748,4,"220,9",3,1,1,5,Low-Value,At Risk Customers
21917,256,7,"554,8",5,2,1,8,High-Value,Potential Loyalists
21918,238,5,"260,7",5,1,1,7,Mid-Value,Potential Loyalists
21919,647,2,"50,45",4,1,1,6,Mid-Value,Potential Loyalists
21920,221,2,"69,95",5,1,1,7,Mid-Value,Potential Loyalists
21921,125,3,"135,95",5,1,1,7,Mid-Value,Potential Loyalists
21922,230,4,"177,95",5,1,1,7,Mid-Value,Potential Loyalists
21923,596,4,"276,7",4,1,1,6,Mid-Value,Potential Loyalists
21927,1305,2,"55,25",2,1,1,4,Low-Value,Can't Lose
21928,1433,3,"310,4",2,1,1,4,Low-Value,Can't Lose
21929,227,1,"177,60000000000002",5,1,1,7,Mid-Value,Potential Loyalists
21930,835,1,"60,4",3,1,1,5,Low-Value,At Risk Customers
21931,801,1,"33,9",3,1,1,5,Low-Value,At Risk Customers
21933,294,3,"182,35",5,1,1,7,Mid-Value,Potential Loyalists
21934,731,2,"22,95",3,1,1,5,Low-Value,At Risk Customers
21935,456,9,"230,75",4,2,1,7,Mid-Value,Potential Loyalists
21936,535,2,"123,95",4,1,1,6,Mid-Value,Potential Loyalists
21941,1173,1,"23,9",2,1,1,4,Low-Value,Can't Lose
21942,211,7,"441,36",5,2,1,8,High-Value,Potential Loyalists
21943,64,4,"462,25",5,1,1,7,Mid-Value,Potential Loyalists
21944,947,1,"155,55",3,1,1,5,Low-Value,At Risk Customers
21946,401,2,"38,85",4,1,1,6,Mid-Value,Potential Loyalists
21947,8,6,"425,85",5,1,1,7,Mid-Value,Potential Loyalists
21948,264,6,"246,1",5,1,1,7,Mid-Value,Potential Loyalists
21953,10,10,"1081,95",5,2,2,9,High-Value,Champions
21954,744,4,"278,0",3,1,1,5,Low-Value,At Risk Customers
21957,1709,2,"164,2",1,1,1,3,Low-Value,Lost
21960,837,9,"364,0",3,2,1,6,Mid-Value,Potential Loyalists
21962,234,2,"199,5",5,1,1,7,Mid-Value,Potential Loyalists
21963,1080,2,"80,75",3,1,1,5,Low-Value,At Risk Customers
21964,396,2,"224,25",4,1,1,6,Mid-Value,Potential Loyalists
21965,746,3,"262,7",3,1,1,5,Low-Value,At Risk Customers
21966,523,4,"154,95",4,1,1,6,Mid-Value,Potential Loyalists
21967,1366,1,"9,65",2,1,1,4,Low-Value,Can't Lose
21968,794,4,"140,35",3,1,1,5,Low-Value,At Risk Customers
21969,464,4,"48,45",4,1,1,6,Mid-Value,Potential Loyalists
21971,248,5,"188,1",5,1,1,7,Mid-Value,Potential Loyalists
21973,118,2,"77,5",5,1,1,7,Mid-Value,Potential Loyalists
21974,457,2,"73,45",4,1,1,6,Mid-Value,Potential Loyalists
21975,770,2,"17,0",3,1,1,5,Low-Value,At Risk Customers
21976,815,3,"515,45",3,1,1,5,Low-Value,At Risk Customers
21977,462,1,"79,9",4,1,1,6,Mid-Value,Potential Loyalists
21979,85,8,"530,5",5,2,1,8,High-Value,Potential Loyalists
21980,628,2,"172,1",4,1,1,6,Mid-Value,Potential Loyalists
21981,205,4,"99,35",5,1,1,7,Mid-Value,Potential Loyalists
21982,22,4,"337,8",5,1,1,7,Mid-Value,Potential Loyalists
21983,996,1,"29,5",3,1,1,5,Low-Value,At Risk Customers
21986,1769,1,"15,9",1,1,1,3,Low-Value,Lost
21987,41,3,"76,7",5,1,1,7,Mid-Value,Potential Loyalists
21989,453,2,"61,95",4,1,1,6,Mid-Value,Potential Loyalists
21991,1419,1,"309,1",2,1,1,4,Low-Value,Can't Lose
21992,407,3,"93,65",4,1,1,6,Mid-Value,Potential Loyalists
21993,58,4,"182,1",5,1,1,7,Mid-Value,Potential Loyalists
21994,52,9,"407,25",5,2,1,8,High-Value,Potential Loyalists
21995,320,3,"131,1",5,1,1,7,Mid-Value,Potential Loyalists
21996,95,5,"480,35",5,1,1,7,Mid-Value,Potential Loyalists
21998,56,11,"555,2",5,2,1,8,High-Value,Potential Loyalists
21999,218,2,"97,25",5,1,1,7,Mid-Value,Potential Loyalists
22000,308,2,"138,8",5,1,1,7,Mid-Value,Potential Loyalists
22001,1040,1,"40,75",3,1,1,5,Low-Value,At Risk Customers
22002,144,4,"488,95",5,1,1,7,Mid-Value,Potential Loyalists
22003,1438,1,"24,299999999999997",2,1,1,4,Low-Value,Can't Lose
22004,890,3,"484,2",3,1,1,5,Low-Value,At Risk Customers
22009,260,3,"267,05",5,1,1,7,Mid-Value,Potential Loyalists
22012,579,7,"504,55",4,2,1,7,Mid-Value,Potential Loyalists
22014,19,4,"451,9",5,1,1,7,Mid-Value,Potential Loyalists
22016,5,4,"200,55",5,1,1,7,Mid-Value,Potential Loyalists
22018,1286,1,"12,9",2,1,1,4,Low-Value,Can't Lose
22019,58,8,"202,85",5,2,1,8,High-Value,Potential Loyalists
22020,94,2,"154,89999999999998",5,1,1,7,Mid-Value,Potential Loyalists
22022,455,1,"15,5",4,1,1,6,Mid-Value,Potential Loyalists
22023,1352,1,"28,0",2,1,1,4,Low-Value,Can't Lose
22024,1002,2,"669,15",3,1,2,6,Mid-Value,Potential Loyalists
22025,488,1,"60,7",4,1,1,6,Mid-Value,Potential Loyalists
22026,855,1,"43,650000000000006",3,1,1,5,Low-Value,At Risk Customers
22027,140,3,"273,3",5,1,1,7,Mid-Value,Potential Loyalists
22028,195,10,"933,05",5,2,2,9,High-Value,Champions
22029,928,2,"86,75",3,1,1,5,Low-Value,At Risk Customers
22030,447,3,"173,25",4,1,1,6,Mid-Value,Potential Loyalists
22031,160,2,"92,15",5,1,1,7,Mid-Value,Potential Loyalists
22032,381,2,"69,35",4,1,1,6,Mid-Value,Potential Loyalists
22033,630,2,"79,65",4,1,1,6,Mid-Value,Potential Loyalists
22034,1005,2,"310,35",3,1,1,5,Low-Value,At Risk Customers
22035,91,9,"576,55",5,2,1,8,High-Value,Potential Loyalists
22036,61,7,"379,6",5,2,1,8,High-Value,Potential Loyalists
22037,398,9,"962,2",4,2,2,8,High-Value,Potential Loyalists
22039,1087,1,"20,9",3,1,1,5,Low-Value,At Risk Customers
22044,238,3,"418,0",5,1,1,7,Mid-Value,Potential Loyalists
22045,247,8,"234,39999999999998",5,2,1,8,High-Value,Potential Loyalists
22048,336,7,"371,59999999999997",5,2,1,8,High-Value,Potential Loyalists
22049,78,9,"507,45",5,2,1,8,High-Value,Potential Loyalists
22051,46,5,"262,8",5,1,1,7,Mid-Value,Potential Loyalists
22052,458,7,"393,09999999999997",4,2,1,7,Mid-Value,Potential Loyalists
22055,1436,1,"19,9",2,1,1,4,Low-Value,Can't Lose
22057,25,2,"159,5",5,1,1,7,Mid-Value,Potential Loyalists
22060,447,12,"623,15",4,3,1,8,High-Value,Potential Loyalists
22061,620,3,"71,1",4,1,1,6,Mid-Value,Potential Loyalists
22062,1106,2,"132,8",2,1,1,4,Low-Value,Can't Lose
22064,25,1,"2,85",5,1,1,7,Mid-Value,Potential Loyalists
22065,132,9,"694,65",5,2,2,9,High-Value,Champions
22066,943,5,"307,25",3,1,1,5,Low-Value,At Risk Customers
22067,63,4,"244,85",5,1,1,7,Mid-Value,Potential Loyalists
22069,507,6,"204,15",4,1,1,6,Mid-Value,Potential Loyalists
22071,899,1,"143,25",3,1,1,5,Low-Value,At Risk Customers
22072,878,5,"564,45",3,1,1,5,Low-Value,At Risk Customers
22073,577,4,"122,45",4,1,1,6,Mid-Value,Potential Loyalists
22075,1465,1,"77,0",1,1,1,3,Low-Value,Lost
22076,148,7,"1106,7",5,2,2,9,High-Value,Champions
22077,231,2,"97,30000000000001",5,1,1,7,Mid-Value,Potential Loyalists
22078,624,3,"195,0",4,1,1,6,Mid-Value,Potential Loyalists
22079,857,5,"538,75",3,1,1,5,Low-Value,At Risk Customers
22080,592,2,"142,25",4,1,1,6,Mid-Value,Potential Loyalists
22081,798,3,"63,900000000000006",3,1,1,5,Low-Value,At Risk Customers
22082,679,4,"255,3",4,1,1,6,Mid-Value,Potential Loyalists
22085,80,12,"865,65",5,3,2,10,High-Value,Champions
22088,91,8,"1464,05",5,2,3,10,High-Value,Champions
22089,321,3,"378,9",5,1,1,7,Mid-Value,Potential Loyalists
22091,126,9,"1130,85",5,2,2,9,High-Value,Champions
22092,43,5,"254,55",5,1,1,7,Mid-Value,Potential Loyalists
22094,383,5,"257,8",4,1,1,6,Mid-Value,Potential Loyalists
22095,353,7,"317,35",5,2,1,8,High-Value,Potential Loyalists
22097,278,2,"138,75",5,1,1,7,Mid-Value,Potential Loyalists
22098,342,3,"160,6",5,1,1,7,Mid-Value,Potential Loyalists
22099,1672,1,"34,5",1,1,1,3,Low-Value,Lost
22100,1411,2,"58,599999999999994",2,1,1,4,Low-Value,Can't Lose
22101,88,5,"219,4",5,1,1,7,Mid-Value,Potential Loyalists
22102,14,3,"84,0",5,1,1,7,Mid-Value,Potential Loyalists
22104,674,2,"129,9",4,1,1,6,Mid-Value,Potential Loyalists
22105,613,1,"39,1",4,1,1,6,Mid-Value,Potential Loyalists
22106,761,3,"271,35",3,1,1,5,Low-Value,At Risk Customers
22107,346,1,"7,75",5,1,1,7,Mid-Value,Potential Loyalists
22111,702,3,"345,70000000000005",4,1,1,6,Mid-Value,Potential Loyalists
22112,223,4,"269,30000000000007",5,1,1,7,Mid-Value,Potential Loyalists
22113,568,3,"116,35",4,1,1,6,Mid-Value,Potential Loyalists
22116,332,7,"543,4",5,2,1,8,High-Value,Potential Loyalists
22117,1411,1,"75,5",2,1,1,4,Low-Value,Can't Lose
22118,1122,1,"3,8",2,1,1,4,Low-Value,Can't Lose
22119,401,8,"2015,8",4,2,4,10,High-Value,Champions
22120,190,2,"189,8",5,1,1,7,Mid-Value,Potential Loyalists
22121,148,6,"386,65",5,1,1,7,Mid-Value,Potential Loyalists
22124,556,2,"28,450000000000003",4,1,1,6,Mid-Value,Potential Loyalists
22125,865,9,"512,95",3,2,1,6,Mid-Value,Potential Loyalists
22126,27,7,"769,3499999999999",5,2,2,9,High-Value,Champions
22127,119,4,"190,35",5,1,1,7,Mid-Value,Potential Loyalists
22128,544,1,"27,2",4,1,1,6,Mid-Value,Potential Loyalists
22130,1151,1,"9,5",2,1,1,4,Low-Value,Can't Lose
22134,2,12,"1396,85",5,3,3,11,High-Value,Champions
22139,249,5,"446,3",5,1,1,7,Mid-Value,Potential Loyalists
22140,1446,1,"9,85",2,1,1,4,Low-Value,Can't Lose
22141,131,2,"165,6",5,1,1,7,Mid-Value,Potential Loyalists
22142,618,3,"192,20000000000002",4,1,1,6,Mid-Value,Potential Loyalists
22143,508,1,"398,09999999999997",4,1,1,6,Mid-Value,Potential Loyalists
22144,206,4,"153,35000000000002",5,1,1,7,Mid-Value,Potential Loyalists
22145,1441,1,"81,4",2,1,1,4,Low-Value,Can't Lose
22147,238,9,"439,15",5,2,1,8,High-Value,Potential Loyalists
22149,18,5,"515,55",5,1,1,7,Mid-Value,Potential Loyalists
22150,185,2,"27,8",5,1,1,7,Mid-Value,Potential Loyalists
22151,432,4,"68,6",4,1,1,6,Mid-Value,Potential Loyalists
22152,535,1,"12,1",4,1,1,6,Mid-Value,Potential Loyalists
22154,344,3,"292,4",5,1,1,7,Mid-Value,Potential Loyalists
22155,1540,1,"51,4",1,1,1,3,Low-Value,Lost
22156,159,7,"350,65",5,2,1,8,High-Value,Potential Loyalists
22158,667,1,"22,8",4,1,1,6,Mid-Value,Potential Loyalists
22159,716,1,"10,5",4,1,1,6,Mid-Value,Potential Loyalists
22161,1662,3,"307,30000000000007",1,1,1,3,Low-Value,Lost
22164,444,3,"149,15",4,1,1,6,Mid-Value,Potential Loyalists
22165,130,3,"205,90000000000003",5,1,1,7,Mid-Value,Potential Loyalists
22166,772,4,"290,75",3,1,1,5,Low-Value,At Risk Customers
22167,157,3,"109,85",5,1,1,7,Mid-Value,Potential Loyalists
22168,1262,2,"18,9",2,1,1,4,Low-Value,Can't Lose
22169,449,4,"220,3",4,1,1,6,Mid-Value,Potential Loyalists
22170,1,12,"546,3",5,3,1,9,High-Value,Champions
22172,301,1,"34,15",5,1,1,7,Mid-Value,Potential Loyalists
22173,1128,2,"118,4",2,1,1,4,Low-Value,Can't Lose
22174,309,1,"35,1",5,1,1,7,Mid-Value,Potential Loyalists
22176,861,2,"118,85",3,1,1,5,Low-Value,At Risk Customers
22177,1218,3,"61,55",2,1,1,4,Low-Value,Can't Lose
22179,1092,1,"10,0",3,1,1,5,Low-Value,At Risk Customers
22180,293,2,"18,85",5,1,1,7,Mid-Value,Potential Loyalists
22181,410,5,"106,25",4,1,1,6,Mid-Value,Potential Loyalists
22183,63,6,"123,35",5,1,1,7,Mid-Value,Potential Loyalists
22185,994,1,"25,45",3,1,1,5,Low-Value,At Risk Customers
22188,12,2,"80,45",5,1,1,7,Mid-Value,Potential Loyalists
22190,205,3,"124,64999999999999",5,1,1,7,Mid-Value,Potential Loyalists
22193,905,1,"147,7",3,1,1,5,Low-Value,At Risk Customers
22194,952,4,"93,8",3,1,1,5,Low-Value,At Risk Customers
22196,200,7,"368,35",5,2,1,8,High-Value,Potential Loyalists
22197,188,2,"144,5",5,1,1,7,Mid-Value,Potential Loyalists
22199,21,4,"279,15",5,1,1,7,Mid-Value,Potential Loyalists
22201,1456,1,"10,05",2,1,1,4,Low-Value,Can't Lose
22203,649,2,"96,94999999999999",4,1,1,6,Mid-Value,Potential Loyalists
22205,205,3,"109,35",5,1,1,7,Mid-Value,Potential Loyalists
22207,540,2,"297,8",4,1,1,6,Mid-Value,Potential Loyalists
22208,1499,2,"162,25",1,1,1,3,Low-Value,Lost
22209,1222,3,"318,35",2,1,1,4,Low-Value,Can't Lose
22210,1313,1,"90,4",2,1,1,4,Low-Value,Can't Lose
22211,198,6,"684,1",5,1,2,8,High-Value,Potential Loyalists
22212,952,1,"12,15",3,1,1,5,Low-Value,At Risk Customers
22213,73,4,"142,35",5,1,1,7,Mid-Value,Potential Loyalists
22214,887,1,"237,8",3,1,1,5,Low-Value,At Risk Customers
22216,179,3,"140,8",5,1,1,7,Mid-Value,Potential Loyalists
22219,1004,2,"74,15",3,1,1,5,Low-Value,At Risk Customers
22221,490,6,"243,4",4,1,1,6,Mid-Value,Potential Loyalists
22222,915,3,"215,05",3,1,1,5,Low-Value,At Risk Customers
22223,187,6,"136,1",5,1,1,7,Mid-Value,Potential Loyalists
22224,42,4,"178,89999999999998",5,1,1,7,Mid-Value,Potential Loyalists
22225,270,3,"117,6",5,1,1,7,Mid-Value,Potential Loyalists
22226,18,4,"336,05",5,1,1,7,Mid-Value,Potential Loyalists
22228,197,9,"675,85",5,2,2,9,High-Value,Champions
22229,157,5,"189,65",5,1,1,7,Mid-Value,Potential Loyalists
22231,1653,1,"18,45",1,1,1,3,Low-Value,Lost
22232,734,4,"133,35",3,1,1,5,Low-Value,At Risk Customers
22233,284,4,"166,71",5,1,1,7,Mid-Value,Potential Loyalists
22234,1100,1,"69,8",2,1,1,4,Low-Value,Can't Lose
22235,742,5,"370,95",3,1,1,5,Low-Value,At Risk Customers
22237,454,6,"367,0",4,1,1,6,Mid-Value,Potential Loyalists
22238,908,5,"366,7",3,1,1,5,Low-Value,At Risk Customers
22240,194,4,"331,6",5,1,1,7,Mid-Value,Potential Loyalists
22241,527,4,"161,3",4,1,1,6,Mid-Value,Potential Loyalists
22245,705,1,"36,1",4,1,1,6,Mid-Value,Potential Loyalists
22247,1154,3,"118,95",2,1,1,4,Low-Value,Can't Lose
22248,1447,1,"17,85",2,1,1,4,Low-Value,Can't Lose
22249,37,11,"1184,7",5,2,2,9,High-Value,Champions
22250,811,1,"18,9",3,1,1,5,Low-Value,At Risk Customers
22252,18,1,"35,5",5,1,1,7,Mid-Value,Potential Loyalists
22253,7,2,"110,6",5,1,1,7,Mid-Value,Potential Loyalists
22255,514,1,"42,7",4,1,1,6,Mid-Value,Potential Loyalists
22257,129,3,"94,05000000000001",5,1,1,7,Mid-Value,Potential Loyalists
22258,368,2,"220,00000000000003",4,1,1,6,Mid-Value,Potential Loyalists
22261,204,6,"143,2",5,1,1,7,Mid-Value,Potential Loyalists
22262,374,3,"281,85",4,1,1,6,Mid-Value,Potential Loyalists
22263,1223,2,"94,75",2,1,1,4,Low-Value,Can't Lose
22265,120,5,"339,2",5,1,1,7,Mid-Value,Potential Loyalists
22266,197,6,"341,59999999999997",5,1,1,7,Mid-Value,Potential Loyalists
22267,722,1,"486,4",4,1,1,6,Mid-Value,Potential Loyalists
22268,1058,2,"104,45",3,1,1,5,Low-Value,At Risk Customers
22269,501,4,"260,15",4,1,1,6,Mid-Value,Potential Loyalists
22276,1377,4,"156,1",2,1,1,4,Low-Value,Can't Lose
22277,503,2,"103,4",4,1,1,6,Mid-Value,Potential Loyalists
22278,391,1,"48,6",4,1,1,6,Mid-Value,Potential Loyalists
22279,87,11,"403,75",5,2,1,8,High-Value,Potential Loyalists
22280,329,1,"63,2",5,1,1,7,Mid-Value,Potential Loyalists
22282,1157,2,"22,0",2,1,1,4,Low-Value,Can't Lose
22283,11,3,"158,9",5,1,1,7,Mid-Value,Potential Loyalists
22285,925,1,"114,14999999999999",3,1,1,5,Low-Value,At Risk Customers
22287,391,8,"368,29999999999995",4,2,1,7,Mid-Value,Potential Loyalists
22289,251,3,"100,6",5,1,1,7,Mid-Value,Potential Loyalists
22291,527,4,"114,15",4,1,1,6,Mid-Value,Potential Loyalists
22296,310,1,"5,75",5,1,1,7,Mid-Value,Potential Loyalists
22297,118,3,"54,7",5,1,1,7,Mid-Value,Potential Loyalists
22299,1236,2,"24,5",2,1,1,4,Low-Value,Can't Lose
22300,396,9,"347,4",4,2,1,7,Mid-Value,Potential Loyalists
22303,259,3,"79,75",5,1,1,7,Mid-Value,Potential Loyalists
22305,885,4,"344,54999999999995",3,1,1,5,Low-Value,At Risk Customers
22308,875,1,"95,7",3,1,1,5,Low-Value,At Risk Customers
22310,55,4,"146,65",5,1,1,7,Mid-Value,Potential Loyalists
22311,842,1,"18,95",3,1,1,5,Low-Value,At Risk Customers
22313,738,7,"269,75",3,2,1,6,Mid-Value,Potential Loyalists
22316,758,3,"245,5",3,1,1,5,Low-Value,At Risk Customers
22318,21,2,"170,7",5,1,1,7,Mid-Value,Potential Loyalists
22319,1499,4,"198,5",1,1,1,3,Low-Value,Lost
22321,340,12,"1292,5",5,3,2,10,High-Value,Champions
22322,1341,1,"22,7",2,1,1,4,Low-Value,Can't Lose
22323,762,3,"148,9",3,1,1,5,Low-Value,At Risk Customers
22327,31,6,"336,25",5,1,1,7,Mid-Value,Potential Loyalists
22328,1087,1,"12,2",3,1,1,5,Low-Value,At Risk Customers
22329,886,2,"94,75",3,1,1,5,Low-Value,At Risk Customers
22330,37,1,"94,25",5,1,1,7,Mid-Value,Potential Loyalists
22332,470,2,"19,55",4,1,1,6,Mid-Value,Potential Loyalists
22333,108,4,"297,15",5,1,1,7,Mid-Value,Potential Loyalists
22334,369,1,"290,25",4,1,1,6,Mid-Value,Potential Loyalists
22335,348,3,"98,9",5,1,1,7,Mid-Value,Potential Loyalists
22336,216,5,"406,6",5,1,1,7,Mid-Value,Potential Loyalists
22338,33,6,"316,75",5,1,1,7,Mid-Value,Potential Loyalists
22339,322,3,"80,7",5,1,1,7,Mid-Value,Potential Loyalists
22340,1209,1,"54,0",2,1,1,4,Low-Value,Can't Lose
22343,331,1,"9,5",5,1,1,7,Mid-Value,Potential Loyalists
22344,1548,4,"300,7",1,1,1,3,Low-Value,Lost
22347,1033,2,"79,15",3,1,1,5,Low-Value,At Risk Customers
22349,71,5,"678,9",5,1,2,8,High-Value,Potential Loyalists
22351,43,4,"205,7",5,1,1,7,Mid-Value,Potential Loyalists
22357,1089,1,"43,9",3,1,1,5,Low-Value,At Risk Customers
22359,173,6,"249,1",5,1,1,7,Mid-Value,Potential Loyalists
22360,64,5,"298,25",5,1,1,7,Mid-Value,Potential Loyalists
22362,1287,1,"153,60000000000002",2,1,1,4,Low-Value,Can't Lose
22363,449,1,"20,6",4,1,1,6,Mid-Value,Potential Loyalists
22366,766,3,"142,14999999999998",3,1,1,5,Low-Value,At Risk Customers
22368,979,5,"683,1",3,1,2,6,Mid-Value,Potential Loyalists
22371,43,6,"183,55",5,1,1,7,Mid-Value,Potential Loyalists
22372,1152,2,"19,299999999999997",2,1,1,4,Low-Value,Can't Lose
22373,115,2,"165,7",5,1,1,7,Mid-Value,Potential Loyalists
22376,472,6,"636,45",4,1,1,6,Mid-Value,Potential Loyalists
22377,835,2,"133,35",3,1,1,5,Low-Value,At Risk Customers
22378,1626,1,"23,0",1,1,1,3,Low-Value,Lost
22379,176,3,"753,6999999999999",5,1,2,8,High-Value,Potential Loyalists
22380,857,2,"80,15",3,1,1,5,Low-Value,At Risk Customers
22381,738,1,"46,9",3,1,1,5,Low-Value,At Risk Customers
22382,375,2,"27,75",4,1,1,6,Mid-Value,Potential Loyalists
22384,20,2,"260,0",5,1,1,7,Mid-Value,Potential Loyalists
22386,1381,1,"117,2",2,1,1,4,Low-Value,Can't Lose
22387,1235,2,"217,45",2,1,1,4,Low-Value,Can't Lose
22388,754,2,"231,7",3,1,1,5,Low-Value,At Risk Customers
22389,843,1,"21,55",3,1,1,5,Low-Value,At Risk Customers
22390,7,10,"890,3000000000001",5,2,2,9,High-Value,Champions
22391,89,6,"362,65",5,1,1,7,Mid-Value,Potential Loyalists
22392,11,3,"176,25",5,1,1,7,Mid-Value,Potential Loyalists
22394,817,4,"228,9",3,1,1,5,Low-Value,At Risk Customers
22395,1142,1,"57,6",2,1,1,4,Low-Value,Can't Lose
22396,402,2,"121,8",4,1,1,6,Mid-Value,Potential Loyalists
22397,417,1,"44,6",4,1,1,6,Mid-Value,Potential Loyalists
22398,595,1,"9,2",4,1,1,6,Mid-Value,Potential Loyalists
22400,1139,2,"114,10000000000001",2,1,1,4,Low-Value,Can't Lose
22404,71,4,"202,0",5,1,1,7,Mid-Value,Potential Loyalists
22405,843,3,"135,8",3,1,1,5,Low-Value,At Risk Customers
22406,547,4,"181,35",4,1,1,6,Mid-Value,Potential Loyalists
22407,521,3,"45,1",4,1,1,6,Mid-Value,Potential Loyalists
22409,36,3,"41,550000000000004",5,1,1,7,Mid-Value,Potential Loyalists
22411,395,8,"568,1",4,2,1,7,Mid-Value,Potential Loyalists
22412,406,1,"34,1",4,1,1,6,Mid-Value,Potential Loyalists
22414,24,7,"268,5",5,2,1,8,High-Value,Potential Loyalists
22416,582,2,"97,25",4,1,1,6,Mid-Value,Potential Loyalists
22419,637,2,"55,300000000000004",4,1,1,6,Mid-Value,Potential Loyalists
22422,835,3,"44,85",3,1,1,5,Low-Value,At Risk Customers
22423,4,1,"26,3",5,1,1,7,Mid-Value,Potential Loyalists
22425,770,1,"9,5",3,1,1,5,Low-Value,At Risk Customers
22427,188,1,"33,5",5,1,1,7,Mid-Value,Potential Loyalists
22429,382,7,"340,40000000000003",4,2,1,7,Mid-Value,Potential Loyalists
22432,761,2,"142,5",3,1,1,5,Low-Value,At Risk Customers
22433,894,4,"355,85",3,1,1,5,Low-Value,At Risk Customers
22434,440,2,"218,75",4,1,1,6,Mid-Value,Potential Loyalists
22435,493,3,"213,64999999999998",4,1,1,6,Mid-Value,Potential Loyalists
22437,1180,2,"181,70000000000002",2,1,1,4,Low-Value,Can't Lose
22440,75,4,"497,55",5,1,1,7,Mid-Value,Potential Loyalists
22443,53,1,"62,85",5,1,1,7,Mid-Value,Potential Loyalists
22444,673,3,"136,70000000000002",4,1,1,6,Mid-Value,Potential Loyalists
22445,1007,3,"131,25",3,1,1,5,Low-Value,At Risk Customers
22446,1188,4,"153,0",2,1,1,4,Low-Value,Can't Lose
22448,1239,1,"48,8",2,1,1,4,Low-Value,Can't Lose
22449,1018,3,"169,6",3,1,1,5,Low-Value,At Risk Customers
22455,75,5,"361,2",5,1,1,7,Mid-Value,Potential Loyalists
22457,300,3,"237,49999999999997",5,1,1,7,Mid-Value,Potential Loyalists
22458,126,4,"236,75",5,1,1,7,Mid-Value,Potential Loyalists
22459,38,5,"1851,3500000000001",5,1,3,9,High-Value,Champions
22460,97,6,"176,9",5,1,1,7,Mid-Value,Potential Loyalists
22461,1624,1,"66,1",1,1,1,3,Low-Value,Lost
22462,26,4,"86,1",5,1,1,7,Mid-Value,Potential Loyalists
22463,207,5,"498,75",5,1,1,7,Mid-Value,Potential Loyalists
22464,66,2,"186,3",5,1,1,7,Mid-Value,Potential Loyalists
22465,243,8,"388,9",5,2,1,8,High-Value,Potential Loyalists
22467,1209,1,"14,5",2,1,1,4,Low-Value,Can't Lose
22469,1614,1,"56,7",1,1,1,3,Low-Value,Lost
22470,1022,1,"17,4",3,1,1,5,Low-Value,At Risk Customers
22471,540,5,"313,55",4,1,1,6,Mid-Value,Potential Loyalists
22472,370,4,"173,20000000000002",4,1,1,6,Mid-Value,Potential Loyalists
22473,182,9,"364,35",5,2,1,8,High-Value,Potential Loyalists
22475,383,3,"318,1",4,1,1,6,Mid-Value,Potential Loyalists
22477,342,1,"5,6",5,1,1,7,Mid-Value,Potential Loyalists
22478,137,6,"172,95",5,1,1,7,Mid-Value,Potential Loyalists
22479,177,5,"261,8",5,1,1,7,Mid-Value,Potential Loyalists
22480,43,3,"167,75",5,1,1,7,Mid-Value,Potential Loyalists
22481,1530,1,"20,2",1,1,1,3,Low-Value,Lost
22482,406,10,"818,1999999999999",4,2,2,8,High-Value,Potential Loyalists
22483,678,2,"72,05000000000001",4,1,1,6,Mid-Value,Potential Loyalists
22484,10,2,"182,14999999999998",5,1,1,7,Mid-Value,Potential Loyalists
22487,227,7,"461,15",5,2,1,8,High-Value,Potential Loyalists
22488,243,2,"95,0",5,1,1,7,Mid-Value,Potential Loyalists
22489,303,14,"999,85",5,3,2,10,High-Value,Champions
22490,1448,1,"16,9",2,1,1,4,Low-Value,Can't Lose
22491,71,8,"409,05",5,2,1,8,High-Value,Potential Loyalists
22493,367,3,"353,55",4,1,1,6,Mid-Value,Potential Loyalists
22495,855,4,"661,45",3,1,1,5,Low-Value,At Risk Customers
22496,292,4,"281,75",5,1,1,7,Mid-Value,Potential Loyalists
22497,174,3,"154,85",5,1,1,7,Mid-Value,Potential Loyalists
22498,16,5,"127,39999999999999",5,1,1,7,Mid-Value,Potential Loyalists
22499,1298,1,"61,9",2,1,1,4,Low-Value,Can't Lose
22500,1615,1,"6,1",1,1,1,3,Low-Value,Lost
22501,1674,1,"195,7",1,1,1,3,Low-Value,Lost
22503,324,7,"262,2",5,2,1,8,High-Value,Potential Loyalists
22505,1628,2,"210,7",1,1,1,3,Low-Value,Lost
22506,65,1,"11,7",5,1,1,7,Mid-Value,Potential Loyalists
22507,276,6,"600,6",5,1,1,7,Mid-Value,Potential Loyalists
22514,146,5,"342,75",5,1,1,7,Mid-Value,Potential Loyalists
22515,200,4,"220,2",5,1,1,7,Mid-Value,Potential Loyalists
22516,56,4,"197,3",5,1,1,7,Mid-Value,Potential Loyalists
22517,174,3,"63,85",5,1,1,7,Mid-Value,Potential Loyalists
22519,883,2,"758,5",3,1,2,6,Mid-Value,Potential Loyalists
22520,161,4,"273,2",5,1,1,7,Mid-Value,Potential Loyalists
22521,165,1,"39,0",5,1,1,7,Mid-Value,Potential Loyalists
22522,698,2,"323,6",4,1,1,6,Mid-Value,Potential Loyalists
22523,561,2,"140,6",4,1,1,6,Mid-Value,Potential Loyalists
22525,1396,2,"131,6",2,1,1,4,Low-Value,Can't Lose
22529,1448,1,"34,2",2,1,1,4,Low-Value,Can't Lose
22530,283,5,"127,05",5,1,1,7,Mid-Value,Potential Loyalists
22532,101,3,"272,3",5,1,1,7,Mid-Value,Potential Loyalists
22533,1232,2,"152,8",2,1,1,4,Low-Value,Can't Lose
22535,1349,5,"287,9",2,1,1,4,Low-Value,Can't Lose
22536,61,5,"104,95",5,1,1,7,Mid-Value,Potential Loyalists
22537,820,4,"74,60000000000001",3,1,1,5,Low-Value,At Risk Customers
22538,956,3,"114,39999999999999",3,1,1,5,Low-Value,At Risk Customers
22539,564,2,"192,15",4,1,1,6,Mid-Value,Potential Loyalists
22543,1769,1,"125,15",1,1,1,3,Low-Value,Lost
22546,12,2,"67,5",5,1,1,7,Mid-Value,Potential Loyalists
22550,8,6,"278,95",5,1,1,7,Mid-Value,Potential Loyalists
22551,1189,1,"13,75",2,1,1,4,Low-Value,Can't Lose
22554,185,3,"243,45000000000002",5,1,1,7,Mid-Value,Potential Loyalists
22557,179,9,"664,9",5,2,2,9,High-Value,Champions
22559,1659,1,"109,5",1,1,1,3,Low-Value,Lost
22560,82,1,"69,4",5,1,1,7,Mid-Value,Potential Loyalists
22561,463,1,"37,5",4,1,1,6,Mid-Value,Potential Loyalists
22562,278,1,"3,5",5,1,1,7,Mid-Value,Potential Loyalists
22565,145,2,"66,15",5,1,1,7,Mid-Value,Potential Loyalists
22566,1502,2,"164,25",1,1,1,3,Low-Value,Lost
22568,9,11,"507,55",5,2,1,8,High-Value,Potential Loyalists
22570,80,3,"187,2",5,1,1,7,Mid-Value,Potential Loyalists
22571,374,10,"1043,2",4,2,2,8,High-Value,Potential Loyalists
22572,72,4,"298,5",5,1,1,7,Mid-Value,Potential Loyalists
22573,406,2,"70,5",4,1,1,6,Mid-Value,Potential Loyalists
22574,410,1,"9,35",4,1,1,6,Mid-Value,Potential Loyalists
22578,1523,1,"19,7",1,1,1,3,Low-Value,Lost
22579,76,4,"190,5",5,1,1,7,Mid-Value,Potential Loyalists
22580,22,3,"417,0",5,1,1,7,Mid-Value,Potential Loyalists
22582,506,2,"203,00000000000003",4,1,1,6,Mid-Value,Potential Loyalists
22584,28,2,"456,45000000000005",5,1,1,7,Mid-Value,Potential Loyalists
22585,700,1,"5,6",4,1,1,6,Mid-Value,Potential Loyalists
22586,337,2,"118,19999999999999",5,1,1,7,Mid-Value,Potential Loyalists
22587,398,4,"368,34999999999997",4,1,1,6,Mid-Value,Potential Loyalists
22589,1231,1,"68,2",2,1,1,4,Low-Value,Can't Lose
22591,388,4,"240,4",4,1,1,6,Mid-Value,Potential Loyalists
22593,944,1,"18,9",3,1,1,5,Low-Value,At Risk Customers
22594,21,9,"272,95",5,2,1,8,High-Value,Potential Loyalists
22596,50,4,"86,4",5,1,1,7,Mid-Value,Potential Loyalists
22597,826,5,"278,55",3,1,1,5,Low-Value,At Risk Customers
22599,38,7,"145,55",5,2,1,8,High-Value,Potential Loyalists
22603,150,2,"34,05",5,1,1,7,Mid-Value,Potential Loyalists
22605,354,9,"670,4000000000001",5,2,2,9,High-Value,Champions
22607,1136,1,"10,23",2,1,1,4,Low-Value,Can't Lose
22610,991,1,"20,6",3,1,1,5,Low-Value,At Risk Customers
22611,520,4,"342,3",4,1,1,6,Mid-Value,Potential Loyalists
22612,474,3,"171,39999999999998",4,1,1,6,Mid-Value,Potential Loyalists
22617,550,2,"39,0",4,1,1,6,Mid-Value,Potential Loyalists
22620,42,4,"198,29999999999998",5,1,1,7,Mid-Value,Potential Loyalists
22621,187,3,"353,75",5,1,1,7,Mid-Value,Potential Loyalists
22622,728,2,"246,35000000000002",4,1,1,6,Mid-Value,Potential Loyalists
22623,49,1,"12,25",5,1,1,7,Mid-Value,Potential Loyalists
22624,459,10,"438,0",4,2,1,7,Mid-Value,Potential Loyalists
22625,608,3,"345,6",4,1,1,6,Mid-Value,Potential Loyalists
22626,172,4,"293,85",5,1,1,7,Mid-Value,Potential Loyalists
22627,917,2,"280,45",3,1,1,5,Low-Value,At Risk Customers
22628,745,1,"27,8",3,1,1,5,Low-Value,At Risk Customers
22630,1675,1,"15,4",1,1,1,3,Low-Value,Lost
22632,975,1,"134,7",3,1,1,5,Low-Value,At Risk Customers
22634,17,8,"433,03",5,2,1,8,High-Value,Potential Loyalists
22635,252,1,"117,60000000000001",5,1,1,7,Mid-Value,Potential Loyalists
22636,374,2,"214,2",4,1,1,6,Mid-Value,Potential Loyalists
22638,793,3,"127,30000000000001",3,1,1,5,Low-Value,At Risk Customers
22640,36,3,"85,65",5,1,1,7,Mid-Value,Potential Loyalists
22641,968,1,"39,2",3,1,1,5,Low-Value,At Risk Customers
22642,482,4,"111,35",4,1,1,6,Mid-Value,Potential Loyalists
22643,531,2,"214,8",4,1,1,6,Mid-Value,Potential Loyalists
22644,1043,3,"103,85",3,1,1,5,Low-Value,At Risk Customers
22645,35,4,"65,2",5,1,1,7,Mid-Value,Potential Loyalists
22646,1552,1,"5,1",1,1,1,3,Low-Value,Lost
22647,14,5,"447,45",5,1,1,7,Mid-Value,Potential Loyalists
22650,40,7,"292,8",5,2,1,8,High-Value,Potential Loyalists
22652,374,1,"158,0",4,1,1,6,Mid-Value,Potential Loyalists
22655,147,2,"68,9",5,1,1,7,Mid-Value,Potential Loyalists
22656,90,8,"570,2",5,2,1,8,High-Value,Potential Loyalists
22657,426,2,"83,8",4,1,1,6,Mid-Value,Potential Loyalists
22661,346,4,"218,95000000000002",5,1,1,7,Mid-Value,Potential Loyalists
22664,1384,2,"38,7",2,1,1,4,Low-Value,Can't Lose
22665,48,9,"477,05",5,2,1,8,High-Value,Potential Loyalists
22666,720,1,"316,8",4,1,1,6,Mid-Value,Potential Loyalists
22667,202,4,"579,6999999999999",5,1,1,7,Mid-Value,Potential Loyalists
22668,778,1,"165,95",3,1,1,5,Low-Value,At Risk Customers
22670,20,10,"405,35",5,2,1,8,High-Value,Potential Loyalists
22671,984,1,"69,2",3,1,1,5,Low-Value,At Risk Customers
22673,1538,1,"158,1",1,1,1,3,Low-Value,Lost
22675,244,7,"299,65",5,2,1,8,High-Value,Potential Loyalists
22680,1222,2,"354,35",2,1,1,4,Low-Value,Can't Lose
22681,351,1,"2,75",5,1,1,7,Mid-Value,Potential Loyalists
22682,30,7,"489,5",5,2,1,8,High-Value,Potential Loyalists
22683,60,2,"208,35",5,1,1,7,Mid-Value,Potential Loyalists
22685,1537,2,"98,30000000000001",1,1,1,3,Low-Value,Lost
22686,405,1,"6,25",4,1,1,6,Mid-Value,Potential Loyalists
22690,878,1,"100,4",3,1,1,5,Low-Value,At Risk Customers
22691,1242,2,"153,05",2,1,1,4,Low-Value,Can't Lose
22693,743,4,"479,6",3,1,1,5,Low-Value,At Risk Customers
22694,428,5,"365,7",4,1,1,6,Mid-Value,Potential Loyalists
22695,22,6,"538,4000000000001",5,1,1,7,Mid-Value,Potential Loyalists
22696,4,7,"377,0",5,2,1,8,High-Value,Potential Loyalists
22698,136,12,"646,4000000000001",5,3,1,9,High-Value,Champions
22700,1673,2,"29,5",1,1,1,3,Low-Value,Lost
22701,349,2,"67,45",5,1,1,7,Mid-Value,Potential Loyalists
22706,1806,1,"82,0",1,1,1,3,Low-Value,Lost
22708,704,1,"28,0",4,1,1,6,Mid-Value,Potential Loyalists
22709,862,1,"13,05",3,1,1,5,Low-Value,At Risk Customers
22710,1288,1,"54,5",2,1,1,4,Low-Value,Can't Lose
22711,818,4,"164,8",3,1,1,5,Low-Value,At Risk Customers
22712,67,4,"384,04999999999995",5,1,1,7,Mid-Value,Potential Loyalists
22714,892,3,"284,45000000000005",3,1,1,5,Low-Value,At Risk Customers
22715,61,3,"87,75",5,1,1,7,Mid-Value,Potential Loyalists
22716,130,1,"23,7",5,1,1,7,Mid-Value,Potential Loyalists
22720,1314,1,"14,5",2,1,1,4,Low-Value,Can't Lose
22722,380,9,"960,1",4,2,2,8,High-Value,Potential Loyalists
22723,1250,2,"27,5",2,1,1,4,Low-Value,Can't Lose
22724,1749,1,"74,15",1,1,1,3,Low-Value,Lost
22725,238,7,"613,6",5,2,1,8,High-Value,Potential Loyalists
22727,1366,2,"42,55",2,1,1,4,Low-Value,Can't Lose
22728,427,2,"87,44999999999999",4,1,1,6,Mid-Value,Potential Loyalists
22729,154,1,"12,0",5,1,1,7,Mid-Value,Potential Loyalists
22733,1263,1,"270,8",2,1,1,4,Low-Value,Can't Lose
22734,802,1,"7,8",3,1,1,5,Low-Value,At Risk Customers
22737,382,1,"25,9",4,1,1,6,Mid-Value,Potential Loyalists
22738,1033,1,"155,4",3,1,1,5,Low-Value,At Risk Customers
22741,762,1,"20,1",3,1,1,5,Low-Value,At Risk Customers
22744,1067,1,"128,85",3,1,1,5,Low-Value,At Risk Customers
22746,749,1,"129,9",3,1,1,5,Low-Value,At Risk Customers
22747,348,2,"180,75",5,1,1,7,Mid-Value,Potential Loyalists
22749,469,5,"346,7",4,1,1,6,Mid-Value,Potential Loyalists
22750,28,3,"155,7",5,1,1,7,Mid-Value,Potential Loyalists
22751,742,4,"47,5",3,1,1,5,Low-Value,At Risk Customers
22754,662,4,"121,3",4,1,1,6,Mid-Value,Potential Loyalists
22755,570,1,"68,6",4,1,1,6,Mid-Value,Potential Loyalists
22756,745,3,"641,25",3,1,1,5,Low-Value,At Risk Customers
22757,213,1,"45,3",5,1,1,7,Mid-Value,Potential Loyalists
22760,601,2,"49,0",4,1,1,6,Mid-Value,Potential Loyalists
22761,792,3,"74,5",3,1,1,5,Low-Value,At Risk Customers
22762,922,1,"29,849999999999998",3,1,1,5,Low-Value,At Risk Customers
22763,830,2,"25,6",3,1,1,5,Low-Value,At Risk Customers
22766,905,1,"17,2",3,1,1,5,Low-Value,At Risk Customers
22769,113,4,"280,5",5,1,1,7,Mid-Value,Potential Loyalists
22770,1305,4,"178,00000000000003",2,1,1,4,Low-Value,Can't Lose
22774,62,5,"228,65",5,1,1,7,Mid-Value,Potential Loyalists
22775,883,6,"269,5",3,1,1,5,Low-Value,At Risk Customers
22776,1600,1,"144,14999999999998",1,1,1,3,Low-Value,Lost
22778,1268,1,"19,65",2,1,1,4,Low-Value,Can't Lose
22780,44,2,"31,55",5,1,1,7,Mid-Value,Potential Loyalists
22781,379,5,"376,4",4,1,1,6,Mid-Value,Potential Loyalists
22783,435,4,"189,3",4,1,1,6,Mid-Value,Potential Loyalists
22784,871,1,"84,3",3,1,1,5,Low-Value,At Risk Customers
22786,306,1,"25,75",5,1,1,7,Mid-Value,Potential Loyalists
22787,175,3,"315,3",5,1,1,7,Mid-Value,Potential Loyalists
22789,117,5,"378,85",5,1,1,7,Mid-Value,Potential Loyalists
22791,222,4,"149,8",5,1,1,7,Mid-Value,Potential Loyalists
22792,177,4,"575,1",5,1,1,7,Mid-Value,Potential Loyalists
22793,713,2,"51,900000000000006",4,1,1,6,Mid-Value,Potential Loyalists
22794,21,6,"294,9",5,1,1,7,Mid-Value,Potential Loyalists
22795,339,6,"547,9499999999999",5,1,1,7,Mid-Value,Potential Loyalists
22796,1120,1,"237,4",2,1,1,4,Low-Value,Can't Lose
22797,208,2,"222,39999999999998",5,1,1,7,Mid-Value,Potential Loyalists
22798,776,1,"72,8",3,1,1,5,Low-Value,At Risk Customers
22799,238,3,"873,85",5,1,2,8,High-Value,Potential Loyalists
22800,922,3,"173,05",3,1,1,5,Low-Value,At Risk Customers
22802,938,1,"81,0",3,1,1,5,Low-Value,At Risk Customers
22803,323,1,"127,2",5,1,1,7,Mid-Value,Potential Loyalists
22804,27,9,"529,0",5,2,1,8,High-Value,Potential Loyalists
22805,414,6,"471,13",4,1,1,6,Mid-Value,Potential Loyalists
22806,324,4,"97,7",5,1,1,7,Mid-Value,Potential Loyalists
22807,1379,1,"9,7",2,1,1,4,Low-Value,Can't Lose
22809,267,4,"211,35",5,1,1,7,Mid-Value,Potential Loyalists
22811,1315,1,"16,2",2,1,1,4,Low-Value,Can't Lose
22814,838,3,"90,9",3,1,1,5,Low-Value,At Risk Customers
22816,26,6,"380,40000000000003",5,1,1,7,Mid-Value,Potential Loyalists
22817,27,3,"95,94999999999999",5,1,1,7,Mid-Value,Potential Loyalists
22821,1387,1,"78,5",2,1,1,4,Low-Value,Can't Lose
22822,937,1,"55,8",3,1,1,5,Low-Value,At Risk Customers
22823,79,6,"764,95",5,1,2,8,High-Value,Potential Loyalists
22824,886,2,"117,1",3,1,1,5,Low-Value,At Risk Customers
22827,1,2,"40,5",5,1,1,7,Mid-Value,Potential Loyalists
22828,1510,1,"40,85",1,1,1,3,Low-Value,Lost
22830,106,6,"391,45",5,1,1,7,Mid-Value,Potential Loyalists
22831,587,6,"348,79999999999995",4,1,1,6,Mid-Value,Potential Loyalists
22833,1679,1,"64,95",1,1,1,3,Low-Value,Lost
22837,951,3,"210,75",3,1,1,5,Low-Value,At Risk Customers
22840,1193,2,"110,0",2,1,1,4,Low-Value,Can't Lose
22841,442,3,"128,75",4,1,1,6,Mid-Value,Potential Loyalists
22842,1334,2,"41,95",2,1,1,4,Low-Value,Can't Lose
22844,529,1,"99,75",4,1,1,6,Mid-Value,Potential Loyalists
22846,218,6,"120,14999999999999",5,1,1,7,Mid-Value,Potential Loyalists
22847,962,1,"159,4",3,1,1,5,Low-Value,At Risk Customers
22851,1704,1,"38,75",1,1,1,3,Low-Value,Lost
22853,543,2,"169,45",4,1,1,6,Mid-Value,Potential Loyalists
22854,1345,1,"2,25",2,1,1,4,Low-Value,Can't Lose
22855,1195,2,"43,75",2,1,1,4,Low-Value,Can't Lose
22856,266,5,"159,35",5,1,1,7,Mid-Value,Potential Loyalists
22858,8,3,"127,14999999999999",5,1,1,7,Mid-Value,Potential Loyalists
22859,243,1,"125,85",5,1,1,7,Mid-Value,Potential Loyalists
22862,587,1,"189,60000000000002",4,1,1,6,Mid-Value,Potential Loyalists
22863,416,10,"272,9",4,2,1,7,Mid-Value,Potential Loyalists
22865,568,2,"72,15",4,1,1,6,Mid-Value,Potential Loyalists
22866,137,3,"95,75",5,1,1,7,Mid-Value,Potential Loyalists
22867,996,5,"351,4",3,1,1,5,Low-Value,At Risk Customers
22868,635,3,"465,5",4,1,1,6,Mid-Value,Potential Loyalists
22869,1005,1,"93,1",3,1,1,5,Low-Value,At Risk Customers
22870,896,2,"260,2",3,1,1,5,Low-Value,At Risk Customers
22871,18,6,"173,57999999999998",5,1,1,7,Mid-Value,Potential Loyalists
22873,512,8,"1071,8999999999999",4,2,2,8,High-Value,Potential Loyalists
22874,1123,1,"144,7",2,1,1,4,Low-Value,Can't Lose
22875,61,4,"63,4",5,1,1,7,Mid-Value,Potential Loyalists
22876,593,1,"233,7",4,1,1,6,Mid-Value,Potential Loyalists
22877,585,1,"26,099999999999998",4,1,1,6,Mid-Value,Potential Loyalists
22879,807,6,"94,3",3,1,1,5,Low-Value,At Risk Customers
22882,498,3,"107,3",4,1,1,6,Mid-Value,Potential Loyalists
22883,252,3,"85,05",5,1,1,7,Mid-Value,Potential Loyalists
22884,1223,2,"28,150000000000002",2,1,1,4,Low-Value,Can't Lose
22886,137,2,"63,89999999999999",5,1,1,7,Mid-Value,Potential Loyalists
22887,734,1,"50,9",3,1,1,5,Low-Value,At Risk Customers
22888,1694,2,"20,1",1,1,1,3,Low-Value,Lost
22889,381,7,"546,0500000000001",4,2,1,7,Mid-Value,Potential Loyalists
22890,100,9,"542,5",5,2,1,8,High-Value,Potential Loyalists
22891,888,1,"41,4",3,1,1,5,Low-Value,At Risk Customers
22892,87,5,"282,85",5,1,1,7,Mid-Value,Potential Loyalists
22896,553,2,"129,4",4,1,1,6,Mid-Value,Potential Loyalists
22897,1026,2,"515,35",3,1,1,5,Low-Value,At Risk Customers
22900,29,19,"1139,3",5,4,2,11,High-Value,Champions
22901,180,1,"11,5",5,1,1,7,Mid-Value,Potential Loyalists
22905,258,3,"128,35",5,1,1,7,Mid-Value,Potential Loyalists
22906,915,5,"175,4",3,1,1,5,Low-Value,At Risk Customers
22907,149,4,"333,65000000000003",5,1,1,7,Mid-Value,Potential Loyalists
22908,185,1,"13,4",5,1,1,7,Mid-Value,Potential Loyalists
22909,84,7,"238,05",5,2,1,8,High-Value,Potential Loyalists
22910,51,1,"12,85",5,1,1,7,Mid-Value,Potential Loyalists
22913,213,4,"156,3",5,1,1,7,Mid-Value,Potential Loyalists
22914,696,4,"330,65",4,1,1,6,Mid-Value,Potential Loyalists
22915,553,1,"18,75",4,1,1,6,Mid-Value,Potential Loyalists
22918,398,2,"25,049999999999997",4,1,1,6,Mid-Value,Potential Loyalists
22919,732,2,"408,35",3,1,1,5,Low-Value,At Risk Customers
22922,54,7,"230,60000000000002",5,2,1,8,High-Value,Potential Loyalists
22923,133,2,"79,75",5,1,1,7,Mid-Value,Potential Loyalists
22924,544,2,"177,95",4,1,1,6,Mid-Value,Potential Loyalists
22925,670,4,"210,0",4,1,1,6,Mid-Value,Potential Loyalists
22930,631,3,"79,6",4,1,1,6,Mid-Value,Potential Loyalists
22931,1682,2,"25,400000000000002",1,1,1,3,Low-Value,Lost
22935,1413,1,"10,6",2,1,1,4,Low-Value,Can't Lose
22936,1518,1,"50,4",1,1,1,3,Low-Value,Lost
22937,187,3,"181,2",5,1,1,7,Mid-Value,Potential Loyalists
22938,355,4,"206,45",5,1,1,7,Mid-Value,Potential Loyalists
22939,21,12,"900,95",5,3,2,10,High-Value,Champions
22940,131,10,"492,25",5,2,1,8,High-Value,Potential Loyalists
22942,512,2,"136,25",4,1,1,6,Mid-Value,Potential Loyalists
22943,1360,1,"29,5",2,1,1,4,Low-Value,Can't Lose
22946,54,3,"66,6",5,1,1,7,Mid-Value,Potential Loyalists
22947,618,2,"138,35000000000002",4,1,1,6,Mid-Value,Potential Loyalists
22948,1004,5,"309,65000000000003",3,1,1,5,Low-Value,At Risk Customers
22949,236,8,"199,3",5,2,1,8,High-Value,Potential Loyalists
22950,1076,1,"59,4",3,1,1,5,Low-Value,At Risk Customers
22951,1248,1,"31,0",2,1,1,4,Low-Value,Can't Lose
22952,1174,2,"554,45",2,1,1,4,Low-Value,Can't Lose
22954,399,3,"39,20000000000001",4,1,1,6,Mid-Value,Potential Loyalists
22955,1477,1,"48,15",1,1,1,3,Low-Value,Lost
22957,52,6,"283,2",5,1,1,7,Mid-Value,Potential Loyalists
22960,10,11,"768,3",5,2,2,9,High-Value,Champions
22961,31,6,"309,6",5,1,1,7,Mid-Value,Potential Loyalists
22962,3,1,"22,2",5,1,1,7,Mid-Value,Potential Loyalists
22963,1464,1,"77,4",1,1,1,3,Low-Value,Lost
22965,1238,9,"781,55",2,2,2,6,Mid-Value,Potential Loyalists
22966,1129,1,"29,5",2,1,1,4,Low-Value,Can't Lose
22967,395,1,"103,1",4,1,1,6,Mid-Value,Potential Loyalists
22968,137,1,"107,25",5,1,1,7,Mid-Value,Potential Loyalists
22969,1716,1,"27,45",1,1,1,3,Low-Value,Lost
22970,1322,1,"65,6",2,1,1,4,Low-Value,Can't Lose
22971,73,5,"273,8",5,1,1,7,Mid-Value,Potential Loyalists
22972,858,3,"286,75",3,1,1,5,Low-Value,At Risk Customers
22974,1325,1,"11,0",2,1,1,4,Low-Value,Can't Lose
22975,115,8,"861,3000000000001",5,2,2,9,High-Value,Champions
22978,1382,2,"117,7",2,1,1,4,Low-Value,Can't Lose
22980,45,4,"145,2",5,1,1,7,Mid-Value,Potential Loyalists
22983,536,7,"525,8",4,2,1,7,Mid-Value,Potential Loyalists
22985,264,2,"201,9",5,1,1,7,Mid-Value,Potential Loyalists
22987,1322,5,"154,15",2,1,1,4,Low-Value,Can't Lose
22989,1154,2,"76,15",2,1,1,4,Low-Value,Can't Lose
22990,315,3,"76,45",5,1,1,7,Mid-Value,Potential Loyalists
22991,233,2,"440,79999999999995",5,1,1,7,Mid-Value,Potential Loyalists
22993,81,6,"502,20000000000005",5,1,1,7,Mid-Value,Potential Loyalists
22994,690,3,"338,29999999999995",4,1,1,6,Mid-Value,Potential Loyalists
22996,1656,2,"219,95",1,1,1,3,Low-Value,Lost
22997,535,4,"233,55",4,1,1,6,Mid-Value,Potential Loyalists
22998,364,2,"14,3",5,1,1,7,Mid-Value,Potential Loyalists
22999,134,2,"191,7",5,1,1,7,Mid-Value,Potential Loyalists
23000,336,1,"13,75",5,1,1,7,Mid-Value,Potential Loyalists
23001,132,1,"15,6",5,1,1,7,Mid-Value,Potential Loyalists
23003,300,8,"421,3",5,2,1,8,High-Value,Potential Loyalists
23004,203,3,"76,6",5,1,1,7,Mid-Value,Potential Loyalists
23005,133,2,"235,79999999999998",5,1,1,7,Mid-Value,Potential Loyalists
23006,139,2,"209,04999999999998",5,1,1,7,Mid-Value,Potential Loyalists
23010,59,3,"194,85",5,1,1,7,Mid-Value,Potential Loyalists
23015,753,1,"398,0",3,1,1,5,Low-Value,At Risk Customers
23016,617,3,"486,65",4,1,1,6,Mid-Value,Potential Loyalists
23019,680,2,"52,55",4,1,1,6,Mid-Value,Potential Loyalists
23020,372,2,"92,25",4,1,1,6,Mid-Value,Potential Loyalists
23022,46,7,"192,15",5,2,1,8,High-Value,Potential Loyalists
23023,538,1,"626,0",4,1,1,6,Mid-Value,Potential Loyalists
23024,1110,1,"54,449999999999996",2,1,1,4,Low-Value,Can't Lose
23025,90,3,"270,6",5,1,1,7,Mid-Value,Potential Loyalists
23026,445,5,"138,14999999999998",4,1,1,6,Mid-Value,Potential Loyalists
23027,942,1,"112,2",3,1,1,5,Low-Value,At Risk Customers
23028,794,4,"719,1999999999999",3,1,2,6,Mid-Value,Potential Loyalists
23029,869,3,"60,55",3,1,1,5,Low-Value,At Risk Customers
23030,126,3,"91,1",5,1,1,7,Mid-Value,Potential Loyalists
23032,422,6,"552,1999999999999",4,1,1,6,Mid-Value,Potential Loyalists
23033,311,2,"11,450000000000001",5,1,1,7,Mid-Value,Potential Loyalists
23035,538,2,"81,1",4,1,1,6,Mid-Value,Potential Loyalists
23037,255,2,"293,84999999999997",5,1,1,7,Mid-Value,Potential Loyalists
23039,114,9,"847,95",5,2,2,9,High-Value,Champions
23041,418,3,"34,75",4,1,1,6,Mid-Value,Potential Loyalists
23043,251,4,"313,05",5,1,1,7,Mid-Value,Potential Loyalists
23045,46,2,"118,4",5,1,1,7,Mid-Value,Potential Loyalists
23046,142,2,"58,60000000000001",5,1,1,7,Mid-Value,Potential Loyalists
23047,728,3,"80,3",4,1,1,6,Mid-Value,Potential Loyalists
23048,562,1,"193,25",4,1,1,6,Mid-Value,Potential Loyalists
23049,351,2,"53,199999999999996",5,1,1,7,Mid-Value,Potential Loyalists
23050,631,5,"319,85",4,1,1,6,Mid-Value,Potential Loyalists
23052,408,1,"16,3",4,1,1,6,Mid-Value,Potential Loyalists
23053,825,1,"2,95",3,1,1,5,Low-Value,At Risk Customers
23055,81,3,"225,39999999999998",5,1,1,7,Mid-Value,Potential Loyalists
23056,96,5,"533,9",5,1,1,7,Mid-Value,Potential Loyalists
23060,84,4,"68,45",5,1,1,7,Mid-Value,Potential Loyalists
23064,434,1,"15,4",4,1,1,6,Mid-Value,Potential Loyalists
23066,222,3,"76,69999999999999",5,1,1,7,Mid-Value,Potential Loyalists
23068,1811,1,"63,05",1,1,1,3,Low-Value,Lost
23069,96,10,"304,3",5,2,1,8,High-Value,Potential Loyalists
23070,150,3,"184,25",5,1,1,7,Mid-Value,Potential Loyalists
23071,944,2,"31,55",3,1,1,5,Low-Value,At Risk Customers
23074,675,2,"27,0",4,1,1,6,Mid-Value,Potential Loyalists
23075,57,4,"84,2",5,1,1,7,Mid-Value,Potential Loyalists
23077,243,5,"1048,1",5,1,2,8,High-Value,Potential Loyalists
23078,10,1,"29,0",5,1,1,7,Mid-Value,Potential Loyalists
23080,1506,1,"37,15",1,1,1,3,Low-Value,Lost
23081,539,3,"455,75",4,1,1,6,Mid-Value,Potential Loyalists
23082,202,1,"8,2",5,1,1,7,Mid-Value,Potential Loyalists
23083,749,1,"16,6",3,1,1,5,Low-Value,At Risk Customers
23087,87,2,"80,75",5,1,1,7,Mid-Value,Potential Loyalists
23088,363,1,"23,7",5,1,1,7,Mid-Value,Potential Loyalists
23089,184,2,"165,35",5,1,1,7,Mid-Value,Potential Loyalists
23091,206,1,"19,3",5,1,1,7,Mid-Value,Potential Loyalists
23092,236,3,"235,9",5,1,1,7,Mid-Value,Potential Loyalists
23093,972,2,"36,05",3,1,1,5,Low-Value,At Risk Customers
23094,28,5,"375,9",5,1,1,7,Mid-Value,Potential Loyalists
23095,1388,3,"120,0",2,1,1,4,Low-Value,Can't Lose
23096,10,4,"367,75",5,1,1,7,Mid-Value,Potential Loyalists
23098,21,8,"360,5",5,2,1,8,High-Value,Potential Loyalists
23101,1258,3,"313,7",2,1,1,4,Low-Value,Can't Lose
23102,1105,2,"160,85",2,1,1,4,Low-Value,Can't Lose
23104,1207,1,"115,6",2,1,1,4,Low-Value,Can't Lose
23105,805,2,"168,15",3,1,1,5,Low-Value,At Risk Customers
23107,977,1,"119,25",3,1,1,5,Low-Value,At Risk Customers
23108,307,3,"106,65",5,1,1,7,Mid-Value,Potential Loyalists
23110,124,2,"36,0",5,1,1,7,Mid-Value,Potential Loyalists
23111,42,3,"53,05",5,1,1,7,Mid-Value,Potential Loyalists
23114,350,2,"147,3",5,1,1,7,Mid-Value,Potential Loyalists
23115,391,1,"40,8",4,1,1,6,Mid-Value,Potential Loyalists
23116,493,1,"102,3",4,1,1,6,Mid-Value,Potential Loyalists
23117,1450,1,"4,85",2,1,1,4,Low-Value,Can't Lose
23119,899,2,"98,9",3,1,1,5,Low-Value,At Risk Customers
23120,560,2,"233,15",4,1,1,6,Mid-Value,Potential Loyalists
23122,552,3,"30,35",4,1,1,6,Mid-Value,Potential Loyalists
23123,187,2,"88,85000000000001",5,1,1,7,Mid-Value,Potential Loyalists
23124,194,7,"506,85",5,2,1,8,High-Value,Potential Loyalists
23125,19,4,"325,0",5,1,1,7,Mid-Value,Potential Loyalists
23126,219,6,"554,85",5,1,1,7,Mid-Value,Potential Loyalists
23127,137,9,"642,95",5,2,1,8,High-Value,Potential Loyalists
23128,393,5,"648,9",4,1,1,6,Mid-Value,Potential Loyalists
23131,428,1,"15,4",4,1,1,6,Mid-Value,Potential Loyalists
23132,1125,3,"990,5",2,1,2,5,Low-Value,At Risk Customers
23135,558,2,"67,9",4,1,1,6,Mid-Value,Potential Loyalists
23138,1014,1,"49,1",3,1,1,5,Low-Value,At Risk Customers
23139,1743,1,"22,95",1,1,1,3,Low-Value,Lost
23140,290,5,"115,95",5,1,1,7,Mid-Value,Potential Loyalists
23142,331,1,"15,9",5,1,1,7,Mid-Value,Potential Loyalists
23143,687,4,"256,20000000000005",4,1,1,6,Mid-Value,Potential Loyalists
23144,276,1,"122,6",5,1,1,7,Mid-Value,Potential Loyalists
23145,742,4,"110,35",3,1,1,5,Low-Value,At Risk Customers
23146,412,2,"226,39999999999998",4,1,1,6,Mid-Value,Potential Loyalists
23147,340,3,"110,89999999999999",5,1,1,7,Mid-Value,Potential Loyalists
23150,232,1,"94,05",5,1,1,7,Mid-Value,Potential Loyalists
23153,27,9,"304,0",5,2,1,8,High-Value,Potential Loyalists
23154,258,6,"201,2",5,1,1,7,Mid-Value,Potential Loyalists
23155,1149,3,"68,35000000000001",2,1,1,4,Low-Value,Can't Lose
23156,418,5,"187,6",4,1,1,6,Mid-Value,Potential Loyalists
23157,69,3,"90,0",5,1,1,7,Mid-Value,Potential Loyalists
23158,234,5,"643,1999999999999",5,1,1,7,Mid-Value,Potential Loyalists
23159,155,1,"22,1",5,1,1,7,Mid-Value,Potential Loyalists
23160,368,5,"208,45",4,1,1,6,Mid-Value,Potential Loyalists
23161,902,3,"134,68",3,1,1,5,Low-Value,At Risk Customers
23162,701,1,"38,5",4,1,1,6,Mid-Value,Potential Loyalists
23165,815,3,"229,20000000000002",3,1,1,5,Low-Value,At Risk Customers
23166,1130,1,"39,1",2,1,1,4,Low-Value,Can't Lose
23167,57,1,"34,1",5,1,1,7,Mid-Value,Potential Loyalists
23168,1704,1,"75,9",1,1,1,3,Low-Value,Lost
23169,517,3,"116,75",4,1,1,6,Mid-Value,Potential Loyalists
23170,396,1,"17,55",4,1,1,6,Mid-Value,Potential Loyalists
23172,95,4,"523,9499999999999",5,1,1,7,Mid-Value,Potential Loyalists
23173,1127,5,"137,45",2,1,1,4,Low-Value,Can't Lose
23175,1620,1,"27,1",1,1,1,3,Low-Value,Lost
23176,877,3,"304,8",3,1,1,5,Low-Value,At Risk Customers
23177,857,3,"544,6",3,1,1,5,Low-Value,At Risk Customers
23179,1121,2,"80,45",2,1,1,4,Low-Value,Can't Lose
23181,391,2,"132,9",4,1,1,6,Mid-Value,Potential Loyalists
23182,201,5,"199,15",5,1,1,7,Mid-Value,Potential Loyalists
23183,96,8,"224,7",5,2,1,8,High-Value,Potential Loyalists
23185,676,1,"109,55",4,1,1,6,Mid-Value,Potential Loyalists
23187,92,4,"144,8",5,1,1,7,Mid-Value,Potential Loyalists
23190,644,1,"55,2",4,1,1,6,Mid-Value,Potential Loyalists
23193,328,4,"134,91",5,1,1,7,Mid-Value,Potential Loyalists
23194,1401,2,"35,9",2,1,1,4,Low-Value,Can't Lose
23195,13,2,"90,9",5,1,1,7,Mid-Value,Potential Loyalists
23196,1,2,"52,3",5,1,1,7,Mid-Value,Potential Loyalists
23197,1323,3,"112,0",2,1,1,4,Low-Value,Can't Lose
23198,760,3,"78,1",3,1,1,5,Low-Value,At Risk Customers
23199,721,2,"29,2",4,1,1,6,Mid-Value,Potential Loyalists
23203,60,10,"308,35",5,2,1,8,High-Value,Potential Loyalists
23204,111,6,"1157,05",5,1,2,8,High-Value,Potential Loyalists
23206,805,5,"277,85",3,1,1,5,Low-Value,At Risk Customers
23209,108,8,"330,65",5,2,1,8,High-Value,Potential Loyalists
23210,805,2,"39,8",3,1,1,5,Low-Value,At Risk Customers
23211,560,3,"99,75",4,1,1,6,Mid-Value,Potential Loyalists
23213,1071,1,"221,3",3,1,1,5,Low-Value,At Risk Customers
23215,49,3,"138,4",5,1,1,7,Mid-Value,Potential Loyalists
23216,1112,9,"549,3",2,2,1,5,Low-Value,At Risk Customers
23217,1768,1,"42,6",1,1,1,3,Low-Value,Lost
23218,77,2,"57,650000000000006",5,1,1,7,Mid-Value,Potential Loyalists
23221,30,3,"140,2",5,1,1,7,Mid-Value,Potential Loyalists
23222,48,1,"8,7",5,1,1,7,Mid-Value,Potential Loyalists
23223,248,1,"95,75",5,1,1,7,Mid-Value,Potential Loyalists
23224,336,7,"289,09999999999997",5,2,1,8,High-Value,Potential Loyalists
23226,179,3,"77,35",5,1,1,7,Mid-Value,Potential Loyalists
23228,67,5,"571,9000000000001",5,1,1,7,Mid-Value,Potential Loyalists
23229,630,4,"350,5",4,1,1,6,Mid-Value,Potential Loyalists
23230,48,4,"342,54999999999995",5,1,1,7,Mid-Value,Potential Loyalists
23231,269,3,"112,2",5,1,1,7,Mid-Value,Potential Loyalists
23233,1134,2,"53,55",2,1,1,4,Low-Value,Can't Lose
23234,1721,1,"39,7",1,1,1,3,Low-Value,Lost
23235,672,4,"233,5",4,1,1,6,Mid-Value,Potential Loyalists
23237,967,1,"79,80000000000001",3,1,1,5,Low-Value,At Risk Customers
23239,424,2,"49,6",4,1,1,6,Mid-Value,Potential Loyalists
23241,700,1,"6,55",4,1,1,6,Mid-Value,Potential Loyalists
23243,1431,1,"45,6",2,1,1,4,Low-Value,Can't Lose
23244,539,1,"21,3",4,1,1,6,Mid-Value,Potential Loyalists
23245,1488,2,"25,650000000000002",1,1,1,3,Low-Value,Lost
23247,55,2,"122,49999999999999",5,1,1,7,Mid-Value,Potential Loyalists
23248,413,3,"357,6",4,1,1,6,Mid-Value,Potential Loyalists
23249,1483,2,"163,5",1,1,1,3,Low-Value,Lost
23250,425,4,"373,54999999999995",4,1,1,6,Mid-Value,Potential Loyalists
23251,892,2,"269,4",3,1,1,5,Low-Value,At Risk Customers
23252,1623,1,"36,3",1,1,1,3,Low-Value,Lost
23255,420,3,"179,25",4,1,1,6,Mid-Value,Potential Loyalists
23256,587,6,"289,15000000000003",4,1,1,6,Mid-Value,Potential Loyalists
23258,817,2,"113,65",3,1,1,5,Low-Value,At Risk Customers
23259,1725,1,"24,5",1,1,1,3,Low-Value,Lost
23261,58,9,"210,45",5,2,1,8,High-Value,Potential Loyalists
23263,172,3,"233,49999999999997",5,1,1,7,Mid-Value,Potential Loyalists
23264,735,3,"87,25",3,1,1,5,Low-Value,At Risk Customers
23266,667,1,"32,25",4,1,1,6,Mid-Value,Potential Loyalists
23267,205,1,"221,9",5,1,1,7,Mid-Value,Potential Loyalists
23268,382,6,"292,8",4,1,1,6,Mid-Value,Potential Loyalists
23270,42,3,"100,75",5,1,1,7,Mid-Value,Potential Loyalists
23271,1299,1,"49,75",2,1,1,4,Low-Value,Can't Lose
23272,19,4,"219,20000000000002",5,1,1,7,Mid-Value,Potential Loyalists
23273,30,3,"72,35",5,1,1,7,Mid-Value,Potential Loyalists
23276,186,4,"180,39999999999998",5,1,1,7,Mid-Value,Potential Loyalists
23277,1071,2,"320,05",3,1,1,5,Low-Value,At Risk Customers
23281,525,1,"224,0",4,1,1,6,Mid-Value,Potential Loyalists
23283,1606,1,"270,0",1,1,1,3,Low-Value,Lost
23284,210,4,"255,6",5,1,1,7,Mid-Value,Potential Loyalists
23285,168,1,"25,5",5,1,1,7,Mid-Value,Potential Loyalists
23287,722,3,"348,65",4,1,1,6,Mid-Value,Potential Loyalists
23288,798,5,"306,0",3,1,1,5,Low-Value,At Risk Customers
23289,95,6,"561,8",5,1,1,7,Mid-Value,Potential Loyalists
23293,1,2,"201,70000000000002",5,1,1,7,Mid-Value,Potential Loyalists
23297,330,1,"24,7",5,1,1,7,Mid-Value,Potential Loyalists
23299,1524,2,"67,35000000000001",1,1,1,3,Low-Value,Lost
23300,596,6,"313,1",4,1,1,6,Mid-Value,Potential Loyalists
23302,381,4,"407,2",4,1,1,6,Mid-Value,Potential Loyalists
23303,123,5,"123,5",5,1,1,7,Mid-Value,Potential Loyalists
23304,187,6,"451,20000000000005",5,1,1,7,Mid-Value,Potential Loyalists
23307,816,1,"135,0",3,1,1,5,Low-Value,At Risk Customers
23308,1739,1,"13,2",1,1,1,3,Low-Value,Lost
23309,1312,1,"71,25",2,1,1,4,Low-Value,Can't Lose
23310,116,4,"281,15",5,1,1,7,Mid-Value,Potential Loyalists
23312,1015,2,"91,93",3,1,1,5,Low-Value,At Risk Customers
23313,500,2,"113,0",4,1,1,6,Mid-Value,Potential Loyalists
23314,604,1,"23,4",4,1,1,6,Mid-Value,Potential Loyalists
23315,127,8,"1283,6000000000001",5,2,2,9,High-Value,Champions
23316,244,3,"262,20000000000005",5,1,1,7,Mid-Value,Potential Loyalists
23317,821,4,"193,60000000000002",3,1,1,5,Low-Value,At Risk Customers
23318,1126,3,"744,8",2,1,2,5,Low-Value,At Risk Customers
23319,814,3,"523,9",3,1,1,5,Low-Value,At Risk Customers
23320,96,3,"113,4",5,1,1,7,Mid-Value,Potential Loyalists
23321,281,2,"117,2",5,1,1,7,Mid-Value,Potential Loyalists
23323,730,1,"32,8",4,1,1,6,Mid-Value,Potential Loyalists
23324,106,12,"1106,2",5,3,2,10,High-Value,Champions
23328,634,2,"37,400000000000006",4,1,1,6,Mid-Value,Potential Loyalists
23329,348,3,"133,95",5,1,1,7,Mid-Value,Potential Loyalists
23330,1118,3,"219,05",2,1,1,4,Low-Value,Can't Lose
23331,216,3,"73,05",5,1,1,7,Mid-Value,Potential Loyalists
23333,1322,1,"20,9",2,1,1,4,Low-Value,Can't Lose
23334,809,3,"49,24",3,1,1,5,Low-Value,At Risk Customers
23337,240,1,"21,45",5,1,1,7,Mid-Value,Potential Loyalists
23339,126,7,"286,2",5,2,1,8,High-Value,Potential Loyalists
23340,790,3,"79,6",3,1,1,5,Low-Value,At Risk Customers
23341,1054,2,"705,25",3,1,2,6,Mid-Value,Potential Loyalists
23344,185,2,"49,05",5,1,1,7,Mid-Value,Potential Loyalists
23345,980,1,"20,9",3,1,1,5,Low-Value,At Risk Customers
23347,1054,1,"3,25",3,1,1,5,Low-Value,At Risk Customers
23348,1529,2,"38,25",1,1,1,3,Low-Value,Lost
23350,1552,2,"55,65",1,1,1,3,Low-Value,Lost
23353,633,4,"64,39999999999999",4,1,1,6,Mid-Value,Potential Loyalists
23355,50,4,"388,45",5,1,1,7,Mid-Value,Potential Loyalists
23357,1107,1,"37,4",2,1,1,4,Low-Value,Can't Lose
23358,87,2,"71,55",5,1,1,7,Mid-Value,Potential Loyalists
23361,128,5,"686,05",5,1,2,8,High-Value,Potential Loyalists
23362,180,5,"298,2",5,1,1,7,Mid-Value,Potential Loyalists
23364,90,2,"38,3",5,1,1,7,Mid-Value,Potential Loyalists
23365,29,9,"526,4",5,2,1,8,High-Value,Potential Loyalists
23366,919,2,"60,05",3,1,1,5,Low-Value,At Risk Customers
23367,733,6,"546,9499999999999",3,1,1,5,Low-Value,At Risk Customers
23368,46,2,"116,35000000000001",5,1,1,7,Mid-Value,Potential Loyalists
23369,1034,1,"124,2",3,1,1,5,Low-Value,At Risk Customers
23370,368,4,"139,15",4,1,1,6,Mid-Value,Potential Loyalists
23371,242,3,"491,4",5,1,1,7,Mid-Value,Potential Loyalists
23372,95,5,"318,05000000000007",5,1,1,7,Mid-Value,Potential Loyalists
23373,416,8,"448,5",4,2,1,7,Mid-Value,Potential Loyalists
23378,14,2,"104,19",5,1,1,7,Mid-Value,Potential Loyalists
23380,1084,2,"34,150000000000006",3,1,1,5,Low-Value,At Risk Customers
23381,245,6,"308,65",5,1,1,7,Mid-Value,Potential Loyalists
23382,362,1,"13,4",5,1,1,7,Mid-Value,Potential Loyalists
23385,201,1,"100,8",5,1,1,7,Mid-Value,Potential Loyalists
23389,1072,2,"59,9",3,1,1,5,Low-Value,At Risk Customers
23390,860,2,"155,05",3,1,1,5,Low-Value,At Risk Customers
23391,161,1,"20,6",5,1,1,7,Mid-Value,Potential Loyalists
23394,433,5,"141,25",4,1,1,6,Mid-Value,Potential Loyalists
23395,858,4,"68,2",3,1,1,5,Low-Value,At Risk Customers
23398,734,6,"259,55",3,1,1,5,Low-Value,At Risk Customers
23400,461,5,"203,39999999999998",4,1,1,6,Mid-Value,Potential Loyalists
23402,1368,2,"88,15",2,1,1,4,Low-Value,Can't Lose
23405,162,3,"140,55",5,1,1,7,Mid-Value,Potential Loyalists
23407,1666,1,"105,6",1,1,1,3,Low-Value,Lost
23408,42,9,"172,45000000000002",5,2,1,8,High-Value,Potential Loyalists
23409,75,7,"288,8",5,2,1,8,High-Value,Potential Loyalists
23410,883,1,"87,4",3,1,1,5,Low-Value,At Risk Customers
23411,946,1,"53,05",3,1,1,5,Low-Value,At Risk Customers
23412,75,3,"52,50000000000001",5,1,1,7,Mid-Value,Potential Loyalists
23413,496,4,"286,45",4,1,1,6,Mid-Value,Potential Loyalists
23414,569,2,"124,69999999999999",4,1,1,6,Mid-Value,Potential Loyalists
23415,895,3,"139,85",3,1,1,5,Low-Value,At Risk Customers
23417,681,4,"352,1",4,1,1,6,Mid-Value,Potential Loyalists
23419,847,1,"69,1",3,1,1,5,Low-Value,At Risk Customers
23422,735,2,"180,4",3,1,1,5,Low-Value,At Risk Customers
23424,169,3,"141,60000000000002",5,1,1,7,Mid-Value,Potential Loyalists
23426,7,3,"204,99999999999997",5,1,1,7,Mid-Value,Potential Loyalists
23427,852,1,"62,849999999999994",3,1,1,5,Low-Value,At Risk Customers
23430,749,3,"827,2",3,1,2,6,Mid-Value,Potential Loyalists
23431,852,2,"439,75",3,1,1,5,Low-Value,At Risk Customers
23432,599,1,"8,25",4,1,1,6,Mid-Value,Potential Loyalists
23434,7,9,"1359,85",5,2,3,10,High-Value,Champions
23436,1070,2,"38,15",3,1,1,5,Low-Value,At Risk Customers
23437,835,2,"46,3",3,1,1,5,Low-Value,At Risk Customers
23440,39,4,"87,5",5,1,1,7,Mid-Value,Potential Loyalists
23441,733,4,"318,6",3,1,1,5,Low-Value,At Risk Customers
23442,1312,1,"181,7",2,1,1,4,Low-Value,Can't Lose
23445,38,5,"318,35",5,1,1,7,Mid-Value,Potential Loyalists
23446,1081,2,"201,35",3,1,1,5,Low-Value,At Risk Customers
23447,743,1,"202,64999999999998",3,1,1,5,Low-Value,At Risk Customers
23449,1228,1,"10,7",2,1,1,4,Low-Value,Can't Lose
23452,1062,3,"92,4",3,1,1,5,Low-Value,At Risk Customers
23453,308,1,"30,05",5,1,1,7,Mid-Value,Potential Loyalists
23454,95,8,"373,8",5,2,1,8,High-Value,Potential Loyalists
23456,1054,1,"21,75",3,1,1,5,Low-Value,At Risk Customers
23457,500,2,"329,79999999999995",4,1,1,6,Mid-Value,Potential Loyalists
23458,157,2,"65,95",5,1,1,7,Mid-Value,Potential Loyalists
23459,474,2,"494,65",4,1,1,6,Mid-Value,Potential Loyalists
23460,20,6,"336,9",5,1,1,7,Mid-Value,Potential Loyalists
23463,321,5,"116,65",5,1,1,7,Mid-Value,Potential Loyalists
23465,1719,1,"17,6",1,1,1,3,Low-Value,Lost
23468,91,4,"296,9",5,1,1,7,Mid-Value,Potential Loyalists
23469,879,2,"16,45",3,1,1,5,Low-Value,At Risk Customers
23470,1407,1,"28,25",2,1,1,4,Low-Value,Can't Lose
23471,1003,2,"34,7",3,1,1,5,Low-Value,At Risk Customers
23472,109,4,"166,0",5,1,1,7,Mid-Value,Potential Loyalists
23475,319,2,"68,9",5,1,1,7,Mid-Value,Potential Loyalists
23476,1018,1,"46,25",3,1,1,5,Low-Value,At Risk Customers
23477,690,1,"79,9",4,1,1,6,Mid-Value,Potential Loyalists
23478,810,1,"42,0",3,1,1,5,Low-Value,At Risk Customers
23479,99,4,"208,7",5,1,1,7,Mid-Value,Potential Loyalists
23481,911,1,"112,2",3,1,1,5,Low-Value,At Risk Customers
23482,241,3,"101,9",5,1,1,7,Mid-Value,Potential Loyalists
23483,43,2,"63,45",5,1,1,7,Mid-Value,Potential Loyalists
23486,921,4,"443,45000000000005",3,1,1,5,Low-Value,At Risk Customers
23487,172,1,"35,099999999999994",5,1,1,7,Mid-Value,Potential Loyalists
23489,18,5,"731,75",5,1,2,8,High-Value,Potential Loyalists
23490,1265,1,"234,4",2,1,1,4,Low-Value,Can't Lose
23491,199,5,"239,5",5,1,1,7,Mid-Value,Potential Loyalists
23492,368,4,"271,05",4,1,1,6,Mid-Value,Potential Loyalists
23495,224,1,"40,5",5,1,1,7,Mid-Value,Potential Loyalists
23496,1451,1,"42,2",2,1,1,4,Low-Value,Can't Lose
23497,130,7,"190,65",5,2,1,8,High-Value,Potential Loyalists
23499,771,1,"37,9",3,1,1,5,Low-Value,At Risk Customers
23502,832,1,"2,75",3,1,1,5,Low-Value,At Risk Customers
23503,1011,3,"334,2",3,1,1,5,Low-Value,At Risk Customers
23504,1603,1,"54,5",1,1,1,3,Low-Value,Lost
23506,133,4,"257,2",5,1,1,7,Mid-Value,Potential Loyalists
23507,1176,4,"193,9",2,1,1,4,Low-Value,Can't Lose
23508,1254,3,"453,8",2,1,1,4,Low-Value,Can't Lose
23510,553,3,"221,05",4,1,1,6,Mid-Value,Potential Loyalists
23511,365,7,"562,85",5,2,1,8,High-Value,Potential Loyalists
23512,494,1,"89,4",4,1,1,6,Mid-Value,Potential Loyalists
23513,701,3,"209,45",4,1,1,6,Mid-Value,Potential Loyalists
23514,423,2,"97,14999999999999",4,1,1,6,Mid-Value,Potential Loyalists
23515,1386,1,"281,5",2,1,1,4,Low-Value,Can't Lose
23516,463,2,"15,0",4,1,1,6,Mid-Value,Potential Loyalists
23519,27,2,"154,8",5,1,1,7,Mid-Value,Potential Loyalists
23522,111,6,"552,5",5,1,1,7,Mid-Value,Potential Loyalists
23523,123,5,"251,25",5,1,1,7,Mid-Value,Potential Loyalists
23524,1117,6,"208,6",2,1,1,4,Low-Value,Can't Lose
23526,1014,4,"49,449999999999996",3,1,1,5,Low-Value,At Risk Customers
23528,599,3,"280,95",4,1,1,6,Mid-Value,Potential Loyalists
23529,621,4,"548,2",4,1,1,6,Mid-Value,Potential Loyalists
23531,60,8,"205,1",5,2,1,8,High-Value,Potential Loyalists
23533,1144,1,"85,35",2,1,1,4,Low-Value,Can't Lose
23535,749,5,"157,85",3,1,1,5,Low-Value,At Risk Customers
23536,180,7,"284,1",5,2,1,8,High-Value,Potential Loyalists
23537,144,5,"209,0",5,1,1,7,Mid-Value,Potential Loyalists
23538,245,5,"181,05",5,1,1,7,Mid-Value,Potential Loyalists
23539,582,3,"204,89999999999998",4,1,1,6,Mid-Value,Potential Loyalists
23541,73,6,"357,9",5,1,1,7,Mid-Value,Potential Loyalists
23542,1147,1,"1,35",2,1,1,4,Low-Value,Can't Lose
23544,585,5,"236,65",4,1,1,6,Mid-Value,Potential Loyalists
23545,599,2,"71,7",4,1,1,6,Mid-Value,Potential Loyalists
23546,343,5,"370,15",5,1,1,7,Mid-Value,Potential Loyalists
23547,3,5,"229,4",5,1,1,7,Mid-Value,Potential Loyalists
23548,169,1,"51,9",5,1,1,7,Mid-Value,Potential Loyalists
23549,456,4,"119,91",4,1,1,6,Mid-Value,Potential Loyalists
23550,923,1,"23,5",3,1,1,5,Low-Value,At Risk Customers
23552,805,2,"53,0",3,1,1,5,Low-Value,At Risk Customers
23553,630,6,"146,9",4,1,1,6,Mid-Value,Potential Loyalists
23554,984,2,"57,5",3,1,1,5,Low-Value,At Risk Customers
23555,768,3,"440,7",3,1,1,5,Low-Value,At Risk Customers
23559,429,5,"145,3",4,1,1,6,Mid-Value,Potential Loyalists
23561,79,3,"98,0",5,1,1,7,Mid-Value,Potential Loyalists
23563,256,6,"295,1",5,1,1,7,Mid-Value,Potential Loyalists
23566,1462,2,"133,0",1,1,1,3,Low-Value,Lost
23568,424,2,"73,9",4,1,1,6,Mid-Value,Potential Loyalists
23569,511,4,"514,65",4,1,1,6,Mid-Value,Potential Loyalists
23571,508,1,"73,4",4,1,1,6,Mid-Value,Potential Loyalists
23572,545,1,"179,8",4,1,1,6,Mid-Value,Potential Loyalists
23573,496,3,"177,75",4,1,1,6,Mid-Value,Potential Loyalists
23574,541,6,"237,2",4,1,1,6,Mid-Value,Potential Loyalists
23576,993,2,"124,39999999999999",3,1,1,5,Low-Value,At Risk Customers
23578,246,2,"70,95",5,1,1,7,Mid-Value,Potential Loyalists
23579,1473,3,"274,45",1,1,1,3,Low-Value,Lost
23582,1301,1,"36,55",2,1,1,4,Low-Value,Can't Lose
23583,397,3,"86,60000000000001",4,1,1,6,Mid-Value,Potential Loyalists
23584,225,3,"148,54999999999998",5,1,1,7,Mid-Value,Potential Loyalists
23587,700,1,"44,6",4,1,1,6,Mid-Value,Potential Loyalists
23588,490,7,"473,1",4,2,1,7,Mid-Value,Potential Loyalists
23590,188,1,"43,2",5,1,1,7,Mid-Value,Potential Loyalists
23592,14,4,"339,05",5,1,1,7,Mid-Value,Potential Loyalists
23593,232,8,"432,85",5,2,1,8,High-Value,Potential Loyalists
23595,85,1,"35,95",5,1,1,7,Mid-Value,Potential Loyalists
23596,565,8,"629,6",4,2,1,7,Mid-Value,Potential Loyalists
23598,591,3,"204,79999999999998",4,1,1,6,Mid-Value,Potential Loyalists
23599,734,6,"613,5",3,1,1,5,Low-Value,At Risk Customers
23600,271,2,"114,4",5,1,1,7,Mid-Value,Potential Loyalists
23601,526,3,"681,0500000000001",4,1,2,7,Mid-Value,Potential Loyalists
23602,1275,1,"22,3",2,1,1,4,Low-Value,Can't Lose
23603,791,5,"133,75",3,1,1,5,Low-Value,At Risk Customers
23604,253,4,"589,6500000000001",5,1,1,7,Mid-Value,Potential Loyalists
23605,1120,1,"15,4",2,1,1,4,Low-Value,Can't Lose
23606,62,4,"144,85",5,1,1,7,Mid-Value,Potential Loyalists
23608,444,3,"198,3",4,1,1,6,Mid-Value,Potential Loyalists
23609,175,10,"372,5",5,2,1,8,High-Value,Potential Loyalists
23611,1286,2,"56,2",2,1,1,4,Low-Value,Can't Lose
23613,136,2,"49,699999999999996",5,1,1,7,Mid-Value,Potential Loyalists
23615,272,1,"48,45",5,1,1,7,Mid-Value,Potential Loyalists
23616,1155,1,"155,7",2,1,1,4,Low-Value,Can't Lose
23617,95,7,"282,20000000000005",5,2,1,8,High-Value,Potential Loyalists
23619,1265,2,"63,25",2,1,1,4,Low-Value,Can't Lose
23620,24,2,"96,94999999999999",5,1,1,7,Mid-Value,Potential Loyalists
23621,96,6,"1296,95",5,1,2,8,High-Value,Potential Loyalists
23622,116,3,"55,550000000000004",5,1,1,7,Mid-Value,Potential Loyalists
23627,29,2,"164,35",5,1,1,7,Mid-Value,Potential Loyalists
23629,30,1,"11,5",5,1,1,7,Mid-Value,Potential Loyalists
23630,253,6,"295,35",5,1,1,7,Mid-Value,Potential Loyalists
23631,816,1,"21,2",3,1,1,5,Low-Value,At Risk Customers
23632,1033,1,"92,0",3,1,1,5,Low-Value,At Risk Customers
23633,828,2,"114,05",3,1,1,5,Low-Value,At Risk Customers
23637,1344,2,"26,25",2,1,1,4,Low-Value,Can't Lose
23638,1316,1,"41,2",2,1,1,4,Low-Value,Can't Lose
23639,1033,1,"59,2",3,1,1,5,Low-Value,At Risk Customers
23640,1249,2,"83,05",2,1,1,4,Low-Value,Can't Lose
23641,717,2,"66,3",4,1,1,6,Mid-Value,Potential Loyalists
23642,1454,1,"19,7",2,1,1,4,Low-Value,Can't Lose
23646,1251,2,"99,05",2,1,1,4,Low-Value,Can't Lose
23647,21,10,"775,55",5,2,2,9,High-Value,Champions
23650,918,1,"20,5",3,1,1,5,Low-Value,At Risk Customers
23653,1366,3,"130,7",2,1,1,4,Low-Value,Can't Lose
23654,3,9,"339,34999999999997",5,2,1,8,High-Value,Potential Loyalists
23655,58,2,"37,5",5,1,1,7,Mid-Value,Potential Loyalists
23658,1126,3,"379,6",2,1,1,4,Low-Value,Can't Lose
23660,300,1,"24,3",5,1,1,7,Mid-Value,Potential Loyalists
23661,1297,2,"104,75",2,1,1,4,Low-Value,Can't Lose
23662,27,5,"395,0",5,1,1,7,Mid-Value,Potential Loyalists
23663,129,1,"18,05",5,1,1,7,Mid-Value,Potential Loyalists
23665,959,1,"27,900000000000002",3,1,1,5,Low-Value,At Risk Customers
23667,159,4,"598,75",5,1,1,7,Mid-Value,Potential Loyalists
23669,7,8,"641,85",5,2,1,8,High-Value,Potential Loyalists
23671,29,5,"131,75",5,1,1,7,Mid-Value,Potential Loyalists
23672,147,7,"396,95",5,2,1,8,High-Value,Potential Loyalists
23673,764,13,"559,3",3,3,1,7,Mid-Value,Potential Loyalists
23674,1401,1,"37,8",2,1,1,4,Low-Value,Can't Lose
23676,24,7,"554,05",5,2,1,8,High-Value,Potential Loyalists
23680,846,5,"288,0",3,1,1,5,Low-Value,At Risk Customers
23681,1051,1,"26,55",3,1,1,5,Low-Value,At Risk Customers
23683,913,1,"22,8",3,1,1,5,Low-Value,At Risk Customers
23684,20,2,"93,0",5,1,1,7,Mid-Value,Potential Loyalists
23687,1072,3,"238,55",3,1,1,5,Low-Value,At Risk Customers
23688,735,4,"98,35",3,1,1,5,Low-Value,At Risk Customers
23690,94,7,"185,4",5,2,1,8,High-Value,Potential Loyalists
23693,873,2,"82,3",3,1,1,5,Low-Value,At Risk Customers
23694,37,5,"525,9499999999999",5,1,1,7,Mid-Value,Potential Loyalists
23695,1313,1,"78,4",2,1,1,4,Low-Value,Can't Lose
23699,96,5,"239,95000000000002",5,1,1,7,Mid-Value,Potential Loyalists
23700,106,3,"107,55",5,1,1,7,Mid-Value,Potential Loyalists
23701,670,1,"7,65",4,1,1,6,Mid-Value,Potential Loyalists
23702,453,3,"98,30000000000001",4,1,1,6,Mid-Value,Potential Loyalists
23703,42,5,"278,25",5,1,1,7,Mid-Value,Potential Loyalists
23704,251,2,"269,15000000000003",5,1,1,7,Mid-Value,Potential Loyalists
23705,1169,8,"369,0",2,2,1,5,Low-Value,At Risk Customers
23706,112,3,"126,19999999999999",5,1,1,7,Mid-Value,Potential Loyalists
23707,1373,1,"12,3",2,1,1,4,Low-Value,Can't Lose
23708,1231,1,"84,9",2,1,1,4,Low-Value,Can't Lose
23709,1035,1,"81,5",3,1,1,5,Low-Value,At Risk Customers
23710,738,2,"54,24999999999999",3,1,1,5,Low-Value,At Risk Customers
23711,647,1,"27,4",4,1,1,6,Mid-Value,Potential Loyalists
23712,1676,1,"79,05000000000001",1,1,1,3,Low-Value,Lost
23713,412,6,"336,25",4,1,1,6,Mid-Value,Potential Loyalists
23714,599,1,"11,5",4,1,1,6,Mid-Value,Potential Loyalists
23715,12,2,"53,9",5,1,1,7,Mid-Value,Potential Loyalists
23716,214,6,"167,55",5,1,1,7,Mid-Value,Potential Loyalists
23717,1079,1,"6,6",3,1,1,5,Low-Value,At Risk Customers
23718,1305,3,"164,55",2,1,1,4,Low-Value,Can't Lose
23720,901,6,"353,6",3,1,1,5,Low-Value,At Risk Customers
23721,613,2,"160,3",4,1,1,6,Mid-Value,Potential Loyalists
23722,1651,1,"6,0",1,1,1,3,Low-Value,Lost
23723,964,8,"337,85",3,2,1,6,Mid-Value,Potential Loyalists
23724,778,1,"27,25",3,1,1,5,Low-Value,At Risk Customers
23725,408,6,"324,3",4,1,1,6,Mid-Value,Potential Loyalists
23726,1505,1,"8,4",1,1,1,3,Low-Value,Lost
23727,535,5,"375,9",4,1,1,6,Mid-Value,Potential Loyalists
23729,204,6,"266,0",5,1,1,7,Mid-Value,Potential Loyalists
23730,249,7,"226,0",5,2,1,8,High-Value,Potential Loyalists
23731,599,3,"89,1",4,1,1,6,Mid-Value,Potential Loyalists
23732,31,17,"1042,1499999999999",5,4,2,11,High-Value,Champions
23733,790,2,"98,85",3,1,1,5,Low-Value,At Risk Customers
23734,7,4,"112,6",5,1,1,7,Mid-Value,Potential Loyalists
23735,648,7,"169,75",4,2,1,7,Mid-Value,Potential Loyalists
23736,584,1,"151,8",4,1,1,6,Mid-Value,Potential Loyalists
23738,1519,4,"287,5",1,1,1,3,Low-Value,Lost
23740,25,4,"148,55",5,1,1,7,Mid-Value,Potential Loyalists
23742,262,6,"208,95",5,1,1,7,Mid-Value,Potential Loyalists
23745,1152,1,"26,95",2,1,1,4,Low-Value,Can't Lose
23746,1369,1,"8,9",2,1,1,4,Low-Value,Can't Lose
23751,444,1,"29,45",4,1,1,6,Mid-Value,Potential Loyalists
23752,598,1,"80,9",4,1,1,6,Mid-Value,Potential Loyalists
23753,661,1,"7,9",4,1,1,6,Mid-Value,Potential Loyalists
23754,93,1,"61,6",5,1,1,7,Mid-Value,Potential Loyalists
23755,558,2,"286,5",4,1,1,6,Mid-Value,Potential Loyalists
23757,406,1,"17,1",4,1,1,6,Mid-Value,Potential Loyalists
23758,101,3,"190,89999999999998",5,1,1,7,Mid-Value,Potential Loyalists
23759,488,2,"34,15",4,1,1,6,Mid-Value,Potential Loyalists
23760,774,4,"183,95",3,1,1,5,Low-Value,At Risk Customers
23762,1153,1,"33,9",2,1,1,4,Low-Value,Can't Lose
23764,117,3,"111,2",5,1,1,7,Mid-Value,Potential Loyalists
23765,5,1,"41,9",5,1,1,7,Mid-Value,Potential Loyalists
23767,10,4,"510,95000000000005",5,1,1,7,Mid-Value,Potential Loyalists
23768,235,1,"11,5",5,1,1,7,Mid-Value,Potential Loyalists
23769,627,1,"8,35",4,1,1,6,Mid-Value,Potential Loyalists
23770,1163,2,"29,0",2,1,1,4,Low-Value,Can't Lose
23773,479,3,"121,85000000000001",4,1,1,6,Mid-Value,Potential Loyalists
23775,453,3,"201,3",4,1,1,6,Mid-Value,Potential Loyalists
23777,148,5,"142,3",5,1,1,7,Mid-Value,Potential Loyalists
23778,1006,3,"239,15",3,1,1,5,Low-Value,At Risk Customers
23779,550,2,"124,0",4,1,1,6,Mid-Value,Potential Loyalists
23780,953,1,"18,75",3,1,1,5,Low-Value,At Risk Customers
23782,31,7,"149,6",5,2,1,8,High-Value,Potential Loyalists
23783,851,4,"139,5",3,1,1,5,Low-Value,At Risk Customers
23785,934,3,"471,69999999999993",3,1,1,5,Low-Value,At Risk Customers
23786,915,1,"59,25",3,1,1,5,Low-Value,At Risk Customers
23789,1452,2,"215,3",2,1,1,4,Low-Value,Can't Lose
23790,512,5,"181,25",4,1,1,6,Mid-Value,Potential Loyalists
23794,86,6,"627,75",5,1,1,7,Mid-Value,Potential Loyalists
23797,1572,3,"109,65",1,1,1,3,Low-Value,Lost
23798,639,6,"439,25",4,1,1,6,Mid-Value,Potential Loyalists
23800,269,1,"4,75",5,1,1,7,Mid-Value,Potential Loyalists
23803,703,5,"495,6",4,1,1,6,Mid-Value,Potential Loyalists
23807,299,3,"149,1",5,1,1,7,Mid-Value,Potential Loyalists
23808,223,3,"20,45",5,1,1,7,Mid-Value,Potential Loyalists
23809,1376,1,"26,6",2,1,1,4,Low-Value,Can't Lose
23810,1475,3,"253,65",1,1,1,3,Low-Value,Lost
23813,430,4,"537,6",4,1,1,6,Mid-Value,Potential Loyalists
23815,122,1,"62,1",5,1,1,7,Mid-Value,Potential Loyalists
23816,235,5,"290,8",5,1,1,7,Mid-Value,Potential Loyalists
23817,596,2,"207,2",4,1,1,6,Mid-Value,Potential Loyalists
23818,598,3,"281,04999999999995",4,1,1,6,Mid-Value,Potential Loyalists
23819,193,3,"110,05000000000001",5,1,1,7,Mid-Value,Potential Loyalists
23821,152,3,"225,2",5,1,1,7,Mid-Value,Potential Loyalists
23822,510,3,"325,2",4,1,1,6,Mid-Value,Potential Loyalists
23823,27,8,"419,0",5,2,1,8,High-Value,Potential Loyalists
23825,638,4,"273,1",4,1,1,6,Mid-Value,Potential Loyalists
23827,1,7,"1286,35",5,2,2,9,High-Value,Champions
23828,311,2,"121,9",5,1,1,7,Mid-Value,Potential Loyalists
23829,446,4,"507,2",4,1,1,6,Mid-Value,Potential Loyalists
23830,803,1,"209,45",3,1,1,5,Low-Value,At Risk Customers
23831,127,6,"234,2",5,1,1,7,Mid-Value,Potential Loyalists
23833,537,8,"252,95",4,2,1,7,Mid-Value,Potential Loyalists
23834,608,1,"20,65",4,1,1,6,Mid-Value,Potential Loyalists
23835,170,4,"179,54999999999998",5,1,1,7,Mid-Value,Potential Loyalists
23837,986,10,"820,0",3,2,2,7,Mid-Value,Potential Loyalists
23842,126,3,"286,25",5,1,1,7,Mid-Value,Potential Loyalists
23843,920,1,"38,3",3,1,1,5,Low-Value,At Risk Customers
23844,1224,1,"90,8",2,1,1,4,Low-Value,Can't Lose
23845,99,3,"345,25",5,1,1,7,Mid-Value,Potential Loyalists
23847,874,3,"901,1",3,1,2,6,Mid-Value,Potential Loyalists
23848,318,2,"105,5",5,1,1,7,Mid-Value,Potential Loyalists
23850,563,9,"604,1999999999999",4,2,1,7,Mid-Value,Potential Loyalists
23852,826,2,"185,45",3,1,1,5,Low-Value,At Risk Customers
23854,582,6,"210,0",4,1,1,6,Mid-Value,Potential Loyalists
23855,2,1,"103,6",5,1,1,7,Mid-Value,Potential Loyalists
23857,892,2,"440,2",3,1,1,5,Low-Value,At Risk Customers
23859,152,5,"402,15",5,1,1,7,Mid-Value,Potential Loyalists
23860,1061,2,"143,95",3,1,1,5,Low-Value,At Risk Customers
23862,1493,1,"21,7",1,1,1,3,Low-Value,Lost
23863,1608,1,"2,7",1,1,1,3,Low-Value,Lost
23864,5,3,"348,5",5,1,1,7,Mid-Value,Potential Loyalists
23865,318,2,"34,6",5,1,1,7,Mid-Value,Potential Loyalists
23866,29,4,"232,79999999999998",5,1,1,7,Mid-Value,Potential Loyalists
23869,890,1,"74,0",3,1,1,5,Low-Value,At Risk Customers
23874,297,2,"85,1",5,1,1,7,Mid-Value,Potential Loyalists
23875,7,6,"394,9",5,1,1,7,Mid-Value,Potential Loyalists
23876,381,1,"72,9",4,1,1,6,Mid-Value,Potential Loyalists
23877,182,1,"20,6",5,1,1,7,Mid-Value,Potential Loyalists
23878,131,1,"34,5",5,1,1,7,Mid-Value,Potential Loyalists
23881,1055,2,"54,75",3,1,1,5,Low-Value,At Risk Customers
23882,611,1,"42,45",4,1,1,6,Mid-Value,Potential Loyalists
23883,941,4,"147,95",3,1,1,5,Low-Value,At Risk Customers
23884,647,2,"55,0",4,1,1,6,Mid-Value,Potential Loyalists
23885,767,3,"165,3",3,1,1,5,Low-Value,At Risk Customers
23886,19,3,"50,2",5,1,1,7,Mid-Value,Potential Loyalists
23887,360,1,"101,8",5,1,1,7,Mid-Value,Potential Loyalists
23888,614,6,"438,95",4,1,1,6,Mid-Value,Potential Loyalists
23892,821,2,"278,65",3,1,1,5,Low-Value,At Risk Customers
23893,313,2,"127,6",5,1,1,7,Mid-Value,Potential Loyalists
23894,682,5,"357,75",4,1,1,6,Mid-Value,Potential Loyalists
23896,1155,3,"185,45",2,1,1,4,Low-Value,Can't Lose
23898,109,6,"311,84999999999997",5,1,1,7,Mid-Value,Potential Loyalists
23904,1401,1,"25,25",2,1,1,4,Low-Value,Can't Lose
23905,760,1,"39,1",3,1,1,5,Low-Value,At Risk Customers
23906,1482,2,"68,45",1,1,1,3,Low-Value,Lost
23907,1716,2,"223,54999999999998",1,1,1,3,Low-Value,Lost
23908,21,3,"250,25",5,1,1,7,Mid-Value,Potential Loyalists
23909,32,2,"170,05",5,1,1,7,Mid-Value,Potential Loyalists
23910,777,2,"14,5",3,1,1,5,Low-Value,At Risk Customers
23912,1098,1,"99,5",2,1,1,4,Low-Value,Can't Lose
23914,1054,2,"109,19999999999999",3,1,1,5,Low-Value,At Risk Customers
23915,157,3,"647,5",5,1,1,7,Mid-Value,Potential Loyalists
23918,1610,1,"311,85",1,1,1,3,Low-Value,Lost
23919,1398,1,"51,3",2,1,1,4,Low-Value,Can't Lose
23920,813,2,"59,5",3,1,1,5,Low-Value,At Risk Customers
23921,172,4,"242,25",5,1,1,7,Mid-Value,Potential Loyalists
23923,628,4,"170,5",4,1,1,6,Mid-Value,Potential Loyalists
23924,134,2,"51,849999999999994",5,1,1,7,Mid-Value,Potential Loyalists
23925,1297,1,"398,0",2,1,1,4,Low-Value,Can't Lose
23926,132,5,"372,0",5,1,1,7,Mid-Value,Potential Loyalists
23927,1487,1,"70,0",1,1,1,3,Low-Value,Lost
23928,1109,2,"136,05",2,1,1,4,Low-Value,Can't Lose
23929,1533,1,"10,75",1,1,1,3,Low-Value,Lost
23931,1491,3,"123,3",1,1,1,3,Low-Value,Lost
23932,74,5,"247,26",5,1,1,7,Mid-Value,Potential Loyalists
23934,533,5,"109,31",4,1,1,6,Mid-Value,Potential Loyalists
23935,20,4,"370,7",5,1,1,7,Mid-Value,Potential Loyalists
23936,791,2,"53,7",3,1,1,5,Low-Value,At Risk Customers
23938,310,1,"33,2",5,1,1,7,Mid-Value,Potential Loyalists
23939,1256,4,"263,90000000000003",2,1,1,4,Low-Value,Can't Lose
23940,31,8,"330,25",5,2,1,8,High-Value,Potential Loyalists
23941,56,5,"247,45",5,1,1,7,Mid-Value,Potential Loyalists
23942,427,2,"29,450000000000003",4,1,1,6,Mid-Value,Potential Loyalists
23945,1205,4,"118,1",2,1,1,4,Low-Value,Can't Lose
23946,229,2,"39,95",5,1,1,7,Mid-Value,Potential Loyalists
23947,11,6,"170,05",5,1,1,7,Mid-Value,Potential Loyalists
23948,38,8,"699,85",5,2,2,9,High-Value,Champions
23949,1356,1,"28,75",2,1,1,4,Low-Value,Can't Lose
23951,189,2,"34,25",5,1,1,7,Mid-Value,Potential Loyalists
23952,232,7,"714,1",5,2,2,9,High-Value,Champions
23955,850,3,"138,0",3,1,1,5,Low-Value,At Risk Customers
23956,402,3,"201,89999999999998",4,1,1,6,Mid-Value,Potential Loyalists
23957,10,10,"554,65",5,2,1,8,High-Value,Potential Loyalists
23959,585,3,"64,05",4,1,1,6,Mid-Value,Potential Loyalists
23960,706,1,"21,55",4,1,1,6,Mid-Value,Potential Loyalists
23961,237,8,"586,5999999999999",5,2,1,8,High-Value,Potential Loyalists
23962,630,2,"185,05",4,1,1,6,Mid-Value,Potential Loyalists
23963,132,5,"366,5",5,1,1,7,Mid-Value,Potential Loyalists
23964,945,3,"250,29999999999998",3,1,1,5,Low-Value,At Risk Customers
23965,83,6,"760,3",5,1,2,8,High-Value,Potential Loyalists
23966,286,3,"80,1",5,1,1,7,Mid-Value,Potential Loyalists
23967,31,9,"679,85",5,2,2,9,High-Value,Champions
23968,610,6,"858,3",4,1,2,7,Mid-Value,Potential Loyalists
23969,602,2,"59,45",4,1,1,6,Mid-Value,Potential Loyalists
23970,535,9,"593,9",4,2,1,7,Mid-Value,Potential Loyalists
23971,600,2,"21,0",4,1,1,6,Mid-Value,Potential Loyalists
23972,1250,4,"62,0",2,1,1,4,Low-Value,Can't Lose
23973,46,10,"387,9",5,2,1,8,High-Value,Potential Loyalists
23974,112,7,"279,6",5,2,1,8,High-Value,Potential Loyalists
23976,193,3,"121,55",5,1,1,7,Mid-Value,Potential Loyalists
23978,265,6,"252,89999999999998",5,1,1,7,Mid-Value,Potential Loyalists
23980,140,7,"455,55",5,2,1,8,High-Value,Potential Loyalists
23981,398,6,"343,9",4,1,1,6,Mid-Value,Potential Loyalists
23982,1239,3,"644,5",2,1,1,4,Low-Value,Can't Lose
23983,1156,1,"58,4",2,1,1,4,Low-Value,Can't Lose
23984,1203,5,"262,6",2,1,1,4,Low-Value,Can't Lose
23986,887,3,"168,2",3,1,1,5,Low-Value,At Risk Customers
23989,685,1,"72,55",4,1,1,6,Mid-Value,Potential Loyalists
23990,230,9,"1069,05",5,2,2,9,High-Value,Champions
23991,388,10,"813,65",4,2,2,8,High-Value,Potential Loyalists
23994,1046,1,"30,25",3,1,1,5,Low-Value,At Risk Customers
23997,1089,7,"153,45",3,2,1,6,Mid-Value,Potential Loyalists
23998,423,2,"401,5",4,1,1,6,Mid-Value,Potential Loyalists
24000,719,3,"346,15",4,1,1,6,Mid-Value,Potential Loyalists
24001,407,2,"37,5",4,1,1,6,Mid-Value,Potential Loyalists
24002,909,2,"83,8",3,1,1,5,Low-Value,At Risk Customers
24004,17,3,"170,83",5,1,1,7,Mid-Value,Potential Loyalists
24005,853,9,"597,45",3,2,1,6,Mid-Value,Potential Loyalists
24006,472,3,"88,7",4,1,1,6,Mid-Value,Potential Loyalists
24008,96,3,"438,15",5,1,1,7,Mid-Value,Potential Loyalists
24010,28,6,"636,4",5,1,1,7,Mid-Value,Potential Loyalists
24011,886,3,"198,79999999999998",3,1,1,5,Low-Value,At Risk Customers
24012,1315,3,"108,0",2,1,1,4,Low-Value,Can't Lose
24015,150,2,"26,85",5,1,1,7,Mid-Value,Potential Loyalists
24017,88,6,"361,0",5,1,1,7,Mid-Value,Potential Loyalists
24019,68,3,"161,7",5,1,1,7,Mid-Value,Potential Loyalists
24020,114,7,"382,05",5,2,1,8,High-Value,Potential Loyalists
24022,1130,1,"3,4",2,1,1,4,Low-Value,Can't Lose
24023,407,5,"157,79999999999998",4,1,1,6,Mid-Value,Potential Loyalists
24024,145,2,"103,0",5,1,1,7,Mid-Value,Potential Loyalists
24025,833,6,"358,79999999999995",3,1,1,5,Low-Value,At Risk Customers
24026,136,3,"161,4",5,1,1,7,Mid-Value,Potential Loyalists
24028,1254,1,"436,4",2,1,1,4,Low-Value,Can't Lose
24031,754,5,"449,8",3,1,1,5,Low-Value,At Risk Customers
24033,286,3,"154,85000000000002",5,1,1,7,Mid-Value,Potential Loyalists
24034,288,2,"235,4",5,1,1,7,Mid-Value,Potential Loyalists
24036,97,10,"856,3",5,2,2,9,High-Value,Champions
24037,798,2,"39,6",3,1,1,5,Low-Value,At Risk Customers
24038,1340,1,"35,400000000000006",2,1,1,4,Low-Value,Can't Lose
24039,238,1,"25,55",5,1,1,7,Mid-Value,Potential Loyalists
24040,164,2,"39,0",5,1,1,7,Mid-Value,Potential Loyalists
24042,207,1,"48,6",5,1,1,7,Mid-Value,Potential Loyalists
24043,579,2,"78,55",4,1,1,6,Mid-Value,Potential Loyalists
24045,769,2,"19,45",3,1,1,5,Low-Value,At Risk Customers
24046,266,2,"302,7",5,1,1,7,Mid-Value,Potential Loyalists
24047,174,1,"67,4",5,1,1,7,Mid-Value,Potential Loyalists
24048,126,3,"235,50000000000003",5,1,1,7,Mid-Value,Potential Loyalists
24051,362,3,"223,95000000000002",5,1,1,7,Mid-Value,Potential Loyalists
24054,885,1,"8,850000000000001",3,1,1,5,Low-Value,At Risk Customers
24055,236,3,"254,0",5,1,1,7,Mid-Value,Potential Loyalists
24056,303,6,"133,75",5,1,1,7,Mid-Value,Potential Loyalists
24057,395,3,"321,5",4,1,1,6,Mid-Value,Potential Loyalists
24065,250,4,"43,65",5,1,1,7,Mid-Value,Potential Loyalists
24069,225,9,"489,9",5,2,1,8,High-Value,Potential Loyalists
24070,376,4,"157,25",4,1,1,6,Mid-Value,Potential Loyalists
24071,768,3,"208,95",3,1,1,5,Low-Value,At Risk Customers
24072,375,7,"793,45",4,2,2,8,High-Value,Potential Loyalists
24074,591,1,"4,9",4,1,1,6,Mid-Value,Potential Loyalists
24076,36,4,"202,60000000000002",5,1,1,7,Mid-Value,Potential Loyalists
24077,80,5,"143,6",5,1,1,7,Mid-Value,Potential Loyalists
24078,897,4,"278,2",3,1,1,5,Low-Value,At Risk Customers
24079,855,1,"19,5",3,1,1,5,Low-Value,At Risk Customers
24080,1086,1,"199,0",3,1,1,5,Low-Value,At Risk Customers
24081,144,5,"196,85000000000002",5,1,1,7,Mid-Value,Potential Loyalists
24082,152,6,"387,0",5,1,1,7,Mid-Value,Potential Loyalists
24084,659,2,"718,5999999999999",4,1,2,7,Mid-Value,Potential Loyalists
24086,566,1,"63,150000000000006",4,1,1,6,Mid-Value,Potential Loyalists
24089,303,2,"11,299999999999999",5,1,1,7,Mid-Value,Potential Loyalists
24090,876,2,"138,95000000000002",3,1,1,5,Low-Value,At Risk Customers
24094,999,3,"128,25",3,1,1,5,Low-Value,At Risk Customers
24095,189,3,"341,35",5,1,1,7,Mid-Value,Potential Loyalists
24098,657,1,"30,7",4,1,1,6,Mid-Value,Potential Loyalists
24100,823,6,"209,2",3,1,1,5,Low-Value,At Risk Customers
24102,830,1,"23,65",3,1,1,5,Low-Value,At Risk Customers
24105,755,2,"119,14999999999999",3,1,1,5,Low-Value,At Risk Customers
24107,957,2,"81,5",3,1,1,5,Low-Value,At Risk Customers
24108,13,11,"615,95",5,2,1,8,High-Value,Potential Loyalists
24109,1801,1,"14,7",1,1,1,3,Low-Value,Lost
24111,320,10,"605,65",5,2,1,8,High-Value,Potential Loyalists
24113,427,4,"184,2",4,1,1,6,Mid-Value,Potential Loyalists
24114,52,1,"5,1",5,1,1,7,Mid-Value,Potential Loyalists
24116,287,2,"107,05",5,1,1,7,Mid-Value,Potential Loyalists
24117,590,2,"56,25",4,1,1,6,Mid-Value,Potential Loyalists
24118,89,1,"79,0",5,1,1,7,Mid-Value,Potential Loyalists
24119,828,1,"23,75",3,1,1,5,Low-Value,At Risk Customers
24120,928,2,"472,95",3,1,1,5,Low-Value,At Risk Customers
24121,922,2,"70,2",3,1,1,5,Low-Value,At Risk Customers
24122,1592,1,"104,2",1,1,1,3,Low-Value,Lost
24123,13,17,"844,05",5,4,2,11,High-Value,Champions
24124,20,4,"447,1",5,1,1,7,Mid-Value,Potential Loyalists
24125,722,4,"322,35",4,1,1,6,Mid-Value,Potential Loyalists
24126,157,3,"172,55",5,1,1,7,Mid-Value,Potential Loyalists
24127,1166,2,"171,05",2,1,1,4,Low-Value,Can't Lose
24128,350,8,"558,85",5,2,1,8,High-Value,Potential Loyalists
24131,957,1,"124,2",3,1,1,5,Low-Value,At Risk Customers
24133,3,9,"489,88",5,2,1,8,High-Value,Potential Loyalists
24136,428,5,"379,95",4,1,1,6,Mid-Value,Potential Loyalists
24138,1344,1,"56,9",2,1,1,4,Low-Value,Can't Lose
24140,621,4,"253,10000000000002",4,1,1,6,Mid-Value,Potential Loyalists
24142,956,2,"54,25",3,1,1,5,Low-Value,At Risk Customers
24143,349,6,"494,75",5,1,1,7,Mid-Value,Potential Loyalists
24144,15,3,"254,14999999999998",5,1,1,7,Mid-Value,Potential Loyalists
24147,561,4,"234,14999999999998",4,1,1,6,Mid-Value,Potential Loyalists
24148,21,3,"153,7",5,1,1,7,Mid-Value,Potential Loyalists
24152,1341,2,"31,049999999999997",2,1,1,4,Low-Value,Can't Lose
24155,208,2,"61,25",5,1,1,7,Mid-Value,Potential Loyalists
24156,855,2,"454,85",3,1,1,5,Low-Value,At Risk Customers
24157,276,4,"135,6",5,1,1,7,Mid-Value,Potential Loyalists
24158,23,7,"852,5",5,2,2,9,High-Value,Champions
24159,118,9,"270,5",5,2,1,8,High-Value,Potential Loyalists
24161,105,1,"129,9",5,1,1,7,Mid-Value,Potential Loyalists
24162,1016,1,"6,7",3,1,1,5,Low-Value,At Risk Customers
24163,619,1,"26,4",4,1,1,6,Mid-Value,Potential Loyalists
24165,934,3,"29,700000000000003",3,1,1,5,Low-Value,At Risk Customers
24166,519,5,"400,45",4,1,1,6,Mid-Value,Potential Loyalists
24169,1316,2,"62,85",2,1,1,4,Low-Value,Can't Lose
24170,101,5,"691,1",5,1,2,8,High-Value,Potential Loyalists
24171,192,6,"1090,75",5,1,2,8,High-Value,Potential Loyalists
24172,530,3,"34,1",4,1,1,6,Mid-Value,Potential Loyalists
24174,709,3,"131,95",4,1,1,6,Mid-Value,Potential Loyalists
24176,8,9,"349,45",5,2,1,8,High-Value,Potential Loyalists
24177,873,1,"42,4",3,1,1,5,Low-Value,At Risk Customers
24179,550,2,"153,8",4,1,1,6,Mid-Value,Potential Loyalists
24181,901,4,"307,6",3,1,1,5,Low-Value,At Risk Customers
24182,153,1,"38,7",5,1,1,7,Mid-Value,Potential Loyalists
24183,444,1,"7,7",4,1,1,6,Mid-Value,Potential Loyalists
24186,175,5,"168,3",5,1,1,7,Mid-Value,Potential Loyalists
24187,525,5,"893,5",4,1,2,7,Mid-Value,Potential Loyalists
24188,270,5,"194,15",5,1,1,7,Mid-Value,Potential Loyalists
24189,650,4,"166,89999999999998",4,1,1,6,Mid-Value,Potential Loyalists
24191,863,1,"455,84999999999997",3,1,1,5,Low-Value,At Risk Customers
24193,1292,3,"107,8",2,1,1,4,Low-Value,Can't Lose
24194,130,2,"46,15",5,1,1,7,Mid-Value,Potential Loyalists
24195,546,4,"150,95",4,1,1,6,Mid-Value,Potential Loyalists
24197,165,8,"331,96000000000004",5,2,1,8,High-Value,Potential Loyalists
24199,360,4,"303,1",5,1,1,7,Mid-Value,Potential Loyalists
24203,600,1,"24,05",4,1,1,6,Mid-Value,Potential Loyalists
24204,38,2,"78,1",5,1,1,7,Mid-Value,Potential Loyalists
24206,138,3,"323,4",5,1,1,7,Mid-Value,Potential Loyalists
24207,846,1,"14,15",3,1,1,5,Low-Value,At Risk Customers
24210,646,3,"96,9",4,1,1,6,Mid-Value,Potential Loyalists
24214,188,6,"1285,25",5,1,2,8,High-Value,Potential Loyalists
24215,60,5,"370,1",5,1,1,7,Mid-Value,Potential Loyalists
24216,45,4,"353,35",5,1,1,7,Mid-Value,Potential Loyalists
24217,714,3,"556,0",4,1,1,6,Mid-Value,Potential Loyalists
24221,1171,6,"184,54999999999998",2,1,1,4,Low-Value,Can't Lose
24222,476,5,"178,1",4,1,1,6,Mid-Value,Potential Loyalists
24223,887,5,"175,0",3,1,1,5,Low-Value,At Risk Customers
24225,167,5,"427,09999999999997",5,1,1,7,Mid-Value,Potential Loyalists
24226,47,4,"224,85",5,1,1,7,Mid-Value,Potential Loyalists
24228,1161,2,"56,45",2,1,1,4,Low-Value,Can't Lose
24229,256,3,"213,0",5,1,1,7,Mid-Value,Potential Loyalists
24233,83,7,"492,7",5,2,1,8,High-Value,Potential Loyalists
24235,1344,1,"9,65",2,1,1,4,Low-Value,Can't Lose
24237,103,4,"535,5",5,1,1,7,Mid-Value,Potential Loyalists
24238,966,3,"270,25",3,1,1,5,Low-Value,At Risk Customers
24239,1301,1,"284,0",2,1,1,4,Low-Value,Can't Lose
24240,68,2,"42,25",5,1,1,7,Mid-Value,Potential Loyalists
24241,1604,1,"141,75",1,1,1,3,Low-Value,Lost
24242,430,2,"132,1",4,1,1,6,Mid-Value,Potential Loyalists
24243,77,1,"26,65",5,1,1,7,Mid-Value,Potential Loyalists
24244,319,4,"392,4",5,1,1,7,Mid-Value,Potential Loyalists
24245,41,1,"28,8",5,1,1,7,Mid-Value,Potential Loyalists
24247,1124,1,"8,6",2,1,1,4,Low-Value,Can't Lose
24248,434,3,"139,15",4,1,1,6,Mid-Value,Potential Loyalists
24249,24,5,"239,35",5,1,1,7,Mid-Value,Potential Loyalists
24250,589,3,"236,5",4,1,1,6,Mid-Value,Potential Loyalists
24251,87,8,"265,85",5,2,1,8,High-Value,Potential Loyalists
24253,727,1,"38,75",4,1,1,6,Mid-Value,Potential Loyalists
24254,7,1,"74,35",5,1,1,7,Mid-Value,Potential Loyalists
24257,1598,1,"131,10000000000002",1,1,1,3,Low-Value,Lost
24258,85,5,"193,9",5,1,1,7,Mid-Value,Potential Loyalists
24259,1712,2,"190,24999999999997",1,1,1,3,Low-Value,Lost
24260,934,5,"91,9",3,1,1,5,Low-Value,At Risk Customers
24262,1330,1,"6,55",2,1,1,4,Low-Value,Can't Lose
24263,1605,1,"225,75",1,1,1,3,Low-Value,Lost
24265,1441,1,"9,85",2,1,1,4,Low-Value,Can't Lose
24266,211,3,"240,85",5,1,1,7,Mid-Value,Potential Loyalists
24267,89,2,"68,39999999999999",5,1,1,7,Mid-Value,Potential Loyalists
24268,74,4,"222,95000000000002",5,1,1,7,Mid-Value,Potential Loyalists
24269,593,4,"307,75",4,1,1,6,Mid-Value,Potential Loyalists
24270,691,2,"192,65",4,1,1,6,Mid-Value,Potential Loyalists
24273,48,5,"112,35",5,1,1,7,Mid-Value,Potential Loyalists
24276,496,2,"218,15",4,1,1,6,Mid-Value,Potential Loyalists
24277,152,2,"79,3",5,1,1,7,Mid-Value,Potential Loyalists
24279,396,4,"173,4",4,1,1,6,Mid-Value,Potential Loyalists
24280,1039,1,"39,7",3,1,1,5,Low-Value,At Risk Customers
24284,22,7,"281,9",5,2,1,8,High-Value,Potential Loyalists
24287,1503,1,"27,65",1,1,1,3,Low-Value,Lost
24288,503,4,"239,35000000000002",4,1,1,6,Mid-Value,Potential Loyalists
24291,667,1,"42,3",4,1,1,6,Mid-Value,Potential Loyalists
24293,306,6,"301,6",5,1,1,7,Mid-Value,Potential Loyalists
24295,1186,3,"129,3",2,1,1,4,Low-Value,Can't Lose
24296,830,1,"90,1",3,1,1,5,Low-Value,At Risk Customers
24297,869,2,"145,35",3,1,1,5,Low-Value,At Risk Customers
24298,196,1,"87,15",5,1,1,7,Mid-Value,Potential Loyalists
24299,1267,1,"58,1",2,1,1,4,Low-Value,Can't Lose
24301,672,2,"63,65",4,1,1,6,Mid-Value,Potential Loyalists
24303,780,4,"335,05",3,1,1,5,Low-Value,At Risk Customers
24304,1506,1,"17,95",1,1,1,3,Low-Value,Lost
24307,419,5,"203,55",4,1,1,6,Mid-Value,Potential Loyalists
24309,944,2,"128,1",3,1,1,5,Low-Value,At Risk Customers
24310,850,4,"246,64999999999998",3,1,1,5,Low-Value,At Risk Customers
24311,48,3,"162,8",5,1,1,7,Mid-Value,Potential Loyalists
24312,11,2,"118,9",5,1,1,7,Mid-Value,Potential Loyalists
24313,1162,1,"478,6",2,1,1,4,Low-Value,Can't Lose
24315,622,4,"170,55",4,1,1,6,Mid-Value,Potential Loyalists
24317,984,1,"16,75",3,1,1,5,Low-Value,At Risk Customers
24318,876,2,"42,150000000000006",3,1,1,5,Low-Value,At Risk Customers
24319,728,2,"84,1",4,1,1,6,Mid-Value,Potential Loyalists
24321,48,1,"135,0",5,1,1,7,Mid-Value,Potential Loyalists
24322,1083,4,"720,75",3,1,2,6,Mid-Value,Potential Loyalists
24325,1356,1,"12,25",2,1,1,4,Low-Value,Can't Lose
24326,312,1,"12,1",5,1,1,7,Mid-Value,Potential Loyalists
24327,1071,2,"75,85",3,1,1,5,Low-Value,At Risk Customers
24329,150,7,"403,0",5,2,1,8,High-Value,Potential Loyalists
24332,507,3,"499,65",4,1,1,6,Mid-Value,Potential Loyalists
24333,573,3,"151,15",4,1,1,6,Mid-Value,Potential Loyalists
24334,797,4,"150,15",3,1,1,5,Low-Value,At Risk Customers
24335,958,1,"5,75",3,1,1,5,Low-Value,At Risk Customers
24336,264,6,"381,40000000000003",5,1,1,7,Mid-Value,Potential Loyalists
24337,1659,1,"121,5",1,1,1,3,Low-Value,Lost
24338,253,7,"231,5",5,2,1,8,High-Value,Potential Loyalists
24340,781,1,"15,25",3,1,1,5,Low-Value,At Risk Customers
24341,993,2,"50,85",3,1,1,5,Low-Value,At Risk Customers
24342,68,5,"94,95",5,1,1,7,Mid-Value,Potential Loyalists
24343,23,13,"832,0",5,3,2,10,High-Value,Champions
24344,400,7,"306,5",4,2,1,7,Mid-Value,Potential Loyalists
24345,281,3,"205,1",5,1,1,7,Mid-Value,Potential Loyalists
24346,213,8,"292,9",5,2,1,8,High-Value,Potential Loyalists
24349,792,3,"132,65",3,1,1,5,Low-Value,At Risk Customers
24350,534,2,"98,3",4,1,1,6,Mid-Value,Potential Loyalists
24352,778,2,"83,10000000000001",3,1,1,5,Low-Value,At Risk Customers
24353,1113,2,"50,800000000000004",2,1,1,4,Low-Value,Can't Lose
24357,68,2,"184,85",5,1,1,7,Mid-Value,Potential Loyalists
24361,1022,1,"10,0",3,1,1,5,Low-Value,At Risk Customers
24362,829,4,"393,2",3,1,1,5,Low-Value,At Risk Customers
24363,1061,2,"76,05",3,1,1,5,Low-Value,At Risk Customers
24364,272,7,"269,15000000000003",5,2,1,8,High-Value,Potential Loyalists
24365,752,2,"173,0",3,1,1,5,Low-Value,At Risk Customers
24367,1033,1,"251,3",3,1,1,5,Low-Value,At Risk Customers
24368,147,2,"54,45",5,1,1,7,Mid-Value,Potential Loyalists
24369,125,6,"402,2",5,1,1,7,Mid-Value,Potential Loyalists
24370,271,5,"73,8",5,1,1,7,Mid-Value,Potential Loyalists
24371,785,1,"39,8",3,1,1,5,Low-Value,At Risk Customers
24374,1364,2,"93,6",2,1,1,4,Low-Value,Can't Lose
24378,455,9,"1046,25",4,2,2,8,High-Value,Potential Loyalists
24379,1065,2,"73,65",3,1,1,5,Low-Value,At Risk Customers
24380,378,4,"95,4",4,1,1,6,Mid-Value,Potential Loyalists
24382,205,1,"37,7",5,1,1,7,Mid-Value,Potential Loyalists
24383,808,2,"53,4",3,1,1,5,Low-Value,At Risk Customers
24384,656,8,"475,7",4,2,1,7,Mid-Value,Potential Loyalists
24385,53,5,"340,94",5,1,1,7,Mid-Value,Potential Loyalists
24387,874,3,"112,65",3,1,1,5,Low-Value,At Risk Customers
24388,68,4,"133,05",5,1,1,7,Mid-Value,Potential Loyalists
24390,694,1,"16,0",4,1,1,6,Mid-Value,Potential Loyalists
24391,396,5,"357,6",4,1,1,6,Mid-Value,Potential Loyalists
24392,242,11,"769,3",5,2,2,9,High-Value,Champions
24393,74,5,"944,6500000000001",5,1,2,8,High-Value,Potential Loyalists
24395,377,5,"640,6",4,1,1,6,Mid-Value,Potential Loyalists
24397,1238,1,"85,05000000000001",2,1,1,4,Low-Value,Can't Lose
24398,360,1,"23,95",5,1,1,7,Mid-Value,Potential Loyalists
24400,18,3,"183,65",5,1,1,7,Mid-Value,Potential Loyalists
24401,104,4,"397,15000000000003",5,1,1,7,Mid-Value,Potential Loyalists
24402,295,2,"165,64999999999998",5,1,1,7,Mid-Value,Potential Loyalists
24404,45,2,"39,7",5,1,1,7,Mid-Value,Potential Loyalists
24405,73,2,"83,89999999999999",5,1,1,7,Mid-Value,Potential Loyalists
24406,76,8,"324,55",5,2,1,8,High-Value,Potential Loyalists
24407,773,3,"523,6",3,1,1,5,Low-Value,At Risk Customers
24408,132,4,"147,0",5,1,1,7,Mid-Value,Potential Loyalists
24411,51,4,"372,55",5,1,1,7,Mid-Value,Potential Loyalists
24413,1137,2,"33,7",2,1,1,4,Low-Value,Can't Lose
24414,1563,2,"209,8",1,1,1,3,Low-Value,Lost
24415,384,13,"377,4",4,3,1,8,High-Value,Potential Loyalists
24416,73,10,"870,25",5,2,2,9,High-Value,Champions
24417,91,4,"146,65",5,1,1,7,Mid-Value,Potential Loyalists
24418,725,2,"1136,8999999999999",4,1,2,7,Mid-Value,Potential Loyalists
24419,774,1,"9,7",3,1,1,5,Low-Value,At Risk Customers
24420,61,2,"72,35",5,1,1,7,Mid-Value,Potential Loyalists
24422,850,3,"324,25",3,1,1,5,Low-Value,At Risk Customers
24424,718,8,"588,15",4,2,1,7,Mid-Value,Potential Loyalists
24425,306,1,"14,45",5,1,1,7,Mid-Value,Potential Loyalists
24426,3,11,"672,95",5,2,2,9,High-Value,Champions
24427,769,2,"75,3",3,1,1,5,Low-Value,At Risk Customers
24429,372,5,"582,5999999999999",4,1,1,6,Mid-Value,Potential Loyalists
24430,554,5,"345,0",4,1,1,6,Mid-Value,Potential Loyalists
24433,1493,1,"36,85",1,1,1,3,Low-Value,Lost
24434,1029,3,"181,3",3,1,1,5,Low-Value,At Risk Customers
24435,293,4,"171,55",5,1,1,7,Mid-Value,Potential Loyalists
24436,173,5,"574,2",5,1,1,7,Mid-Value,Potential Loyalists
24441,621,1,"56,699999999999996",4,1,1,6,Mid-Value,Potential Loyalists
24444,12,1,"423,25",5,1,1,7,Mid-Value,Potential Loyalists
24445,453,4,"180,70000000000002",4,1,1,6,Mid-Value,Potential Loyalists
24450,1693,1,"100,8",1,1,1,3,Low-Value,Lost
24451,514,5,"172,15",4,1,1,6,Mid-Value,Potential Loyalists
24452,335,3,"174,3",5,1,1,7,Mid-Value,Potential Loyalists
24453,1643,1,"6,3",1,1,1,3,Low-Value,Lost
24454,1543,1,"3,1",1,1,1,3,Low-Value,Lost
24455,953,1,"574,2",3,1,1,5,Low-Value,At Risk Customers
24458,2,6,"330,45",5,1,1,7,Mid-Value,Potential Loyalists
24459,295,3,"67,8",5,1,1,7,Mid-Value,Potential Loyalists
24462,119,6,"369,0",5,1,1,7,Mid-Value,Potential Loyalists
24464,755,3,"131,3",3,1,1,5,Low-Value,At Risk Customers
24465,1340,2,"53,75",2,1,1,4,Low-Value,Can't Lose
24466,689,1,"63,2",4,1,1,6,Mid-Value,Potential Loyalists
24467,586,2,"69,85",4,1,1,6,Mid-Value,Potential Loyalists
24469,363,1,"42,0",5,1,1,7,Mid-Value,Potential Loyalists
24470,15,2,"343,90000000000003",5,1,1,7,Mid-Value,Potential Loyalists
24471,10,7,"486,40000000000003",5,2,1,8,High-Value,Potential Loyalists
24472,1174,3,"176,35",2,1,1,4,Low-Value,Can't Lose
24473,1573,4,"138,95",1,1,1,3,Low-Value,Lost
24474,106,7,"504,1",5,2,1,8,High-Value,Potential Loyalists
24475,120,6,"351,35",5,1,1,7,Mid-Value,Potential Loyalists
24476,665,2,"243,0",4,1,1,6,Mid-Value,Potential Loyalists
24477,32,3,"111,94999999999999",5,1,1,7,Mid-Value,Potential Loyalists
24478,765,3,"104,9",3,1,1,5,Low-Value,At Risk Customers
24480,165,12,"745,3",5,3,2,10,High-Value,Champions
24481,1223,2,"353,4",2,1,1,4,Low-Value,Can't Lose
24483,158,9,"630,4",5,2,1,8,High-Value,Potential Loyalists
24484,542,1,"14,5",4,1,1,6,Mid-Value,Potential Loyalists
24485,87,3,"249,39999999999998",5,1,1,7,Mid-Value,Potential Loyalists
24486,145,3,"302,55",5,1,1,7,Mid-Value,Potential Loyalists
24488,1479,1,"152,6",1,1,1,3,Low-Value,Lost
24490,64,6,"892,0999999999999",5,1,2,8,High-Value,Potential Loyalists
24491,104,5,"376,8",5,1,1,7,Mid-Value,Potential Loyalists
24492,225,4,"90,0",5,1,1,7,Mid-Value,Potential Loyalists
24493,193,1,"711,2",5,1,2,8,High-Value,Potential Loyalists
24494,467,1,"72,9",4,1,1,6,Mid-Value,Potential Loyalists
24495,8,5,"139,3",5,1,1,7,Mid-Value,Potential Loyalists
24496,868,1,"16,200000000000003",3,1,1,5,Low-Value,At Risk Customers
24497,622,1,"80,45",4,1,1,6,Mid-Value,Potential Loyalists
24498,207,3,"452,24999999999994",5,1,1,7,Mid-Value,Potential Loyalists
24500,1219,1,"39,4",2,1,1,4,Low-Value,Can't Lose
24501,791,1,"12,85",3,1,1,5,Low-Value,At Risk Customers
24504,42,2,"36,75",5,1,1,7,Mid-Value,Potential Loyalists
24507,30,2,"152,6",5,1,1,7,Mid-Value,Potential Loyalists
24509,372,8,"308,35",4,2,1,7,Mid-Value,Potential Loyalists
24511,441,2,"45,05",4,1,1,6,Mid-Value,Potential Loyalists
24512,1472,1,"141,9",1,1,1,3,Low-Value,Lost
24513,1305,4,"203,8",2,1,1,4,Low-Value,Can't Lose
24515,666,2,"30,4",4,1,1,6,Mid-Value,Potential Loyalists
24522,440,2,"41,7",4,1,1,6,Mid-Value,Potential Loyalists
24524,112,3,"143,45",5,1,1,7,Mid-Value,Potential Loyalists
24525,1133,1,"40,25",2,1,1,4,Low-Value,Can't Lose
24526,8,15,"712,1",5,3,2,10,High-Value,Champions
24528,719,5,"226,35",4,1,1,6,Mid-Value,Potential Loyalists
24529,384,2,"47,150000000000006",4,1,1,6,Mid-Value,Potential Loyalists
24530,105,5,"574,4",5,1,1,7,Mid-Value,Potential Loyalists
24534,315,1,"72,1",5,1,1,7,Mid-Value,Potential Loyalists
24535,1057,1,"7,5",3,1,1,5,Low-Value,At Risk Customers
24536,53,8,"213,8",5,2,1,8,High-Value,Potential Loyalists
24538,282,10,"417,8",5,2,1,8,High-Value,Potential Loyalists
24539,144,1,"204,6",5,1,1,7,Mid-Value,Potential Loyalists
24546,490,2,"461,29999999999995",4,1,1,6,Mid-Value,Potential Loyalists
24547,144,2,"87,75",5,1,1,7,Mid-Value,Potential Loyalists
24548,124,6,"312,35",5,1,1,7,Mid-Value,Potential Loyalists
24549,28,5,"370,35",5,1,1,7,Mid-Value,Potential Loyalists
24551,480,10,"348,45000000000005",4,2,1,7,Mid-Value,Potential Loyalists
24552,769,3,"234,4",3,1,1,5,Low-Value,At Risk Customers
24554,555,6,"373,25",4,1,1,6,Mid-Value,Potential Loyalists
24556,53,8,"232,85",5,2,1,8,High-Value,Potential Loyalists
24557,22,2,"318,20000000000005",5,1,1,7,Mid-Value,Potential Loyalists
24558,125,1,"506,4",5,1,1,7,Mid-Value,Potential Loyalists
24559,1626,1,"50,4",1,1,1,3,Low-Value,Lost
24560,1809,1,"10,23",1,1,1,3,Low-Value,Lost
24561,1636,2,"225,60000000000002",1,1,1,3,Low-Value,Lost
24564,134,4,"197,75",5,1,1,7,Mid-Value,Potential Loyalists
24565,27,2,"259,55",5,1,1,7,Mid-Value,Potential Loyalists
24569,432,1,"11,8",4,1,1,6,Mid-Value,Potential Loyalists
24570,417,3,"196,89999999999998",4,1,1,6,Mid-Value,Potential Loyalists
24572,1053,1,"33,25",3,1,1,5,Low-Value,At Risk Customers
24573,1131,4,"254,54999999999998",2,1,1,4,Low-Value,Can't Lose
24574,1188,1,"15,05",2,1,1,4,Low-Value,Can't Lose
24576,914,1,"26,4",3,1,1,5,Low-Value,At Risk Customers
24577,63,1,"50,4",5,1,1,7,Mid-Value,Potential Loyalists
24580,10,9,"653,55",5,2,1,8,High-Value,Potential Loyalists
24581,172,4,"167,3",5,1,1,7,Mid-Value,Potential Loyalists
24582,506,3,"379,0",4,1,1,6,Mid-Value,Potential Loyalists
24588,1553,1,"8,6",1,1,1,3,Low-Value,Lost
24590,1600,1,"24,0",1,1,1,3,Low-Value,Lost
24592,26,4,"438,0",5,1,1,7,Mid-Value,Potential Loyalists
24594,81,7,"269,7",5,2,1,8,High-Value,Potential Loyalists
24596,508,1,"8,15",4,1,1,6,Mid-Value,Potential Loyalists
24598,724,1,"40,75",4,1,1,6,Mid-Value,Potential Loyalists
24599,1727,2,"208,2",1,1,1,3,Low-Value,Lost
24600,1369,4,"165,0",2,1,1,4,Low-Value,Can't Lose
24602,1006,1,"95,1",3,1,1,5,Low-Value,At Risk Customers
24603,211,5,"341,45000000000005",5,1,1,7,Mid-Value,Potential Loyalists
24605,74,3,"290,15",5,1,1,7,Mid-Value,Potential Loyalists
24607,140,3,"107,1",5,1,1,7,Mid-Value,Potential Loyalists
24608,45,2,"210,3",5,1,1,7,Mid-Value,Potential Loyalists
24609,16,10,"539,25",5,2,1,8,High-Value,Potential Loyalists
24610,379,3,"155,45",4,1,1,6,Mid-Value,Potential Loyalists
24613,1072,2,"43,0",3,1,1,5,Low-Value,At Risk Customers
24614,969,1,"13,15",3,1,1,5,Low-Value,At Risk Customers
24615,98,3,"104,85",5,1,1,7,Mid-Value,Potential Loyalists
24616,151,3,"69,55",5,1,1,7,Mid-Value,Potential Loyalists
24617,1351,1,"10,7",2,1,1,4,Low-Value,Can't Lose
24619,430,1,"17,25",4,1,1,6,Mid-Value,Potential Loyalists
24620,7,4,"210,0",5,1,1,7,Mid-Value,Potential Loyalists
24621,804,3,"92,8",3,1,1,5,Low-Value,At Risk Customers
24622,407,5,"344,54999999999995",4,1,1,6,Mid-Value,Potential Loyalists
24623,510,3,"634,1999999999999",4,1,1,6,Mid-Value,Potential Loyalists
24625,3,4,"544,1",5,1,1,7,Mid-Value,Potential Loyalists
24626,375,2,"222,64999999999998",4,1,1,6,Mid-Value,Potential Loyalists
24629,1341,2,"57,85",2,1,1,4,Low-Value,Can't Lose
24630,28,3,"90,2",5,1,1,7,Mid-Value,Potential Loyalists
24631,899,3,"106,0",3,1,1,5,Low-Value,At Risk Customers
24635,626,4,"142,9",4,1,1,6,Mid-Value,Potential Loyalists
24637,1530,1,"2,2",1,1,1,3,Low-Value,Lost
24638,178,3,"83,2",5,1,1,7,Mid-Value,Potential Loyalists
24640,1030,1,"25,0",3,1,1,5,Low-Value,At Risk Customers
24641,1024,2,"92,1",3,1,1,5,Low-Value,At Risk Customers
24643,138,4,"256,95",5,1,1,7,Mid-Value,Potential Loyalists
24644,603,2,"105,35",4,1,1,6,Mid-Value,Potential Loyalists
24645,1025,2,"44,5",3,1,1,5,Low-Value,At Risk Customers
24646,220,1,"35,05",5,1,1,7,Mid-Value,Potential Loyalists
24647,1226,1,"84,9",2,1,1,4,Low-Value,Can't Lose
24649,153,1,"10,6",5,1,1,7,Mid-Value,Potential Loyalists
24651,104,8,"443,45",5,2,1,8,High-Value,Potential Loyalists
24653,576,1,"17,15",4,1,1,6,Mid-Value,Potential Loyalists
24655,1137,1,"17,25",2,1,1,4,Low-Value,Can't Lose
24656,1172,2,"155,65",2,1,1,4,Low-Value,Can't Lose
24657,1057,1,"15,9",3,1,1,5,Low-Value,At Risk Customers
24658,599,2,"71,55",4,1,1,6,Mid-Value,Potential Loyalists
24659,67,3,"28,0",5,1,1,7,Mid-Value,Potential Loyalists
24662,858,4,"144,1",3,1,1,5,Low-Value,At Risk Customers
24667,17,1,"35,25",5,1,1,7,Mid-Value,Potential Loyalists
24668,1108,1,"20,9",2,1,1,4,Low-Value,Can't Lose
24669,216,4,"176,59999999999997",5,1,1,7,Mid-Value,Potential Loyalists
24671,148,6,"233,0",5,1,1,7,Mid-Value,Potential Loyalists
24672,857,4,"247,05",3,1,1,5,Low-Value,At Risk Customers
24673,45,6,"359,09999999999997",5,1,1,7,Mid-Value,Potential Loyalists
24677,1323,2,"25,4",2,1,1,4,Low-Value,Can't Lose
24679,781,9,"940,7",3,2,2,7,Mid-Value,Potential Loyalists
24680,902,1,"19,4",3,1,1,5,Low-Value,At Risk Customers
24681,496,7,"466,6",4,2,1,7,Mid-Value,Potential Loyalists
24684,1430,1,"15,6",2,1,1,4,Low-Value,Can't Lose
24685,112,3,"237,05",5,1,1,7,Mid-Value,Potential Loyalists
24686,1497,1,"7,75",1,1,1,3,Low-Value,Lost
24687,1145,2,"47,65",2,1,1,4,Low-Value,Can't Lose
24689,779,4,"241,85",3,1,1,5,Low-Value,At Risk Customers
24693,1543,1,"9,8",1,1,1,3,Low-Value,Lost
24694,111,4,"192,55",5,1,1,7,Mid-Value,Potential Loyalists
24695,339,3,"238,85",5,1,1,7,Mid-Value,Potential Loyalists
24697,565,2,"70,55000000000001",4,1,1,6,Mid-Value,Potential Loyalists
24699,914,1,"88,5",3,1,1,5,Low-Value,At Risk Customers
24701,794,1,"15,65",3,1,1,5,Low-Value,At Risk Customers
24702,208,5,"216,55",5,1,1,7,Mid-Value,Potential Loyalists
24705,15,2,"56,400000000000006",5,1,1,7,Mid-Value,Potential Loyalists
24706,817,9,"578,6",3,2,1,6,Mid-Value,Potential Loyalists
24708,155,5,"145,9",5,1,1,7,Mid-Value,Potential Loyalists
24709,125,3,"98,75",5,1,1,7,Mid-Value,Potential Loyalists
24711,147,8,"478,45",5,2,1,8,High-Value,Potential Loyalists
24712,47,3,"146,95000000000002",5,1,1,7,Mid-Value,Potential Loyalists
24713,760,1,"348,6",3,1,1,5,Low-Value,At Risk Customers
24714,118,5,"189,8",5,1,1,7,Mid-Value,Potential Loyalists
24716,397,4,"226,49999999999997",4,1,1,6,Mid-Value,Potential Loyalists
24717,1047,5,"715,2",3,1,2,6,Mid-Value,Potential Loyalists
24718,237,2,"779,3999999999999",5,1,2,8,High-Value,Potential Loyalists
24719,211,8,"537,75",5,2,1,8,High-Value,Potential Loyalists
24720,405,1,"30,35",4,1,1,6,Mid-Value,Potential Loyalists
24722,255,1,"36,7",5,1,1,7,Mid-Value,Potential Loyalists
24726,42,7,"362,8",5,2,1,8,High-Value,Potential Loyalists
24727,657,1,"32,15",4,1,1,6,Mid-Value,Potential Loyalists
24728,91,2,"393,15000000000003",5,1,1,7,Mid-Value,Potential Loyalists
24729,264,5,"483,34999999999997",5,1,1,7,Mid-Value,Potential Loyalists
24730,234,4,"488,15",5,1,1,7,Mid-Value,Potential Loyalists
24733,544,6,"235,05",4,1,1,6,Mid-Value,Potential Loyalists
24735,37,5,"932,2999999999998",5,1,2,8,High-Value,Potential Loyalists
24737,42,4,"133,05",5,1,1,7,Mid-Value,Potential Loyalists
24738,21,10,"581,3",5,2,1,8,High-Value,Potential Loyalists
24739,827,1,"9,3",3,1,1,5,Low-Value,At Risk Customers
24740,183,3,"171,65",5,1,1,7,Mid-Value,Potential Loyalists
24742,552,5,"215,04999999999998",4,1,1,6,Mid-Value,Potential Loyalists
24743,48,5,"161,29999999999998",5,1,1,7,Mid-Value,Potential Loyalists
24744,861,1,"24,4",3,1,1,5,Low-Value,At Risk Customers
24747,1301,1,"61,0",2,1,1,4,Low-Value,Can't Lose
24748,18,5,"364,5",5,1,1,7,Mid-Value,Potential Loyalists
24749,414,2,"56,2",4,1,1,6,Mid-Value,Potential Loyalists
24750,316,3,"181,95",5,1,1,7,Mid-Value,Potential Loyalists
24752,169,2,"98,8",5,1,1,7,Mid-Value,Potential Loyalists
24753,98,8,"416,0",5,2,1,8,High-Value,Potential Loyalists
24754,899,1,"8,100000000000001",3,1,1,5,Low-Value,At Risk Customers
24755,1555,3,"115,39999999999999",1,1,1,3,Low-Value,Lost
24757,122,5,"242,35",5,1,1,7,Mid-Value,Potential Loyalists
24758,1351,1,"100,8",2,1,1,4,Low-Value,Can't Lose
24759,956,1,"118,8",3,1,1,5,Low-Value,At Risk Customers
24762,151,3,"221,75",5,1,1,7,Mid-Value,Potential Loyalists
24764,679,2,"120,80000000000001",4,1,1,6,Mid-Value,Potential Loyalists
24765,159,6,"1043,35",5,1,2,8,High-Value,Potential Loyalists
24766,250,3,"201,85000000000002",5,1,1,7,Mid-Value,Potential Loyalists
24767,846,3,"275,25",3,1,1,5,Low-Value,At Risk Customers
24769,629,4,"165,05",4,1,1,6,Mid-Value,Potential Loyalists
24770,921,5,"446,25",3,1,1,5,Low-Value,At Risk Customers
24771,1355,4,"255,85",2,1,1,4,Low-Value,Can't Lose
24772,742,4,"353,15",3,1,1,5,Low-Value,At Risk Customers
24773,132,4,"252,89999999999998",5,1,1,7,Mid-Value,Potential Loyalists
24775,343,8,"527,0",5,2,1,8,High-Value,Potential Loyalists
24777,752,3,"467,4",3,1,1,5,Low-Value,At Risk Customers
24782,135,7,"330,15",5,2,1,8,High-Value,Potential Loyalists
24783,452,1,"76,3",4,1,1,6,Mid-Value,Potential Loyalists
24784,1725,1,"8,95",1,1,1,3,Low-Value,Lost
24785,73,7,"190,9",5,2,1,8,High-Value,Potential Loyalists
24787,637,4,"317,0",4,1,1,6,Mid-Value,Potential Loyalists
24788,558,5,"303,3",4,1,1,6,Mid-Value,Potential Loyalists
24789,140,1,"20,4",5,1,1,7,Mid-Value,Potential Loyalists
24790,796,1,"12,0",3,1,1,5,Low-Value,At Risk Customers
24791,1398,4,"135,2",2,1,1,4,Low-Value,Can't Lose
24792,754,1,"107,7",3,1,1,5,Low-Value,At Risk Customers
24793,53,5,"309,9",5,1,1,7,Mid-Value,Potential Loyalists
24794,564,12,"1168,3500000000001",4,3,2,9,High-Value,Champions
24796,1226,1,"35,1",2,1,1,4,Low-Value,Can't Lose
24797,1438,2,"286,3",2,1,1,4,Low-Value,Can't Lose
24798,274,6,"327,15",5,1,1,7,Mid-Value,Potential Loyalists
24804,12,3,"203,55",5,1,1,7,Mid-Value,Potential Loyalists
24805,231,15,"921,25",5,3,2,10,High-Value,Champions
24806,99,2,"60,65",5,1,1,7,Mid-Value,Potential Loyalists
24808,1117,1,"68,7",2,1,1,4,Low-Value,Can't Lose
24810,243,1,"272,4",5,1,1,7,Mid-Value,Potential Loyalists
24811,136,3,"176,85000000000002",5,1,1,7,Mid-Value,Potential Loyalists
24812,30,4,"53,65",5,1,1,7,Mid-Value,Potential Loyalists
24813,386,8,"370,0",4,2,1,7,Mid-Value,Potential Loyalists
24814,179,6,"455,6",5,1,1,7,Mid-Value,Potential Loyalists
24815,83,1,"144,7",5,1,1,7,Mid-Value,Potential Loyalists
24816,458,3,"133,25",4,1,1,6,Mid-Value,Potential Loyalists
24817,1272,2,"46,75",2,1,1,4,Low-Value,Can't Lose
24818,1470,4,"487,95",1,1,1,3,Low-Value,Lost
24819,342,7,"385,1",5,2,1,8,High-Value,Potential Loyalists
24821,500,3,"511,05",4,1,1,6,Mid-Value,Potential Loyalists
24822,348,2,"108,19999999999999",5,1,1,7,Mid-Value,Potential Loyalists
24826,93,5,"265,75",5,1,1,7,Mid-Value,Potential Loyalists
24827,1352,1,"20,2",2,1,1,4,Low-Value,Can't Lose
24829,5,9,"380,85",5,2,1,8,High-Value,Potential Loyalists
24830,325,5,"74,95",5,1,1,7,Mid-Value,Potential Loyalists
24831,395,5,"382,0",4,1,1,6,Mid-Value,Potential Loyalists
24833,252,1,"22,45",5,1,1,7,Mid-Value,Potential Loyalists
24835,3,1,"7,4",5,1,1,7,Mid-Value,Potential Loyalists
24836,828,1,"19,15",3,1,1,5,Low-Value,At Risk Customers
24837,356,1,"6,45",5,1,1,7,Mid-Value,Potential Loyalists
24838,264,9,"680,15",5,2,2,9,High-Value,Champions
24840,1282,1,"73,7",2,1,1,4,Low-Value,Can't Lose
24841,996,1,"2,4",3,1,1,5,Low-Value,At Risk Customers
24842,149,5,"243,2",5,1,1,7,Mid-Value,Potential Loyalists
24844,973,1,"17,8",3,1,1,5,Low-Value,At Risk Customers
24846,127,14,"518,9",5,3,1,9,High-Value,Champions
24847,1150,3,"140,35",2,1,1,4,Low-Value,Can't Lose
24848,27,3,"72,47",5,1,1,7,Mid-Value,Potential Loyalists
24851,31,4,"149,45",5,1,1,7,Mid-Value,Potential Loyalists
24852,1517,2,"33,35",1,1,1,3,Low-Value,Lost
24853,444,3,"71,0",4,1,1,6,Mid-Value,Potential Loyalists
24854,48,2,"104,55000000000001",5,1,1,7,Mid-Value,Potential Loyalists
24855,1590,1,"24,4",1,1,1,3,Low-Value,Lost
24856,1632,2,"129,35000000000002",1,1,1,3,Low-Value,Lost
24857,112,4,"360,6",5,1,1,7,Mid-Value,Potential Loyalists
24859,140,2,"33,2",5,1,1,7,Mid-Value,Potential Loyalists
24862,552,1,"2,5",4,1,1,6,Mid-Value,Potential Loyalists
24863,567,7,"480,25",4,2,1,7,Mid-Value,Potential Loyalists
24864,20,6,"286,85",5,1,1,7,Mid-Value,Potential Loyalists
24865,285,14,"1070,1",5,3,2,10,High-Value,Champions
24866,1209,1,"24,5",2,1,1,4,Low-Value,Can't Lose
24868,46,7,"358,40000000000003",5,2,1,8,High-Value,Potential Loyalists
24869,7,10,"799,1",5,2,2,9,High-Value,Champions
24870,193,3,"377,4",5,1,1,7,Mid-Value,Potential Loyalists
24871,395,2,"113,75",4,1,1,6,Mid-Value,Potential Loyalists
24872,140,7,"458,90000000000003",5,2,1,8,High-Value,Potential Loyalists
24874,878,4,"289,4",3,1,1,5,Low-Value,At Risk Customers
24875,1268,1,"41,4",2,1,1,4,Low-Value,Can't Lose
24876,763,4,"170,6",3,1,1,5,Low-Value,At Risk Customers
24877,36,2,"189,6",5,1,1,7,Mid-Value,Potential Loyalists
24879,208,2,"70,75",5,1,1,7,Mid-Value,Potential Loyalists
24880,19,5,"263,05",5,1,1,7,Mid-Value,Potential Loyalists
24881,234,1,"17,1",5,1,1,7,Mid-Value,Potential Loyalists
24883,280,8,"741,9",5,2,2,9,High-Value,Champions
24886,752,2,"412,65000000000003",3,1,1,5,Low-Value,At Risk Customers
24888,161,2,"69,94999999999999",5,1,1,7,Mid-Value,Potential Loyalists
24890,175,1,"142,95",5,1,1,7,Mid-Value,Potential Loyalists
24891,1059,1,"33,15",3,1,1,5,Low-Value,At Risk Customers
24893,453,1,"29,45",4,1,1,6,Mid-Value,Potential Loyalists
24894,1277,1,"118,64999999999999",2,1,1,4,Low-Value,Can't Lose
24896,54,6,"384,3",5,1,1,7,Mid-Value,Potential Loyalists
24897,21,2,"44,0",5,1,1,7,Mid-Value,Potential Loyalists
24898,133,1,"27,25",5,1,1,7,Mid-Value,Potential Loyalists
24900,994,1,"89,2",3,1,1,5,Low-Value,At Risk Customers
24902,1433,1,"122,3",2,1,1,4,Low-Value,Can't Lose
24903,616,2,"103,8",4,1,1,6,Mid-Value,Potential Loyalists
24904,298,1,"30,35",5,1,1,7,Mid-Value,Potential Loyalists
24905,7,2,"184,9",5,1,1,7,Mid-Value,Potential Loyalists
24909,663,1,"40,75",4,1,1,6,Mid-Value,Potential Loyalists
24915,7,5,"281,65",5,1,1,7,Mid-Value,Potential Loyalists
24916,726,2,"45,3",4,1,1,6,Mid-Value,Potential Loyalists
24917,227,4,"177,89999999999998",5,1,1,7,Mid-Value,Potential Loyalists
24918,1093,1,"7,7",3,1,1,5,Low-Value,At Risk Customers
24920,79,10,"551,2",5,2,1,8,High-Value,Potential Loyalists
24921,1383,1,"14,3",2,1,1,4,Low-Value,Can't Lose
24923,204,7,"771,35",5,2,2,9,High-Value,Champions
24924,298,10,"624,1800000000001",5,2,1,8,High-Value,Potential Loyalists
24925,490,5,"365,8",4,1,1,6,Mid-Value,Potential Loyalists
24926,143,3,"96,19999999999999",5,1,1,7,Mid-Value,Potential Loyalists
24927,18,5,"1141,45",5,1,2,8,High-Value,Potential Loyalists
24928,749,6,"210,15",3,1,1,5,Low-Value,At Risk Customers
24929,624,1,"37,55",4,1,1,6,Mid-Value,Potential Loyalists
24931,720,2,"70,85",4,1,1,6,Mid-Value,Potential Loyalists
24933,861,2,"65,75",3,1,1,5,Low-Value,At Risk Customers
24934,133,1,"8,25",5,1,1,7,Mid-Value,Potential Loyalists
24935,1347,2,"230,8",2,1,1,4,Low-Value,Can't Lose
24936,932,1,"20,9",3,1,1,5,Low-Value,At Risk Customers
24937,84,6,"364,9",5,1,1,7,Mid-Value,Potential Loyalists
24938,1309,1,"12,3",2,1,1,4,Low-Value,Can't Lose
24939,22,5,"642,25",5,1,1,7,Mid-Value,Potential Loyalists
24940,45,3,"87,05",5,1,1,7,Mid-Value,Potential Loyalists
24941,334,5,"322,15",5,1,1,7,Mid-Value,Potential Loyalists
24942,402,3,"45,35",4,1,1,6,Mid-Value,Potential Loyalists
24943,188,3,"267,75",5,1,1,7,Mid-Value,Potential Loyalists
24944,61,4,"228,05",5,1,1,7,Mid-Value,Potential Loyalists
24950,22,4,"326,4",5,1,1,7,Mid-Value,Potential Loyalists
24951,157,2,"114,60000000000001",5,1,1,7,Mid-Value,Potential Loyalists
24952,557,4,"235,45",4,1,1,6,Mid-Value,Potential Loyalists
24953,991,4,"379,6",3,1,1,5,Low-Value,At Risk Customers
24954,1261,1,"40,0",2,1,1,4,Low-Value,Can't Lose
24956,55,2,"55,2",5,1,1,7,Mid-Value,Potential Loyalists
24957,283,6,"719,1",5,1,2,8,High-Value,Potential Loyalists
24959,630,3,"114,45",4,1,1,6,Mid-Value,Potential Loyalists
24960,216,2,"201,2",5,1,1,7,Mid-Value,Potential Loyalists
24961,139,2,"68,95",5,1,1,7,Mid-Value,Potential Loyalists
24966,579,2,"29,3",4,1,1,6,Mid-Value,Potential Loyalists
24969,1781,1,"17,8",1,1,1,3,Low-Value,Lost
24970,588,6,"161,95",4,1,1,6,Mid-Value,Potential Loyalists
24972,124,4,"117,7",5,1,1,7,Mid-Value,Potential Loyalists
24974,806,2,"86,89999999999999",3,1,1,5,Low-Value,At Risk Customers
24975,190,2,"1034,8999999999999",5,1,2,8,High-Value,Potential Loyalists
24976,255,2,"297,95",5,1,1,7,Mid-Value,Potential Loyalists
24977,421,2,"40,3",4,1,1,6,Mid-Value,Potential Loyalists
24980,14,3,"261,25",5,1,1,7,Mid-Value,Potential Loyalists
24981,856,1,"161,55",3,1,1,5,Low-Value,At Risk Customers
24984,1706,1,"8,55",1,1,1,3,Low-Value,Lost
24985,989,1,"13,15",3,1,1,5,Low-Value,At Risk Customers
24989,1575,1,"46,8",1,1,1,3,Low-Value,Lost
24990,545,1,"23,4",4,1,1,6,Mid-Value,Potential Loyalists
24991,1275,1,"8,95",2,1,1,4,Low-Value,Can't Lose
24992,30,3,"236,14999999999998",5,1,1,7,Mid-Value,Potential Loyalists
24993,246,6,"136,4",5,1,1,7,Mid-Value,Potential Loyalists
24994,437,6,"253,35",4,1,1,6,Mid-Value,Potential Loyalists
24995,1637,1,"62,1",1,1,1,3,Low-Value,Lost
24996,929,1,"182,0",3,1,1,5,Low-Value,At Risk Customers
24997,57,2,"64,9",5,1,1,7,Mid-Value,Potential Loyalists
24998,490,3,"30,35",4,1,1,6,Mid-Value,Potential Loyalists
24999,343,2,"180,5",5,1,1,7,Mid-Value,Potential Loyalists
25003,1728,1,"7,65",1,1,1,3,Low-Value,Lost
25004,781,1,"86,05",3,1,1,5,Low-Value,At Risk Customers
25006,626,3,"208,0",4,1,1,6,Mid-Value,Potential Loyalists
25007,286,2,"91,85",5,1,1,7,Mid-Value,Potential Loyalists
25008,848,1,"44,25",3,1,1,5,Low-Value,At Risk Customers
25012,1437,1,"2,2",2,1,1,4,Low-Value,Can't Lose
25013,389,1,"25,049999999999997",4,1,1,6,Mid-Value,Potential Loyalists
25016,402,4,"532,35",4,1,1,6,Mid-Value,Potential Loyalists
25017,384,10,"499,34999999999997",4,2,1,7,Mid-Value,Potential Loyalists
25019,1680,1,"50,3",1,1,1,3,Low-Value,Lost
25021,13,7,"702,6",5,2,2,9,High-Value,Champions
25022,1254,2,"48,550000000000004",2,1,1,4,Low-Value,Can't Lose
25024,1456,1,"12,8",2,1,1,4,Low-Value,Can't Lose
25025,350,4,"75,4",5,1,1,7,Mid-Value,Potential Loyalists
25026,535,2,"203,35000000000002",4,1,1,6,Mid-Value,Potential Loyalists
25028,365,2,"65,5",5,1,1,7,Mid-Value,Potential Loyalists
25029,1640,1,"125,0",1,1,1,3,Low-Value,Lost
25030,227,3,"192,7",5,1,1,7,Mid-Value,Potential Loyalists
25031,174,4,"283,6",5,1,1,7,Mid-Value,Potential Loyalists
25033,1461,1,"26,0",1,1,1,3,Low-Value,Lost
25034,855,4,"236,55",3,1,1,5,Low-Value,At Risk Customers
25035,274,5,"351,05",5,1,1,7,Mid-Value,Potential Loyalists
25036,159,12,"328,15",5,3,1,9,High-Value,Champions
25039,183,2,"288,3",5,1,1,7,Mid-Value,Potential Loyalists
25040,0,2,"333,65",5,1,1,7,Mid-Value,Potential Loyalists
25041,532,3,"183,3",4,1,1,6,Mid-Value,Potential Loyalists
25044,1793,1,"129,0",1,1,1,3,Low-Value,Lost
25046,567,4,"356,2",4,1,1,6,Mid-Value,Potential Loyalists
25047,221,5,"217,3",5,1,1,7,Mid-Value,Potential Loyalists
25048,222,1,"100,2",5,1,1,7,Mid-Value,Potential Loyalists
25050,1272,1,"170,0",2,1,1,4,Low-Value,Can't Lose
25051,440,6,"452,3",4,1,1,6,Mid-Value,Potential Loyalists
25053,889,4,"178,75",3,1,1,5,Low-Value,At Risk Customers
25056,53,1,"59,4",5,1,1,7,Mid-Value,Potential Loyalists
25057,808,3,"34,8",3,1,1,5,Low-Value,At Risk Customers
25058,291,3,"117,15",5,1,1,7,Mid-Value,Potential Loyalists
25059,535,7,"515,6",4,2,1,7,Mid-Value,Potential Loyalists
25060,140,3,"133,45",5,1,1,7,Mid-Value,Potential Loyalists
25061,1340,1,"13,75",2,1,1,4,Low-Value,Can't Lose
25062,148,1,"20,5",5,1,1,7,Mid-Value,Potential Loyalists
25064,432,5,"144,05",4,1,1,6,Mid-Value,Potential Loyalists
25065,21,4,"322,8",5,1,1,7,Mid-Value,Potential Loyalists
25070,24,4,"103,9",5,1,1,7,Mid-Value,Potential Loyalists
25073,1717,1,"19,4",1,1,1,3,Low-Value,Lost
25077,45,3,"207,25",5,1,1,7,Mid-Value,Potential Loyalists
25078,1620,1,"57,35",1,1,1,3,Low-Value,Lost
25079,861,3,"154,1",3,1,1,5,Low-Value,At Risk Customers
25080,859,1,"126,4",3,1,1,5,Low-Value,At Risk Customers
25081,1009,3,"97,95",3,1,1,5,Low-Value,At Risk Customers
25082,437,2,"212,74999999999997",4,1,1,6,Mid-Value,Potential Loyalists
25083,1578,5,"382,7",1,1,1,3,Low-Value,Lost
25084,1710,1,"2,85",1,1,1,3,Low-Value,Lost
25086,220,5,"198,95",5,1,1,7,Mid-Value,Potential Loyalists
25087,1524,2,"77,05",1,1,1,3,Low-Value,Lost
25088,746,3,"270,25",3,1,1,5,Low-Value,At Risk Customers
25090,3,9,"532,1600000000001",5,2,1,8,High-Value,Potential Loyalists
25093,231,2,"61,65",5,1,1,7,Mid-Value,Potential Loyalists
25095,376,3,"168,55",4,1,1,6,Mid-Value,Potential Loyalists
25097,129,5,"323,4",5,1,1,7,Mid-Value,Potential Loyalists
25098,144,5,"214,75",5,1,1,7,Mid-Value,Potential Loyalists
25099,10,5,"226,39999999999998",5,1,1,7,Mid-Value,Potential Loyalists
25100,573,2,"251,79999999999998",4,1,1,6,Mid-Value,Potential Loyalists
25101,1494,2,"112,1",1,1,1,3,Low-Value,Lost
25102,15,3,"108,7",5,1,1,7,Mid-Value,Potential Loyalists
25104,452,3,"205,0",4,1,1,6,Mid-Value,Potential Loyalists
25105,647,2,"34,9",4,1,1,6,Mid-Value,Potential Loyalists
25108,16,6,"285,2",5,1,1,7,Mid-Value,Potential Loyalists
25110,92,6,"245,25",5,1,1,7,Mid-Value,Potential Loyalists
25111,21,5,"414,25",5,1,1,7,Mid-Value,Potential Loyalists
25112,903,3,"215,65",3,1,1,5,Low-Value,At Risk Customers
25113,74,1,"25,55",5,1,1,7,Mid-Value,Potential Loyalists
25115,795,5,"175,39999999999998",3,1,1,5,Low-Value,At Risk Customers
25117,27,8,"380,3",5,2,1,8,High-Value,Potential Loyalists
25118,883,2,"175,45",3,1,1,5,Low-Value,At Risk Customers
25119,260,4,"69,85",5,1,1,7,Mid-Value,Potential Loyalists
25120,571,1,"40,0",4,1,1,6,Mid-Value,Potential Loyalists
25121,731,2,"102,45",3,1,1,5,Low-Value,At Risk Customers
25124,322,5,"368,59999999999997",5,1,1,7,Mid-Value,Potential Loyalists
25125,419,8,"587,0500000000001",4,2,1,7,Mid-Value,Potential Loyalists
25126,291,3,"103,75",5,1,1,7,Mid-Value,Potential Loyalists
25127,984,3,"107,65",3,1,1,5,Low-Value,At Risk Customers
25128,719,2,"119,35",4,1,1,6,Mid-Value,Potential Loyalists
25130,75,7,"1627,6",5,2,3,10,High-Value,Champions
25131,16,1,"135,0",5,1,1,7,Mid-Value,Potential Loyalists
25132,13,2,"221,4",5,1,1,7,Mid-Value,Potential Loyalists
25133,86,4,"249,95",5,1,1,7,Mid-Value,Potential Loyalists
25134,129,2,"214,70000000000002",5,1,1,7,Mid-Value,Potential Loyalists
25136,23,4,"294,95",5,1,1,7,Mid-Value,Potential Loyalists
25138,1754,1,"22,15",1,1,1,3,Low-Value,Lost
25141,339,8,"313,7",5,2,1,8,High-Value,Potential Loyalists
25142,37,6,"654,8",5,1,1,7,Mid-Value,Potential Loyalists
25143,403,2,"113,25",4,1,1,6,Mid-Value,Potential Loyalists
25144,791,3,"106,44999999999999",3,1,1,5,Low-Value,At Risk Customers
25147,408,3,"328,7",4,1,1,6,Mid-Value,Potential Loyalists
25148,197,2,"45,5",5,1,1,7,Mid-Value,Potential Loyalists
25151,1369,1,"45,0",2,1,1,4,Low-Value,Can't Lose
25152,178,1,"55,050000000000004",5,1,1,7,Mid-Value,Potential Loyalists
25153,192,9,"552,1",5,2,1,8,High-Value,Potential Loyalists
25154,161,5,"444,45000000000005",5,1,1,7,Mid-Value,Potential Loyalists
25156,449,1,"8,55",4,1,1,6,Mid-Value,Potential Loyalists
25157,169,8,"562,1",5,2,1,8,High-Value,Potential Loyalists
25166,144,2,"132,5",5,1,1,7,Mid-Value,Potential Loyalists
25171,63,11,"494,5",5,2,1,8,High-Value,Potential Loyalists
25172,507,5,"199,2",4,1,1,6,Mid-Value,Potential Loyalists
25178,1107,5,"275,55",2,1,1,4,Low-Value,Can't Lose
25179,577,5,"308,55",4,1,1,6,Mid-Value,Potential Loyalists
25183,769,1,"31,55",3,1,1,5,Low-Value,At Risk Customers
25184,1378,4,"209,6",2,1,1,4,Low-Value,Can't Lose
25185,84,4,"97,95",5,1,1,7,Mid-Value,Potential Loyalists
25186,902,3,"259,79999999999995",3,1,1,5,Low-Value,At Risk Customers
25189,791,2,"42,099999999999994",3,1,1,5,Low-Value,At Risk Customers
25190,1513,1,"193,75",1,1,1,3,Low-Value,Lost
25191,10,10,"545,3",5,2,1,8,High-Value,Potential Loyalists
25192,746,4,"1406,8",3,1,3,7,Mid-Value,Potential Loyalists
25193,716,1,"48,05",4,1,1,6,Mid-Value,Potential Loyalists
25194,1293,1,"83,75",2,1,1,4,Low-Value,Can't Lose
25196,617,1,"46,8",4,1,1,6,Mid-Value,Potential Loyalists
25197,299,3,"118,3",5,1,1,7,Mid-Value,Potential Loyalists
25198,388,3,"105,25",4,1,1,6,Mid-Value,Potential Loyalists
25199,894,1,"248,39999999999998",3,1,1,5,Low-Value,At Risk Customers
25200,134,2,"211,1",5,1,1,7,Mid-Value,Potential Loyalists
25201,98,3,"287,5",5,1,1,7,Mid-Value,Potential Loyalists
25202,1525,1,"15,7",1,1,1,3,Low-Value,Lost
25203,113,4,"135,3",5,1,1,7,Mid-Value,Potential Loyalists
25205,14,5,"188,45",5,1,1,7,Mid-Value,Potential Loyalists
25207,56,3,"56,8",5,1,1,7,Mid-Value,Potential Loyalists
25209,1534,1,"50,9",1,1,1,3,Low-Value,Lost
25210,18,5,"330,04999999999995",5,1,1,7,Mid-Value,Potential Loyalists
25211,256,3,"107,15",5,1,1,7,Mid-Value,Potential Loyalists
25212,521,2,"24,3",4,1,1,6,Mid-Value,Potential Loyalists
25213,866,4,"404,90000000000003",3,1,1,5,Low-Value,At Risk Customers
25216,596,2,"63,9",4,1,1,6,Mid-Value,Potential Loyalists
25217,412,4,"335,0",4,1,1,6,Mid-Value,Potential Loyalists
25218,54,4,"443,29999999999995",5,1,1,7,Mid-Value,Potential Loyalists
25219,600,1,"30,25",4,1,1,6,Mid-Value,Potential Loyalists
25222,579,4,"112,6",4,1,1,6,Mid-Value,Potential Loyalists
25223,785,2,"57,95",3,1,1,5,Low-Value,At Risk Customers
25224,70,5,"291,8",5,1,1,7,Mid-Value,Potential Loyalists
25225,778,1,"55,0",3,1,1,5,Low-Value,At Risk Customers
25226,494,1,"30,8",4,1,1,6,Mid-Value,Potential Loyalists
25227,1218,1,"43,8",2,1,1,4,Low-Value,Can't Lose
25228,1405,1,"12,2",2,1,1,4,Low-Value,Can't Lose
25229,530,1,"195,7",4,1,1,6,Mid-Value,Potential Loyalists
25230,210,1,"201,6",5,1,1,7,Mid-Value,Potential Loyalists
25231,41,3,"65,05000000000001",5,1,1,7,Mid-Value,Potential Loyalists
25232,19,2,"184,8",5,1,1,7,Mid-Value,Potential Loyalists
25233,432,3,"521,6999999999999",4,1,1,6,Mid-Value,Potential Loyalists
25236,1147,3,"104,75",2,1,1,4,Low-Value,Can't Lose
25239,370,2,"17,9",4,1,1,6,Mid-Value,Potential Loyalists
25240,93,1,"73,0",5,1,1,7,Mid-Value,Potential Loyalists
25241,534,2,"142,75",4,1,1,6,Mid-Value,Potential Loyalists
25242,1222,1,"368,4",2,1,1,4,Low-Value,Can't Lose
25244,227,4,"142,6",5,1,1,7,Mid-Value,Potential Loyalists
25245,949,1,"209,45",3,1,1,5,Low-Value,At Risk Customers
25246,17,8,"870,6999999999999",5,2,2,9,High-Value,Champions
25250,44,3,"321,25",5,1,1,7,Mid-Value,Potential Loyalists
25251,566,2,"67,15",4,1,1,6,Mid-Value,Potential Loyalists
25252,3,3,"149,2",5,1,1,7,Mid-Value,Potential Loyalists
25253,123,1,"15,5",5,1,1,7,Mid-Value,Potential Loyalists
25254,609,1,"22,35",4,1,1,6,Mid-Value,Potential Loyalists
25256,1331,2,"61,45",2,1,1,4,Low-Value,Can't Lose
25257,11,3,"36,55",5,1,1,7,Mid-Value,Potential Loyalists
25258,592,2,"36,35",4,1,1,6,Mid-Value,Potential Loyalists
25262,346,1,"5,95",5,1,1,7,Mid-Value,Potential Loyalists
25263,1703,2,"46,55",1,1,1,3,Low-Value,Lost
25265,186,9,"523,3000000000001",5,2,1,8,High-Value,Potential Loyalists
25266,522,3,"171,85",4,1,1,6,Mid-Value,Potential Loyalists
25267,67,3,"43,7",5,1,1,7,Mid-Value,Potential Loyalists
25268,177,6,"301,15",5,1,1,7,Mid-Value,Potential Loyalists
25270,1504,1,"82,85",1,1,1,3,Low-Value,Lost
25272,895,4,"225,25",3,1,1,5,Low-Value,At Risk Customers
25273,17,12,"573,5",5,3,1,9,High-Value,Champions
25276,145,4,"99,0",5,1,1,7,Mid-Value,Potential Loyalists
25277,581,2,"58,95",4,1,1,6,Mid-Value,Potential Loyalists
25278,1371,1,"135,6",2,1,1,4,Low-Value,Can't Lose
25280,574,4,"431,95",4,1,1,6,Mid-Value,Potential Loyalists
25281,537,3,"141,70000000000002",4,1,1,6,Mid-Value,Potential Loyalists
25283,88,2,"689,3",5,1,2,8,High-Value,Potential Loyalists
25286,1235,1,"158,0",2,1,1,4,Low-Value,Can't Lose
25287,388,3,"119,15",4,1,1,6,Mid-Value,Potential Loyalists
25290,741,3,"120,94999999999999",3,1,1,5,Low-Value,At Risk Customers
25291,134,7,"551,2",5,2,1,8,High-Value,Potential Loyalists
25292,438,3,"398,09999999999997",4,1,1,6,Mid-Value,Potential Loyalists
25293,7,5,"634,55",5,1,1,7,Mid-Value,Potential Loyalists
25294,623,7,"324,75",4,2,1,7,Mid-Value,Potential Loyalists
25295,192,6,"185,25",5,1,1,7,Mid-Value,Potential Loyalists
25297,129,2,"184,1",5,1,1,7,Mid-Value,Potential Loyalists
25298,1320,1,"89,6",2,1,1,4,Low-Value,Can't Lose
25299,703,3,"117,94999999999999",4,1,1,6,Mid-Value,Potential Loyalists
25300,743,5,"466,0",3,1,1,5,Low-Value,At Risk Customers
25302,116,1,"74,55",5,1,1,7,Mid-Value,Potential Loyalists
25303,24,2,"124,45",5,1,1,7,Mid-Value,Potential Loyalists
25306,590,3,"151,45",4,1,1,6,Mid-Value,Potential Loyalists
25308,1235,2,"40,7",2,1,1,4,Low-Value,Can't Lose
25309,829,3,"320,85",3,1,1,5,Low-Value,At Risk Customers
25313,1057,2,"35,2",3,1,1,5,Low-Value,At Risk Customers
25314,33,5,"268,65",5,1,1,7,Mid-Value,Potential Loyalists
25318,406,2,"150,8",4,1,1,6,Mid-Value,Potential Loyalists
25319,177,2,"324,15",5,1,1,7,Mid-Value,Potential Loyalists
25320,179,2,"47,3",5,1,1,7,Mid-Value,Potential Loyalists
25321,1180,1,"48,6",2,1,1,4,Low-Value,Can't Lose
25322,1618,1,"137,2",1,1,1,3,Low-Value,Lost
25323,152,3,"124,85",5,1,1,7,Mid-Value,Potential Loyalists
25324,518,1,"55,4",4,1,1,6,Mid-Value,Potential Loyalists
25325,3,6,"237,1",5,1,1,7,Mid-Value,Potential Loyalists
25327,319,3,"240,95",5,1,1,7,Mid-Value,Potential Loyalists
25328,216,2,"148,60000000000002",5,1,1,7,Mid-Value,Potential Loyalists
25329,25,5,"168,2",5,1,1,7,Mid-Value,Potential Loyalists
25333,165,3,"285,04999999999995",5,1,1,7,Mid-Value,Potential Loyalists
25335,131,2,"110,15",5,1,1,7,Mid-Value,Potential Loyalists
25336,1221,1,"98,9",2,1,1,4,Low-Value,Can't Lose
25337,431,3,"255,95",4,1,1,6,Mid-Value,Potential Loyalists
25338,542,2,"44,55",4,1,1,6,Mid-Value,Potential Loyalists
25339,1179,3,"319,9",2,1,1,4,Low-Value,Can't Lose
25342,613,2,"339,4",4,1,1,6,Mid-Value,Potential Loyalists
25344,377,7,"181,0",4,2,1,7,Mid-Value,Potential Loyalists
25345,19,4,"776,3",5,1,2,8,High-Value,Potential Loyalists
25347,46,10,"332,35",5,2,1,8,High-Value,Potential Loyalists
25348,345,1,"16,45",5,1,1,7,Mid-Value,Potential Loyalists
25349,1562,1,"38,15",1,1,1,3,Low-Value,Lost
25350,13,4,"965,0999999999999",5,1,2,8,High-Value,Potential Loyalists
25352,216,2,"236,49999999999997",5,1,1,7,Mid-Value,Potential Loyalists
25354,935,2,"331,65",3,1,1,5,Low-Value,At Risk Customers
25355,348,2,"10,55",5,1,1,7,Mid-Value,Potential Loyalists
25357,1014,2,"51,55",3,1,1,5,Low-Value,At Risk Customers
25361,779,2,"69,95",3,1,1,5,Low-Value,At Risk Customers
25362,777,3,"87,15",3,1,1,5,Low-Value,At Risk Customers
25363,658,3,"155,2",4,1,1,6,Mid-Value,Potential Loyalists
25364,196,4,"176,15",5,1,1,7,Mid-Value,Potential Loyalists
25365,105,6,"327,6",5,1,1,7,Mid-Value,Potential Loyalists
25368,717,1,"83,55",4,1,1,6,Mid-Value,Potential Loyalists
25369,59,4,"113,8",5,1,1,7,Mid-Value,Potential Loyalists
25370,23,2,"127,1",5,1,1,7,Mid-Value,Potential Loyalists
25372,1076,2,"111,85",3,1,1,5,Low-Value,At Risk Customers
25374,1106,4,"67,44999999999999",2,1,1,4,Low-Value,Can't Lose
25378,40,2,"31,25",5,1,1,7,Mid-Value,Potential Loyalists
25380,49,5,"104,3",5,1,1,7,Mid-Value,Potential Loyalists
25382,1285,1,"3,2",2,1,1,4,Low-Value,Can't Lose
25383,140,6,"316,65000000000003",5,1,1,7,Mid-Value,Potential Loyalists
25386,671,1,"43,45",4,1,1,6,Mid-Value,Potential Loyalists
25387,71,5,"207,05",5,1,1,7,Mid-Value,Potential Loyalists
25391,556,3,"106,85",4,1,1,6,Mid-Value,Potential Loyalists
25392,31,6,"361,35",5,1,1,7,Mid-Value,Potential Loyalists
25397,570,2,"105,7",4,1,1,6,Mid-Value,Potential Loyalists
25399,1718,1,"34,35",1,1,1,3,Low-Value,Lost
25400,1213,2,"38,699999999999996",2,1,1,4,Low-Value,Can't Lose
25404,351,4,"242,54999999999998",5,1,1,7,Mid-Value,Potential Loyalists
25405,886,5,"435,5",3,1,1,5,Low-Value,At Risk Customers
25408,70,2,"111,19999999999999",5,1,1,7,Mid-Value,Potential Loyalists
25410,844,2,"87,25",3,1,1,5,Low-Value,At Risk Customers
25412,123,8,"524,5",5,2,1,8,High-Value,Potential Loyalists
25414,19,2,"45,0",5,1,1,7,Mid-Value,Potential Loyalists
25417,897,2,"109,45",3,1,1,5,Low-Value,At Risk Customers
25418,212,1,"34,7",5,1,1,7,Mid-Value,Potential Loyalists
25419,1259,1,"39,9",2,1,1,4,Low-Value,Can't Lose
25420,121,3,"69,15",5,1,1,7,Mid-Value,Potential Loyalists
25421,148,5,"97,4",5,1,1,7,Mid-Value,Potential Loyalists
25423,1171,1,"39,8",2,1,1,4,Low-Value,Can't Lose
25425,519,2,"80,10000000000001",4,1,1,6,Mid-Value,Potential Loyalists
25427,73,5,"306,4",5,1,1,7,Mid-Value,Potential Loyalists
25429,805,3,"320,55",3,1,1,5,Low-Value,At Risk Customers
25431,46,6,"654,15",5,1,1,7,Mid-Value,Potential Loyalists
25434,1469,2,"86,25",1,1,1,3,Low-Value,Lost
25436,56,3,"133,8",5,1,1,7,Mid-Value,Potential Loyalists
25437,408,4,"257,85",4,1,1,6,Mid-Value,Potential Loyalists
25439,3,2,"67,4",5,1,1,7,Mid-Value,Potential Loyalists
25440,778,4,"127,94999999999999",3,1,1,5,Low-Value,At Risk Customers
25441,29,3,"388,4",5,1,1,7,Mid-Value,Potential Loyalists
25447,568,3,"138,75",4,1,1,6,Mid-Value,Potential Loyalists
25450,486,3,"70,85",4,1,1,6,Mid-Value,Potential Loyalists
25453,1573,1,"111,7",1,1,1,3,Low-Value,Lost
25454,1266,1,"161,7",2,1,1,4,Low-Value,Can't Lose
25455,31,12,"517,25",5,3,1,9,High-Value,Champions
25456,1236,4,"91,75",2,1,1,4,Low-Value,Can't Lose
25457,551,3,"323,7",4,1,1,6,Mid-Value,Potential Loyalists
25459,77,6,"210,7",5,1,1,7,Mid-Value,Potential Loyalists
25461,464,4,"145,0",4,1,1,6,Mid-Value,Potential Loyalists
25463,862,2,"133,7",3,1,1,5,Low-Value,At Risk Customers
25464,170,4,"291,45",5,1,1,7,Mid-Value,Potential Loyalists
25465,238,2,"42,550000000000004",5,1,1,7,Mid-Value,Potential Loyalists
25466,141,5,"406,2",5,1,1,7,Mid-Value,Potential Loyalists
25468,596,4,"317,45",4,1,1,6,Mid-Value,Potential Loyalists
25469,1358,1,"13,35",2,1,1,4,Low-Value,Can't Lose
25470,752,1,"90,4",3,1,1,5,Low-Value,At Risk Customers
25474,445,1,"18,25",4,1,1,6,Mid-Value,Potential Loyalists
25475,881,1,"31,4",3,1,1,5,Low-Value,At Risk Customers
25476,46,1,"47,95",5,1,1,7,Mid-Value,Potential Loyalists
25478,96,1,"253,2",5,1,1,7,Mid-Value,Potential Loyalists
25479,283,3,"248,8",5,1,1,7,Mid-Value,Potential Loyalists
25480,906,2,"369,90000000000003",3,1,1,5,Low-Value,At Risk Customers
25481,230,2,"44,400000000000006",5,1,1,7,Mid-Value,Potential Loyalists
25484,885,2,"402,70000000000005",3,1,1,5,Low-Value,At Risk Customers
25485,427,1,"19,85",4,1,1,6,Mid-Value,Potential Loyalists
25486,576,1,"109,4",4,1,1,6,Mid-Value,Potential Loyalists
25487,160,4,"345,04999999999995",5,1,1,7,Mid-Value,Potential Loyalists
25489,1246,2,"77,45",2,1,1,4,Low-Value,Can't Lose
25490,824,3,"198,6",3,1,1,5,Low-Value,At Risk Customers
25491,81,3,"161,0",5,1,1,7,Mid-Value,Potential Loyalists
25492,108,1,"5,65",5,1,1,7,Mid-Value,Potential Loyalists
25493,1816,1,"196,15",1,1,1,3,Low-Value,Lost
25494,444,3,"169,3",4,1,1,6,Mid-Value,Potential Loyalists
25495,252,4,"107,8",5,1,1,7,Mid-Value,Potential Loyalists
25496,205,4,"259,95000000000005",5,1,1,7,Mid-Value,Potential Loyalists
25499,885,1,"93,1",3,1,1,5,Low-Value,At Risk Customers
25500,27,5,"226,20000000000002",5,1,1,7,Mid-Value,Potential Loyalists
25501,864,3,"243,5",3,1,1,5,Low-Value,At Risk Customers
25502,1673,1,"382,6",1,1,1,3,Low-Value,Lost
25504,1010,4,"235,55",3,1,1,5,Low-Value,At Risk Customers
25505,1698,1,"18,6",1,1,1,3,Low-Value,Lost
25506,77,5,"336,25",5,1,1,7,Mid-Value,Potential Loyalists
25507,1781,1,"21,9",1,1,1,3,Low-Value,Lost
25509,1379,1,"87,15",2,1,1,4,Low-Value,Can't Lose
25510,5,2,"46,75",5,1,1,7,Mid-Value,Potential Loyalists
25511,368,2,"112,55",4,1,1,6,Mid-Value,Potential Loyalists
25512,260,5,"344,8",5,1,1,7,Mid-Value,Potential Loyalists
25513,4,2,"79,80000000000001",5,1,1,7,Mid-Value,Potential Loyalists
25515,1270,2,"91,35",2,1,1,4,Low-Value,Can't Lose
25516,210,2,"44,15",5,1,1,7,Mid-Value,Potential Loyalists
25519,115,6,"303,05",5,1,1,7,Mid-Value,Potential Loyalists
25520,1604,1,"12,7",1,1,1,3,Low-Value,Lost
25521,1103,1,"115,35000000000001",2,1,1,4,Low-Value,Can't Lose
25522,1392,2,"86,0",2,1,1,4,Low-Value,Can't Lose
25524,40,5,"380,1",5,1,1,7,Mid-Value,Potential Loyalists
25526,96,8,"341,4",5,2,1,8,High-Value,Potential Loyalists
25527,537,2,"193,39999999999998",4,1,1,6,Mid-Value,Potential Loyalists
25530,1169,1,"38,0",2,1,1,4,Low-Value,Can't Lose
25533,156,5,"307,65",5,1,1,7,Mid-Value,Potential Loyalists
25534,1285,2,"616,75",2,1,1,4,Low-Value,Can't Lose
25536,90,4,"123,7",5,1,1,7,Mid-Value,Potential Loyalists
25537,225,7,"721,0",5,2,2,9,High-Value,Champions
25538,735,2,"72,39999999999999",3,1,1,5,Low-Value,At Risk Customers
25539,834,1,"40,85",3,1,1,5,Low-Value,At Risk Customers
25540,562,8,"532,0",4,2,1,7,Mid-Value,Potential Loyalists
25542,9,10,"911,7",5,2,2,9,High-Value,Champions
25543,192,2,"152,3",5,1,1,7,Mid-Value,Potential Loyalists
25545,861,1,"318,8",3,1,1,5,Low-Value,At Risk Customers
25548,325,3,"116,75",5,1,1,7,Mid-Value,Potential Loyalists
25550,1178,5,"263,6",2,1,1,4,Low-Value,Can't Lose
25552,108,4,"265,05",5,1,1,7,Mid-Value,Potential Loyalists
25553,439,6,"213,4",4,1,1,6,Mid-Value,Potential Loyalists
25554,3,11,"720,05",5,2,2,9,High-Value,Champions
25555,444,1,"62,9",4,1,1,6,Mid-Value,Potential Loyalists
25557,969,2,"159,3",3,1,1,5,Low-Value,At Risk Customers
25558,688,3,"55,9",4,1,1,6,Mid-Value,Potential Loyalists
25559,135,3,"891,4499999999999",5,1,2,8,High-Value,Potential Loyalists
25560,1489,1,"60,1",1,1,1,3,Low-Value,Lost
25561,427,3,"116,5",4,1,1,6,Mid-Value,Potential Loyalists
25562,254,1,"204,0",5,1,1,7,Mid-Value,Potential Loyalists
25563,1097,1,"65,4",2,1,1,4,Low-Value,Can't Lose
25566,9,2,"326,85",5,1,1,7,Mid-Value,Potential Loyalists
25568,17,1,"196,0",5,1,1,7,Mid-Value,Potential Loyalists
25569,358,7,"397,4",5,2,1,8,High-Value,Potential Loyalists
25570,884,3,"154,05",3,1,1,5,Low-Value,At Risk Customers
25571,942,3,"117,1",3,1,1,5,Low-Value,At Risk Customers
25572,1205,3,"228,0",2,1,1,4,Low-Value,Can't Lose
25573,106,2,"84,4",5,1,1,7,Mid-Value,Potential Loyalists
25576,83,2,"108,35",5,1,1,7,Mid-Value,Potential Loyalists
25577,122,4,"240,75",5,1,1,7,Mid-Value,Potential Loyalists
25578,661,8,"284,3",4,2,1,7,Mid-Value,Potential Loyalists
25580,517,2,"65,9",4,1,1,6,Mid-Value,Potential Loyalists
25582,127,6,"141,35",5,1,1,7,Mid-Value,Potential Loyalists
25583,404,3,"169,8",4,1,1,6,Mid-Value,Potential Loyalists
25584,160,5,"458,55",5,1,1,7,Mid-Value,Potential Loyalists
25585,743,2,"48,55",3,1,1,5,Low-Value,At Risk Customers
25587,218,1,"64,4",5,1,1,7,Mid-Value,Potential Loyalists
25588,406,1,"146,2",4,1,1,6,Mid-Value,Potential Loyalists
25590,153,4,"145,7",5,1,1,7,Mid-Value,Potential Loyalists
25591,530,2,"180,05",4,1,1,6,Mid-Value,Potential Loyalists
25592,960,2,"125,7",3,1,1,5,Low-Value,At Risk Customers
25593,721,4,"148,7",4,1,1,6,Mid-Value,Potential Loyalists
25594,826,1,"19,4",3,1,1,5,Low-Value,At Risk Customers
25595,496,1,"45,6",4,1,1,6,Mid-Value,Potential Loyalists
25597,287,7,"774,5500000000001",5,2,2,9,High-Value,Champions
25598,1209,1,"30,75",2,1,1,4,Low-Value,Can't Lose
25599,550,4,"285,7",4,1,1,6,Mid-Value,Potential Loyalists
25600,45,3,"393,8",5,1,1,7,Mid-Value,Potential Loyalists
25601,1267,1,"60,7",2,1,1,4,Low-Value,Can't Lose
25602,763,3,"60,45",3,1,1,5,Low-Value,At Risk Customers
25603,1073,4,"232,2",3,1,1,5,Low-Value,At Risk Customers
25604,189,6,"519,35",5,1,1,7,Mid-Value,Potential Loyalists
25605,16,4,"113,65",5,1,1,7,Mid-Value,Potential Loyalists
25606,1315,1,"145,5",2,1,1,4,Low-Value,Can't Lose
25608,466,1,"60,15",4,1,1,6,Mid-Value,Potential Loyalists
25609,987,4,"304,4",3,1,1,5,Low-Value,At Risk Customers
25610,1210,1,"48,3",2,1,1,4,Low-Value,Can't Lose
25611,766,2,"96,1",3,1,1,5,Low-Value,At Risk Customers
25615,46,7,"657,6999999999999",5,2,1,8,High-Value,Potential Loyalists
25616,70,3,"146,75",5,1,1,7,Mid-Value,Potential Loyalists
25617,110,1,"172,2",5,1,1,7,Mid-Value,Potential Loyalists
25618,280,15,"1421,3500000000001",5,3,3,11,High-Value,Champions
25620,638,1,"20,6",4,1,1,6,Mid-Value,Potential Loyalists
25621,439,2,"85,0",4,1,1,6,Mid-Value,Potential Loyalists
25622,306,1,"253,2",5,1,1,7,Mid-Value,Potential Loyalists
25623,150,2,"23,95",5,1,1,7,Mid-Value,Potential Loyalists
25625,591,7,"457,65",4,2,1,7,Mid-Value,Potential Loyalists
25626,69,8,"253,7",5,2,1,8,High-Value,Potential Loyalists
25627,409,7,"353,55",4,2,1,7,Mid-Value,Potential Loyalists
25628,1470,1,"102,9",1,1,1,3,Low-Value,Lost
25629,430,3,"587,1",4,1,1,6,Mid-Value,Potential Loyalists
25630,88,5,"185,95",5,1,1,7,Mid-Value,Potential Loyalists
25631,265,6,"423,35",5,1,1,7,Mid-Value,Potential Loyalists
25632,175,7,"414,45",5,2,1,8,High-Value,Potential Loyalists
25633,1572,2,"65,1",1,1,1,3,Low-Value,Lost
25638,449,7,"1199,25",4,2,2,8,High-Value,Potential Loyalists
25639,1536,2,"97,25",1,1,1,3,Low-Value,Lost
25640,1021,1,"2,85",3,1,1,5,Low-Value,At Risk Customers
25641,84,3,"274,45",5,1,1,7,Mid-Value,Potential Loyalists
25643,430,3,"66,65",4,1,1,6,Mid-Value,Potential Loyalists
25644,187,4,"36,85",5,1,1,7,Mid-Value,Potential Loyalists
25645,685,2,"140,0",4,1,1,6,Mid-Value,Potential Loyalists
25646,369,4,"151,2",4,1,1,6,Mid-Value,Potential Loyalists
25647,1126,1,"19,0",2,1,1,4,Low-Value,Can't Lose
25649,1166,1,"22,8",2,1,1,4,Low-Value,Can't Lose
25650,71,5,"228,45",5,1,1,7,Mid-Value,Potential Loyalists
25652,39,2,"17,9",5,1,1,7,Mid-Value,Potential Loyalists
25653,686,5,"295,4",4,1,1,6,Mid-Value,Potential Loyalists
25656,473,4,"288,55",4,1,1,6,Mid-Value,Potential Loyalists
25658,1294,2,"138,64999999999998",2,1,1,4,Low-Value,Can't Lose
25661,1175,1,"55,0",2,1,1,4,Low-Value,Can't Lose
25662,174,11,"523,1",5,2,1,8,High-Value,Potential Loyalists
25665,1091,2,"53,25",3,1,1,5,Low-Value,At Risk Customers
25669,1563,4,"224,6",1,1,1,3,Low-Value,Lost
25670,63,1,"9,2",5,1,1,7,Mid-Value,Potential Loyalists
25671,158,3,"126,05000000000001",5,1,1,7,Mid-Value,Potential Loyalists
25672,153,2,"223,45",5,1,1,7,Mid-Value,Potential Loyalists
25674,11,2,"41,0",5,1,1,7,Mid-Value,Potential Loyalists
25675,89,6,"240,64999999999998",5,1,1,7,Mid-Value,Potential Loyalists
25678,225,1,"37,85",5,1,1,7,Mid-Value,Potential Loyalists
25679,540,2,"23,3",4,1,1,6,Mid-Value,Potential Loyalists
25680,1440,1,"74,0",2,1,1,4,Low-Value,Can't Lose
25681,505,4,"264,4",4,1,1,6,Mid-Value,Potential Loyalists
25683,1782,1,"42,15",1,1,1,3,Low-Value,Lost
25685,447,5,"177,8",4,1,1,6,Mid-Value,Potential Loyalists
25687,106,2,"105,15",5,1,1,7,Mid-Value,Potential Loyalists
25688,1721,1,"3,9",1,1,1,3,Low-Value,Lost
25689,221,3,"221,8",5,1,1,7,Mid-Value,Potential Loyalists
25690,427,2,"134,55",4,1,1,6,Mid-Value,Potential Loyalists
25691,1363,2,"83,60000000000001",2,1,1,4,Low-Value,Can't Lose
25693,148,1,"52,6",5,1,1,7,Mid-Value,Potential Loyalists
25696,442,3,"237,84999999999997",4,1,1,6,Mid-Value,Potential Loyalists
25698,41,4,"156,9",5,1,1,7,Mid-Value,Potential Loyalists
25701,11,2,"138,75",5,1,1,7,Mid-Value,Potential Loyalists
25703,56,6,"203,6",5,1,1,7,Mid-Value,Potential Loyalists
25705,326,3,"193,15",5,1,1,7,Mid-Value,Potential Loyalists
25706,1085,2,"50,0",3,1,1,5,Low-Value,At Risk Customers
25707,903,7,"299,55",3,2,1,6,Mid-Value,Potential Loyalists
25708,211,3,"693,9",5,1,2,8,High-Value,Potential Loyalists
25709,1456,1,"11,1",2,1,1,4,Low-Value,Can't Lose
25710,125,9,"733,15",5,2,2,9,High-Value,Champions
25711,530,3,"160,6",4,1,1,6,Mid-Value,Potential Loyalists
25715,486,3,"89,2",4,1,1,6,Mid-Value,Potential Loyalists
25717,526,1,"28,5",4,1,1,6,Mid-Value,Potential Loyalists
25720,886,1,"7,25",3,1,1,5,Low-Value,At Risk Customers
25721,21,1,"42,6",5,1,1,7,Mid-Value,Potential Loyalists
25722,251,5,"198,9",5,1,1,7,Mid-Value,Potential Loyalists
25723,68,6,"442,4",5,1,1,7,Mid-Value,Potential Loyalists
25725,8,1,"10,4",5,1,1,7,Mid-Value,Potential Loyalists
25727,561,3,"1202,65",4,1,2,7,Mid-Value,Potential Loyalists
25728,883,1,"18,0",3,1,1,5,Low-Value,At Risk Customers
25730,22,3,"100,05",5,1,1,7,Mid-Value,Potential Loyalists
25732,557,2,"16,35",4,1,1,6,Mid-Value,Potential Loyalists
25733,998,2,"205,20000000000002",3,1,1,5,Low-Value,At Risk Customers
25734,230,3,"48,8",5,1,1,7,Mid-Value,Potential Loyalists
25737,617,3,"336,15",4,1,1,6,Mid-Value,Potential Loyalists
25738,53,4,"84,95",5,1,1,7,Mid-Value,Potential Loyalists
25739,805,6,"340,5",3,1,1,5,Low-Value,At Risk Customers
25740,1115,11,"1067,05",2,2,2,6,Mid-Value,Potential Loyalists
25741,0,2,"36,7",5,1,1,7,Mid-Value,Potential Loyalists
25743,753,4,"136,15",3,1,1,5,Low-Value,At Risk Customers
25745,444,11,"527,5",4,2,1,7,Mid-Value,Potential Loyalists
25749,636,8,"470,1",4,2,1,7,Mid-Value,Potential Loyalists
25750,755,1,"267,0",3,1,1,5,Low-Value,At Risk Customers
25752,492,1,"20,5",4,1,1,6,Mid-Value,Potential Loyalists
25753,644,3,"321,15",4,1,1,6,Mid-Value,Potential Loyalists
25754,117,2,"87,14999999999999",5,1,1,7,Mid-Value,Potential Loyalists
25755,509,8,"322,95",4,2,1,7,Mid-Value,Potential Loyalists
25758,144,10,"195,25",5,2,1,8,High-Value,Potential Loyalists
25759,387,9,"437,09999999999997",4,2,1,7,Mid-Value,Potential Loyalists
25760,35,10,"637,35",5,2,1,8,High-Value,Potential Loyalists
25761,896,3,"288,7",3,1,1,5,Low-Value,At Risk Customers
25763,590,6,"432,15",4,1,1,6,Mid-Value,Potential Loyalists
25764,118,3,"177,0",5,1,1,7,Mid-Value,Potential Loyalists
25765,876,1,"175,2",3,1,1,5,Low-Value,At Risk Customers
25766,897,4,"192,95",3,1,1,5,Low-Value,At Risk Customers
25768,88,3,"255,0",5,1,1,7,Mid-Value,Potential Loyalists
25769,273,6,"168,55",5,1,1,7,Mid-Value,Potential Loyalists
25770,838,7,"360,25",3,2,1,6,Mid-Value,Potential Loyalists
25771,63,5,"88,25",5,1,1,7,Mid-Value,Potential Loyalists
25775,385,5,"396,95",4,1,1,6,Mid-Value,Potential Loyalists
25777,103,17,"1538,6",5,4,3,12,High-Value,Champions
25778,1213,1,"2,25",2,1,1,4,Low-Value,Can't Lose
25779,238,2,"71,0",5,1,1,7,Mid-Value,Potential Loyalists
25781,1270,4,"244,2",2,1,1,4,Low-Value,Can't Lose
25784,566,7,"483,25",4,2,1,7,Mid-Value,Potential Loyalists
25785,460,3,"48,15",4,1,1,6,Mid-Value,Potential Loyalists
25786,1236,2,"72,1",2,1,1,4,Low-Value,Can't Lose
25788,1758,1,"47,5",1,1,1,3,Low-Value,Lost
25790,1072,1,"16,55",3,1,1,5,Low-Value,At Risk Customers
25791,178,4,"141,3",5,1,1,7,Mid-Value,Potential Loyalists
25795,1515,2,"97,35",1,1,1,3,Low-Value,Lost
25796,102,2,"23,599999999999998",5,1,1,7,Mid-Value,Potential Loyalists
25797,383,4,"187,5",4,1,1,6,Mid-Value,Potential Loyalists
25799,320,5,"193,15",5,1,1,7,Mid-Value,Potential Loyalists
25800,1,2,"326,3",5,1,1,7,Mid-Value,Potential Loyalists
25801,59,3,"181,5",5,1,1,7,Mid-Value,Potential Loyalists
25802,391,10,"1339,35",4,2,3,9,High-Value,Champions
25803,1072,4,"328,0",3,1,1,5,Low-Value,At Risk Customers
25804,210,3,"257,65",5,1,1,7,Mid-Value,Potential Loyalists
25805,1051,3,"106,9",3,1,1,5,Low-Value,At Risk Customers
25806,1153,1,"4,45",2,1,1,4,Low-Value,Can't Lose
25808,1250,1,"27,3",2,1,1,4,Low-Value,Can't Lose
25810,455,2,"149,45",4,1,1,6,Mid-Value,Potential Loyalists
25812,758,1,"24,2",3,1,1,5,Low-Value,At Risk Customers
25813,299,2,"21,299999999999997",5,1,1,7,Mid-Value,Potential Loyalists
25814,109,1,"13,55",5,1,1,7,Mid-Value,Potential Loyalists
25815,871,1,"75,75",3,1,1,5,Low-Value,At Risk Customers
25816,152,4,"360,5",5,1,1,7,Mid-Value,Potential Loyalists
25817,1322,1,"29,099999999999998",2,1,1,4,Low-Value,Can't Lose
25818,165,1,"163,6",5,1,1,7,Mid-Value,Potential Loyalists
25819,469,8,"543,85",4,2,1,7,Mid-Value,Potential Loyalists
25822,462,2,"259,35",4,1,1,6,Mid-Value,Potential Loyalists
25823,781,2,"54,15",3,1,1,5,Low-Value,At Risk Customers
25824,723,4,"168,35000000000002",4,1,1,6,Mid-Value,Potential Loyalists
25826,1344,2,"20,25",2,1,1,4,Low-Value,Can't Lose
25827,161,3,"397,20000000000005",5,1,1,7,Mid-Value,Potential Loyalists
25831,636,1,"148,45",4,1,1,6,Mid-Value,Potential Loyalists
25832,1257,1,"161,7",2,1,1,4,Low-Value,Can't Lose
25833,916,2,"66,5",3,1,1,5,Low-Value,At Risk Customers
25834,353,5,"269,9",5,1,1,7,Mid-Value,Potential Loyalists
25835,210,2,"128,85",5,1,1,7,Mid-Value,Potential Loyalists
25836,14,3,"194,60000000000002",5,1,1,7,Mid-Value,Potential Loyalists
25837,572,2,"124,6",4,1,1,6,Mid-Value,Potential Loyalists
25841,136,8,"244,25",5,2,1,8,High-Value,Potential Loyalists
25842,1154,1,"38,6",2,1,1,4,Low-Value,Can't Lose
25843,586,1,"5,6",4,1,1,6,Mid-Value,Potential Loyalists
25844,666,5,"261,65",4,1,1,6,Mid-Value,Potential Loyalists
25845,1519,1,"66,5",1,1,1,3,Low-Value,Lost
25847,606,1,"12,25",4,1,1,6,Mid-Value,Potential Loyalists
25848,480,1,"30,35",4,1,1,6,Mid-Value,Potential Loyalists
25849,208,3,"72,5",5,1,1,7,Mid-Value,Potential Loyalists
25851,61,7,"1402,3500000000001",5,2,3,10,High-Value,Champions
25852,91,8,"509,34999999999997",5,2,1,8,High-Value,Potential Loyalists
25853,1397,1,"14,7",2,1,1,4,Low-Value,Can't Lose
25854,121,4,"157,45",5,1,1,7,Mid-Value,Potential Loyalists
25855,848,4,"127,7",3,1,1,5,Low-Value,At Risk Customers
25856,34,12,"795,05",5,3,2,10,High-Value,Champions
25857,535,2,"146,60000000000002",4,1,1,6,Mid-Value,Potential Loyalists
25858,570,2,"373,5",4,1,1,6,Mid-Value,Potential Loyalists
25859,35,2,"50,099999999999994",5,1,1,7,Mid-Value,Potential Loyalists
25860,114,1,"13,3",5,1,1,7,Mid-Value,Potential Loyalists
25861,737,4,"181,3",3,1,1,5,Low-Value,At Risk Customers
25864,142,2,"64,8",5,1,1,7,Mid-Value,Potential Loyalists
25865,30,4,"77,05",5,1,1,7,Mid-Value,Potential Loyalists
25866,1429,1,"12,85",2,1,1,4,Low-Value,Can't Lose
25868,213,1,"63,6",5,1,1,7,Mid-Value,Potential Loyalists
25869,889,1,"77,7",3,1,1,5,Low-Value,At Risk Customers
25870,1181,5,"92,55",2,1,1,4,Low-Value,Can't Lose
25871,1652,1,"438,2",1,1,1,3,Low-Value,Lost
25873,61,6,"368,95",5,1,1,7,Mid-Value,Potential Loyalists
25874,122,1,"20,9",5,1,1,7,Mid-Value,Potential Loyalists
25876,192,2,"101,0",5,1,1,7,Mid-Value,Potential Loyalists
25877,726,3,"72,9",4,1,1,6,Mid-Value,Potential Loyalists
25878,159,3,"182,35",5,1,1,7,Mid-Value,Potential Loyalists
25879,221,6,"241,29999999999998",5,1,1,7,Mid-Value,Potential Loyalists
25880,717,1,"5,75",4,1,1,6,Mid-Value,Potential Loyalists
25881,131,8,"270,15000000000003",5,2,1,8,High-Value,Potential Loyalists
25883,1131,2,"201,89999999999998",2,1,1,4,Low-Value,Can't Lose
25884,1552,2,"40,8",1,1,1,3,Low-Value,Lost
25885,460,2,"31,0",4,1,1,6,Mid-Value,Potential Loyalists
25888,1495,3,"340,5",1,1,1,3,Low-Value,Lost
25890,102,5,"63,4",5,1,1,7,Mid-Value,Potential Loyalists
25891,527,2,"55,0",4,1,1,6,Mid-Value,Potential Loyalists
25893,7,3,"324,15",5,1,1,7,Mid-Value,Potential Loyalists
25895,410,5,"212,14999999999998",4,1,1,6,Mid-Value,Potential Loyalists
25896,389,4,"217,75",4,1,1,6,Mid-Value,Potential Loyalists
25900,56,6,"191,55",5,1,1,7,Mid-Value,Potential Loyalists
25902,358,4,"128,0",5,1,1,7,Mid-Value,Potential Loyalists
25903,62,5,"180,0",5,1,1,7,Mid-Value,Potential Loyalists
25904,603,1,"78,15",4,1,1,6,Mid-Value,Potential Loyalists
25905,1070,1,"28,95",3,1,1,5,Low-Value,At Risk Customers
25906,393,6,"223,3",4,1,1,6,Mid-Value,Potential Loyalists
25908,320,7,"266,25",5,2,1,8,High-Value,Potential Loyalists
25909,92,3,"91,35000000000001",5,1,1,7,Mid-Value,Potential Loyalists
25910,25,4,"240,1",5,1,1,7,Mid-Value,Potential Loyalists
25911,827,1,"19,6",3,1,1,5,Low-Value,At Risk Customers
25912,31,5,"90,0",5,1,1,7,Mid-Value,Potential Loyalists
25914,738,9,"588,45",3,2,1,6,Mid-Value,Potential Loyalists
25915,1054,2,"82,3",3,1,1,5,Low-Value,At Risk Customers
25919,25,2,"165,8",5,1,1,7,Mid-Value,Potential Loyalists
25920,577,3,"132,55",4,1,1,6,Mid-Value,Potential Loyalists
25921,1373,2,"72,0",2,1,1,4,Low-Value,Can't Lose
25923,568,3,"294,04999999999995",4,1,1,6,Mid-Value,Potential Loyalists
25924,85,5,"86,45",5,1,1,7,Mid-Value,Potential Loyalists
25926,30,2,"98,7",5,1,1,7,Mid-Value,Potential Loyalists
25928,1645,2,"280,8",1,1,1,3,Low-Value,Lost
25929,417,1,"27,0",4,1,1,6,Mid-Value,Potential Loyalists
25930,66,3,"160,35000000000002",5,1,1,7,Mid-Value,Potential Loyalists
25932,941,2,"191,4",3,1,1,5,Low-Value,At Risk Customers
25935,1091,4,"44,599999999999994",3,1,1,5,Low-Value,At Risk Customers
25936,883,4,"282,55",3,1,1,5,Low-Value,At Risk Customers
25938,122,3,"216,25000000000003",5,1,1,7,Mid-Value,Potential Loyalists
25939,1548,3,"121,25",1,1,1,3,Low-Value,Lost
25940,990,4,"172,6",3,1,1,5,Low-Value,At Risk Customers
25942,806,4,"303,0",3,1,1,5,Low-Value,At Risk Customers
25943,580,1,"22,7",4,1,1,6,Mid-Value,Potential Loyalists
25944,267,2,"328,5",5,1,1,7,Mid-Value,Potential Loyalists
25946,986,1,"17,1",3,1,1,5,Low-Value,At Risk Customers
25947,1124,1,"62,25",2,1,1,4,Low-Value,Can't Lose
25949,397,2,"23,25",4,1,1,6,Mid-Value,Potential Loyalists
25950,1820,1,"6,4",1,1,1,3,Low-Value,Lost
25951,476,3,"61,7",4,1,1,6,Mid-Value,Potential Loyalists
25952,1096,5,"313,6",2,1,1,4,Low-Value,Can't Lose
25953,392,2,"85,55",4,1,1,6,Mid-Value,Potential Loyalists
25954,707,1,"114,1",4,1,1,6,Mid-Value,Potential Loyalists
25955,29,1,"10,7",5,1,1,7,Mid-Value,Potential Loyalists
25956,328,6,"284,25",5,1,1,7,Mid-Value,Potential Loyalists
25958,1557,1,"7,6",1,1,1,3,Low-Value,Lost
25959,600,3,"60,050000000000004",4,1,1,6,Mid-Value,Potential Loyalists
25960,1726,1,"26,55",1,1,1,3,Low-Value,Lost
25964,606,1,"18,8",4,1,1,6,Mid-Value,Potential Loyalists
25965,484,4,"142,45",4,1,1,6,Mid-Value,Potential Loyalists
25966,69,3,"123,75",5,1,1,7,Mid-Value,Potential Loyalists
25967,4,11,"277,45",5,2,1,8,High-Value,Potential Loyalists
25968,1788,1,"3,8",1,1,1,3,Low-Value,Lost
25969,814,1,"62,7",3,1,1,5,Low-Value,At Risk Customers
25971,636,1,"32,95",4,1,1,6,Mid-Value,Potential Loyalists
25973,284,4,"125,64999999999999",5,1,1,7,Mid-Value,Potential Loyalists
25975,655,4,"124,9",4,1,1,6,Mid-Value,Potential Loyalists
25976,54,3,"133,1",5,1,1,7,Mid-Value,Potential Loyalists
25978,124,3,"184,55",5,1,1,7,Mid-Value,Potential Loyalists
25979,491,1,"233,7",4,1,1,6,Mid-Value,Potential Loyalists
25980,949,5,"374,15",3,1,1,5,Low-Value,At Risk Customers
25981,168,3,"105,45",5,1,1,7,Mid-Value,Potential Loyalists
25985,428,3,"110,35",4,1,1,6,Mid-Value,Potential Loyalists
25986,17,3,"152,62",5,1,1,7,Mid-Value,Potential Loyalists
25987,764,1,"56,1",3,1,1,5,Low-Value,At Risk Customers
25988,375,3,"236,20000000000002",4,1,1,6,Mid-Value,Potential Loyalists
25989,869,3,"101,8",3,1,1,5,Low-Value,At Risk Customers
25990,169,5,"172,1",5,1,1,7,Mid-Value,Potential Loyalists
25992,1453,1,"42,8",2,1,1,4,Low-Value,Can't Lose
25994,1648,1,"26,95",1,1,1,3,Low-Value,Lost
25995,631,6,"678,85",4,1,2,7,Mid-Value,Potential Loyalists
25996,1356,1,"41,4",2,1,1,4,Low-Value,Can't Lose
25997,1634,1,"36,2",1,1,1,3,Low-Value,Lost
25998,11,3,"162,35000000000002",5,1,1,7,Mid-Value,Potential Loyalists
25999,399,2,"60,8",4,1,1,6,Mid-Value,Potential Loyalists
26000,309,4,"221,35",5,1,1,7,Mid-Value,Potential Loyalists
26001,104,5,"314,6",5,1,1,7,Mid-Value,Potential Loyalists
26002,244,2,"289,85",5,1,1,7,Mid-Value,Potential Loyalists
26003,19,12,"816,75",5,3,2,10,High-Value,Champions
26005,1201,5,"121,0",2,1,1,4,Low-Value,Can't Lose
26007,890,11,"632,1",3,2,1,6,Mid-Value,Potential Loyalists
26008,1273,3,"127,1",2,1,1,4,Low-Value,Can't Lose
26010,91,4,"393,34999999999997",5,1,1,7,Mid-Value,Potential Loyalists
26014,1,1,"91,0",5,1,1,7,Mid-Value,Potential Loyalists
26016,1158,1,"158,3",2,1,1,4,Low-Value,Can't Lose
26018,36,2,"82,7",5,1,1,7,Mid-Value,Potential Loyalists
26019,848,2,"496,6",3,1,1,5,Low-Value,At Risk Customers
26021,1382,1,"39,1",2,1,1,4,Low-Value,Can't Lose
26023,305,8,"652,1",5,2,1,8,High-Value,Potential Loyalists
26025,922,3,"50,05",3,1,1,5,Low-Value,At Risk Customers
26027,538,3,"53,6",4,1,1,6,Mid-Value,Potential Loyalists
26028,336,2,"47,1",5,1,1,7,Mid-Value,Potential Loyalists
26029,415,1,"81,0",4,1,1,6,Mid-Value,Potential Loyalists
26032,288,2,"491,65000000000003",5,1,1,7,Mid-Value,Potential Loyalists
26033,442,2,"185,35000000000002",4,1,1,6,Mid-Value,Potential Loyalists
26034,754,3,"195,4",3,1,1,5,Low-Value,At Risk Customers
26035,234,1,"127,35000000000001",5,1,1,7,Mid-Value,Potential Loyalists
26037,632,2,"110,99999999999999",4,1,1,6,Mid-Value,Potential Loyalists
26038,255,1,"10,3",5,1,1,7,Mid-Value,Potential Loyalists
26040,803,2,"51,35",3,1,1,5,Low-Value,At Risk Customers
26042,861,3,"322,1",3,1,1,5,Low-Value,At Risk Customers
26045,451,2,"103,0",4,1,1,6,Mid-Value,Potential Loyalists
26046,123,2,"69,9",5,1,1,7,Mid-Value,Potential Loyalists
26047,856,1,"57,75",3,1,1,5,Low-Value,At Risk Customers
26048,168,2,"157,45",5,1,1,7,Mid-Value,Potential Loyalists
26049,650,2,"186,1",4,1,1,6,Mid-Value,Potential Loyalists
26052,453,3,"112,5",4,1,1,6,Mid-Value,Potential Loyalists
26054,1356,2,"29,75",2,1,1,4,Low-Value,Can't Lose
26055,778,1,"7,3",3,1,1,5,Low-Value,At Risk Customers
26056,43,4,"143,15",5,1,1,7,Mid-Value,Potential Loyalists
26058,206,1,"39,3",5,1,1,7,Mid-Value,Potential Loyalists
26059,381,3,"1476,5",4,1,3,8,High-Value,Potential Loyalists
26060,1547,1,"25,1",1,1,1,3,Low-Value,Lost
26061,1347,2,"29,75",2,1,1,4,Low-Value,Can't Lose
26063,1545,2,"72,8",1,1,1,3,Low-Value,Lost
26064,410,8,"519,0500000000001",4,2,1,7,Mid-Value,Potential Loyalists
26065,455,1,"9,55",4,1,1,6,Mid-Value,Potential Loyalists
26066,1166,7,"232,45",2,2,1,5,Low-Value,At Risk Customers
26067,178,2,"37,35",5,1,1,7,Mid-Value,Potential Loyalists
26069,573,1,"19,1",4,1,1,6,Mid-Value,Potential Loyalists
26070,105,4,"196,85",5,1,1,7,Mid-Value,Potential Loyalists
26073,990,3,"369,35",3,1,1,5,Low-Value,At Risk Customers
26074,213,8,"278,7",5,2,1,8,High-Value,Potential Loyalists
26075,650,6,"267,55",4,1,1,6,Mid-Value,Potential Loyalists
26077,202,3,"276,9",5,1,1,7,Mid-Value,Potential Loyalists
26080,877,4,"189,4",3,1,1,5,Low-Value,At Risk Customers
26083,992,7,"255,65",3,2,1,6,Mid-Value,Potential Loyalists
26084,536,4,"172,75",4,1,1,6,Mid-Value,Potential Loyalists
26089,900,4,"612,85",3,1,1,5,Low-Value,At Risk Customers
26092,309,3,"109,8",5,1,1,7,Mid-Value,Potential Loyalists
26093,177,6,"220,4",5,1,1,7,Mid-Value,Potential Loyalists
26094,74,9,"1223,5",5,2,2,9,High-Value,Champions
26095,1066,1,"51,4",3,1,1,5,Low-Value,At Risk Customers
26096,448,3,"81,4",4,1,1,6,Mid-Value,Potential Loyalists
26097,211,9,"1272,9499999999998",5,2,2,9,High-Value,Champions
26098,258,8,"385,55",5,2,1,8,High-Value,Potential Loyalists
26099,117,1,"135,4",5,1,1,7,Mid-Value,Potential Loyalists
26100,84,13,"935,05",5,3,2,10,High-Value,Champions
26101,1476,1,"172,9",1,1,1,3,Low-Value,Lost
26103,1088,3,"118,0",3,1,1,5,Low-Value,At Risk Customers
26104,754,3,"208,4",3,1,1,5,Low-Value,At Risk Customers
26105,139,2,"48,6",5,1,1,7,Mid-Value,Potential Loyalists
26106,1550,1,"39,95",1,1,1,3,Low-Value,Lost
26107,807,1,"94,05",3,1,1,5,Low-Value,At Risk Customers
26108,9,4,"138,4",5,1,1,7,Mid-Value,Potential Loyalists
26109,636,4,"194,75",4,1,1,6,Mid-Value,Potential Loyalists
26110,118,3,"118,55",5,1,1,7,Mid-Value,Potential Loyalists
26111,1116,1,"170,7",2,1,1,4,Low-Value,Can't Lose
26112,1086,1,"45,45",3,1,1,5,Low-Value,At Risk Customers
26113,799,5,"294,9",3,1,1,5,Low-Value,At Risk Customers
26114,395,4,"604,65",4,1,1,6,Mid-Value,Potential Loyalists
26115,922,4,"314,84999999999997",3,1,1,5,Low-Value,At Risk Customers
26116,326,1,"7,7",5,1,1,7,Mid-Value,Potential Loyalists
26117,461,3,"180,85",4,1,1,6,Mid-Value,Potential Loyalists
26120,162,2,"305,35",5,1,1,7,Mid-Value,Potential Loyalists
26121,44,5,"193,7",5,1,1,7,Mid-Value,Potential Loyalists
26122,585,1,"54,8",4,1,1,6,Mid-Value,Potential Loyalists
26124,1697,2,"177,05",1,1,1,3,Low-Value,Lost
26125,1339,1,"8,55",2,1,1,4,Low-Value,Can't Lose
26126,1261,3,"182,45",2,1,1,4,Low-Value,Can't Lose
26128,924,6,"490,09999999999997",3,1,1,5,Low-Value,At Risk Customers
26130,57,3,"125,0",5,1,1,7,Mid-Value,Potential Loyalists
26132,1390,2,"208,75",2,1,1,4,Low-Value,Can't Lose
26134,425,1,"243,6",4,1,1,6,Mid-Value,Potential Loyalists
26135,1607,1,"136,0",1,1,1,3,Low-Value,Lost
26136,36,1,"41,4",5,1,1,7,Mid-Value,Potential Loyalists
26137,705,1,"5,2",4,1,1,6,Mid-Value,Potential Loyalists
26140,1242,2,"243,5",2,1,1,4,Low-Value,Can't Lose
26141,530,3,"355,8",4,1,1,6,Mid-Value,Potential Loyalists
26142,7,4,"165,95",5,1,1,7,Mid-Value,Potential Loyalists
26143,653,1,"175,2",4,1,1,6,Mid-Value,Potential Loyalists
26145,0,3,"182,1",5,1,1,7,Mid-Value,Potential Loyalists
26146,1041,2,"22,65",3,1,1,5,Low-Value,At Risk Customers
26151,974,2,"44,3",3,1,1,5,Low-Value,At Risk Customers
26154,189,5,"90,6",5,1,1,7,Mid-Value,Potential Loyalists
26155,60,7,"575,6",5,2,1,8,High-Value,Potential Loyalists
26156,165,7,"306,7",5,2,1,8,High-Value,Potential Loyalists
26157,863,2,"444,5",3,1,1,5,Low-Value,At Risk Customers
26159,21,4,"263,4",5,1,1,7,Mid-Value,Potential Loyalists
26160,790,1,"16,2",3,1,1,5,Low-Value,At Risk Customers
26161,43,2,"63,95",5,1,1,7,Mid-Value,Potential Loyalists
26163,23,8,"341,0",5,2,1,8,High-Value,Potential Loyalists
26164,416,3,"327,95",4,1,1,6,Mid-Value,Potential Loyalists
26165,14,12,"710,6",5,3,2,10,High-Value,Champions
26166,864,3,"30,4",3,1,1,5,Low-Value,At Risk Customers
26167,7,2,"267,2",5,1,1,7,Mid-Value,Potential Loyalists
26170,808,4,"635,45",3,1,1,5,Low-Value,At Risk Customers
26171,912,4,"483,5",3,1,1,5,Low-Value,At Risk Customers
26173,583,3,"79,65",4,1,1,6,Mid-Value,Potential Loyalists
26175,201,4,"220,70000000000002",5,1,1,7,Mid-Value,Potential Loyalists
26176,1733,1,"78,30000000000001",1,1,1,3,Low-Value,Lost
26177,1086,2,"40,05",3,1,1,5,Low-Value,At Risk Customers
26178,1538,1,"13,15",1,1,1,3,Low-Value,Lost
26181,488,1,"255,9",4,1,1,6,Mid-Value,Potential Loyalists
26183,1170,1,"104,2",2,1,1,4,Low-Value,Can't Lose
26184,38,2,"151,15",5,1,1,7,Mid-Value,Potential Loyalists
26185,54,3,"137,05",5,1,1,7,Mid-Value,Potential Loyalists
26186,706,5,"270,55",4,1,1,6,Mid-Value,Potential Loyalists
26187,269,2,"240,7",5,1,1,7,Mid-Value,Potential Loyalists
26192,250,3,"60,05",5,1,1,7,Mid-Value,Potential Loyalists
26193,209,2,"21,65",5,1,1,7,Mid-Value,Potential Loyalists
26201,112,1,"2,9",5,1,1,7,Mid-Value,Potential Loyalists
26202,510,3,"387,35",4,1,1,6,Mid-Value,Potential Loyalists
26205,851,5,"465,75",3,1,1,5,Low-Value,At Risk Customers
26206,21,10,"382,55",5,2,1,8,High-Value,Potential Loyalists
26210,54,4,"310,45000000000005",5,1,1,7,Mid-Value,Potential Loyalists
26211,425,5,"173,9",4,1,1,6,Mid-Value,Potential Loyalists
26212,189,2,"193,0",5,1,1,7,Mid-Value,Potential Loyalists
26213,151,3,"526,75",5,1,1,7,Mid-Value,Potential Loyalists
26214,12,4,"507,25",5,1,1,7,Mid-Value,Potential Loyalists
26217,543,4,"206,95",4,1,1,6,Mid-Value,Potential Loyalists
26218,282,6,"555,25",5,1,1,7,Mid-Value,Potential Loyalists
26219,1261,1,"21,0",2,1,1,4,Low-Value,Can't Lose
26221,166,7,"478,59999999999997",5,2,1,8,High-Value,Potential Loyalists
26223,785,2,"18,5",3,1,1,5,Low-Value,At Risk Customers
26224,567,4,"88,9",4,1,1,6,Mid-Value,Potential Loyalists
26225,1583,2,"20,2",1,1,1,3,Low-Value,Lost
26226,459,5,"336,85",4,1,1,6,Mid-Value,Potential Loyalists
26231,509,3,"73,2",4,1,1,6,Mid-Value,Potential Loyalists
26235,432,3,"126,70000000000002",4,1,1,6,Mid-Value,Potential Loyalists
26240,18,7,"409,95",5,2,1,8,High-Value,Potential Loyalists
26241,775,1,"21,3",3,1,1,5,Low-Value,At Risk Customers
26242,1162,5,"202,05",2,1,1,4,Low-Value,Can't Lose
26244,1035,1,"165,60000000000002",3,1,1,5,Low-Value,At Risk Customers
26245,379,2,"95,3",4,1,1,6,Mid-Value,Potential Loyalists
26246,491,9,"505,5",4,2,1,7,Mid-Value,Potential Loyalists
26247,603,2,"77,0",4,1,1,6,Mid-Value,Potential Loyalists
26249,109,5,"164,9",5,1,1,7,Mid-Value,Potential Loyalists
26250,1475,2,"80,8",1,1,1,3,Low-Value,Lost
26251,588,2,"49,85",4,1,1,6,Mid-Value,Potential Loyalists
26252,236,5,"401,75",5,1,1,7,Mid-Value,Potential Loyalists
26253,545,3,"289,2",4,1,1,6,Mid-Value,Potential Loyalists
26254,225,4,"120,05",5,1,1,7,Mid-Value,Potential Loyalists
26255,1251,2,"69,85",2,1,1,4,Low-Value,Can't Lose
26258,90,5,"223,09999999999997",5,1,1,7,Mid-Value,Potential Loyalists
26259,48,6,"232,85",5,1,1,7,Mid-Value,Potential Loyalists
26260,365,4,"316,05",5,1,1,7,Mid-Value,Potential Loyalists
26261,514,3,"117,4",4,1,1,6,Mid-Value,Potential Loyalists
26262,26,9,"390,04999999999995",5,2,1,8,High-Value,Potential Loyalists
26263,795,5,"249,5",3,1,1,5,Low-Value,At Risk Customers
26264,1764,2,"44,35",1,1,1,3,Low-Value,Lost
26265,21,3,"251,7",5,1,1,7,Mid-Value,Potential Loyalists
26266,396,4,"89,85000000000001",4,1,1,6,Mid-Value,Potential Loyalists
26267,435,3,"515,25",4,1,1,6,Mid-Value,Potential Loyalists
26269,1771,1,"107,2",1,1,1,3,Low-Value,Lost
26272,733,2,"106,0",3,1,1,5,Low-Value,At Risk Customers
26273,227,2,"41,349999999999994",5,1,1,7,Mid-Value,Potential Loyalists
26277,740,2,"46,45",3,1,1,5,Low-Value,At Risk Customers
26279,88,7,"1123,8",5,2,2,9,High-Value,Champions
26280,45,5,"264,3",5,1,1,7,Mid-Value,Potential Loyalists
26281,110,3,"157,95",5,1,1,7,Mid-Value,Potential Loyalists
26282,122,6,"401,15",5,1,1,7,Mid-Value,Potential Loyalists
26283,582,3,"96,45",4,1,1,6,Mid-Value,Potential Loyalists
26284,267,1,"11,95",5,1,1,7,Mid-Value,Potential Loyalists
26289,10,12,"684,7",5,3,2,10,High-Value,Champions
26291,1182,2,"173,70000000000002",2,1,1,4,Low-Value,Can't Lose
26293,585,1,"26,1",4,1,1,6,Mid-Value,Potential Loyalists
26294,1001,2,"140,15",3,1,1,5,Low-Value,At Risk Customers
26296,632,9,"315,25",4,2,1,7,Mid-Value,Potential Loyalists
26297,951,2,"48,199999999999996",3,1,1,5,Low-Value,At Risk Customers
26298,84,5,"629,3",5,1,1,7,Mid-Value,Potential Loyalists
26300,14,4,"194,75",5,1,1,7,Mid-Value,Potential Loyalists
26305,8,2,"90,35",5,1,1,7,Mid-Value,Potential Loyalists
26306,350,3,"64,4",5,1,1,7,Mid-Value,Potential Loyalists
26309,60,4,"158,55",5,1,1,7,Mid-Value,Potential Loyalists
26310,1357,1,"8,0",2,1,1,4,Low-Value,Can't Lose
26311,7,11,"290,6",5,2,1,8,High-Value,Potential Loyalists
26312,624,7,"1138,1",4,2,2,8,High-Value,Potential Loyalists
26317,373,4,"159,75",4,1,1,6,Mid-Value,Potential Loyalists
26318,455,3,"118,0",4,1,1,6,Mid-Value,Potential Loyalists
26321,55,3,"31,4",5,1,1,7,Mid-Value,Potential Loyalists
26322,1126,2,"113,05",2,1,1,4,Low-Value,Can't Lose
26323,70,4,"105,85",5,1,1,7,Mid-Value,Potential Loyalists
26324,218,7,"440,74999999999994",5,2,1,8,High-Value,Potential Loyalists
26326,523,2,"614,4000000000001",4,1,1,6,Mid-Value,Potential Loyalists
26327,1013,1,"5,35",3,1,1,5,Low-Value,At Risk Customers
26329,367,5,"280,9",4,1,1,6,Mid-Value,Potential Loyalists
26330,1323,2,"78,0",2,1,1,4,Low-Value,Can't Lose
26331,152,3,"489,65",5,1,1,7,Mid-Value,Potential Loyalists
26332,1727,1,"68,25",1,1,1,3,Low-Value,Lost
26336,1289,2,"97,2",2,1,1,4,Low-Value,Can't Lose
26337,38,4,"265,7",5,1,1,7,Mid-Value,Potential Loyalists
26338,531,3,"99,19999999999999",4,1,1,6,Mid-Value,Potential Loyalists
26342,1202,6,"165,75",2,1,1,4,Low-Value,Can't Lose
26343,437,3,"85,85",4,1,1,6,Mid-Value,Potential Loyalists
26345,879,2,"210,45000000000002",3,1,1,5,Low-Value,At Risk Customers
26346,777,7,"366,25",3,2,1,6,Mid-Value,Potential Loyalists
26347,123,4,"211,75",5,1,1,7,Mid-Value,Potential Loyalists
26350,1478,1,"221,0",1,1,1,3,Low-Value,Lost
26351,655,3,"46,400000000000006",4,1,1,6,Mid-Value,Potential Loyalists
26353,1447,1,"167,2",2,1,1,4,Low-Value,Can't Lose
26356,801,4,"114,5",3,1,1,5,Low-Value,At Risk Customers
26357,918,2,"28,5",3,1,1,5,Low-Value,At Risk Customers
26359,666,3,"564,9499999999999",4,1,1,6,Mid-Value,Potential Loyalists
26360,5,13,"937,6",5,3,2,10,High-Value,Champions
26361,78,4,"136,5",5,1,1,7,Mid-Value,Potential Loyalists
26363,517,2,"302,45",4,1,1,6,Mid-Value,Potential Loyalists
26366,393,4,"731,1",4,1,2,7,Mid-Value,Potential Loyalists
26368,57,4,"94,05",5,1,1,7,Mid-Value,Potential Loyalists
26369,897,2,"41,8",3,1,1,5,Low-Value,At Risk Customers
26371,140,7,"464,85",5,2,1,8,High-Value,Potential Loyalists
26372,636,2,"27,35",4,1,1,6,Mid-Value,Potential Loyalists
26373,825,4,"231,4",3,1,1,5,Low-Value,At Risk Customers
26374,539,3,"138,0",4,1,1,6,Mid-Value,Potential Loyalists
26376,1199,4,"137,85",2,1,1,4,Low-Value,Can't Lose
26380,530,2,"204,4",4,1,1,6,Mid-Value,Potential Loyalists
26382,518,2,"143,3",4,1,1,6,Mid-Value,Potential Loyalists
26383,582,3,"436,79999999999995",4,1,1,6,Mid-Value,Potential Loyalists
26384,581,2,"127,8",4,1,1,6,Mid-Value,Potential Loyalists
26387,1621,2,"185,70000000000002",1,1,1,3,Low-Value,Lost
26389,747,1,"12,7",3,1,1,5,Low-Value,At Risk Customers
26391,1166,1,"49,15",2,1,1,4,Low-Value,Can't Lose
26392,833,2,"359,95000000000005",3,1,1,5,Low-Value,At Risk Customers
26393,599,3,"107,35",4,1,1,6,Mid-Value,Potential Loyalists
26397,391,5,"406,9",4,1,1,6,Mid-Value,Potential Loyalists
26398,75,6,"557,6",5,1,1,7,Mid-Value,Potential Loyalists
26400,45,2,"11,55",5,1,1,7,Mid-Value,Potential Loyalists
26401,281,4,"49,1",5,1,1,7,Mid-Value,Potential Loyalists
26402,612,2,"157,4",4,1,1,6,Mid-Value,Potential Loyalists
26403,19,9,"674,55",5,2,2,9,High-Value,Champions
26406,107,1,"68,0",5,1,1,7,Mid-Value,Potential Loyalists
26409,893,1,"41,1",3,1,1,5,Low-Value,At Risk Customers
26410,30,3,"195,1",5,1,1,7,Mid-Value,Potential Loyalists
26411,692,3,"163,15",4,1,1,6,Mid-Value,Potential Loyalists
26412,470,2,"329,1",4,1,1,6,Mid-Value,Potential Loyalists
26413,740,1,"9,4",3,1,1,5,Low-Value,At Risk Customers
26415,809,4,"116,55",3,1,1,5,Low-Value,At Risk Customers
26417,1149,2,"113,45",2,1,1,4,Low-Value,Can't Lose
26418,583,5,"606,25",4,1,1,6,Mid-Value,Potential Loyalists
26421,906,2,"80,05",3,1,1,5,Low-Value,At Risk Customers
26423,825,1,"84,8",3,1,1,5,Low-Value,At Risk Customers
26425,1032,3,"391,45",3,1,1,5,Low-Value,At Risk Customers
26426,441,4,"178,5",4,1,1,6,Mid-Value,Potential Loyalists
26427,1342,1,"67,2",2,1,1,4,Low-Value,Can't Lose
26428,547,1,"87,1",4,1,1,6,Mid-Value,Potential Loyalists
26429,150,5,"441,55",5,1,1,7,Mid-Value,Potential Loyalists
26430,165,6,"183,95000000000002",5,1,1,7,Mid-Value,Potential Loyalists
26431,445,2,"55,15",4,1,1,6,Mid-Value,Potential Loyalists
26432,1422,3,"297,05",2,1,1,4,Low-Value,Can't Lose
26433,18,4,"478,25",5,1,1,7,Mid-Value,Potential Loyalists
26434,8,6,"268,8",5,1,1,7,Mid-Value,Potential Loyalists
26435,891,4,"183,3",3,1,1,5,Low-Value,At Risk Customers
26436,747,8,"350,8",3,2,1,6,Mid-Value,Potential Loyalists
26438,141,3,"128,4",5,1,1,7,Mid-Value,Potential Loyalists
26439,1584,4,"165,05",1,1,1,3,Low-Value,Lost
26440,578,4,"151,85",4,1,1,6,Mid-Value,Potential Loyalists
26441,281,3,"155,8",5,1,1,7,Mid-Value,Potential Loyalists
26442,651,1,"62,7",4,1,1,6,Mid-Value,Potential Loyalists
26444,278,1,"74,95",5,1,1,7,Mid-Value,Potential Loyalists
26446,1067,2,"77,5",3,1,1,5,Low-Value,At Risk Customers
26447,792,2,"51,1",3,1,1,5,Low-Value,At Risk Customers
26450,967,1,"223,5",3,1,1,5,Low-Value,At Risk Customers
26452,790,2,"69,35",3,1,1,5,Low-Value,At Risk Customers
26453,105,3,"260,85",5,1,1,7,Mid-Value,Potential Loyalists
26454,1613,2,"174,7",1,1,1,3,Low-Value,Lost
26455,956,1,"61,349999999999994",3,1,1,5,Low-Value,At Risk Customers
26456,119,3,"137,1",5,1,1,7,Mid-Value,Potential Loyalists
26458,291,4,"286,6",5,1,1,7,Mid-Value,Potential Loyalists
26461,1160,2,"36,5",2,1,1,4,Low-Value,Can't Lose
26463,556,1,"1,1",4,1,1,6,Mid-Value,Potential Loyalists
26465,1673,1,"14,700000000000001",1,1,1,3,Low-Value,Lost
26466,558,6,"236,0",4,1,1,6,Mid-Value,Potential Loyalists
26467,804,3,"283,15",3,1,1,5,Low-Value,At Risk Customers
26468,953,2,"158,9",3,1,1,5,Low-Value,At Risk Customers
26469,999,2,"134,95",3,1,1,5,Low-Value,At Risk Customers
26470,161,3,"98,95",5,1,1,7,Mid-Value,Potential Loyalists
26471,381,10,"860,65",4,2,2,8,High-Value,Potential Loyalists
26472,110,2,"86,2",5,1,1,7,Mid-Value,Potential Loyalists
26473,6,3,"154,9",5,1,1,7,Mid-Value,Potential Loyalists
26474,394,2,"349,35",4,1,1,6,Mid-Value,Potential Loyalists
26475,400,2,"17,25",4,1,1,6,Mid-Value,Potential Loyalists
26477,1306,2,"181,0",2,1,1,4,Low-Value,Can't Lose
26481,263,2,"44,9",5,1,1,7,Mid-Value,Potential Loyalists
26482,814,6,"318,70000000000005",3,1,1,5,Low-Value,At Risk Customers
26483,490,4,"354,7",4,1,1,6,Mid-Value,Potential Loyalists
26485,497,3,"180,79999999999998",4,1,1,6,Mid-Value,Potential Loyalists
26486,11,3,"427,3",5,1,1,7,Mid-Value,Potential Loyalists
26489,1622,1,"232,5",1,1,1,3,Low-Value,Lost
26491,85,4,"98,10000000000001",5,1,1,7,Mid-Value,Potential Loyalists
26492,1675,2,"48,05",1,1,1,3,Low-Value,Lost
26493,409,3,"214,35000000000002",4,1,1,6,Mid-Value,Potential Loyalists
26497,570,4,"216,25",4,1,1,6,Mid-Value,Potential Loyalists
26498,102,1,"31,85",5,1,1,7,Mid-Value,Potential Loyalists
26500,88,1,"2,2",5,1,1,7,Mid-Value,Potential Loyalists
26504,327,2,"78,5",5,1,1,7,Mid-Value,Potential Loyalists
26505,141,2,"30,049999999999997",5,1,1,7,Mid-Value,Potential Loyalists
26506,10,7,"288,15",5,2,1,8,High-Value,Potential Loyalists
26507,1550,2,"14,9",1,1,1,3,Low-Value,Lost
26508,849,3,"219,5",3,1,1,5,Low-Value,At Risk Customers
26512,721,1,"23,95",4,1,1,6,Mid-Value,Potential Loyalists
26513,1577,4,"458,8",1,1,1,3,Low-Value,Lost
26514,883,7,"379,65000000000003",3,2,1,6,Mid-Value,Potential Loyalists
26518,488,1,"8,6",4,1,1,6,Mid-Value,Potential Loyalists
26519,392,5,"125,85",4,1,1,6,Mid-Value,Potential Loyalists
26522,1623,1,"27,4",1,1,1,3,Low-Value,Lost
26523,125,6,"449,1",5,1,1,7,Mid-Value,Potential Loyalists
26525,355,1,"31,55",5,1,1,7,Mid-Value,Potential Loyalists
26526,609,1,"2,65",4,1,1,6,Mid-Value,Potential Loyalists
26527,417,4,"67,2",4,1,1,6,Mid-Value,Potential Loyalists
26528,539,4,"354,75",4,1,1,6,Mid-Value,Potential Loyalists
26530,851,4,"298,0",3,1,1,5,Low-Value,At Risk Customers
26532,28,2,"99,2",5,1,1,7,Mid-Value,Potential Loyalists
26534,711,1,"12,9",4,1,1,6,Mid-Value,Potential Loyalists
26536,403,1,"4,55",4,1,1,6,Mid-Value,Potential Loyalists
26537,628,4,"143,54999999999998",4,1,1,6,Mid-Value,Potential Loyalists
26540,113,2,"22,1",5,1,1,7,Mid-Value,Potential Loyalists
26541,390,1,"117,8",4,1,1,6,Mid-Value,Potential Loyalists
26543,1533,2,"55,5",1,1,1,3,Low-Value,Lost
26544,8,6,"283,8",5,1,1,7,Mid-Value,Potential Loyalists
26546,48,6,"325,65",5,1,1,7,Mid-Value,Potential Loyalists
26547,71,1,"23,45",5,1,1,7,Mid-Value,Potential Loyalists
26550,7,4,"138,7",5,1,1,7,Mid-Value,Potential Loyalists
26552,765,2,"264,0",3,1,1,5,Low-Value,At Risk Customers
26553,61,4,"213,65",5,1,1,7,Mid-Value,Potential Loyalists
26555,1426,2,"84,35000000000001",2,1,1,4,Low-Value,Can't Lose
26557,698,3,"49,4",4,1,1,6,Mid-Value,Potential Loyalists
26558,12,2,"54,8",5,1,1,7,Mid-Value,Potential Loyalists
26559,24,4,"94,6",5,1,1,7,Mid-Value,Potential Loyalists
26563,941,2,"74,4",3,1,1,5,Low-Value,At Risk Customers
26564,1245,1,"58,6",2,1,1,4,Low-Value,Can't Lose
26566,1636,3,"286,2",1,1,1,3,Low-Value,Lost
26567,87,7,"582,05",5,2,1,8,High-Value,Potential Loyalists
26568,460,4,"172,0",4,1,1,6,Mid-Value,Potential Loyalists
26569,43,1,"273,29999999999995",5,1,1,7,Mid-Value,Potential Loyalists
26570,959,1,"8,0",3,1,1,5,Low-Value,At Risk Customers
26573,628,2,"95,5",4,1,1,6,Mid-Value,Potential Loyalists
26575,725,6,"133,65",4,1,1,6,Mid-Value,Potential Loyalists
26576,356,2,"48,05",5,1,1,7,Mid-Value,Potential Loyalists
26578,3,5,"1269,3999999999999",5,1,2,8,High-Value,Potential Loyalists
26579,876,2,"93,1",3,1,1,5,Low-Value,At Risk Customers
26580,316,1,"6,05",5,1,1,7,Mid-Value,Potential Loyalists
26581,53,1,"30,35",5,1,1,7,Mid-Value,Potential Loyalists
26583,991,1,"84,75",3,1,1,5,Low-Value,At Risk Customers
26584,400,5,"247,35",4,1,1,6,Mid-Value,Potential Loyalists
26585,19,24,"1548,3500000000001",5,5,3,13,High-Value,Champions
26586,205,1,"31,650000000000002",5,1,1,7,Mid-Value,Potential Loyalists
26587,1305,1,"50,8",2,1,1,4,Low-Value,Can't Lose
26588,1506,1,"46,65",1,1,1,3,Low-Value,Lost
26589,679,6,"384,25",4,1,1,6,Mid-Value,Potential Loyalists
26590,54,4,"129,6",5,1,1,7,Mid-Value,Potential Loyalists
26591,487,4,"589,7",4,1,1,6,Mid-Value,Potential Loyalists
26594,418,5,"333,0",4,1,1,6,Mid-Value,Potential Loyalists
26596,78,2,"60,9",5,1,1,7,Mid-Value,Potential Loyalists
26597,733,1,"44,9",3,1,1,5,Low-Value,At Risk Customers
26598,471,2,"28,549999999999997",4,1,1,6,Mid-Value,Potential Loyalists
26602,62,9,"503,59999999999997",5,2,1,8,High-Value,Potential Loyalists
26605,336,1,"212,6",5,1,1,7,Mid-Value,Potential Loyalists
26608,1070,4,"293,4",3,1,1,5,Low-Value,At Risk Customers
26609,32,4,"176,25",5,1,1,7,Mid-Value,Potential Loyalists
26611,26,2,"566,5",5,1,1,7,Mid-Value,Potential Loyalists
26612,487,5,"463,16",4,1,1,6,Mid-Value,Potential Loyalists
26614,18,5,"238,55",5,1,1,7,Mid-Value,Potential Loyalists
26615,577,4,"199,20000000000002",4,1,1,6,Mid-Value,Potential Loyalists
26616,55,5,"207,45000000000002",5,1,1,7,Mid-Value,Potential Loyalists
26618,973,2,"154,4",3,1,1,5,Low-Value,At Risk Customers
26623,864,1,"85,05000000000001",3,1,1,5,Low-Value,At Risk Customers
26624,745,4,"145,3",3,1,1,5,Low-Value,At Risk Customers
26625,426,7,"292,7",4,2,1,7,Mid-Value,Potential Loyalists
26628,71,2,"101,30000000000001",5,1,1,7,Mid-Value,Potential Loyalists
26629,794,2,"36,199999999999996",3,1,1,5,Low-Value,At Risk Customers
26630,97,1,"85,15",5,1,1,7,Mid-Value,Potential Loyalists
26632,675,9,"539,15",4,2,1,7,Mid-Value,Potential Loyalists
26633,143,3,"82,05000000000001",5,1,1,7,Mid-Value,Potential Loyalists
26635,701,1,"11,4",4,1,1,6,Mid-Value,Potential Loyalists
26641,310,3,"117,5",5,1,1,7,Mid-Value,Potential Loyalists
26643,605,3,"290,55",4,1,1,6,Mid-Value,Potential Loyalists
26645,121,2,"22,2",5,1,1,7,Mid-Value,Potential Loyalists
26646,756,7,"300,90000000000003",3,2,1,6,Mid-Value,Potential Loyalists
26647,260,4,"47,599999999999994",5,1,1,7,Mid-Value,Potential Loyalists
26648,98,1,"8,0",5,1,1,7,Mid-Value,Potential Loyalists
26649,437,3,"152,05",4,1,1,6,Mid-Value,Potential Loyalists
26650,7,4,"257,4",5,1,1,7,Mid-Value,Potential Loyalists
26651,428,5,"350,84999999999997",4,1,1,6,Mid-Value,Potential Loyalists
26654,379,9,"396,70000000000005",4,2,1,7,Mid-Value,Potential Loyalists
26655,139,3,"95,65",5,1,1,7,Mid-Value,Potential Loyalists
26656,1378,1,"32,8",2,1,1,4,Low-Value,Can't Lose
26657,145,5,"201,4",5,1,1,7,Mid-Value,Potential Loyalists
26658,311,5,"262,4",5,1,1,7,Mid-Value,Potential Loyalists
26660,21,5,"320,9",5,1,1,7,Mid-Value,Potential Loyalists
26661,89,4,"314,20000000000005",5,1,1,7,Mid-Value,Potential Loyalists
26662,1108,1,"28,1",2,1,1,4,Low-Value,Can't Lose
26663,1120,1,"38,9",2,1,1,4,Low-Value,Can't Lose
26664,396,3,"162,35",4,1,1,6,Mid-Value,Potential Loyalists
26665,926,1,"19,3",3,1,1,5,Low-Value,At Risk Customers
26666,52,2,"136,65",5,1,1,7,Mid-Value,Potential Loyalists
26667,260,13,"1667,75",5,3,3,11,High-Value,Champions
26668,854,5,"252,2",3,1,1,5,Low-Value,At Risk Customers
26672,316,3,"121,3",5,1,1,7,Mid-Value,Potential Loyalists
26673,126,5,"276,0",5,1,1,7,Mid-Value,Potential Loyalists
26678,88,3,"195,3",5,1,1,7,Mid-Value,Potential Loyalists
26680,752,5,"316,45",3,1,1,5,Low-Value,At Risk Customers
26681,890,1,"33,5",3,1,1,5,Low-Value,At Risk Customers
26684,352,2,"106,75",5,1,1,7,Mid-Value,Potential Loyalists
26685,764,2,"67,15",3,1,1,5,Low-Value,At Risk Customers
26687,442,1,"14,8",4,1,1,6,Mid-Value,Potential Loyalists
26688,264,3,"144,3",5,1,1,7,Mid-Value,Potential Loyalists
26690,696,1,"30,6",4,1,1,6,Mid-Value,Potential Loyalists
26691,722,3,"47,85",4,1,1,6,Mid-Value,Potential Loyalists
26694,880,10,"276,0",3,2,1,6,Mid-Value,Potential Loyalists
26696,761,1,"67,8",3,1,1,5,Low-Value,At Risk Customers
26697,577,1,"152,6",4,1,1,6,Mid-Value,Potential Loyalists
26699,1122,2,"23,15",2,1,1,4,Low-Value,Can't Lose
26700,102,3,"289,79999999999995",5,1,1,7,Mid-Value,Potential Loyalists
26703,654,2,"145,8",4,1,1,6,Mid-Value,Potential Loyalists
26705,445,5,"267,45",4,1,1,6,Mid-Value,Potential Loyalists
26706,1189,5,"223,57999999999998",2,1,1,4,Low-Value,Can't Lose
26707,1323,2,"128,0",2,1,1,4,Low-Value,Can't Lose
26710,999,1,"131,85000000000002",3,1,1,5,Low-Value,At Risk Customers
26711,1559,1,"50,9",1,1,1,3,Low-Value,Lost
26712,243,5,"226,95000000000002",5,1,1,7,Mid-Value,Potential Loyalists
26713,175,2,"74,6",5,1,1,7,Mid-Value,Potential Loyalists
26716,548,1,"98,4",4,1,1,6,Mid-Value,Potential Loyalists
26717,94,2,"74,9",5,1,1,7,Mid-Value,Potential Loyalists
26718,409,1,"7,0",4,1,1,6,Mid-Value,Potential Loyalists
26719,550,4,"54,75",4,1,1,6,Mid-Value,Potential Loyalists
26720,1360,1,"21,75",2,1,1,4,Low-Value,Can't Lose
26722,1106,3,"291,09999999999997",2,1,1,4,Low-Value,Can't Lose
26723,365,8,"431,2",5,2,1,8,High-Value,Potential Loyalists
26724,481,2,"171,7",4,1,1,6,Mid-Value,Potential Loyalists
26726,1068,1,"4,25",3,1,1,5,Low-Value,At Risk Customers
26729,526,2,"162,1",4,1,1,6,Mid-Value,Potential Loyalists
26730,422,4,"73,2",4,1,1,6,Mid-Value,Potential Loyalists
26734,46,7,"149,4",5,2,1,8,High-Value,Potential Loyalists
26735,26,2,"160,64999999999998",5,1,1,7,Mid-Value,Potential Loyalists
26738,514,2,"67,9",4,1,1,6,Mid-Value,Potential Loyalists
26740,20,3,"36,3",5,1,1,7,Mid-Value,Potential Loyalists
26741,1215,1,"28,7",2,1,1,4,Low-Value,Can't Lose
26742,637,7,"264,7",4,2,1,7,Mid-Value,Potential Loyalists
26743,497,4,"218,10000000000002",4,1,1,6,Mid-Value,Potential Loyalists
26745,153,10,"882,15",5,2,2,9,High-Value,Champions
26746,346,3,"88,35",5,1,1,7,Mid-Value,Potential Loyalists
26748,931,2,"221,99999999999997",3,1,1,5,Low-Value,At Risk Customers
26749,406,2,"19,75",4,1,1,6,Mid-Value,Potential Loyalists
26750,168,4,"548,85",5,1,1,7,Mid-Value,Potential Loyalists
26751,298,5,"202,15",5,1,1,7,Mid-Value,Potential Loyalists
26755,91,9,"994,85",5,2,2,9,High-Value,Champions
26759,17,6,"265,5",5,1,1,7,Mid-Value,Potential Loyalists
26763,1191,2,"16,799999999999997",2,1,1,4,Low-Value,Can't Lose
26767,241,5,"137,35000000000002",5,1,1,7,Mid-Value,Potential Loyalists
26769,594,3,"38,510000000000005",4,1,1,6,Mid-Value,Potential Loyalists
26772,770,2,"46,45",3,1,1,5,Low-Value,At Risk Customers
26773,1133,1,"5,95",2,1,1,4,Low-Value,Can't Lose
26774,190,2,"70,3",5,1,1,7,Mid-Value,Potential Loyalists
26775,897,2,"23,700000000000003",3,1,1,5,Low-Value,At Risk Customers
26777,90,1,"30,35",5,1,1,7,Mid-Value,Potential Loyalists
26778,239,1,"5,5",5,1,1,7,Mid-Value,Potential Loyalists
26779,74,6,"101,95",5,1,1,7,Mid-Value,Potential Loyalists
26780,1229,1,"24,6",2,1,1,4,Low-Value,Can't Lose
26781,36,1,"40,75",5,1,1,7,Mid-Value,Potential Loyalists
26782,809,1,"12,55",3,1,1,5,Low-Value,At Risk Customers
26784,853,1,"19,8",3,1,1,5,Low-Value,At Risk Customers
26785,123,2,"139,54999999999998",5,1,1,7,Mid-Value,Potential Loyalists
26786,1218,1,"32,3",2,1,1,4,Low-Value,Can't Lose
26788,29,3,"140,8",5,1,1,7,Mid-Value,Potential Loyalists
26790,175,3,"121,75",5,1,1,7,Mid-Value,Potential Loyalists
26792,1063,4,"203,6",3,1,1,5,Low-Value,At Risk Customers
26793,157,1,"71,69999999999999",5,1,1,7,Mid-Value,Potential Loyalists
26794,542,2,"123,85",4,1,1,6,Mid-Value,Potential Loyalists
26795,734,3,"97,75",3,1,1,5,Low-Value,At Risk Customers
26798,342,2,"130,35000000000002",5,1,1,7,Mid-Value,Potential Loyalists
26799,270,2,"213,05",5,1,1,7,Mid-Value,Potential Loyalists
26800,461,4,"706,25",4,1,2,7,Mid-Value,Potential Loyalists
26801,3,4,"399,90000000000003",5,1,1,7,Mid-Value,Potential Loyalists
26802,545,2,"20,35",4,1,1,6,Mid-Value,Potential Loyalists
26803,774,1,"29,55",3,1,1,5,Low-Value,At Risk Customers
26806,514,4,"115,4",4,1,1,6,Mid-Value,Potential Loyalists
26807,42,3,"122,5",5,1,1,7,Mid-Value,Potential Loyalists
26810,431,3,"86,5",4,1,1,6,Mid-Value,Potential Loyalists
26811,1748,1,"5,1",1,1,1,3,Low-Value,Lost
26813,468,3,"563,25",4,1,1,6,Mid-Value,Potential Loyalists
26814,78,4,"168,5",5,1,1,7,Mid-Value,Potential Loyalists
26815,266,3,"67,05",5,1,1,7,Mid-Value,Potential Loyalists
26817,64,4,"54,099999999999994",5,1,1,7,Mid-Value,Potential Loyalists
26818,851,4,"127,0",3,1,1,5,Low-Value,At Risk Customers
26819,16,2,"41,400000000000006",5,1,1,7,Mid-Value,Potential Loyalists
26820,707,3,"338,55",4,1,1,6,Mid-Value,Potential Loyalists
26821,604,1,"43,85",4,1,1,6,Mid-Value,Potential Loyalists
26823,1541,1,"28,0",1,1,1,3,Low-Value,Lost
26824,397,3,"231,95",4,1,1,6,Mid-Value,Potential Loyalists
26825,71,3,"187,8",5,1,1,7,Mid-Value,Potential Loyalists
26826,428,3,"292,0",4,1,1,6,Mid-Value,Potential Loyalists
26827,508,1,"16,799999999999997",4,1,1,6,Mid-Value,Potential Loyalists
26831,371,3,"66,1",4,1,1,6,Mid-Value,Potential Loyalists
26832,499,2,"208,45000000000002",4,1,1,6,Mid-Value,Potential Loyalists
26833,138,4,"379,95",5,1,1,7,Mid-Value,Potential Loyalists
26835,397,9,"387,55",4,2,1,7,Mid-Value,Potential Loyalists
26836,379,6,"541,2",4,1,1,6,Mid-Value,Potential Loyalists
26839,1122,1,"16,8",2,1,1,4,Low-Value,Can't Lose
26844,90,5,"144,8",5,1,1,7,Mid-Value,Potential Loyalists
26845,49,4,"246,9",5,1,1,7,Mid-Value,Potential Loyalists
26846,1097,2,"91,85",2,1,1,4,Low-Value,Can't Lose
26847,487,2,"159,5",4,1,1,6,Mid-Value,Potential Loyalists
26848,263,2,"97,2",5,1,1,7,Mid-Value,Potential Loyalists
26849,78,6,"191,8",5,1,1,7,Mid-Value,Potential Loyalists
26860,948,3,"119,2",3,1,1,5,Low-Value,At Risk Customers
26861,386,6,"703,1",4,1,2,7,Mid-Value,Potential Loyalists
26862,134,3,"365,7",5,1,1,7,Mid-Value,Potential Loyalists
26863,393,6,"546,65",4,1,1,6,Mid-Value,Potential Loyalists
26864,597,2,"23,85",4,1,1,6,Mid-Value,Potential Loyalists
26866,73,4,"65,2",5,1,1,7,Mid-Value,Potential Loyalists
26867,251,7,"269,8",5,2,1,8,High-Value,Potential Loyalists
26869,141,1,"15,5",5,1,1,7,Mid-Value,Potential Loyalists
26870,1439,1,"26,65",2,1,1,4,Low-Value,Can't Lose
26871,175,4,"334,45",5,1,1,7,Mid-Value,Potential Loyalists
26872,944,3,"168,95",3,1,1,5,Low-Value,At Risk Customers
26873,146,6,"851,65",5,1,2,8,High-Value,Potential Loyalists
26874,1232,1,"278,4",2,1,1,4,Low-Value,Can't Lose
26875,93,4,"425,1",5,1,1,7,Mid-Value,Potential Loyalists
26876,333,7,"314,45000000000005",5,2,1,8,High-Value,Potential Loyalists
26877,1437,1,"24,299999999999997",2,1,1,4,Low-Value,Can't Lose
26878,11,4,"74,10000000000001",5,1,1,7,Mid-Value,Potential Loyalists
26879,414,5,"214,0",4,1,1,6,Mid-Value,Potential Loyalists
26880,977,1,"24,4",3,1,1,5,Low-Value,At Risk Customers
26883,1753,1,"117,2",1,1,1,3,Low-Value,Lost
26884,1473,3,"173,55",1,1,1,3,Low-Value,Lost
26885,78,1,"7,05",5,1,1,7,Mid-Value,Potential Loyalists
26886,466,1,"53,8",4,1,1,6,Mid-Value,Potential Loyalists
26887,297,2,"13,350000000000001",5,1,1,7,Mid-Value,Potential Loyalists
26888,1300,2,"120,6",2,1,1,4,Low-Value,Can't Lose
26889,581,6,"517,5999999999999",4,1,1,6,Mid-Value,Potential Loyalists
26892,1132,5,"245,35000000000002",2,1,1,4,Low-Value,Can't Lose
26893,1215,1,"23,4",2,1,1,4,Low-Value,Can't Lose
26896,76,1,"7,25",5,1,1,7,Mid-Value,Potential Loyalists
26897,755,2,"155,5",3,1,1,5,Low-Value,At Risk Customers
26898,57,2,"39,9",5,1,1,7,Mid-Value,Potential Loyalists
26901,177,9,"517,75",5,2,1,8,High-Value,Potential Loyalists
26902,1236,4,"102,95",2,1,1,4,Low-Value,Can't Lose
26903,365,1,"120,0",5,1,1,7,Mid-Value,Potential Loyalists
26904,532,4,"227,25",4,1,1,6,Mid-Value,Potential Loyalists
26905,731,4,"234,05",3,1,1,5,Low-Value,At Risk Customers
26906,276,3,"376,0",5,1,1,7,Mid-Value,Potential Loyalists
26908,273,4,"158,1",5,1,1,7,Mid-Value,Potential Loyalists
26909,887,1,"227,2",3,1,1,5,Low-Value,At Risk Customers
26910,381,6,"335,0",4,1,1,6,Mid-Value,Potential Loyalists
26911,1246,2,"182,0",2,1,1,4,Low-Value,Can't Lose
26913,72,2,"103,10000000000001",5,1,1,7,Mid-Value,Potential Loyalists
26914,1027,2,"118,89999999999999",3,1,1,5,Low-Value,At Risk Customers
26915,617,2,"214,79999999999998",4,1,1,6,Mid-Value,Potential Loyalists
26916,880,1,"35,3",3,1,1,5,Low-Value,At Risk Customers
26917,127,2,"215,2",5,1,1,7,Mid-Value,Potential Loyalists
26918,1202,6,"478,9",2,1,1,4,Low-Value,Can't Lose
26920,202,4,"281,55",5,1,1,7,Mid-Value,Potential Loyalists
26922,868,4,"195,55",3,1,1,5,Low-Value,At Risk Customers
26923,32,2,"41,900000000000006",5,1,1,7,Mid-Value,Potential Loyalists
26926,219,3,"171,75",5,1,1,7,Mid-Value,Potential Loyalists
26927,1333,1,"229,65",2,1,1,4,Low-Value,Can't Lose
26929,1155,1,"1,6",2,1,1,4,Low-Value,Can't Lose
26931,242,5,"752,6500000000001",5,1,2,8,High-Value,Potential Loyalists
26933,430,2,"61,2",4,1,1,6,Mid-Value,Potential Loyalists
26934,251,1,"5,45",5,1,1,7,Mid-Value,Potential Loyalists
26937,20,4,"403,65",5,1,1,7,Mid-Value,Potential Loyalists
26938,17,4,"144,55",5,1,1,7,Mid-Value,Potential Loyalists
26939,288,3,"242,5",5,1,1,7,Mid-Value,Potential Loyalists
26940,151,7,"243,05",5,2,1,8,High-Value,Potential Loyalists
26942,200,4,"90,35",5,1,1,7,Mid-Value,Potential Loyalists
26943,563,1,"99,6",4,1,1,6,Mid-Value,Potential Loyalists
26944,1688,1,"15,7",1,1,1,3,Low-Value,Lost
26946,441,4,"479,95",4,1,1,6,Mid-Value,Potential Loyalists
26947,1025,8,"438,45",3,2,1,6,Mid-Value,Potential Loyalists
26948,253,2,"177,04999999999998",5,1,1,7,Mid-Value,Potential Loyalists
26949,215,1,"20,8",5,1,1,7,Mid-Value,Potential Loyalists
26950,523,1,"160,4",4,1,1,6,Mid-Value,Potential Loyalists
26952,62,5,"88,4",5,1,1,7,Mid-Value,Potential Loyalists
26953,200,6,"367,04999999999995",5,1,1,7,Mid-Value,Potential Loyalists
26954,533,1,"498,75",4,1,1,6,Mid-Value,Potential Loyalists
26958,331,3,"80,85",5,1,1,7,Mid-Value,Potential Loyalists
26962,188,1,"84,3",5,1,1,7,Mid-Value,Potential Loyalists
26964,239,6,"657,35",5,1,1,7,Mid-Value,Potential Loyalists
26965,35,4,"478,75",5,1,1,7,Mid-Value,Potential Loyalists
26967,479,3,"186,29999999999998",4,1,1,6,Mid-Value,Potential Loyalists
26971,97,3,"33,25",5,1,1,7,Mid-Value,Potential Loyalists
26973,309,1,"82,0",5,1,1,7,Mid-Value,Potential Loyalists
26974,1263,2,"99,1",2,1,1,4,Low-Value,Can't Lose
26975,1778,1,"23,85",1,1,1,3,Low-Value,Lost
26976,698,6,"243,95",4,1,1,6,Mid-Value,Potential Loyalists
26977,57,2,"238,95",5,1,1,7,Mid-Value,Potential Loyalists
26980,106,8,"406,25",5,2,1,8,High-Value,Potential Loyalists
26983,220,2,"146,1",5,1,1,7,Mid-Value,Potential Loyalists
26984,986,1,"200,10000000000002",3,1,1,5,Low-Value,At Risk Customers
26987,1417,1,"25,65",2,1,1,4,Low-Value,Can't Lose
26989,735,1,"288,0",3,1,1,5,Low-Value,At Risk Customers
26991,18,4,"241,10000000000002",5,1,1,7,Mid-Value,Potential Loyalists
26992,851,1,"53,7",3,1,1,5,Low-Value,At Risk Customers
26993,543,2,"34,900000000000006",4,1,1,6,Mid-Value,Potential Loyalists
26996,224,2,"108,7",5,1,1,7,Mid-Value,Potential Loyalists
26999,73,5,"91,5",5,1,1,7,Mid-Value,Potential Loyalists
27000,169,1,"6,2",5,1,1,7,Mid-Value,Potential Loyalists
27002,130,3,"62,75",5,1,1,7,Mid-Value,Potential Loyalists
27003,616,1,"18,55",4,1,1,6,Mid-Value,Potential Loyalists
27004,431,3,"366,55",4,1,1,6,Mid-Value,Potential Loyalists
27007,53,3,"100,7",5,1,1,7,Mid-Value,Potential Loyalists
27008,521,3,"449,6",4,1,1,6,Mid-Value,Potential Loyalists
27009,441,1,"26,85",4,1,1,6,Mid-Value,Potential Loyalists
27010,509,4,"364,3",4,1,1,6,Mid-Value,Potential Loyalists
27011,302,3,"297,5",5,1,1,7,Mid-Value,Potential Loyalists
27013,1313,3,"78,7",2,1,1,4,Low-Value,Can't Lose
27014,18,3,"146,35000000000002",5,1,1,7,Mid-Value,Potential Loyalists
27015,599,4,"145,2",4,1,1,6,Mid-Value,Potential Loyalists
27016,121,2,"15,45",5,1,1,7,Mid-Value,Potential Loyalists
27017,262,2,"53,25",5,1,1,7,Mid-Value,Potential Loyalists
27020,502,1,"16,799999999999997",4,1,1,6,Mid-Value,Potential Loyalists
27021,1004,1,"10,85",3,1,1,5,Low-Value,At Risk Customers
27023,75,3,"59,6",5,1,1,7,Mid-Value,Potential Loyalists
27025,718,2,"38,9",4,1,1,6,Mid-Value,Potential Loyalists
27026,54,2,"110,7",5,1,1,7,Mid-Value,Potential Loyalists
27028,163,8,"897,6500000000001",5,2,2,9,High-Value,Champions
27030,1446,1,"117,6",2,1,1,4,Low-Value,Can't Lose
27032,1771,1,"38,4",1,1,1,3,Low-Value,Lost
27033,206,4,"177,2",5,1,1,7,Mid-Value,Potential Loyalists
27034,479,6,"386,71",4,1,1,6,Mid-Value,Potential Loyalists
27038,1712,1,"19,05",1,1,1,3,Low-Value,Lost
27039,754,3,"136,25",3,1,1,5,Low-Value,At Risk Customers
27040,323,4,"102,95",5,1,1,7,Mid-Value,Potential Loyalists
27041,241,3,"119,2",5,1,1,7,Mid-Value,Potential Loyalists
27043,316,4,"291,04999999999995",5,1,1,7,Mid-Value,Potential Loyalists
27045,374,1,"9,2",4,1,1,6,Mid-Value,Potential Loyalists
27046,91,1,"17,8",5,1,1,7,Mid-Value,Potential Loyalists
27047,703,5,"94,53",4,1,1,6,Mid-Value,Potential Loyalists
27048,222,3,"59,9",5,1,1,7,Mid-Value,Potential Loyalists
27049,908,2,"99,55",3,1,1,5,Low-Value,At Risk Customers
27051,945,2,"107,2",3,1,1,5,Low-Value,At Risk Customers
27052,87,1,"33,05",5,1,1,7,Mid-Value,Potential Loyalists
27053,74,13,"698,35",5,3,2,10,High-Value,Champions
27056,458,2,"133,2",4,1,1,6,Mid-Value,Potential Loyalists
27057,1133,1,"67,8",2,1,1,4,Low-Value,Can't Lose
27059,274,10,"770,15",5,2,2,9,High-Value,Champions
27060,671,1,"37,7",4,1,1,6,Mid-Value,Potential Loyalists
27061,317,4,"174,45",5,1,1,7,Mid-Value,Potential Loyalists
27062,563,7,"101,35",4,2,1,7,Mid-Value,Potential Loyalists
27064,771,6,"601,05",3,1,1,5,Low-Value,At Risk Customers
27066,916,1,"66,5",3,1,1,5,Low-Value,At Risk Customers
27067,1107,1,"44,6",2,1,1,4,Low-Value,Can't Lose
27068,188,3,"680,55",5,1,2,8,High-Value,Potential Loyalists
27072,1125,8,"698,9",2,2,2,6,Mid-Value,Potential Loyalists
27074,559,2,"17,35",4,1,1,6,Mid-Value,Potential Loyalists
27075,1678,1,"54,75",1,1,1,3,Low-Value,Lost
27076,428,4,"636,55",4,1,1,6,Mid-Value,Potential Loyalists
27078,1324,1,"85,1",2,1,1,4,Low-Value,Can't Lose
27079,1723,1,"27,299999999999997",1,1,1,3,Low-Value,Lost
27084,336,1,"18,15",5,1,1,7,Mid-Value,Potential Loyalists
27085,328,4,"237,64999999999998",5,1,1,7,Mid-Value,Potential Loyalists
27086,703,7,"489,0",4,2,1,7,Mid-Value,Potential Loyalists
27087,1103,4,"112,55",2,1,1,4,Low-Value,Can't Lose
27088,10,5,"155,2",5,1,1,7,Mid-Value,Potential Loyalists
27089,853,5,"311,6",3,1,1,5,Low-Value,At Risk Customers
27090,210,3,"160,0",5,1,1,7,Mid-Value,Potential Loyalists
27093,158,2,"183,39999999999998",5,1,1,7,Mid-Value,Potential Loyalists
27096,477,4,"91,45",4,1,1,6,Mid-Value,Potential Loyalists
27098,1225,1,"168,1",2,1,1,4,Low-Value,Can't Lose
27099,170,2,"140,15",5,1,1,7,Mid-Value,Potential Loyalists
27102,950,1,"20,25",3,1,1,5,Low-Value,At Risk Customers
27107,1200,3,"146,6",2,1,1,4,Low-Value,Can't Lose
27110,1270,1,"39,2",2,1,1,4,Low-Value,Can't Lose
27111,102,3,"278,35",5,1,1,7,Mid-Value,Potential Loyalists
27112,1208,2,"61,2",2,1,1,4,Low-Value,Can't Lose
27113,166,2,"144,75",5,1,1,7,Mid-Value,Potential Loyalists
27115,510,1,"8,7",4,1,1,6,Mid-Value,Potential Loyalists
27117,404,1,"42,45",4,1,1,6,Mid-Value,Potential Loyalists
27119,1126,7,"543,35",2,2,1,5,Low-Value,At Risk Customers
27120,995,1,"16,8",3,1,1,5,Low-Value,At Risk Customers
27121,518,1,"22,8",4,1,1,6,Mid-Value,Potential Loyalists
27122,443,8,"310,4",4,2,1,7,Mid-Value,Potential Loyalists
27123,206,4,"91,0",5,1,1,7,Mid-Value,Potential Loyalists
27124,543,1,"17,2",4,1,1,6,Mid-Value,Potential Loyalists
27126,1414,1,"54,2",2,1,1,4,Low-Value,Can't Lose
27127,781,3,"112,25",3,1,1,5,Low-Value,At Risk Customers
27128,825,1,"4,95",3,1,1,5,Low-Value,At Risk Customers
27130,537,2,"52,3",4,1,1,6,Mid-Value,Potential Loyalists
27132,67,1,"289,95",5,1,1,7,Mid-Value,Potential Loyalists
27134,624,2,"364,9",4,1,1,6,Mid-Value,Potential Loyalists
27135,945,1,"11,3",3,1,1,5,Low-Value,At Risk Customers
27137,587,1,"205,9",4,1,1,6,Mid-Value,Potential Loyalists
27138,268,1,"27,3",5,1,1,7,Mid-Value,Potential Loyalists
27140,762,3,"374,04999999999995",3,1,1,5,Low-Value,At Risk Customers
27142,1425,2,"137,4",2,1,1,4,Low-Value,Can't Lose
27143,1229,1,"221,9",2,1,1,4,Low-Value,Can't Lose
27144,276,3,"200,4",5,1,1,7,Mid-Value,Potential Loyalists
27146,280,7,"254,9",5,2,1,8,High-Value,Potential Loyalists
27147,798,1,"66,5",3,1,1,5,Low-Value,At Risk Customers
27148,1227,3,"150,55",2,1,1,4,Low-Value,Can't Lose
27149,1797,1,"36,9",1,1,1,3,Low-Value,Lost
27150,615,1,"17,8",4,1,1,6,Mid-Value,Potential Loyalists
27152,228,1,"56,849999999999994",5,1,1,7,Mid-Value,Potential Loyalists
27155,1292,1,"30,3",2,1,1,4,Low-Value,Can't Lose
27158,1128,2,"108,19999999999999",2,1,1,4,Low-Value,Can't Lose
27159,223,7,"344,25",5,2,1,8,High-Value,Potential Loyalists
27160,370,4,"505,79999999999995",4,1,1,6,Mid-Value,Potential Loyalists
27161,1288,4,"265,55",2,1,1,4,Low-Value,Can't Lose
27162,298,4,"361,0",5,1,1,7,Mid-Value,Potential Loyalists
27165,822,3,"163,55",3,1,1,5,Low-Value,At Risk Customers
27166,1,7,"359,15",5,2,1,8,High-Value,Potential Loyalists
27167,181,1,"109,4",5,1,1,7,Mid-Value,Potential Loyalists
27168,557,2,"77,8",4,1,1,6,Mid-Value,Potential Loyalists
27171,389,4,"276,34999999999997",4,1,1,6,Mid-Value,Potential Loyalists
27176,162,9,"538,65",5,2,1,8,High-Value,Potential Loyalists
27178,1613,1,"7,0",1,1,1,3,Low-Value,Lost
27179,53,2,"72,2",5,1,1,7,Mid-Value,Potential Loyalists
27183,113,2,"68,8",5,1,1,7,Mid-Value,Potential Loyalists
27184,618,1,"40,5",4,1,1,6,Mid-Value,Potential Loyalists
27185,410,5,"208,65",4,1,1,6,Mid-Value,Potential Loyalists
27186,379,1,"81,0",4,1,1,6,Mid-Value,Potential Loyalists
27188,969,2,"60,4",3,1,1,5,Low-Value,At Risk Customers
27189,607,2,"120,75",4,1,1,6,Mid-Value,Potential Loyalists
27190,203,4,"184,9",5,1,1,7,Mid-Value,Potential Loyalists
27191,201,3,"264,65",5,1,1,7,Mid-Value,Potential Loyalists
27192,13,1,"13,3",5,1,1,7,Mid-Value,Potential Loyalists
27194,215,7,"764,25",5,2,2,9,High-Value,Champions
27196,1361,1,"88,05000000000001",2,1,1,4,Low-Value,Can't Lose
27198,932,3,"267,04999999999995",3,1,1,5,Low-Value,At Risk Customers
27199,1549,1,"60,25",1,1,1,3,Low-Value,Lost
27200,120,2,"72,35",5,1,1,7,Mid-Value,Potential Loyalists
27202,613,8,"657,6",4,2,1,7,Mid-Value,Potential Loyalists
27203,175,7,"319,25",5,2,1,8,High-Value,Potential Loyalists
27204,444,12,"457,25",4,3,1,8,High-Value,Potential Loyalists
27206,0,7,"671,05",5,2,2,9,High-Value,Champions
27208,101,4,"429,1500000000001",5,1,1,7,Mid-Value,Potential Loyalists
27209,425,2,"93,35",4,1,1,6,Mid-Value,Potential Loyalists
27211,124,3,"131,4",5,1,1,7,Mid-Value,Potential Loyalists
27215,14,2,"22,05",5,1,1,7,Mid-Value,Potential Loyalists
27216,973,2,"123,89999999999999",3,1,1,5,Low-Value,At Risk Customers
27218,370,2,"67,5",4,1,1,6,Mid-Value,Potential Loyalists
27219,154,9,"667,0",5,2,2,9,High-Value,Champions
27220,5,2,"115,0",5,1,1,7,Mid-Value,Potential Loyalists
27222,17,3,"57,5",5,1,1,7,Mid-Value,Potential Loyalists
27224,1325,1,"17,25",2,1,1,4,Low-Value,Can't Lose
27225,1798,1,"28,65",1,1,1,3,Low-Value,Lost
27226,206,11,"1138,45",5,2,2,9,High-Value,Champions
27229,881,2,"244,15",3,1,1,5,Low-Value,At Risk Customers
27230,430,2,"293,3",4,1,1,6,Mid-Value,Potential Loyalists
27231,669,3,"224,2",4,1,1,6,Mid-Value,Potential Loyalists
27233,648,1,"7,25",4,1,1,6,Mid-Value,Potential Loyalists
27235,327,2,"138,85",5,1,1,7,Mid-Value,Potential Loyalists
27237,395,3,"83,3",4,1,1,6,Mid-Value,Potential Loyalists
27238,43,3,"251,14999999999998",5,1,1,7,Mid-Value,Potential Loyalists
27239,819,5,"289,95",3,1,1,5,Low-Value,At Risk Customers
27240,682,1,"91,0",4,1,1,6,Mid-Value,Potential Loyalists
27241,774,7,"227,95",3,2,1,6,Mid-Value,Potential Loyalists
27242,1583,1,"829,75",1,1,2,4,Low-Value,Can't Lose
27243,335,2,"59,550000000000004",5,1,1,7,Mid-Value,Potential Loyalists
27244,38,2,"51,849999999999994",5,1,1,7,Mid-Value,Potential Loyalists
27246,225,3,"348,2",5,1,1,7,Mid-Value,Potential Loyalists
27247,1373,2,"89,55",2,1,1,4,Low-Value,Can't Lose
27248,416,3,"462,8",4,1,1,6,Mid-Value,Potential Loyalists
27249,131,2,"186,2",5,1,1,7,Mid-Value,Potential Loyalists
27253,245,7,"532,6",5,2,1,8,High-Value,Potential Loyalists
27256,1093,2,"68,15",3,1,1,5,Low-Value,At Risk Customers
27257,1242,2,"122,75",2,1,1,4,Low-Value,Can't Lose
27258,692,4,"61,95",4,1,1,6,Mid-Value,Potential Loyalists
27259,1329,1,"71,9",2,1,1,4,Low-Value,Can't Lose
27260,1122,4,"318,95",2,1,1,4,Low-Value,Can't Lose
27261,300,1,"8,6",5,1,1,7,Mid-Value,Potential Loyalists
27262,1616,3,"196,45000000000002",1,1,1,3,Low-Value,Lost
27263,487,1,"35,400000000000006",4,1,1,6,Mid-Value,Potential Loyalists
27265,1516,4,"192,25000000000003",1,1,1,3,Low-Value,Lost
27266,1165,1,"30,8",2,1,1,4,Low-Value,Can't Lose
27268,541,1,"27,450000000000003",4,1,1,6,Mid-Value,Potential Loyalists
27269,55,14,"575,8",5,3,1,9,High-Value,Champions
27270,553,3,"616,4499999999999",4,1,1,6,Mid-Value,Potential Loyalists
27271,1203,4,"458,59999999999997",2,1,1,4,Low-Value,Can't Lose
27272,135,2,"121,3",5,1,1,7,Mid-Value,Potential Loyalists
27273,22,5,"388,95",5,1,1,7,Mid-Value,Potential Loyalists
27274,1032,7,"428,09999999999997",3,2,1,6,Mid-Value,Potential Loyalists
27278,788,2,"101,2",3,1,1,5,Low-Value,At Risk Customers
27279,13,7,"1609,0",5,2,3,10,High-Value,Champions
27281,327,2,"99,9",5,1,1,7,Mid-Value,Potential Loyalists
27282,1015,2,"151,1",3,1,1,5,Low-Value,At Risk Customers
27284,20,6,"235,45",5,1,1,7,Mid-Value,Potential Loyalists
27288,842,1,"17,25",3,1,1,5,Low-Value,At Risk Customers
27289,694,2,"49,2",4,1,1,6,Mid-Value,Potential Loyalists
27290,164,11,"634,05",5,2,1,8,High-Value,Potential Loyalists
27291,979,2,"50,95",3,1,1,5,Low-Value,At Risk Customers
27292,45,4,"86,85",5,1,1,7,Mid-Value,Potential Loyalists
27293,29,12,"495,4",5,3,1,9,High-Value,Champions
27295,1224,3,"112,5",2,1,1,4,Low-Value,Can't Lose
27296,390,1,"32,4",4,1,1,6,Mid-Value,Potential Loyalists
27297,71,3,"66,3",5,1,1,7,Mid-Value,Potential Loyalists
27298,470,1,"128,3",4,1,1,6,Mid-Value,Potential Loyalists
27299,913,4,"862,9",3,1,2,6,Mid-Value,Potential Loyalists
27301,35,9,"688,15",5,2,2,9,High-Value,Champions
27304,758,1,"31,5",3,1,1,5,Low-Value,At Risk Customers
27306,292,3,"278,7",5,1,1,7,Mid-Value,Potential Loyalists
27307,79,1,"8,55",5,1,1,7,Mid-Value,Potential Loyalists
27308,830,3,"95,1",3,1,1,5,Low-Value,At Risk Customers
27310,7,9,"443,09999999999997",5,2,1,8,High-Value,Potential Loyalists
27311,244,5,"206,0",5,1,1,7,Mid-Value,Potential Loyalists
27312,946,1,"21,3",3,1,1,5,Low-Value,At Risk Customers
27313,436,3,"143,85000000000002",4,1,1,6,Mid-Value,Potential Loyalists
27315,18,4,"171,65",5,1,1,7,Mid-Value,Potential Loyalists
27316,165,2,"360,55",5,1,1,7,Mid-Value,Potential Loyalists
27317,107,5,"223,3",5,1,1,7,Mid-Value,Potential Loyalists
27318,60,8,"283,0",5,2,1,8,High-Value,Potential Loyalists
27319,442,2,"18,8",4,1,1,6,Mid-Value,Potential Loyalists
27320,699,3,"73,75",4,1,1,6,Mid-Value,Potential Loyalists
27321,777,3,"289,79999999999995",3,1,1,5,Low-Value,At Risk Customers
27324,186,2,"164,8",5,1,1,7,Mid-Value,Potential Loyalists
27327,811,2,"56,05",3,1,1,5,Low-Value,At Risk Customers
27328,300,4,"312,95",5,1,1,7,Mid-Value,Potential Loyalists
27329,79,3,"217,05",5,1,1,7,Mid-Value,Potential Loyalists
27330,809,3,"210,35",3,1,1,5,Low-Value,At Risk Customers
27331,400,4,"238,45",4,1,1,6,Mid-Value,Potential Loyalists
27333,746,3,"129,2",3,1,1,5,Low-Value,At Risk Customers
27335,774,1,"15,95",3,1,1,5,Low-Value,At Risk Customers
27336,21,5,"313,15",5,1,1,7,Mid-Value,Potential Loyalists
27337,340,4,"164,29999999999998",5,1,1,7,Mid-Value,Potential Loyalists
27338,256,3,"61,45",5,1,1,7,Mid-Value,Potential Loyalists
27339,236,3,"156,65",5,1,1,7,Mid-Value,Potential Loyalists
27340,1023,2,"36,75",3,1,1,5,Low-Value,At Risk Customers
27342,1676,1,"61,0",1,1,1,3,Low-Value,Lost
27343,522,3,"227,70000000000002",4,1,1,6,Mid-Value,Potential Loyalists
27345,73,9,"416,2",5,2,1,8,High-Value,Potential Loyalists
27346,1559,2,"204,64999999999998",1,1,1,3,Low-Value,Lost
27347,1025,1,"8,85",3,1,1,5,Low-Value,At Risk Customers
27349,59,5,"421,65000000000003",5,1,1,7,Mid-Value,Potential Loyalists
27350,149,7,"243,7",5,2,1,8,High-Value,Potential Loyalists
27351,193,5,"172,35",5,1,1,7,Mid-Value,Potential Loyalists
27352,1269,2,"499,20000000000005",2,1,1,4,Low-Value,Can't Lose
27355,584,2,"313,85",4,1,1,6,Mid-Value,Potential Loyalists
27357,487,4,"324,9",4,1,1,6,Mid-Value,Potential Loyalists
27359,1096,6,"529,55",2,1,1,4,Low-Value,Can't Lose
27360,154,4,"280,7",5,1,1,7,Mid-Value,Potential Loyalists
27361,495,4,"136,45",4,1,1,6,Mid-Value,Potential Loyalists
27364,416,1,"10,45",4,1,1,6,Mid-Value,Potential Loyalists
27366,78,7,"413,95",5,2,1,8,High-Value,Potential Loyalists
27368,418,2,"76,8",4,1,1,6,Mid-Value,Potential Loyalists
27369,515,5,"526,85",4,1,1,6,Mid-Value,Potential Loyalists
27370,1651,1,"92,1",1,1,1,3,Low-Value,Lost
27371,1666,1,"24,1",1,1,1,3,Low-Value,Lost
27372,837,1,"19,7",3,1,1,5,Low-Value,At Risk Customers
27375,1317,2,"49,5",2,1,1,4,Low-Value,Can't Lose
27377,451,1,"42,45",4,1,1,6,Mid-Value,Potential Loyalists
27378,1089,1,"20,7",3,1,1,5,Low-Value,At Risk Customers
27380,420,2,"391,6",4,1,1,6,Mid-Value,Potential Loyalists
27381,77,2,"104,9",5,1,1,7,Mid-Value,Potential Loyalists
27384,389,3,"49,65",4,1,1,6,Mid-Value,Potential Loyalists
27388,1282,1,"49,45",2,1,1,4,Low-Value,Can't Lose
27390,618,2,"103,55",4,1,1,6,Mid-Value,Potential Loyalists
27391,1701,1,"27,55",1,1,1,3,Low-Value,Lost
27392,164,6,"593,8",5,1,1,7,Mid-Value,Potential Loyalists
27393,998,4,"111,9",3,1,1,5,Low-Value,At Risk Customers
27394,811,2,"118,9",3,1,1,5,Low-Value,At Risk Customers
27395,237,3,"64,65",5,1,1,7,Mid-Value,Potential Loyalists
27396,789,1,"11,35",3,1,1,5,Low-Value,At Risk Customers
27398,151,5,"144,75",5,1,1,7,Mid-Value,Potential Loyalists
27400,27,8,"565,0999999999999",5,2,1,8,High-Value,Potential Loyalists
27401,55,4,"194,55",5,1,1,7,Mid-Value,Potential Loyalists
27403,189,4,"52,1",5,1,1,7,Mid-Value,Potential Loyalists
27404,112,2,"104,15",5,1,1,7,Mid-Value,Potential Loyalists
27406,1594,1,"10,6",1,1,1,3,Low-Value,Lost
27407,132,5,"326,5",5,1,1,7,Mid-Value,Potential Loyalists
27409,414,2,"55,05",4,1,1,6,Mid-Value,Potential Loyalists
27410,1273,1,"9,7",2,1,1,4,Low-Value,Can't Lose
27412,875,3,"220,25",3,1,1,5,Low-Value,At Risk Customers
27414,1023,2,"269,05",3,1,1,5,Low-Value,At Risk Customers
27415,149,1,"11,8",5,1,1,7,Mid-Value,Potential Loyalists
27417,253,1,"9,15",5,1,1,7,Mid-Value,Potential Loyalists
27418,189,6,"1307,2",5,1,2,8,High-Value,Potential Loyalists
27419,689,2,"83,5",4,1,1,6,Mid-Value,Potential Loyalists
27420,36,4,"205,25",5,1,1,7,Mid-Value,Potential Loyalists
27422,21,6,"489,45",5,1,1,7,Mid-Value,Potential Loyalists
27423,38,9,"311,9",5,2,1,8,High-Value,Potential Loyalists
27424,1544,1,"1,35",1,1,1,3,Low-Value,Lost
27425,1790,1,"12,4",1,1,1,3,Low-Value,Lost
27426,41,1,"61,4",5,1,1,7,Mid-Value,Potential Loyalists
27431,134,2,"195,5",5,1,1,7,Mid-Value,Potential Loyalists
27432,149,5,"170,2",5,1,1,7,Mid-Value,Potential Loyalists
27435,17,1,"16,049999999999997",5,1,1,7,Mid-Value,Potential Loyalists
27437,240,5,"338,98",5,1,1,7,Mid-Value,Potential Loyalists
27439,197,3,"95,8",5,1,1,7,Mid-Value,Potential Loyalists
27442,1748,2,"85,4",1,1,1,3,Low-Value,Lost
27443,75,5,"388,1",5,1,1,7,Mid-Value,Potential Loyalists
27444,15,9,"1070,75",5,2,2,9,High-Value,Champions
27447,880,1,"101,1",3,1,1,5,Low-Value,At Risk Customers
27448,1221,1,"84,3",2,1,1,4,Low-Value,Can't Lose
27451,1397,2,"150,64999999999998",2,1,1,4,Low-Value,Can't Lose
27454,743,1,"36,9",3,1,1,5,Low-Value,At Risk Customers
27455,411,1,"11,4",4,1,1,6,Mid-Value,Potential Loyalists
27456,776,1,"5,55",3,1,1,5,Low-Value,At Risk Customers
27457,240,4,"289,25",5,1,1,7,Mid-Value,Potential Loyalists
27460,461,2,"31,1",4,1,1,6,Mid-Value,Potential Loyalists
27462,773,1,"97,95",3,1,1,5,Low-Value,At Risk Customers
27464,384,3,"83,6",4,1,1,6,Mid-Value,Potential Loyalists
27466,628,2,"25,75",4,1,1,6,Mid-Value,Potential Loyalists
27467,69,3,"132,35",5,1,1,7,Mid-Value,Potential Loyalists
27469,73,6,"215,2",5,1,1,7,Mid-Value,Potential Loyalists
27470,606,1,"132,75",4,1,1,6,Mid-Value,Potential Loyalists
27471,960,1,"85,5",3,1,1,5,Low-Value,At Risk Customers
27472,236,3,"93,79999999999998",5,1,1,7,Mid-Value,Potential Loyalists
27473,15,1,"24,3",5,1,1,7,Mid-Value,Potential Loyalists
27474,65,5,"143,85",5,1,1,7,Mid-Value,Potential Loyalists
27476,738,2,"217,20000000000002",3,1,1,5,Low-Value,At Risk Customers
27477,1588,1,"4,050000000000001",1,1,1,3,Low-Value,Lost
27478,252,4,"97,1",5,1,1,7,Mid-Value,Potential Loyalists
27479,57,1,"23,95",5,1,1,7,Mid-Value,Potential Loyalists
27482,577,3,"47,05",4,1,1,6,Mid-Value,Potential Loyalists
27483,1531,1,"12,65",1,1,1,3,Low-Value,Lost
27484,22,1,"29,6",5,1,1,7,Mid-Value,Potential Loyalists
27487,17,6,"447,05",5,1,1,7,Mid-Value,Potential Loyalists
27488,74,6,"416,25",5,1,1,7,Mid-Value,Potential Loyalists
27489,417,5,"179,35000000000002",4,1,1,6,Mid-Value,Potential Loyalists
27490,1277,1,"62,099999999999994",2,1,1,4,Low-Value,Can't Lose
27491,697,1,"14,15",4,1,1,6,Mid-Value,Potential Loyalists
27492,815,4,"276,5",3,1,1,5,Low-Value,At Risk Customers
27494,43,4,"286,3",5,1,1,7,Mid-Value,Potential Loyalists
27495,963,1,"29,25",3,1,1,5,Low-Value,At Risk Customers
27496,199,4,"232,45",5,1,1,7,Mid-Value,Potential Loyalists
27497,151,4,"162,8",5,1,1,7,Mid-Value,Potential Loyalists
27498,453,9,"536,45",4,2,1,7,Mid-Value,Potential Loyalists
27499,1228,3,"185,2",2,1,1,4,Low-Value,Can't Lose
27501,1241,1,"30,3",2,1,1,4,Low-Value,Can't Lose
27503,737,8,"394,1",3,2,1,6,Mid-Value,Potential Loyalists
27505,1060,5,"364,55",3,1,1,5,Low-Value,At Risk Customers
27506,243,10,"620,25",5,2,1,8,High-Value,Potential Loyalists
27507,38,4,"152,2",5,1,1,7,Mid-Value,Potential Loyalists
27508,987,2,"414,09999999999997",3,1,1,5,Low-Value,At Risk Customers
27509,49,7,"150,75",5,2,1,8,High-Value,Potential Loyalists
27511,788,1,"58,55",3,1,1,5,Low-Value,At Risk Customers
27513,737,1,"9,7",3,1,1,5,Low-Value,At Risk Customers
27515,46,9,"566,3",5,2,1,8,High-Value,Potential Loyalists
27517,978,2,"32,75",3,1,1,5,Low-Value,At Risk Customers
27518,1121,1,"41,9",2,1,1,4,Low-Value,Can't Lose
27519,574,7,"599,65",4,2,1,7,Mid-Value,Potential Loyalists
27520,1037,2,"87,95",3,1,1,5,Low-Value,At Risk Customers
27523,581,3,"92,75",4,1,1,6,Mid-Value,Potential Loyalists
27525,433,1,"11,9",4,1,1,6,Mid-Value,Potential Loyalists
27526,983,2,"164,75",3,1,1,5,Low-Value,At Risk Customers
27528,991,1,"34,1",3,1,1,5,Low-Value,At Risk Customers
27532,1009,4,"68,95",3,1,1,5,Low-Value,At Risk Customers
27533,1774,1,"5,05",1,1,1,3,Low-Value,Lost
27534,1286,1,"29,6",2,1,1,4,Low-Value,Can't Lose
27535,96,8,"460,45",5,2,1,8,High-Value,Potential Loyalists
27536,544,4,"424,70000000000005",4,1,1,6,Mid-Value,Potential Loyalists
27538,468,2,"40,0",4,1,1,6,Mid-Value,Potential Loyalists
27541,648,2,"61,3",4,1,1,6,Mid-Value,Potential Loyalists
27542,805,2,"23,55",3,1,1,5,Low-Value,At Risk Customers
27543,569,4,"122,05",4,1,1,6,Mid-Value,Potential Loyalists
27544,264,1,"26,85",5,1,1,7,Mid-Value,Potential Loyalists
27546,823,1,"241,55",3,1,1,5,Low-Value,At Risk Customers
27547,490,6,"270,20000000000005",4,1,1,6,Mid-Value,Potential Loyalists
27548,622,3,"121,9",4,1,1,6,Mid-Value,Potential Loyalists
27550,298,3,"17,1",5,1,1,7,Mid-Value,Potential Loyalists
27551,881,3,"119,8",3,1,1,5,Low-Value,At Risk Customers
27554,225,3,"169,75",5,1,1,7,Mid-Value,Potential Loyalists
27555,224,1,"18,05",5,1,1,7,Mid-Value,Potential Loyalists
27561,100,12,"735,25",5,3,2,10,High-Value,Champions
27562,1678,2,"62,4",1,1,1,3,Low-Value,Lost
27568,917,4,"184,4",3,1,1,5,Low-Value,At Risk Customers
27569,193,3,"434,15",5,1,1,7,Mid-Value,Potential Loyalists
27570,13,2,"109,75",5,1,1,7,Mid-Value,Potential Loyalists
27572,84,6,"317,15",5,1,1,7,Mid-Value,Potential Loyalists
27575,538,1,"27,8",4,1,1,6,Mid-Value,Potential Loyalists
27576,364,2,"189,8",5,1,1,7,Mid-Value,Potential Loyalists
27578,1255,1,"126,4",2,1,1,4,Low-Value,Can't Lose
27579,1551,1,"11,7",1,1,1,3,Low-Value,Lost
27580,813,2,"168,0",3,1,1,5,Low-Value,At Risk Customers
27582,809,4,"147,65",3,1,1,5,Low-Value,At Risk Customers
27583,127,2,"54,35",5,1,1,7,Mid-Value,Potential Loyalists
27585,1,15,"682,8",5,3,2,10,High-Value,Champions
27586,96,4,"62,25",5,1,1,7,Mid-Value,Potential Loyalists
27587,1275,4,"537,15",2,1,1,4,Low-Value,Can't Lose
27588,1375,1,"8,15",2,1,1,4,Low-Value,Can't Lose
27589,119,2,"100,6",5,1,1,7,Mid-Value,Potential Loyalists
27590,670,4,"255,85",4,1,1,6,Mid-Value,Potential Loyalists
27591,799,5,"632,9000000000001",3,1,1,5,Low-Value,At Risk Customers
27592,31,8,"278,15",5,2,1,8,High-Value,Potential Loyalists
27593,367,10,"604,67",4,2,1,7,Mid-Value,Potential Loyalists
27597,13,7,"662,75",5,2,1,8,High-Value,Potential Loyalists
27598,44,1,"39,2",5,1,1,7,Mid-Value,Potential Loyalists
27599,410,1,"36,25",4,1,1,6,Mid-Value,Potential Loyalists
27601,538,3,"267,75",4,1,1,6,Mid-Value,Potential Loyalists
27602,563,1,"219,1",4,1,1,6,Mid-Value,Potential Loyalists
27606,619,1,"73,65",4,1,1,6,Mid-Value,Potential Loyalists
27607,227,4,"137,15",5,1,1,7,Mid-Value,Potential Loyalists
27608,7,7,"399,5",5,2,1,8,High-Value,Potential Loyalists
27611,140,4,"205,4",5,1,1,7,Mid-Value,Potential Loyalists
27612,142,3,"175,10000000000002",5,1,1,7,Mid-Value,Potential Loyalists
27613,972,1,"100,8",3,1,1,5,Low-Value,At Risk Customers
27614,31,3,"129,55",5,1,1,7,Mid-Value,Potential Loyalists
27615,974,2,"248,05",3,1,1,5,Low-Value,At Risk Customers
27616,1429,2,"189,25",2,1,1,4,Low-Value,Can't Lose
27617,881,1,"250,7",3,1,1,5,Low-Value,At Risk Customers
27618,173,5,"197,05",5,1,1,7,Mid-Value,Potential Loyalists
27620,1142,6,"208,25",2,1,1,4,Low-Value,Can't Lose
27622,809,1,"82,25",3,1,1,5,Low-Value,At Risk Customers
27623,323,1,"19,65",5,1,1,7,Mid-Value,Potential Loyalists
27624,32,14,"711,2",5,3,2,10,High-Value,Champions
27627,230,3,"922,05",5,1,2,8,High-Value,Potential Loyalists
27630,1355,1,"9,85",2,1,1,4,Low-Value,Can't Lose
27631,46,11,"648,8499999999999",5,2,1,8,High-Value,Potential Loyalists
27633,180,3,"513,1",5,1,1,7,Mid-Value,Potential Loyalists
27637,743,1,"109,5",3,1,1,5,Low-Value,At Risk Customers
27638,166,6,"338,45",5,1,1,7,Mid-Value,Potential Loyalists
27639,101,3,"549,9",5,1,1,7,Mid-Value,Potential Loyalists
27642,491,3,"107,6",4,1,1,6,Mid-Value,Potential Loyalists
27643,1087,1,"79,0",3,1,1,5,Low-Value,At Risk Customers
27644,328,1,"99,9",5,1,1,7,Mid-Value,Potential Loyalists
27645,550,3,"232,6",4,1,1,6,Mid-Value,Potential Loyalists
27646,798,2,"30,200000000000003",3,1,1,5,Low-Value,At Risk Customers
27647,47,2,"258,0",5,1,1,7,Mid-Value,Potential Loyalists
27648,193,6,"201,95",5,1,1,7,Mid-Value,Potential Loyalists
27649,1125,3,"44,43",2,1,1,4,Low-Value,Can't Lose
27650,1266,1,"19,6",2,1,1,4,Low-Value,Can't Lose
27652,391,4,"209,5",4,1,1,6,Mid-Value,Potential Loyalists
27654,390,1,"23,9",4,1,1,6,Mid-Value,Potential Loyalists
27655,41,3,"289,84999999999997",5,1,1,7,Mid-Value,Potential Loyalists
27656,266,1,"8,4",5,1,1,7,Mid-Value,Potential Loyalists
27659,140,3,"208,5",5,1,1,7,Mid-Value,Potential Loyalists
27660,934,3,"1372,25",3,1,3,7,Mid-Value,Potential Loyalists
27662,868,1,"20,9",3,1,1,5,Low-Value,At Risk Customers
27663,879,1,"718,8",3,1,2,6,Mid-Value,Potential Loyalists
27664,1646,1,"87,4",1,1,1,3,Low-Value,Lost
27665,71,4,"123,15",5,1,1,7,Mid-Value,Potential Loyalists
27666,202,7,"257,45",5,2,1,8,High-Value,Potential Loyalists
27667,521,4,"122,1",4,1,1,6,Mid-Value,Potential Loyalists
27670,1540,2,"133,5",1,1,1,3,Low-Value,Lost
27671,11,10,"1039,67",5,2,2,9,High-Value,Champions
27673,28,4,"540,7",5,1,1,7,Mid-Value,Potential Loyalists
27674,22,3,"139,60000000000002",5,1,1,7,Mid-Value,Potential Loyalists
27675,241,3,"283,9",5,1,1,7,Mid-Value,Potential Loyalists
27676,771,1,"148,45",3,1,1,5,Low-Value,At Risk Customers
27677,1121,1,"38,6",2,1,1,4,Low-Value,Can't Lose
27680,1524,1,"16,15",1,1,1,3,Low-Value,Lost
27681,1133,1,"44,95",2,1,1,4,Low-Value,Can't Lose
27682,418,3,"131,85",4,1,1,6,Mid-Value,Potential Loyalists
27685,238,3,"251,74999999999997",5,1,1,7,Mid-Value,Potential Loyalists
27686,886,5,"139,4",3,1,1,5,Low-Value,At Risk Customers
27688,428,2,"130,8",4,1,1,6,Mid-Value,Potential Loyalists
27690,48,3,"144,7",5,1,1,7,Mid-Value,Potential Loyalists
27694,895,2,"88,1",3,1,1,5,Low-Value,At Risk Customers
27695,1634,1,"19,1",1,1,1,3,Low-Value,Lost
27698,1039,4,"754,8",3,1,2,6,Mid-Value,Potential Loyalists
27699,1033,1,"21,5",3,1,1,5,Low-Value,At Risk Customers
27700,30,9,"344,9",5,2,1,8,High-Value,Potential Loyalists
27703,113,2,"86,79999999999998",5,1,1,7,Mid-Value,Potential Loyalists
27706,477,3,"348,5",4,1,1,6,Mid-Value,Potential Loyalists
27707,396,3,"135,8",4,1,1,6,Mid-Value,Potential Loyalists
27709,13,7,"485,70000000000005",5,2,1,8,High-Value,Potential Loyalists
27710,732,1,"57,95",3,1,1,5,Low-Value,At Risk Customers
27711,865,1,"30,8",3,1,1,5,Low-Value,At Risk Customers
27713,1726,1,"4,6",1,1,1,3,Low-Value,Lost
27715,1510,1,"37,95",1,1,1,3,Low-Value,Lost
27716,80,3,"88,75",5,1,1,7,Mid-Value,Potential Loyalists
27717,10,13,"1243,95",5,3,2,10,High-Value,Champions
27718,1221,1,"42,9",2,1,1,4,Low-Value,Can't Lose
27719,14,8,"611,4",5,2,1,8,High-Value,Potential Loyalists
27720,8,8,"526,6",5,2,1,8,High-Value,Potential Loyalists
27721,987,2,"85,65",3,1,1,5,Low-Value,At Risk Customers
27723,46,7,"327,45",5,2,1,8,High-Value,Potential Loyalists
27725,12,3,"294,65",5,1,1,7,Mid-Value,Potential Loyalists
27726,135,4,"210,65",5,1,1,7,Mid-Value,Potential Loyalists
27730,24,4,"972,5500000000001",5,1,2,8,High-Value,Potential Loyalists
27733,1,7,"204,15",5,2,1,8,High-Value,Potential Loyalists
27734,1216,2,"99,6",2,1,1,4,Low-Value,Can't Lose
27735,181,1,"84,3",5,1,1,7,Mid-Value,Potential Loyalists
27736,311,6,"168,45",5,1,1,7,Mid-Value,Potential Loyalists
27737,675,2,"35,8",4,1,1,6,Mid-Value,Potential Loyalists
27738,189,2,"57,0",5,1,1,7,Mid-Value,Potential Loyalists
27739,92,1,"22,45",5,1,1,7,Mid-Value,Potential Loyalists
27740,1154,1,"91,2",2,1,1,4,Low-Value,Can't Lose
27741,76,4,"143,35",5,1,1,7,Mid-Value,Potential Loyalists
27742,374,5,"474,65",4,1,1,6,Mid-Value,Potential Loyalists
27745,32,3,"121,75",5,1,1,7,Mid-Value,Potential Loyalists
27746,456,3,"77,85",4,1,1,6,Mid-Value,Potential Loyalists
27748,220,4,"141,60000000000002",5,1,1,7,Mid-Value,Potential Loyalists
27750,235,5,"180,29999999999998",5,1,1,7,Mid-Value,Potential Loyalists
27751,22,3,"112,8",5,1,1,7,Mid-Value,Potential Loyalists
27752,756,4,"112,0",3,1,1,5,Low-Value,At Risk Customers
27753,185,4,"522,0",5,1,1,7,Mid-Value,Potential Loyalists
27755,1149,9,"470,40000000000003",2,2,1,5,Low-Value,At Risk Customers
27756,4,5,"613,45",5,1,1,7,Mid-Value,Potential Loyalists
27757,770,3,"52,0",3,1,1,5,Low-Value,At Risk Customers
27758,87,1,"87,15",5,1,1,7,Mid-Value,Potential Loyalists
27759,104,2,"18,0",5,1,1,7,Mid-Value,Potential Loyalists
27760,537,1,"53,6",4,1,1,6,Mid-Value,Potential Loyalists
27761,236,3,"309,55",5,1,1,7,Mid-Value,Potential Loyalists
27763,94,1,"125,65",5,1,1,7,Mid-Value,Potential Loyalists
27764,1051,1,"68,2",3,1,1,5,Low-Value,At Risk Customers
27767,1686,1,"12,95",1,1,1,3,Low-Value,Lost
27768,306,4,"179,45",5,1,1,7,Mid-Value,Potential Loyalists
27769,85,4,"469,8",5,1,1,7,Mid-Value,Potential Loyalists
27770,90,2,"112,55",5,1,1,7,Mid-Value,Potential Loyalists
27774,381,3,"97,5",4,1,1,6,Mid-Value,Potential Loyalists
27775,540,3,"123,45",4,1,1,6,Mid-Value,Potential Loyalists
27776,651,7,"326,85",4,2,1,7,Mid-Value,Potential Loyalists
27777,295,3,"77,25",5,1,1,7,Mid-Value,Potential Loyalists
27779,931,6,"205,85",3,1,1,5,Low-Value,At Risk Customers
27780,867,1,"106,1",3,1,1,5,Low-Value,At Risk Customers
27783,137,1,"39,4",5,1,1,7,Mid-Value,Potential Loyalists
27784,175,5,"324,0",5,1,1,7,Mid-Value,Potential Loyalists
27785,1134,1,"45,5",2,1,1,4,Low-Value,Can't Lose
27787,1346,1,"172,1",2,1,1,4,Low-Value,Can't Lose
27788,448,1,"35,2",4,1,1,6,Mid-Value,Potential Loyalists
27790,790,2,"69,1",3,1,1,5,Low-Value,At Risk Customers
27791,915,1,"84,75",3,1,1,5,Low-Value,At Risk Customers
27792,1149,2,"187,05",2,1,1,4,Low-Value,Can't Lose
27793,276,9,"911,9",5,2,2,9,High-Value,Champions
27794,58,5,"198,45",5,1,1,7,Mid-Value,Potential Loyalists
27796,378,4,"158,8",4,1,1,6,Mid-Value,Potential Loyalists
27797,159,2,"121,3",5,1,1,7,Mid-Value,Potential Loyalists
27799,435,1,"9,65",4,1,1,6,Mid-Value,Potential Loyalists
27801,532,2,"99,6",4,1,1,6,Mid-Value,Potential Loyalists
27802,161,7,"152,5",5,2,1,8,High-Value,Potential Loyalists
27804,1614,1,"48,5",1,1,1,3,Low-Value,Lost
27808,381,1,"105,0",4,1,1,6,Mid-Value,Potential Loyalists
27809,1465,1,"99,6",1,1,1,3,Low-Value,Lost
27811,375,5,"307,75",4,1,1,6,Mid-Value,Potential Loyalists
27812,168,3,"88,25",5,1,1,7,Mid-Value,Potential Loyalists
27814,216,7,"757,8499999999999",5,2,2,9,High-Value,Champions
27815,797,4,"649,15",3,1,1,5,Low-Value,At Risk Customers
27816,96,2,"77,19999999999999",5,1,1,7,Mid-Value,Potential Loyalists
27817,1128,5,"180,1",2,1,1,4,Low-Value,Can't Lose
27818,614,3,"110,05000000000001",4,1,1,6,Mid-Value,Potential Loyalists
27820,493,2,"263,55",4,1,1,6,Mid-Value,Potential Loyalists
27823,375,4,"521,8",4,1,1,6,Mid-Value,Potential Loyalists
27824,43,7,"881,4000000000001",5,2,2,9,High-Value,Champions
27826,1555,3,"258,05",1,1,1,3,Low-Value,Lost
27828,502,5,"529,65",4,1,1,6,Mid-Value,Potential Loyalists
27829,630,1,"76,35",4,1,1,6,Mid-Value,Potential Loyalists
27830,161,5,"216,49999999999997",5,1,1,7,Mid-Value,Potential Loyalists
27831,272,2,"57,8",5,1,1,7,Mid-Value,Potential Loyalists
27832,183,8,"698,85",5,2,2,9,High-Value,Champions
27833,536,4,"200,15",4,1,1,6,Mid-Value,Potential Loyalists
27834,426,4,"301,05",4,1,1,6,Mid-Value,Potential Loyalists
27836,1111,3,"151,5",2,1,1,4,Low-Value,Can't Lose
27840,844,1,"39,2",3,1,1,5,Low-Value,At Risk Customers
27841,827,5,"371,4",3,1,1,5,Low-Value,At Risk Customers
27843,22,6,"164,6",5,1,1,7,Mid-Value,Potential Loyalists
27846,1000,1,"40,65",3,1,1,5,Low-Value,At Risk Customers
27847,586,1,"12,0",4,1,1,6,Mid-Value,Potential Loyalists
27848,285,4,"291,05",5,1,1,7,Mid-Value,Potential Loyalists
27849,1021,1,"23,3",3,1,1,5,Low-Value,At Risk Customers
27850,352,3,"332,45",5,1,1,7,Mid-Value,Potential Loyalists
27852,584,2,"64,05",4,1,1,6,Mid-Value,Potential Loyalists
27853,26,4,"319,5",5,1,1,7,Mid-Value,Potential Loyalists
27857,5,3,"280,35",5,1,1,7,Mid-Value,Potential Loyalists
27858,130,9,"924,8",5,2,2,9,High-Value,Champions
27860,31,4,"111,4",5,1,1,7,Mid-Value,Potential Loyalists
27862,210,1,"11,4",5,1,1,7,Mid-Value,Potential Loyalists
27863,716,1,"4,2",4,1,1,6,Mid-Value,Potential Loyalists
27864,77,2,"24,2",5,1,1,7,Mid-Value,Potential Loyalists
27865,775,2,"226,55",3,1,1,5,Low-Value,At Risk Customers
27866,293,3,"36,45",5,1,1,7,Mid-Value,Potential Loyalists
27868,400,4,"45,35",4,1,1,6,Mid-Value,Potential Loyalists
27869,1118,6,"130,2",2,1,1,4,Low-Value,Can't Lose
27870,18,2,"125,14999999999999",5,1,1,7,Mid-Value,Potential Loyalists
27872,550,3,"634,6",4,1,1,6,Mid-Value,Potential Loyalists
27873,106,4,"94,44999999999999",5,1,1,7,Mid-Value,Potential Loyalists
27875,1604,1,"136,9",1,1,1,3,Low-Value,Lost
27876,48,2,"78,15",5,1,1,7,Mid-Value,Potential Loyalists
27877,108,4,"86,64999999999999",5,1,1,7,Mid-Value,Potential Loyalists
27878,759,3,"111,39999999999999",3,1,1,5,Low-Value,At Risk Customers
27879,536,6,"426,1",4,1,1,6,Mid-Value,Potential Loyalists
27880,881,2,"163,89999999999998",3,1,1,5,Low-Value,At Risk Customers
27881,260,6,"272,95",5,1,1,7,Mid-Value,Potential Loyalists
27882,890,6,"282,6",3,1,1,5,Low-Value,At Risk Customers
27884,11,8,"538,9",5,2,1,8,High-Value,Potential Loyalists
27887,939,1,"30,69",3,1,1,5,Low-Value,At Risk Customers
27890,1237,1,"115,05000000000001",2,1,1,4,Low-Value,Can't Lose
27891,12,3,"207,20000000000002",5,1,1,7,Mid-Value,Potential Loyalists
27892,51,7,"857,65",5,2,2,9,High-Value,Champions
27894,132,1,"47,7",5,1,1,7,Mid-Value,Potential Loyalists
27900,239,4,"107,05000000000001",5,1,1,7,Mid-Value,Potential Loyalists
27901,293,4,"142,35",5,1,1,7,Mid-Value,Potential Loyalists
27904,1420,1,"14,55",2,1,1,4,Low-Value,Can't Lose
27906,448,4,"169,5",4,1,1,6,Mid-Value,Potential Loyalists
27907,155,6,"459,6",5,1,1,7,Mid-Value,Potential Loyalists
27909,1358,2,"20,2",2,1,1,4,Low-Value,Can't Lose
27910,40,1,"45,9",5,1,1,7,Mid-Value,Potential Loyalists
27911,1714,1,"50,4",1,1,1,3,Low-Value,Lost
27913,1181,1,"15,35",2,1,1,4,Low-Value,Can't Lose
27916,741,1,"100,2",3,1,1,5,Low-Value,At Risk Customers
27917,1270,2,"82,44999999999999",2,1,1,4,Low-Value,Can't Lose
27920,8,7,"528,0",5,2,1,8,High-Value,Potential Loyalists
27921,172,2,"61,3",5,1,1,7,Mid-Value,Potential Loyalists
27922,32,3,"57,5",5,1,1,7,Mid-Value,Potential Loyalists
27923,1291,2,"81,85",2,1,1,4,Low-Value,Can't Lose
27924,475,7,"427,5",4,2,1,7,Mid-Value,Potential Loyalists
27926,738,8,"725,45",3,2,2,7,Mid-Value,Potential Loyalists
27928,746,1,"87,8",3,1,1,5,Low-Value,At Risk Customers
27929,221,5,"196,20000000000002",5,1,1,7,Mid-Value,Potential Loyalists
27931,525,1,"98,9",4,1,1,6,Mid-Value,Potential Loyalists
27932,536,2,"70,25",4,1,1,6,Mid-Value,Potential Loyalists
27933,797,2,"63,75",3,1,1,5,Low-Value,At Risk Customers
27934,657,2,"87,05000000000001",4,1,1,6,Mid-Value,Potential Loyalists
27936,21,10,"340,05",5,2,1,8,High-Value,Potential Loyalists
27938,113,2,"121,0",5,1,1,7,Mid-Value,Potential Loyalists
27939,590,1,"20,8",4,1,1,6,Mid-Value,Potential Loyalists
27940,1632,1,"2,7",1,1,1,3,Low-Value,Lost
27945,228,1,"7,5",5,1,1,7,Mid-Value,Potential Loyalists
27947,76,5,"295,15000000000003",5,1,1,7,Mid-Value,Potential Loyalists
27948,140,2,"141,6",5,1,1,7,Mid-Value,Potential Loyalists
27949,957,1,"20,6",3,1,1,5,Low-Value,At Risk Customers
27950,344,1,"90,45",5,1,1,7,Mid-Value,Potential Loyalists
27951,85,4,"194,45000000000002",5,1,1,7,Mid-Value,Potential Loyalists
27952,31,4,"521,05",5,1,1,7,Mid-Value,Potential Loyalists
27953,439,4,"152,14999999999998",4,1,1,6,Mid-Value,Potential Loyalists
27954,138,6,"472,29999999999995",5,1,1,7,Mid-Value,Potential Loyalists
27955,231,3,"164,60000000000002",5,1,1,7,Mid-Value,Potential Loyalists
27957,1794,1,"221,1",1,1,1,3,Low-Value,Lost
27958,732,2,"296,5",3,1,1,5,Low-Value,At Risk Customers
27959,550,1,"130,64999999999998",4,1,1,6,Mid-Value,Potential Loyalists
27961,1456,1,"10,85",2,1,1,4,Low-Value,Can't Lose
27965,187,1,"368,4",5,1,1,7,Mid-Value,Potential Loyalists
27967,601,1,"117,2",4,1,1,6,Mid-Value,Potential Loyalists
27968,617,2,"34,5",4,1,1,6,Mid-Value,Potential Loyalists
27970,214,8,"249,9",5,2,1,8,High-Value,Potential Loyalists
27975,911,1,"58,349999999999994",3,1,1,5,Low-Value,At Risk Customers
27976,438,7,"197,5",4,2,1,7,Mid-Value,Potential Loyalists
27979,384,1,"42,0",4,1,1,6,Mid-Value,Potential Loyalists
27980,86,3,"63,8",5,1,1,7,Mid-Value,Potential Loyalists
27981,1194,4,"242,6",2,1,1,4,Low-Value,Can't Lose
27982,1823,1,"45,1",1,1,1,3,Low-Value,Lost
27983,592,3,"309,54999999999995",4,1,1,6,Mid-Value,Potential Loyalists
27984,163,1,"33,6",5,1,1,7,Mid-Value,Potential Loyalists
27985,82,7,"399,2",5,2,1,8,High-Value,Potential Loyalists
27987,1124,1,"25,2",2,1,1,4,Low-Value,Can't Lose
27989,92,6,"371,15",5,1,1,7,Mid-Value,Potential Loyalists
27990,125,3,"229,65",5,1,1,7,Mid-Value,Potential Loyalists
27991,94,7,"589,2",5,2,1,8,High-Value,Potential Loyalists
27994,292,6,"475,15",5,1,1,7,Mid-Value,Potential Loyalists
27995,192,1,"112,1",5,1,1,7,Mid-Value,Potential Loyalists
27997,234,4,"203,04999999999998",5,1,1,7,Mid-Value,Potential Loyalists
27999,67,3,"231,4",5,1,1,7,Mid-Value,Potential Loyalists
28001,1193,2,"37,5",2,1,1,4,Low-Value,Can't Lose
28002,23,9,"928,4",5,2,2,9,High-Value,Champions
28004,374,7,"666,7",4,2,2,8,High-Value,Potential Loyalists
28005,150,5,"262,79999999999995",5,1,1,7,Mid-Value,Potential Loyalists
28007,1234,1,"20,5",2,1,1,4,Low-Value,Can't Lose
28008,262,4,"105,8",5,1,1,7,Mid-Value,Potential Loyalists
28010,287,4,"188,7",5,1,1,7,Mid-Value,Potential Loyalists
28011,309,4,"191,25",5,1,1,7,Mid-Value,Potential Loyalists
28012,5,7,"580,15",5,2,1,8,High-Value,Potential Loyalists
28014,222,3,"168,6",5,1,1,7,Mid-Value,Potential Loyalists
28016,186,3,"103,7",5,1,1,7,Mid-Value,Potential Loyalists
28017,1448,1,"17,2",2,1,1,4,Low-Value,Can't Lose
28018,1147,2,"17,15",2,1,1,4,Low-Value,Can't Lose
28019,851,1,"19,75",3,1,1,5,Low-Value,At Risk Customers
28022,531,5,"654,35",4,1,1,6,Mid-Value,Potential Loyalists
28023,365,4,"288,8",5,1,1,7,Mid-Value,Potential Loyalists
28024,87,1,"55,1",5,1,1,7,Mid-Value,Potential Loyalists
28027,48,3,"100,05000000000001",5,1,1,7,Mid-Value,Potential Loyalists
28028,1082,1,"15,15",3,1,1,5,Low-Value,At Risk Customers
28030,209,2,"78,2",5,1,1,7,Mid-Value,Potential Loyalists
28032,218,4,"221,65",5,1,1,7,Mid-Value,Potential Loyalists
28034,818,2,"295,7",3,1,1,5,Low-Value,At Risk Customers
28035,833,2,"117,5",3,1,1,5,Low-Value,At Risk Customers
28037,1241,3,"87,9",2,1,1,4,Low-Value,Can't Lose
28038,33,22,"1269,75",5,5,2,12,High-Value,Champions
28039,1355,1,"54,6",2,1,1,4,Low-Value,Can't Lose
28040,157,8,"334,05",5,2,1,8,High-Value,Potential Loyalists
28042,404,1,"2,2",4,1,1,6,Mid-Value,Potential Loyalists
28043,161,8,"407,6",5,2,1,8,High-Value,Potential Loyalists
28044,46,2,"123,7",5,1,1,7,Mid-Value,Potential Loyalists
28046,101,1,"37,85",5,1,1,7,Mid-Value,Potential Loyalists
28047,244,1,"113,6",5,1,1,7,Mid-Value,Potential Loyalists
28048,728,1,"111,0",4,1,1,6,Mid-Value,Potential Loyalists
28049,69,4,"157,9",5,1,1,7,Mid-Value,Potential Loyalists
28050,395,6,"121,25",4,1,1,6,Mid-Value,Potential Loyalists
28053,203,4,"226,0",5,1,1,7,Mid-Value,Potential Loyalists
28054,207,2,"428,35",5,1,1,7,Mid-Value,Potential Loyalists
28055,1286,1,"38,8",2,1,1,4,Low-Value,Can't Lose
28058,162,10,"544,25",5,2,1,8,High-Value,Potential Loyalists
28059,124,1,"17,5",5,1,1,7,Mid-Value,Potential Loyalists
28060,895,2,"150,10000000000002",3,1,1,5,Low-Value,At Risk Customers
28061,271,1,"37,4",5,1,1,7,Mid-Value,Potential Loyalists
28062,654,1,"27,9",4,1,1,6,Mid-Value,Potential Loyalists
28063,489,2,"215,05",4,1,1,6,Mid-Value,Potential Loyalists
28064,409,6,"243,7",4,1,1,6,Mid-Value,Potential Loyalists
28065,561,3,"58,2",4,1,1,6,Mid-Value,Potential Loyalists
28066,787,4,"150,5",3,1,1,5,Low-Value,At Risk Customers
28070,605,1,"10,0",4,1,1,6,Mid-Value,Potential Loyalists
28073,4,9,"394,6",5,2,1,8,High-Value,Potential Loyalists
28074,116,2,"170,95",5,1,1,7,Mid-Value,Potential Loyalists
28075,765,5,"260,45",3,1,1,5,Low-Value,At Risk Customers
28076,334,1,"62,35",5,1,1,7,Mid-Value,Potential Loyalists
28077,12,9,"522,3",5,2,1,8,High-Value,Potential Loyalists
28078,373,4,"208,7",4,1,1,6,Mid-Value,Potential Loyalists
28081,96,1,"23,65",5,1,1,7,Mid-Value,Potential Loyalists
28083,1071,1,"35,75",3,1,1,5,Low-Value,At Risk Customers
28085,973,8,"557,8",3,2,1,6,Mid-Value,Potential Loyalists
28087,39,11,"786,6",5,2,2,9,High-Value,Champions
28090,76,2,"25,549999999999997",5,1,1,7,Mid-Value,Potential Loyalists
28091,34,5,"387,75",5,1,1,7,Mid-Value,Potential Loyalists
28092,205,3,"126,7",5,1,1,7,Mid-Value,Potential Loyalists
28095,551,2,"141,89999999999998",4,1,1,6,Mid-Value,Potential Loyalists
28097,772,8,"332,7",3,2,1,6,Mid-Value,Potential Loyalists
28098,16,2,"263,85",5,1,1,7,Mid-Value,Potential Loyalists
28100,689,4,"239,55",4,1,1,6,Mid-Value,Potential Loyalists
28104,1,5,"152,0",5,1,1,7,Mid-Value,Potential Loyalists
28105,287,2,"43,4",5,1,1,7,Mid-Value,Potential Loyalists
28106,683,1,"14,2",4,1,1,6,Mid-Value,Potential Loyalists
28107,1333,2,"59,85",2,1,1,4,Low-Value,Can't Lose
28108,561,1,"19,5",4,1,1,6,Mid-Value,Potential Loyalists
28109,336,3,"328,05",5,1,1,7,Mid-Value,Potential Loyalists
28110,545,5,"581,35",4,1,1,6,Mid-Value,Potential Loyalists
28111,81,4,"250,5",5,1,1,7,Mid-Value,Potential Loyalists
28112,1174,1,"35,95",2,1,1,4,Low-Value,Can't Lose
28113,1728,1,"16,0",1,1,1,3,Low-Value,Lost
28114,917,1,"234,4",3,1,1,5,Low-Value,At Risk Customers
28115,387,2,"18,799999999999997",4,1,1,6,Mid-Value,Potential Loyalists
28116,124,3,"150,25",5,1,1,7,Mid-Value,Potential Loyalists
28117,488,1,"24,6",4,1,1,6,Mid-Value,Potential Loyalists
28121,1295,1,"34,5",2,1,1,4,Low-Value,Can't Lose
28122,1538,2,"55,400000000000006",1,1,1,3,Low-Value,Lost
28123,143,2,"74,0",5,1,1,7,Mid-Value,Potential Loyalists
28124,122,2,"83,0",5,1,1,7,Mid-Value,Potential Loyalists
28125,15,3,"239,35",5,1,1,7,Mid-Value,Potential Loyalists
28126,8,6,"253,95",5,1,1,7,Mid-Value,Potential Loyalists
28127,755,8,"427,7",3,2,1,6,Mid-Value,Potential Loyalists
28128,1034,3,"115,3",3,1,1,5,Low-Value,At Risk Customers
28129,524,1,"44,1",4,1,1,6,Mid-Value,Potential Loyalists
28131,181,1,"73,85",5,1,1,7,Mid-Value,Potential Loyalists
28133,853,2,"156,8",3,1,1,5,Low-Value,At Risk Customers
28137,1668,2,"282,09999999999997",1,1,1,3,Low-Value,Lost
28143,5,2,"39,1",5,1,1,7,Mid-Value,Potential Loyalists
28144,18,3,"89,35000000000001",5,1,1,7,Mid-Value,Potential Loyalists
28147,676,4,"275,0",4,1,1,6,Mid-Value,Potential Loyalists
28148,295,15,"721,0",5,3,2,10,High-Value,Champions
28151,128,5,"594,4",5,1,1,7,Mid-Value,Potential Loyalists
28152,512,5,"283,05",4,1,1,6,Mid-Value,Potential Loyalists
28153,90,1,"54,5",5,1,1,7,Mid-Value,Potential Loyalists
28154,64,3,"316,2",5,1,1,7,Mid-Value,Potential Loyalists
28156,1115,5,"99,05",2,1,1,4,Low-Value,Can't Lose
28158,1484,1,"74,5",1,1,1,3,Low-Value,Lost
28160,516,1,"39,5",4,1,1,6,Mid-Value,Potential Loyalists
28162,3,8,"313,0",5,2,1,8,High-Value,Potential Loyalists
28166,160,8,"247,5",5,2,1,8,High-Value,Potential Loyalists
28167,1026,1,"33,0",3,1,1,5,Low-Value,At Risk Customers
28168,319,1,"62,15",5,1,1,7,Mid-Value,Potential Loyalists
28169,37,2,"148,7",5,1,1,7,Mid-Value,Potential Loyalists
28170,215,3,"68,35",5,1,1,7,Mid-Value,Potential Loyalists
28171,30,4,"301,8",5,1,1,7,Mid-Value,Potential Loyalists
28173,300,3,"131,5",5,1,1,7,Mid-Value,Potential Loyalists
28174,19,3,"178,5",5,1,1,7,Mid-Value,Potential Loyalists
28175,16,2,"653,05",5,1,1,7,Mid-Value,Potential Loyalists
28178,108,2,"114,55000000000001",5,1,1,7,Mid-Value,Potential Loyalists
28179,666,2,"294,7",4,1,1,6,Mid-Value,Potential Loyalists
28181,1,3,"117,45",5,1,1,7,Mid-Value,Potential Loyalists
28182,391,6,"340,0",4,1,1,6,Mid-Value,Potential Loyalists
28183,437,8,"246,4",4,2,1,7,Mid-Value,Potential Loyalists
28184,161,6,"505,5",5,1,1,7,Mid-Value,Potential Loyalists
28185,1749,1,"251,3",1,1,1,3,Low-Value,Lost
28186,82,4,"349,7",5,1,1,7,Mid-Value,Potential Loyalists
28187,697,1,"35,55",4,1,1,6,Mid-Value,Potential Loyalists
28188,1215,1,"13,5",2,1,1,4,Low-Value,Can't Lose
28189,1557,2,"206,0",1,1,1,3,Low-Value,Lost
28190,1168,1,"5,45",2,1,1,4,Low-Value,Can't Lose
28193,973,3,"182,60000000000002",3,1,1,5,Low-Value,At Risk Customers
28197,1556,3,"292,05",1,1,1,3,Low-Value,Lost
28199,603,1,"1,8",4,1,1,6,Mid-Value,Potential Loyalists
28200,1197,1,"50,4",2,1,1,4,Low-Value,Can't Lose
28201,748,2,"50,3",3,1,1,5,Low-Value,At Risk Customers
28203,702,2,"36,53",4,1,1,6,Mid-Value,Potential Loyalists
28204,522,5,"135,04999999999998",4,1,1,6,Mid-Value,Potential Loyalists
28205,1252,2,"244,8",2,1,1,4,Low-Value,Can't Lose
28206,52,4,"121,0",5,1,1,7,Mid-Value,Potential Loyalists
28207,122,2,"101,4",5,1,1,7,Mid-Value,Potential Loyalists
28208,869,1,"41,4",3,1,1,5,Low-Value,At Risk Customers
28210,1625,2,"377,35",1,1,1,3,Low-Value,Lost
28211,984,2,"44,0",3,1,1,5,Low-Value,At Risk Customers
28212,1079,2,"266,4",3,1,1,5,Low-Value,At Risk Customers
28213,172,6,"334,25",5,1,1,7,Mid-Value,Potential Loyalists
28216,1475,2,"184,0",1,1,1,3,Low-Value,Lost
28218,913,6,"259,0",3,1,1,5,Low-Value,At Risk Customers
28220,55,1,"15,0",5,1,1,7,Mid-Value,Potential Loyalists
28222,27,6,"259,55",5,1,1,7,Mid-Value,Potential Loyalists
28223,0,6,"470,4",5,1,1,7,Mid-Value,Potential Loyalists
28225,181,1,"128,39999999999998",5,1,1,7,Mid-Value,Potential Loyalists
28229,811,1,"6,55",3,1,1,5,Low-Value,At Risk Customers
28231,64,17,"1247,2",5,4,2,11,High-Value,Champions
28233,218,2,"59,400000000000006",5,1,1,7,Mid-Value,Potential Loyalists
28234,148,1,"125,8",5,1,1,7,Mid-Value,Potential Loyalists
28235,2,8,"941,65",5,2,2,9,High-Value,Champions
28236,412,2,"39,550000000000004",4,1,1,6,Mid-Value,Potential Loyalists
28238,114,3,"76,0",5,1,1,7,Mid-Value,Potential Loyalists
28239,259,1,"40,95",5,1,1,7,Mid-Value,Potential Loyalists
28240,917,1,"71,1",3,1,1,5,Low-Value,At Risk Customers
28241,0,3,"283,0",5,1,1,7,Mid-Value,Potential Loyalists
28243,1183,4,"464,2",2,1,1,4,Low-Value,Can't Lose
28245,403,6,"172,8",4,1,1,6,Mid-Value,Potential Loyalists
28246,203,3,"130,85000000000002",5,1,1,7,Mid-Value,Potential Loyalists
28247,460,4,"149,5",4,1,1,6,Mid-Value,Potential Loyalists
28248,236,2,"184,15",5,1,1,7,Mid-Value,Potential Loyalists
28250,1132,2,"16,05",2,1,1,4,Low-Value,Can't Lose
28252,877,10,"505,95",3,2,1,6,Mid-Value,Potential Loyalists
28253,1139,4,"87,15",2,1,1,4,Low-Value,Can't Lose
28254,1180,2,"58,050000000000004",2,1,1,4,Low-Value,Can't Lose
28257,129,5,"211,95",5,1,1,7,Mid-Value,Potential Loyalists
28258,77,3,"15,399999999999999",5,1,1,7,Mid-Value,Potential Loyalists
28259,914,2,"74,6",3,1,1,5,Low-Value,At Risk Customers
28261,2,5,"246,04999999999998",5,1,1,7,Mid-Value,Potential Loyalists
28262,551,2,"80,30000000000001",4,1,1,6,Mid-Value,Potential Loyalists
28263,1272,2,"293,3",2,1,1,4,Low-Value,Can't Lose
28265,58,3,"67,25",5,1,1,7,Mid-Value,Potential Loyalists
28266,29,5,"347,05",5,1,1,7,Mid-Value,Potential Loyalists
28267,110,5,"735,5500000000001",5,1,2,8,High-Value,Potential Loyalists
28269,412,6,"323,5",4,1,1,6,Mid-Value,Potential Loyalists
28272,544,5,"286,55",4,1,1,6,Mid-Value,Potential Loyalists
28274,1512,3,"102,05",1,1,1,3,Low-Value,Lost
28275,109,11,"441,59999999999997",5,2,1,8,High-Value,Potential Loyalists
28277,772,1,"23,7",3,1,1,5,Low-Value,At Risk Customers
28278,77,4,"97,85",5,1,1,7,Mid-Value,Potential Loyalists
28279,257,2,"514,75",5,1,1,7,Mid-Value,Potential Loyalists
28281,56,3,"51,35",5,1,1,7,Mid-Value,Potential Loyalists
28283,1422,1,"30,0",2,1,1,4,Low-Value,Can't Lose
28284,3,13,"1372,95",5,3,3,11,High-Value,Champions
28285,3,5,"285,1",5,1,1,7,Mid-Value,Potential Loyalists
28286,0,6,"455,45",5,1,1,7,Mid-Value,Potential Loyalists
28287,62,3,"128,3",5,1,1,7,Mid-Value,Potential Loyalists
28288,910,3,"147,5",3,1,1,5,Low-Value,At Risk Customers
28291,1047,1,"0,8",3,1,1,5,Low-Value,At Risk Customers
28292,420,1,"2,55",4,1,1,6,Mid-Value,Potential Loyalists
28294,24,6,"300,25",5,1,1,7,Mid-Value,Potential Loyalists
28295,379,2,"239,70000000000002",4,1,1,6,Mid-Value,Potential Loyalists
28296,644,2,"142,1",4,1,1,6,Mid-Value,Potential Loyalists
28299,117,10,"391,15",5,2,1,8,High-Value,Potential Loyalists
28301,455,5,"271,7",4,1,1,6,Mid-Value,Potential Loyalists
28302,1033,2,"6,0",3,1,1,5,Low-Value,At Risk Customers
28305,33,5,"162,89999999999998",5,1,1,7,Mid-Value,Potential Loyalists
28308,992,2,"349,65",3,1,1,5,Low-Value,At Risk Customers
28313,424,2,"21,7",4,1,1,6,Mid-Value,Potential Loyalists
28316,620,4,"92,1",4,1,1,6,Mid-Value,Potential Loyalists
28318,607,5,"365,40000000000003",4,1,1,6,Mid-Value,Potential Loyalists
28319,1658,1,"34,5",1,1,1,3,Low-Value,Lost
28320,1053,3,"226,65",3,1,1,5,Low-Value,At Risk Customers
28323,23,4,"343,2",5,1,1,7,Mid-Value,Potential Loyalists
28324,564,3,"90,8",4,1,1,6,Mid-Value,Potential Loyalists
28325,1130,5,"143,85",2,1,1,4,Low-Value,Can't Lose
28326,426,10,"613,9",4,2,1,7,Mid-Value,Potential Loyalists
28327,146,3,"86,85",5,1,1,7,Mid-Value,Potential Loyalists
28328,507,3,"151,89999999999998",4,1,1,6,Mid-Value,Potential Loyalists
28329,271,3,"151,35",5,1,1,7,Mid-Value,Potential Loyalists
28331,125,2,"249,2",5,1,1,7,Mid-Value,Potential Loyalists
28332,876,2,"166,2",3,1,1,5,Low-Value,At Risk Customers
28335,1796,1,"63,0",1,1,1,3,Low-Value,Lost
28336,865,2,"114,0",3,1,1,5,Low-Value,At Risk Customers
28337,90,2,"20,9",5,1,1,7,Mid-Value,Potential Loyalists
28338,391,9,"1151,5",4,2,2,8,High-Value,Potential Loyalists
28339,386,3,"557,9",4,1,1,6,Mid-Value,Potential Loyalists
28342,1359,1,"9,75",2,1,1,4,Low-Value,Can't Lose
28343,512,2,"192,75",4,1,1,6,Mid-Value,Potential Loyalists
28344,172,9,"330,45",5,2,1,8,High-Value,Potential Loyalists
28345,139,4,"181,75",5,1,1,7,Mid-Value,Potential Loyalists
28348,936,3,"399,79999999999995",3,1,1,5,Low-Value,At Risk Customers
28349,5,4,"405,25",5,1,1,7,Mid-Value,Potential Loyalists
28351,1718,1,"1,75",1,1,1,3,Low-Value,Lost
28352,256,8,"352,15",5,2,1,8,High-Value,Potential Loyalists
28353,67,7,"406,4",5,2,1,8,High-Value,Potential Loyalists
28354,203,1,"25,650000000000002",5,1,1,7,Mid-Value,Potential Loyalists
28355,98,13,"1654,4",5,3,3,11,High-Value,Champions
28356,88,6,"227,75",5,1,1,7,Mid-Value,Potential Loyalists
28357,353,4,"132,7",5,1,1,7,Mid-Value,Potential Loyalists
28358,897,1,"596,2",3,1,1,5,Low-Value,At Risk Customers
28361,703,2,"83,3",4,1,1,6,Mid-Value,Potential Loyalists
28365,34,6,"324,7",5,1,1,7,Mid-Value,Potential Loyalists
28367,927,2,"169,35",3,1,1,5,Low-Value,At Risk Customers
28368,1176,3,"106,55",2,1,1,4,Low-Value,Can't Lose
28369,542,4,"227,4",4,1,1,6,Mid-Value,Potential Loyalists
28370,418,3,"127,45000000000002",4,1,1,6,Mid-Value,Potential Loyalists
28371,159,4,"197,3",5,1,1,7,Mid-Value,Potential Loyalists
28372,1673,1,"55,9",1,1,1,3,Low-Value,Lost
28373,184,8,"443,0",5,2,1,8,High-Value,Potential Loyalists
28374,22,7,"867,15",5,2,2,9,High-Value,Champions
28377,223,5,"150,35",5,1,1,7,Mid-Value,Potential Loyalists
28379,18,2,"95,6",5,1,1,7,Mid-Value,Potential Loyalists
28380,1004,2,"75,6",3,1,1,5,Low-Value,At Risk Customers
28382,38,3,"248,65",5,1,1,7,Mid-Value,Potential Loyalists
28383,126,2,"39,0",5,1,1,7,Mid-Value,Potential Loyalists
28385,244,3,"252,35",5,1,1,7,Mid-Value,Potential Loyalists
28388,50,5,"225,4",5,1,1,7,Mid-Value,Potential Loyalists
28390,105,10,"313,2",5,2,1,8,High-Value,Potential Loyalists
28392,490,1,"94,19999999999999",4,1,1,6,Mid-Value,Potential Loyalists
28394,118,4,"189,20000000000002",5,1,1,7,Mid-Value,Potential Loyalists
28395,692,1,"3,6",4,1,1,6,Mid-Value,Potential Loyalists
28396,821,1,"49,5",3,1,1,5,Low-Value,At Risk Customers
28399,10,5,"159,75",5,1,1,7,Mid-Value,Potential Loyalists
28401,330,3,"359,1",5,1,1,7,Mid-Value,Potential Loyalists
28402,95,8,"768,9000000000001",5,2,2,9,High-Value,Champions
28403,412,3,"190,95000000000002",4,1,1,6,Mid-Value,Potential Loyalists
28404,333,4,"103,2",5,1,1,7,Mid-Value,Potential Loyalists
28407,11,4,"437,05",5,1,1,7,Mid-Value,Potential Loyalists
28408,372,12,"932,3999999999999",4,3,2,9,High-Value,Champions
28410,39,7,"533,5",5,2,1,8,High-Value,Potential Loyalists
28411,11,8,"583,65",5,2,1,8,High-Value,Potential Loyalists
28412,300,8,"467,95",5,2,1,8,High-Value,Potential Loyalists
28414,161,4,"282,95",5,1,1,7,Mid-Value,Potential Loyalists
28416,619,5,"214,35",4,1,1,6,Mid-Value,Potential Loyalists
28417,297,4,"222,4",5,1,1,7,Mid-Value,Potential Loyalists
28418,420,2,"238,29999999999998",4,1,1,6,Mid-Value,Potential Loyalists
28420,36,3,"139,05",5,1,1,7,Mid-Value,Potential Loyalists
28422,61,9,"627,1",5,2,1,8,High-Value,Potential Loyalists
28423,189,7,"338,04999999999995",5,2,1,8,High-Value,Potential Loyalists
28424,1034,2,"96,6",3,1,1,5,Low-Value,At Risk Customers
28427,241,1,"84,9",5,1,1,7,Mid-Value,Potential Loyalists
28428,91,11,"524,6",5,2,1,8,High-Value,Potential Loyalists
28429,10,4,"170,3",5,1,1,7,Mid-Value,Potential Loyalists
28430,4,9,"471,9",5,2,1,8,High-Value,Potential Loyalists
28431,124,3,"160,35",5,1,1,7,Mid-Value,Potential Loyalists
28432,782,2,"78,1",3,1,1,5,Low-Value,At Risk Customers
28434,215,4,"187,7",5,1,1,7,Mid-Value,Potential Loyalists
28437,127,3,"118,89999999999999",5,1,1,7,Mid-Value,Potential Loyalists
28439,493,1,"85,35",4,1,1,6,Mid-Value,Potential Loyalists
28440,20,1,"32,3",5,1,1,7,Mid-Value,Potential Loyalists
28441,801,2,"72,1",3,1,1,5,Low-Value,At Risk Customers
28442,604,2,"54,0",4,1,1,6,Mid-Value,Potential Loyalists
28444,111,2,"259,70000000000005",5,1,1,7,Mid-Value,Potential Loyalists
28446,1491,1,"90,8",1,1,1,3,Low-Value,Lost
28448,11,7,"903,1",5,2,2,9,High-Value,Champions
28449,634,1,"48,45",4,1,1,6,Mid-Value,Potential Loyalists
28450,1282,4,"381,0",2,1,1,4,Low-Value,Can't Lose
28452,1014,3,"87,05000000000001",3,1,1,5,Low-Value,At Risk Customers
28453,337,2,"492,45",5,1,1,7,Mid-Value,Potential Loyalists
28454,857,2,"170,05",3,1,1,5,Low-Value,At Risk Customers
28455,211,1,"42,8",5,1,1,7,Mid-Value,Potential Loyalists
28457,294,2,"76,5",5,1,1,7,Mid-Value,Potential Loyalists
28458,751,6,"505,34999999999997",3,1,1,5,Low-Value,At Risk Customers
28459,889,4,"138,45",3,1,1,5,Low-Value,At Risk Customers
28460,438,3,"94,24999999999999",4,1,1,6,Mid-Value,Potential Loyalists
28462,1153,1,"79,55",2,1,1,4,Low-Value,Can't Lose
28463,290,1,"96,2",5,1,1,7,Mid-Value,Potential Loyalists
28464,848,3,"289,6",3,1,1,5,Low-Value,At Risk Customers
28465,1565,1,"6,0",1,1,1,3,Low-Value,Lost
28466,877,3,"167,8",3,1,1,5,Low-Value,At Risk Customers
28467,664,1,"77,85",4,1,1,6,Mid-Value,Potential Loyalists
28468,1305,2,"43,50000000000001",2,1,1,4,Low-Value,Can't Lose
28469,557,1,"78,5",4,1,1,6,Mid-Value,Potential Loyalists
28470,34,2,"52,3",5,1,1,7,Mid-Value,Potential Loyalists
28473,872,1,"21,7",3,1,1,5,Low-Value,At Risk Customers
28474,1362,1,"17,5",2,1,1,4,Low-Value,Can't Lose
28475,751,4,"264,3",3,1,1,5,Low-Value,At Risk Customers
28476,799,3,"192,9",3,1,1,5,Low-Value,At Risk Customers
28477,168,7,"576,95",5,2,1,8,High-Value,Potential Loyalists
28479,758,3,"335,65",3,1,1,5,Low-Value,At Risk Customers
28480,46,6,"100,0",5,1,1,7,Mid-Value,Potential Loyalists
28484,511,1,"15,55",4,1,1,6,Mid-Value,Potential Loyalists
28485,1163,2,"230,39999999999998",2,1,1,4,Low-Value,Can't Lose
28486,170,2,"82,9",5,1,1,7,Mid-Value,Potential Loyalists
28487,327,4,"196,7",5,1,1,7,Mid-Value,Potential Loyalists
28488,380,3,"54,25",4,1,1,6,Mid-Value,Potential Loyalists
28489,381,6,"805,3",4,1,2,7,Mid-Value,Potential Loyalists
28490,61,1,"21,5",5,1,1,7,Mid-Value,Potential Loyalists
28491,184,3,"375,20000000000005",5,1,1,7,Mid-Value,Potential Loyalists
28493,505,1,"2,6",4,1,1,6,Mid-Value,Potential Loyalists
28494,24,2,"78,60000000000001",5,1,1,7,Mid-Value,Potential Loyalists
28495,661,3,"616,6",4,1,1,6,Mid-Value,Potential Loyalists
28496,29,2,"58,45",5,1,1,7,Mid-Value,Potential Loyalists
28497,395,5,"344,15",4,1,1,6,Mid-Value,Potential Loyalists
28500,1239,1,"628,3499999999999",2,1,1,4,Low-Value,Can't Lose
28501,95,5,"399,0",5,1,1,7,Mid-Value,Potential Loyalists
28502,146,3,"205,9",5,1,1,7,Mid-Value,Potential Loyalists
28503,729,3,"111,35",4,1,1,6,Mid-Value,Potential Loyalists
28507,705,1,"13,6",4,1,1,6,Mid-Value,Potential Loyalists
28508,595,5,"269,79999999999995",4,1,1,6,Mid-Value,Potential Loyalists
28510,1133,2,"22,2",2,1,1,4,Low-Value,Can't Lose
28511,206,3,"103,9",5,1,1,7,Mid-Value,Potential Loyalists
28512,1,4,"184,95",5,1,1,7,Mid-Value,Potential Loyalists
28514,28,5,"356,20000000000005",5,1,1,7,Mid-Value,Potential Loyalists
28515,239,2,"71,9",5,1,1,7,Mid-Value,Potential Loyalists
28516,1093,1,"2,2",3,1,1,5,Low-Value,At Risk Customers
28518,1124,1,"38,9",2,1,1,4,Low-Value,Can't Lose
28519,771,4,"207,6",3,1,1,5,Low-Value,At Risk Customers
28521,59,9,"323,1",5,2,1,8,High-Value,Potential Loyalists
28522,1055,3,"270,4",3,1,1,5,Low-Value,At Risk Customers
28525,682,1,"49,05",4,1,1,6,Mid-Value,Potential Loyalists
28526,1138,2,"29,25",2,1,1,4,Low-Value,Can't Lose
28527,1205,1,"19,95",2,1,1,4,Low-Value,Can't Lose
28528,776,3,"59,6",3,1,1,5,Low-Value,At Risk Customers
28529,230,4,"231,55",5,1,1,7,Mid-Value,Potential Loyalists
28530,731,1,"3105,2",3,1,5,9,High-Value,Champions
28531,270,3,"124,5",5,1,1,7,Mid-Value,Potential Loyalists
28532,11,4,"135,1",5,1,1,7,Mid-Value,Potential Loyalists
28533,1284,2,"210,45",2,1,1,4,Low-Value,Can't Lose
28536,28,4,"584,0",5,1,1,7,Mid-Value,Potential Loyalists
28537,18,1,"35,0",5,1,1,7,Mid-Value,Potential Loyalists
28538,230,5,"226,0",5,1,1,7,Mid-Value,Potential Loyalists
28541,883,1,"58,1",3,1,1,5,Low-Value,At Risk Customers
28542,868,6,"529,55",3,1,1,5,Low-Value,At Risk Customers
28543,1336,1,"34,5",2,1,1,4,Low-Value,Can't Lose
28545,763,1,"11,75",3,1,1,5,Low-Value,At Risk Customers
28546,628,3,"205,39999999999998",4,1,1,6,Mid-Value,Potential Loyalists
28547,1226,3,"958,25",2,1,2,5,Low-Value,At Risk Customers
28548,1012,3,"45,6",3,1,1,5,Low-Value,At Risk Customers
28549,101,5,"277,4",5,1,1,7,Mid-Value,Potential Loyalists
28551,1157,2,"58,349999999999994",2,1,1,4,Low-Value,Can't Lose
28552,214,3,"138,6",5,1,1,7,Mid-Value,Potential Loyalists
28553,1281,1,"13,75",2,1,1,4,Low-Value,Can't Lose
28557,1409,1,"82,8",2,1,1,4,Low-Value,Can't Lose
28559,113,10,"884,15",5,2,2,9,High-Value,Champions
28560,433,2,"59,3",4,1,1,6,Mid-Value,Potential Loyalists
28561,43,1,"25,3",5,1,1,7,Mid-Value,Potential Loyalists
28562,392,3,"109,75",4,1,1,6,Mid-Value,Potential Loyalists
28564,797,3,"445,75",3,1,1,5,Low-Value,At Risk Customers
28565,371,2,"80,5",4,1,1,6,Mid-Value,Potential Loyalists
28569,202,2,"279,0",5,1,1,7,Mid-Value,Potential Loyalists
28571,266,1,"35,9",5,1,1,7,Mid-Value,Potential Loyalists
28573,7,1,"106,80000000000001",5,1,1,7,Mid-Value,Potential Loyalists
28574,411,4,"108,85",4,1,1,6,Mid-Value,Potential Loyalists
28575,521,2,"107,5",4,1,1,6,Mid-Value,Potential Loyalists
28577,1740,1,"12,4",1,1,1,3,Low-Value,Lost
28578,20,1,"17,2",5,1,1,7,Mid-Value,Potential Loyalists
28579,5,4,"141,25",5,1,1,7,Mid-Value,Potential Loyalists
28580,1710,1,"16,4",1,1,1,3,Low-Value,Lost
28582,916,1,"15,299999999999999",3,1,1,5,Low-Value,At Risk Customers
28583,286,3,"67,4",5,1,1,7,Mid-Value,Potential Loyalists
28584,341,2,"93,1",5,1,1,7,Mid-Value,Potential Loyalists
28586,7,3,"235,89999999999998",5,1,1,7,Mid-Value,Potential Loyalists
28588,419,5,"460,65000000000003",4,1,1,6,Mid-Value,Potential Loyalists
28589,783,5,"340,9",3,1,1,5,Low-Value,At Risk Customers
28590,57,1,"18,25",5,1,1,7,Mid-Value,Potential Loyalists
28591,1219,1,"20,46",2,1,1,4,Low-Value,Can't Lose
28593,12,3,"386,7",5,1,1,7,Mid-Value,Potential Loyalists
28594,147,1,"24,6",5,1,1,7,Mid-Value,Potential Loyalists
28596,285,3,"196,7",5,1,1,7,Mid-Value,Potential Loyalists
28597,32,2,"104,6",5,1,1,7,Mid-Value,Potential Loyalists
28600,1445,2,"101,55",2,1,1,4,Low-Value,Can't Lose
28601,143,4,"221,45",5,1,1,7,Mid-Value,Potential Loyalists
28602,241,3,"115,55",5,1,1,7,Mid-Value,Potential Loyalists
28603,1117,1,"94,8",2,1,1,4,Low-Value,Can't Lose
28605,1365,1,"17,4",2,1,1,4,Low-Value,Can't Lose
28608,42,5,"96,85",5,1,1,7,Mid-Value,Potential Loyalists
28609,756,1,"33,6",3,1,1,5,Low-Value,At Risk Customers
28612,867,4,"306,84999999999997",3,1,1,5,Low-Value,At Risk Customers
28615,1546,1,"1,25",1,1,1,3,Low-Value,Lost
28616,433,7,"587,7099999999999",4,2,1,7,Mid-Value,Potential Loyalists
28618,440,5,"310,2",4,1,1,6,Mid-Value,Potential Loyalists
28619,1,11,"754,45",5,2,2,9,High-Value,Champions
28620,1167,4,"381,3",2,1,1,4,Low-Value,Can't Lose
28621,908,2,"29,3",3,1,1,5,Low-Value,At Risk Customers
28624,1300,3,"67,1",2,1,1,4,Low-Value,Can't Lose
28627,1251,1,"71,25",2,1,1,4,Low-Value,Can't Lose
28628,82,2,"12,5",5,1,1,7,Mid-Value,Potential Loyalists
28629,870,4,"356,7",3,1,1,5,Low-Value,At Risk Customers
28630,598,3,"1047,35",4,1,2,7,Mid-Value,Potential Loyalists
28631,1245,1,"52,8",2,1,1,4,Low-Value,Can't Lose
28633,17,4,"187,75",5,1,1,7,Mid-Value,Potential Loyalists
28636,433,4,"177,15",4,1,1,6,Mid-Value,Potential Loyalists
28637,235,2,"317,70000000000005",5,1,1,7,Mid-Value,Potential Loyalists
28638,17,4,"286,30000000000007",5,1,1,7,Mid-Value,Potential Loyalists
28639,715,5,"98,15",4,1,1,6,Mid-Value,Potential Loyalists
28640,897,1,"245,6",3,1,1,5,Low-Value,At Risk Customers
28643,251,1,"26,65",5,1,1,7,Mid-Value,Potential Loyalists
28644,129,2,"221,7",5,1,1,7,Mid-Value,Potential Loyalists
28645,763,2,"23,2",3,1,1,5,Low-Value,At Risk Customers
28646,853,3,"488,35",3,1,1,5,Low-Value,At Risk Customers
28647,191,7,"715,35",5,2,2,9,High-Value,Champions
28649,5,11,"533,75",5,2,1,8,High-Value,Potential Loyalists
28650,1192,2,"62,65",2,1,1,4,Low-Value,Can't Lose
28651,85,8,"904,3",5,2,2,9,High-Value,Champions
28652,886,1,"104,2",3,1,1,5,Low-Value,At Risk Customers
28654,1519,2,"91,4",1,1,1,3,Low-Value,Lost
28655,143,5,"1252,7",5,1,2,8,High-Value,Potential Loyalists
28658,112,2,"71,2",5,1,1,7,Mid-Value,Potential Loyalists
28659,903,1,"28,6",3,1,1,5,Low-Value,At Risk Customers
28661,49,1,"10,45",5,1,1,7,Mid-Value,Potential Loyalists
28662,329,5,"141,2",5,1,1,7,Mid-Value,Potential Loyalists
28663,732,4,"115,4",3,1,1,5,Low-Value,At Risk Customers
28664,339,2,"56,8",5,1,1,7,Mid-Value,Potential Loyalists
28666,176,6,"291,3",5,1,1,7,Mid-Value,Potential Loyalists
28667,1100,2,"56,05",2,1,1,4,Low-Value,Can't Lose
28669,519,4,"168,4",4,1,1,6,Mid-Value,Potential Loyalists
28671,574,3,"87,25",4,1,1,6,Mid-Value,Potential Loyalists
28673,588,4,"114,39999999999999",4,1,1,6,Mid-Value,Potential Loyalists
28674,304,2,"35,9",5,1,1,7,Mid-Value,Potential Loyalists
28675,144,6,"256,4",5,1,1,7,Mid-Value,Potential Loyalists
28677,1011,2,"96,25",3,1,1,5,Low-Value,At Risk Customers
28678,987,1,"26,85",3,1,1,5,Low-Value,At Risk Customers
28680,1383,1,"9,3",2,1,1,4,Low-Value,Can't Lose
28681,1253,2,"108,1",2,1,1,4,Low-Value,Can't Lose
28682,901,3,"44,65",3,1,1,5,Low-Value,At Risk Customers
28683,733,8,"703,8",3,2,2,7,Mid-Value,Potential Loyalists
28685,748,2,"135,25",3,1,1,5,Low-Value,At Risk Customers
28687,428,4,"185,25",4,1,1,6,Mid-Value,Potential Loyalists
28688,83,3,"82,39999999999999",5,1,1,7,Mid-Value,Potential Loyalists
28690,365,2,"37,55",5,1,1,7,Mid-Value,Potential Loyalists
28691,146,3,"81,3",5,1,1,7,Mid-Value,Potential Loyalists
28692,384,10,"587,65",4,2,1,7,Mid-Value,Potential Loyalists
28693,258,3,"294,95000000000005",5,1,1,7,Mid-Value,Potential Loyalists
28694,943,3,"186,95000000000002",3,1,1,5,Low-Value,At Risk Customers
28700,1205,2,"66,6",2,1,1,4,Low-Value,Can't Lose
28702,1357,1,"45,2",2,1,1,4,Low-Value,Can't Lose
28703,362,3,"286,3",5,1,1,7,Mid-Value,Potential Loyalists
28705,231,1,"145,5",5,1,1,7,Mid-Value,Potential Loyalists
28706,82,7,"223,45000000000002",5,2,1,8,High-Value,Potential Loyalists
28709,188,7,"310,90000000000003",5,2,1,8,High-Value,Potential Loyalists
28712,1442,2,"60,25",2,1,1,4,Low-Value,Can't Lose
28714,488,2,"109,3",4,1,1,6,Mid-Value,Potential Loyalists
28715,222,7,"389,8",5,2,1,8,High-Value,Potential Loyalists
28717,97,6,"506,90000000000003",5,1,1,7,Mid-Value,Potential Loyalists
28718,699,1,"205,9",4,1,1,6,Mid-Value,Potential Loyalists
28719,826,1,"13,9",3,1,1,5,Low-Value,At Risk Customers
28721,598,1,"46,2",4,1,1,6,Mid-Value,Potential Loyalists
28723,1218,1,"35,0",2,1,1,4,Low-Value,Can't Lose
28724,638,7,"362,45",4,2,1,7,Mid-Value,Potential Loyalists
28726,22,2,"244,9",5,1,1,7,Mid-Value,Potential Loyalists
28731,1365,1,"2,95",2,1,1,4,Low-Value,Can't Lose
28732,204,3,"119,69999999999999",5,1,1,7,Mid-Value,Potential Loyalists
28734,253,6,"541,55",5,1,1,7,Mid-Value,Potential Loyalists
28735,60,8,"808,4",5,2,2,9,High-Value,Champions
28738,1716,1,"64,1",1,1,1,3,Low-Value,Lost
28740,182,1,"15,1",5,1,1,7,Mid-Value,Potential Loyalists
28743,694,2,"107,39999999999999",4,1,1,6,Mid-Value,Potential Loyalists
28744,67,2,"62,95",5,1,1,7,Mid-Value,Potential Loyalists
28745,52,6,"220,0",5,1,1,7,Mid-Value,Potential Loyalists
28746,263,1,"34,9",5,1,1,7,Mid-Value,Potential Loyalists
28747,291,4,"235,85000000000002",5,1,1,7,Mid-Value,Potential Loyalists
28748,1133,1,"60,7",2,1,1,4,Low-Value,Can't Lose
28749,1027,1,"16,6",3,1,1,5,Low-Value,At Risk Customers
28750,895,1,"155,6",3,1,1,5,Low-Value,At Risk Customers
28751,539,1,"103,4",4,1,1,6,Mid-Value,Potential Loyalists
28752,1132,2,"9,649999999999999",2,1,1,4,Low-Value,Can't Lose
28753,744,3,"180,14999999999998",3,1,1,5,Low-Value,At Risk Customers
28754,755,5,"352,65",3,1,1,5,Low-Value,At Risk Customers
28756,838,2,"79,9",3,1,1,5,Low-Value,At Risk Customers
28758,720,1,"99,0",4,1,1,6,Mid-Value,Potential Loyalists
28759,525,9,"326,4",4,2,1,7,Mid-Value,Potential Loyalists
28760,312,2,"60,199999999999996",5,1,1,7,Mid-Value,Potential Loyalists
28762,409,2,"134,4",4,1,1,6,Mid-Value,Potential Loyalists
28763,644,1,"25,05",4,1,1,6,Mid-Value,Potential Loyalists
28764,854,4,"346,9",3,1,1,5,Low-Value,At Risk Customers
28769,391,9,"277,35",4,2,1,7,Mid-Value,Potential Loyalists
28772,537,1,"16,6",4,1,1,6,Mid-Value,Potential Loyalists
28773,40,5,"386,0",5,1,1,7,Mid-Value,Potential Loyalists
28777,23,7,"202,9",5,2,1,8,High-Value,Potential Loyalists
28778,231,7,"165,95",5,2,1,8,High-Value,Potential Loyalists
28779,308,3,"217,0",5,1,1,7,Mid-Value,Potential Loyalists
28780,230,1,"285,29999999999995",5,1,1,7,Mid-Value,Potential Loyalists
28781,346,3,"129,60000000000002",5,1,1,7,Mid-Value,Potential Loyalists
28782,453,7,"189,5",4,2,1,7,Mid-Value,Potential Loyalists
28783,119,16,"509,45",5,3,1,9,High-Value,Champions
28786,752,6,"398,20000000000005",3,1,1,5,Low-Value,At Risk Customers
28787,135,3,"69,3",5,1,1,7,Mid-Value,Potential Loyalists
28789,1668,1,"416,8",1,1,1,3,Low-Value,Lost
28790,150,10,"1683,4",5,2,3,10,High-Value,Champions
28792,773,3,"43,9",3,1,1,5,Low-Value,At Risk Customers
28794,107,1,"36,9",5,1,1,7,Mid-Value,Potential Loyalists
28795,59,3,"419,04999999999995",5,1,1,7,Mid-Value,Potential Loyalists
28796,962,2,"36,099999999999994",3,1,1,5,Low-Value,At Risk Customers
28797,248,3,"75,9",5,1,1,7,Mid-Value,Potential Loyalists
28799,504,1,"147,14999999999998",4,1,1,6,Mid-Value,Potential Loyalists
28800,598,7,"608,0",4,2,1,7,Mid-Value,Potential Loyalists
28801,217,7,"213,45000000000002",5,2,1,8,High-Value,Potential Loyalists
28802,1458,2,"22,4",2,1,1,4,Low-Value,Can't Lose
28804,695,1,"113,65",4,1,1,6,Mid-Value,Potential Loyalists
28805,586,1,"43,95",4,1,1,6,Mid-Value,Potential Loyalists
28806,232,8,"516,15",5,2,1,8,High-Value,Potential Loyalists
28807,1564,1,"12,45",1,1,1,3,Low-Value,Lost
28809,12,5,"190,4",5,1,1,7,Mid-Value,Potential Loyalists
28810,939,1,"18,4",3,1,1,5,Low-Value,At Risk Customers
28812,1121,2,"235,65",2,1,1,4,Low-Value,Can't Lose
28813,316,3,"281,2",5,1,1,7,Mid-Value,Potential Loyalists
28814,400,3,"124,25",4,1,1,6,Mid-Value,Potential Loyalists
28816,629,2,"656,55",4,1,1,6,Mid-Value,Potential Loyalists
28817,633,2,"92,2",4,1,1,6,Mid-Value,Potential Loyalists
28818,540,3,"314,95",4,1,1,6,Mid-Value,Potential Loyalists
28820,1260,2,"154,45",2,1,1,4,Low-Value,Can't Lose
28821,1109,5,"518,6",2,1,1,4,Low-Value,Can't Lose
28822,380,3,"151,05",4,1,1,6,Mid-Value,Potential Loyalists
28823,1363,1,"28,950000000000003",2,1,1,4,Low-Value,Can't Lose
28824,329,2,"47,05",5,1,1,7,Mid-Value,Potential Loyalists
28825,1507,3,"89,94999999999999",1,1,1,3,Low-Value,Lost
28826,228,1,"50,6",5,1,1,7,Mid-Value,Potential Loyalists
28827,74,5,"851,95",5,1,2,8,High-Value,Potential Loyalists
28830,1497,1,"36,0",1,1,1,3,Low-Value,Lost
28833,186,6,"207,75",5,1,1,7,Mid-Value,Potential Loyalists
28837,24,6,"228,75",5,1,1,7,Mid-Value,Potential Loyalists
28841,1121,2,"76,65",2,1,1,4,Low-Value,Can't Lose
28842,382,9,"424,8",4,2,1,7,Mid-Value,Potential Loyalists
28844,175,3,"459,55",5,1,1,7,Mid-Value,Potential Loyalists
28845,194,3,"97,94999999999999",5,1,1,7,Mid-Value,Potential Loyalists
28847,69,5,"302,70000000000005",5,1,1,7,Mid-Value,Potential Loyalists
28848,390,4,"111,39999999999999",4,1,1,6,Mid-Value,Potential Loyalists
28849,1023,2,"169,54999999999998",3,1,1,5,Low-Value,At Risk Customers
28850,1582,1,"26,05",1,1,1,3,Low-Value,Lost
28851,519,4,"113,15",4,1,1,6,Mid-Value,Potential Loyalists
28853,446,2,"47,65",4,1,1,6,Mid-Value,Potential Loyalists
28855,1244,4,"144,65",2,1,1,4,Low-Value,Can't Lose
28856,311,5,"338,9",5,1,1,7,Mid-Value,Potential Loyalists
28857,477,1,"10,9",4,1,1,6,Mid-Value,Potential Loyalists
28859,372,2,"190,3",4,1,1,6,Mid-Value,Potential Loyalists
28860,127,2,"68,05",5,1,1,7,Mid-Value,Potential Loyalists
28861,52,3,"102,65",5,1,1,7,Mid-Value,Potential Loyalists
28863,26,1,"54,95",5,1,1,7,Mid-Value,Potential Loyalists
28865,431,4,"381,0",4,1,1,6,Mid-Value,Potential Loyalists
28866,763,2,"83,5",3,1,1,5,Low-Value,At Risk Customers
28868,382,5,"170,3",4,1,1,6,Mid-Value,Potential Loyalists
28870,557,2,"77,3",4,1,1,6,Mid-Value,Potential Loyalists
28872,533,1,"7,2",4,1,1,6,Mid-Value,Potential Loyalists
28874,209,2,"73,1",5,1,1,7,Mid-Value,Potential Loyalists
28875,1047,2,"34,05",3,1,1,5,Low-Value,At Risk Customers
28876,41,11,"372,95",5,2,1,8,High-Value,Potential Loyalists
28877,636,1,"40,65",4,1,1,6,Mid-Value,Potential Loyalists
28879,13,7,"383,75",5,2,1,8,High-Value,Potential Loyalists
28880,757,11,"1098,8",3,2,2,7,Mid-Value,Potential Loyalists
28881,787,2,"29,55",3,1,1,5,Low-Value,At Risk Customers
28882,106,3,"104,95",5,1,1,7,Mid-Value,Potential Loyalists
28883,1465,3,"172,15",1,1,1,3,Low-Value,Lost
28886,1646,1,"80,6",1,1,1,3,Low-Value,Lost
28887,398,2,"55,7",4,1,1,6,Mid-Value,Potential Loyalists
28888,1670,1,"45,5",1,1,1,3,Low-Value,Lost
28889,236,4,"127,9",5,1,1,7,Mid-Value,Potential Loyalists
28890,417,3,"101,0",4,1,1,6,Mid-Value,Potential Loyalists
28891,1268,1,"81,5",2,1,1,4,Low-Value,Can't Lose
28893,141,3,"174,75",5,1,1,7,Mid-Value,Potential Loyalists
28894,1303,2,"219,7",2,1,1,4,Low-Value,Can't Lose
28895,141,4,"166,8",5,1,1,7,Mid-Value,Potential Loyalists
28896,959,3,"70,69999999999999",3,1,1,5,Low-Value,At Risk Customers
28897,1299,1,"55,1",2,1,1,4,Low-Value,Can't Lose
28899,1377,1,"12,1",2,1,1,4,Low-Value,Can't Lose
28901,1714,1,"11,75",1,1,1,3,Low-Value,Lost
28905,15,3,"103,8",5,1,1,7,Mid-Value,Potential Loyalists
28907,14,3,"139,4",5,1,1,7,Mid-Value,Potential Loyalists
28909,952,6,"157,3",3,1,1,5,Low-Value,At Risk Customers
28911,390,6,"1014,3",4,1,2,7,Mid-Value,Potential Loyalists
28913,1068,1,"59,6",3,1,1,5,Low-Value,At Risk Customers
28914,760,5,"198,65",3,1,1,5,Low-Value,At Risk Customers
28915,42,2,"111,9",5,1,1,7,Mid-Value,Potential Loyalists
28916,152,3,"313,55",5,1,1,7,Mid-Value,Potential Loyalists
28917,83,4,"173,7",5,1,1,7,Mid-Value,Potential Loyalists
28918,65,2,"85,5",5,1,1,7,Mid-Value,Potential Loyalists
28919,310,1,"50,4",5,1,1,7,Mid-Value,Potential Loyalists
28921,331,5,"1303,15",5,1,2,8,High-Value,Potential Loyalists
28923,735,2,"133,31",3,1,1,5,Low-Value,At Risk Customers
28925,878,6,"309,3",3,1,1,5,Low-Value,At Risk Customers
28927,219,2,"62,85",5,1,1,7,Mid-Value,Potential Loyalists
28928,29,4,"71,35",5,1,1,7,Mid-Value,Potential Loyalists
28930,537,8,"331,05",4,2,1,7,Mid-Value,Potential Loyalists
28932,424,6,"307,85",4,1,1,6,Mid-Value,Potential Loyalists
28933,190,1,"267,0",5,1,1,7,Mid-Value,Potential Loyalists
28934,1466,3,"118,4",1,1,1,3,Low-Value,Lost
28936,19,8,"312,7",5,2,1,8,High-Value,Potential Loyalists
28937,1475,4,"219,45000000000002",1,1,1,3,Low-Value,Lost
28939,116,7,"387,3",5,2,1,8,High-Value,Potential Loyalists
28941,740,1,"13,0",3,1,1,5,Low-Value,At Risk Customers
28942,939,1,"155,4",3,1,1,5,Low-Value,At Risk Customers
28943,200,5,"217,45",5,1,1,7,Mid-Value,Potential Loyalists
28945,52,10,"267,1",5,2,1,8,High-Value,Potential Loyalists
28947,1819,1,"15,25",1,1,1,3,Low-Value,Lost
28949,1048,1,"32,85",3,1,1,5,Low-Value,At Risk Customers
28952,871,2,"98,8",3,1,1,5,Low-Value,At Risk Customers
28954,1330,2,"69,35",2,1,1,4,Low-Value,Can't Lose
28955,747,2,"201,9",3,1,1,5,Low-Value,At Risk Customers
28956,52,10,"534,65",5,2,1,8,High-Value,Potential Loyalists
28957,418,5,"192,25",4,1,1,6,Mid-Value,Potential Loyalists
28958,319,3,"430,45",5,1,1,7,Mid-Value,Potential Loyalists
28961,1023,2,"143,25",3,1,1,5,Low-Value,At Risk Customers
28962,41,8,"261,45",5,2,1,8,High-Value,Potential Loyalists
28963,816,2,"216,04999999999998",3,1,1,5,Low-Value,At Risk Customers
28964,1117,6,"302,15",2,1,1,4,Low-Value,Can't Lose
28965,574,1,"14,6",4,1,1,6,Mid-Value,Potential Loyalists
28967,426,3,"53,45",4,1,1,6,Mid-Value,Potential Loyalists
28968,283,7,"601,1",5,2,1,8,High-Value,Potential Loyalists
28969,108,3,"72,75",5,1,1,7,Mid-Value,Potential Loyalists
28970,26,9,"409,95000000000005",5,2,1,8,High-Value,Potential Loyalists
28972,888,1,"58,9",3,1,1,5,Low-Value,At Risk Customers
28973,16,1,"44,8",5,1,1,7,Mid-Value,Potential Loyalists
28974,118,13,"714,1",5,3,2,10,High-Value,Champions
28975,490,4,"152,15",4,1,1,6,Mid-Value,Potential Loyalists
28976,816,3,"96,55",3,1,1,5,Low-Value,At Risk Customers
28977,137,5,"434,85",5,1,1,7,Mid-Value,Potential Loyalists
28978,304,1,"95,65",5,1,1,7,Mid-Value,Potential Loyalists
28979,518,3,"194,5",4,1,1,6,Mid-Value,Potential Loyalists
28980,618,2,"220,9",4,1,1,6,Mid-Value,Potential Loyalists
28982,506,1,"270,0",4,1,1,6,Mid-Value,Potential Loyalists
28984,389,17,"983,75",4,4,2,10,High-Value,Champions
28985,38,4,"143,25",5,1,1,7,Mid-Value,Potential Loyalists
28988,61,9,"487,6",5,2,1,8,High-Value,Potential Loyalists
28989,477,2,"41,5",4,1,1,6,Mid-Value,Potential Loyalists
28991,997,1,"18,9",3,1,1,5,Low-Value,At Risk Customers
28993,14,5,"243,75",5,1,1,7,Mid-Value,Potential Loyalists
28994,1739,1,"22,05",1,1,1,3,Low-Value,Lost
28996,522,2,"193,0",4,1,1,6,Mid-Value,Potential Loyalists
28998,1064,4,"307,25",3,1,1,5,Low-Value,At Risk Customers
28999,1116,4,"362,15",2,1,1,4,Low-Value,Can't Lose
29001,11,1,"94,1",5,1,1,7,Mid-Value,Potential Loyalists
29003,103,5,"324,25",5,1,1,7,Mid-Value,Potential Loyalists
29004,171,3,"547,8",5,1,1,7,Mid-Value,Potential Loyalists
29006,647,3,"382,8",4,1,1,6,Mid-Value,Potential Loyalists
29009,205,2,"247,39999999999998",5,1,1,7,Mid-Value,Potential Loyalists
29010,27,8,"401,5",5,2,1,8,High-Value,Potential Loyalists
29011,34,4,"199,5",5,1,1,7,Mid-Value,Potential Loyalists
29013,1132,3,"64,55",2,1,1,4,Low-Value,Can't Lose
29015,402,12,"1028,7",4,3,2,9,High-Value,Champions
29016,45,5,"497,6",5,1,1,7,Mid-Value,Potential Loyalists
29018,60,4,"276,05",5,1,1,7,Mid-Value,Potential Loyalists
29020,181,4,"164,6",5,1,1,7,Mid-Value,Potential Loyalists
29022,372,5,"251,15",4,1,1,6,Mid-Value,Potential Loyalists
29025,55,3,"95,6",5,1,1,7,Mid-Value,Potential Loyalists
29028,662,3,"173,3",4,1,1,6,Mid-Value,Potential Loyalists
29029,342,8,"490,65000000000003",5,2,1,8,High-Value,Potential Loyalists
29030,19,10,"1401,0",5,2,3,10,High-Value,Champions
29032,96,5,"421,6",5,1,1,7,Mid-Value,Potential Loyalists
29033,122,4,"242,65",5,1,1,7,Mid-Value,Potential Loyalists
29035,1699,1,"5,3",1,1,1,3,Low-Value,Lost
29036,1774,1,"19,35",1,1,1,3,Low-Value,Lost
29037,146,5,"617,25",5,1,1,7,Mid-Value,Potential Loyalists
29040,988,2,"131,85",3,1,1,5,Low-Value,At Risk Customers
29041,123,4,"426,04999999999995",5,1,1,7,Mid-Value,Potential Loyalists
29042,378,3,"283,9",4,1,1,6,Mid-Value,Potential Loyalists
29043,880,3,"201,1",3,1,1,5,Low-Value,At Risk Customers
29044,383,2,"392,9",4,1,1,6,Mid-Value,Potential Loyalists
29045,21,5,"387,05",5,1,1,7,Mid-Value,Potential Loyalists
29046,49,5,"153,89999999999998",5,1,1,7,Mid-Value,Potential Loyalists
29049,337,1,"114,1",5,1,1,7,Mid-Value,Potential Loyalists
29051,431,5,"147,7",4,1,1,6,Mid-Value,Potential Loyalists
29053,916,2,"301,9",3,1,1,5,Low-Value,At Risk Customers
29055,1810,1,"10,23",1,1,1,3,Low-Value,Lost
29058,1072,1,"112,3",3,1,1,5,Low-Value,At Risk Customers
29060,832,1,"33,25",3,1,1,5,Low-Value,At Risk Customers
29061,252,1,"20,4",5,1,1,7,Mid-Value,Potential Loyalists
29062,1012,1,"30,45",3,1,1,5,Low-Value,At Risk Customers
29063,743,6,"174,75",3,1,1,5,Low-Value,At Risk Customers
29064,1746,3,"153,6",1,1,1,3,Low-Value,Lost
29065,224,3,"175,7",5,1,1,7,Mid-Value,Potential Loyalists
29066,593,2,"190,1",4,1,1,6,Mid-Value,Potential Loyalists
29068,69,6,"285,65",5,1,1,7,Mid-Value,Potential Loyalists
29069,559,1,"22,4",4,1,1,6,Mid-Value,Potential Loyalists
29070,407,4,"236,15",4,1,1,6,Mid-Value,Potential Loyalists
29072,30,2,"168,9",5,1,1,7,Mid-Value,Potential Loyalists
29079,1540,1,"11,2",1,1,1,3,Low-Value,Lost
29080,875,1,"20,8",3,1,1,5,Low-Value,At Risk Customers
29081,39,8,"760,4",5,2,2,9,High-Value,Champions
29085,239,7,"262,2",5,2,1,8,High-Value,Potential Loyalists
29086,1332,2,"26,25",2,1,1,4,Low-Value,Can't Lose
29087,204,3,"163,1",5,1,1,7,Mid-Value,Potential Loyalists
29088,1389,1,"32,25",2,1,1,4,Low-Value,Can't Lose
29090,1218,4,"374,1",2,1,1,4,Low-Value,Can't Lose
29091,372,14,"687,2",4,3,2,9,High-Value,Champions
29092,1226,2,"71,65",2,1,1,4,Low-Value,Can't Lose
29095,267,2,"1350,6499999999999",5,1,3,9,High-Value,Champions
29096,495,2,"75,0",4,1,1,6,Mid-Value,Potential Loyalists
29097,8,2,"30,3",5,1,1,7,Mid-Value,Potential Loyalists
29099,1133,1,"19,4",2,1,1,4,Low-Value,Can't Lose
29101,20,7,"670,8",5,2,2,9,High-Value,Champions
29102,589,2,"40,7",4,1,1,6,Mid-Value,Potential Loyalists
29103,801,2,"268,85",3,1,1,5,Low-Value,At Risk Customers
29105,60,2,"75,45",5,1,1,7,Mid-Value,Potential Loyalists
29107,817,2,"136,3",3,1,1,5,Low-Value,At Risk Customers
29108,596,6,"239,45",4,1,1,6,Mid-Value,Potential Loyalists
29110,1762,1,"27,1",1,1,1,3,Low-Value,Lost
29111,266,8,"417,95",5,2,1,8,High-Value,Potential Loyalists
29112,365,2,"57,0",5,1,1,7,Mid-Value,Potential Loyalists
29113,214,3,"46,25",5,1,1,7,Mid-Value,Potential Loyalists
29115,1284,2,"68,7",2,1,1,4,Low-Value,Can't Lose
29116,377,2,"40,5",4,1,1,6,Mid-Value,Potential Loyalists
29118,508,3,"73,25",4,1,1,6,Mid-Value,Potential Loyalists
29119,203,6,"653,15",5,1,1,7,Mid-Value,Potential Loyalists
29120,424,4,"545,95",4,1,1,6,Mid-Value,Potential Loyalists
29122,554,6,"636,35",4,1,1,6,Mid-Value,Potential Loyalists
29123,29,2,"62,3",5,1,1,7,Mid-Value,Potential Loyalists
29125,381,3,"185,35",4,1,1,6,Mid-Value,Potential Loyalists
29127,1471,1,"524,25",1,1,1,3,Low-Value,Lost
29128,537,2,"116,69999999999999",4,1,1,6,Mid-Value,Potential Loyalists
29130,502,2,"59,25",4,1,1,6,Mid-Value,Potential Loyalists
29131,386,7,"281,55",4,2,1,7,Mid-Value,Potential Loyalists
29132,739,11,"822,7",3,2,2,7,Mid-Value,Potential Loyalists
29134,49,2,"58,6",5,1,1,7,Mid-Value,Potential Loyalists
29135,803,4,"169,35",3,1,1,5,Low-Value,At Risk Customers
29136,52,3,"75,1",5,1,1,7,Mid-Value,Potential Loyalists
29138,1420,1,"13,75",2,1,1,4,Low-Value,Can't Lose
29140,1573,1,"35,8",1,1,1,3,Low-Value,Lost
29141,1028,2,"98,65",3,1,1,5,Low-Value,At Risk Customers
29145,1035,2,"184,90000000000003",3,1,1,5,Low-Value,At Risk Customers
29146,1229,1,"53,4",2,1,1,4,Low-Value,Can't Lose
29147,724,1,"125,65",4,1,1,6,Mid-Value,Potential Loyalists
29148,320,2,"151,7",5,1,1,7,Mid-Value,Potential Loyalists
29149,529,1,"15,7",4,1,1,6,Mid-Value,Potential Loyalists
29150,132,7,"355,1",5,2,1,8,High-Value,Potential Loyalists
29152,615,6,"452,7",4,1,1,6,Mid-Value,Potential Loyalists
29153,381,4,"97,35",4,1,1,6,Mid-Value,Potential Loyalists
29155,465,3,"75,35",4,1,1,6,Mid-Value,Potential Loyalists
29157,206,5,"556,5",5,1,1,7,Mid-Value,Potential Loyalists
29158,213,2,"79,85",5,1,1,7,Mid-Value,Potential Loyalists
29159,58,5,"130,8",5,1,1,7,Mid-Value,Potential Loyalists
29160,268,1,"50,1",5,1,1,7,Mid-Value,Potential Loyalists
29162,144,7,"613,45",5,2,1,8,High-Value,Potential Loyalists
29163,77,3,"99,95",5,1,1,7,Mid-Value,Potential Loyalists
29164,194,7,"595,6",5,2,1,8,High-Value,Potential Loyalists
29165,760,2,"44,25",3,1,1,5,Low-Value,At Risk Customers
29167,728,1,"48,45",4,1,1,6,Mid-Value,Potential Loyalists
29168,59,5,"150,0",5,1,1,7,Mid-Value,Potential Loyalists
29171,370,1,"122,25",4,1,1,6,Mid-Value,Potential Loyalists
29172,126,3,"870,85",5,1,2,8,High-Value,Potential Loyalists
29173,240,3,"58,25",5,1,1,7,Mid-Value,Potential Loyalists
29175,1129,1,"41,6",2,1,1,4,Low-Value,Can't Lose
29176,12,1,"14,6",5,1,1,7,Mid-Value,Potential Loyalists
29178,171,2,"62,300000000000004",5,1,1,7,Mid-Value,Potential Loyalists
29180,540,4,"105,15",4,1,1,6,Mid-Value,Potential Loyalists
29182,331,10,"604,85",5,2,1,8,High-Value,Potential Loyalists
29183,227,3,"165,35",5,1,1,7,Mid-Value,Potential Loyalists
29184,414,6,"328,84999999999997",4,1,1,6,Mid-Value,Potential Loyalists
29185,1422,1,"23,1",2,1,1,4,Low-Value,Can't Lose
29189,445,1,"6,1",4,1,1,6,Mid-Value,Potential Loyalists
29192,27,11,"587,8",5,2,1,8,High-Value,Potential Loyalists
29193,660,2,"28,45",4,1,1,6,Mid-Value,Potential Loyalists
29195,622,1,"31,15",4,1,1,6,Mid-Value,Potential Loyalists
29196,936,1,"228,2",3,1,1,5,Low-Value,At Risk Customers
29198,168,2,"513,75",5,1,1,7,Mid-Value,Potential Loyalists
29199,221,10,"1250,6999999999998",5,2,2,9,High-Value,Champions
29200,70,4,"323,59999999999997",5,1,1,7,Mid-Value,Potential Loyalists
29201,17,13,"1711,5",5,3,3,11,High-Value,Champions
29202,262,8,"561,15",5,2,1,8,High-Value,Potential Loyalists
29203,290,1,"1,6",5,1,1,7,Mid-Value,Potential Loyalists
29204,157,3,"78,75",5,1,1,7,Mid-Value,Potential Loyalists
29206,1248,2,"115,7",2,1,1,4,Low-Value,Can't Lose
29207,369,4,"384,4",4,1,1,6,Mid-Value,Potential Loyalists
29209,952,1,"8,6",3,1,1,5,Low-Value,At Risk Customers
29210,779,5,"418,15000000000003",3,1,1,5,Low-Value,At Risk Customers
29211,1371,2,"123,85000000000001",2,1,1,4,Low-Value,Can't Lose
29213,73,5,"295,28000000000003",5,1,1,7,Mid-Value,Potential Loyalists
29214,11,12,"499,6",5,3,1,9,High-Value,Champions
29216,444,5,"270,85",4,1,1,6,Mid-Value,Potential Loyalists
29218,303,2,"36,4",5,1,1,7,Mid-Value,Potential Loyalists
29219,160,2,"680,1",5,1,2,8,High-Value,Potential Loyalists
29220,494,4,"138,0",4,1,1,6,Mid-Value,Potential Loyalists
29221,83,3,"192,15000000000003",5,1,1,7,Mid-Value,Potential Loyalists
29222,128,7,"419,05",5,2,1,8,High-Value,Potential Loyalists
29223,487,1,"244,5",4,1,1,6,Mid-Value,Potential Loyalists
29225,719,3,"150,55",4,1,1,6,Mid-Value,Potential Loyalists
29226,102,2,"280,55",5,1,1,7,Mid-Value,Potential Loyalists
29230,269,1,"6,4",5,1,1,7,Mid-Value,Potential Loyalists
29231,716,1,"17,7",4,1,1,6,Mid-Value,Potential Loyalists
29232,545,3,"67,6",4,1,1,6,Mid-Value,Potential Loyalists
29233,689,1,"99,5",4,1,1,6,Mid-Value,Potential Loyalists
29235,1386,5,"348,0",2,1,1,4,Low-Value,Can't Lose
29236,190,5,"968,1",5,1,2,8,High-Value,Potential Loyalists
29243,534,2,"184,1",4,1,1,6,Mid-Value,Potential Loyalists
29244,474,5,"375,05",4,1,1,6,Mid-Value,Potential Loyalists
29246,1205,2,"96,55",2,1,1,4,Low-Value,Can't Lose
29249,785,5,"147,15",3,1,1,5,Low-Value,At Risk Customers
29250,1174,2,"355,5",2,1,1,4,Low-Value,Can't Lose
29251,1749,1,"17,85",1,1,1,3,Low-Value,Lost
29252,373,3,"122,3",4,1,1,6,Mid-Value,Potential Loyalists
29253,673,2,"688,75",4,1,2,7,Mid-Value,Potential Loyalists
29254,1463,1,"58,6",1,1,1,3,Low-Value,Lost
29258,1379,3,"162,10000000000002",2,1,1,4,Low-Value,Can't Lose
29259,50,8,"489,9",5,2,1,8,High-Value,Potential Loyalists
29263,995,1,"52,4",3,1,1,5,Low-Value,At Risk Customers
29264,906,1,"114,75",3,1,1,5,Low-Value,At Risk Customers
29265,217,4,"383,75",5,1,1,7,Mid-Value,Potential Loyalists
29266,223,3,"76,55000000000001",5,1,1,7,Mid-Value,Potential Loyalists
29268,406,1,"247,7",4,1,1,6,Mid-Value,Potential Loyalists
29269,1034,3,"92,55",3,1,1,5,Low-Value,At Risk Customers
29270,111,2,"145,65",5,1,1,7,Mid-Value,Potential Loyalists
29271,305,4,"260,35",5,1,1,7,Mid-Value,Potential Loyalists
29272,354,3,"37,05",5,1,1,7,Mid-Value,Potential Loyalists
29273,679,4,"310,95",4,1,1,6,Mid-Value,Potential Loyalists
29274,495,3,"889,7",4,1,2,7,Mid-Value,Potential Loyalists
29276,131,14,"607,5",5,3,1,9,High-Value,Champions
29277,77,4,"135,45",5,1,1,7,Mid-Value,Potential Loyalists
29278,1268,2,"298,04999999999995",2,1,1,4,Low-Value,Can't Lose
29284,283,7,"371,6",5,2,1,8,High-Value,Potential Loyalists
29285,886,5,"157,14999999999998",3,1,1,5,Low-Value,At Risk Customers
29287,1350,1,"8,55",2,1,1,4,Low-Value,Can't Lose
29288,26,9,"287,7",5,2,1,8,High-Value,Potential Loyalists
29290,1023,5,"174,2",3,1,1,5,Low-Value,At Risk Customers
29293,89,1,"115,3",5,1,1,7,Mid-Value,Potential Loyalists
29294,38,8,"296,25",5,2,1,8,High-Value,Potential Loyalists
29299,732,1,"77,4",3,1,1,5,Low-Value,At Risk Customers
29300,115,5,"345,93",5,1,1,7,Mid-Value,Potential Loyalists
29302,1555,3,"139,15",1,1,1,3,Low-Value,Lost
29303,92,7,"409,75",5,2,1,8,High-Value,Potential Loyalists
29304,157,3,"183,75",5,1,1,7,Mid-Value,Potential Loyalists
29305,1657,2,"202,1",1,1,1,3,Low-Value,Lost
29306,605,2,"94,0",4,1,1,6,Mid-Value,Potential Loyalists
29307,154,2,"265,40000000000003",5,1,1,7,Mid-Value,Potential Loyalists
29310,1152,1,"74,15",2,1,1,4,Low-Value,Can't Lose
29312,19,3,"317,1",5,1,1,7,Mid-Value,Potential Loyalists
29313,773,3,"54,95",3,1,1,5,Low-Value,At Risk Customers
29315,788,5,"162,6",3,1,1,5,Low-Value,At Risk Customers
29316,1287,1,"211,79999999999998",2,1,1,4,Low-Value,Can't Lose
29317,599,1,"117,2",4,1,1,6,Mid-Value,Potential Loyalists
29321,749,3,"344,25",3,1,1,5,Low-Value,At Risk Customers
29322,521,4,"192,35",4,1,1,6,Mid-Value,Potential Loyalists
29323,1518,2,"91,2",1,1,1,3,Low-Value,Lost
29324,1492,1,"18,2",1,1,1,3,Low-Value,Lost
29326,607,3,"66,15",4,1,1,6,Mid-Value,Potential Loyalists
29327,34,5,"850,0",5,1,2,8,High-Value,Potential Loyalists
29330,1315,4,"632,3",2,1,1,4,Low-Value,Can't Lose
29332,353,6,"122,3",5,1,1,7,Mid-Value,Potential Loyalists
29333,1636,2,"63,400000000000006",1,1,1,3,Low-Value,Lost
29334,1469,1,"28,7",1,1,1,3,Low-Value,Lost
29335,762,2,"79,95",3,1,1,5,Low-Value,At Risk Customers
29336,195,2,"114,3",5,1,1,7,Mid-Value,Potential Loyalists
29338,277,11,"774,4",5,2,2,9,High-Value,Champions
29339,1301,2,"93,1",2,1,1,4,Low-Value,Can't Lose
29340,27,2,"92,95",5,1,1,7,Mid-Value,Potential Loyalists
29341,8,6,"638,95",5,1,1,7,Mid-Value,Potential Loyalists
29342,91,9,"393,1",5,2,1,8,High-Value,Potential Loyalists
29344,1651,1,"154,4",1,1,1,3,Low-Value,Lost
29345,547,2,"258,5",4,1,1,6,Mid-Value,Potential Loyalists
29347,1331,1,"13,75",2,1,1,4,Low-Value,Can't Lose
29348,12,8,"304,1",5,2,1,8,High-Value,Potential Loyalists
29351,772,9,"504,85",3,2,1,6,Mid-Value,Potential Loyalists
29352,1754,1,"18,15",1,1,1,3,Low-Value,Lost
29353,1529,1,"60,1",1,1,1,3,Low-Value,Lost
29355,39,7,"1113,7",5,2,2,9,High-Value,Champions
29356,300,5,"317,3",5,1,1,7,Mid-Value,Potential Loyalists
29357,1285,1,"37,8",2,1,1,4,Low-Value,Can't Lose
29358,901,3,"202,1",3,1,1,5,Low-Value,At Risk Customers
29359,956,3,"80,6",3,1,1,5,Low-Value,At Risk Customers
29360,103,3,"123,35",5,1,1,7,Mid-Value,Potential Loyalists
29361,1020,1,"158,0",3,1,1,5,Low-Value,At Risk Customers
29363,40,10,"432,65",5,2,1,8,High-Value,Potential Loyalists
29366,1057,3,"109,10000000000001",3,1,1,5,Low-Value,At Risk Customers
29367,117,4,"140,20000000000002",5,1,1,7,Mid-Value,Potential Loyalists
29368,293,2,"238,35",5,1,1,7,Mid-Value,Potential Loyalists
29369,509,2,"11,799999999999999",4,1,1,6,Mid-Value,Potential Loyalists
29370,354,5,"392,2",5,1,1,7,Mid-Value,Potential Loyalists
29371,1288,1,"94,19999999999999",2,1,1,4,Low-Value,Can't Lose
29372,433,1,"32,8",4,1,1,6,Mid-Value,Potential Loyalists
29373,314,5,"127,4",5,1,1,7,Mid-Value,Potential Loyalists
29374,724,1,"9,1",4,1,1,6,Mid-Value,Potential Loyalists
29375,939,2,"232,4",3,1,1,5,Low-Value,At Risk Customers
29378,273,3,"133,7",5,1,1,7,Mid-Value,Potential Loyalists
29379,927,2,"192,89999999999998",3,1,1,5,Low-Value,At Risk Customers
29380,39,11,"333,4",5,2,1,8,High-Value,Potential Loyalists
29382,1016,1,"28,5",3,1,1,5,Low-Value,At Risk Customers
29383,409,4,"255,55",4,1,1,6,Mid-Value,Potential Loyalists
29384,610,1,"10,85",4,1,1,6,Mid-Value,Potential Loyalists
29392,228,6,"277,95000000000005",5,1,1,7,Mid-Value,Potential Loyalists
29394,13,5,"146,65",5,1,1,7,Mid-Value,Potential Loyalists
29396,1790,1,"5,45",1,1,1,3,Low-Value,Lost
29397,10,6,"369,6",5,1,1,7,Mid-Value,Potential Loyalists
29398,29,2,"19,45",5,1,1,7,Mid-Value,Potential Loyalists
29400,593,1,"23,0",4,1,1,6,Mid-Value,Potential Loyalists
29404,21,2,"170,14999999999998",5,1,1,7,Mid-Value,Potential Loyalists
29405,270,7,"190,2",5,2,1,8,High-Value,Potential Loyalists
29407,76,4,"88,5",5,1,1,7,Mid-Value,Potential Loyalists
29408,587,2,"202,7",4,1,1,6,Mid-Value,Potential Loyalists
29409,563,1,"122,3",4,1,1,6,Mid-Value,Potential Loyalists
29411,199,3,"341,0",5,1,1,7,Mid-Value,Potential Loyalists
29412,1649,1,"77,5",1,1,1,3,Low-Value,Lost
29414,258,3,"69,25",5,1,1,7,Mid-Value,Potential Loyalists
29415,476,5,"121,30000000000001",4,1,1,6,Mid-Value,Potential Loyalists
29416,206,4,"79,6",5,1,1,7,Mid-Value,Potential Loyalists
29417,887,1,"81,0",3,1,1,5,Low-Value,At Risk Customers
29420,541,1,"201,6",4,1,1,6,Mid-Value,Potential Loyalists
29421,129,2,"290,6",5,1,1,7,Mid-Value,Potential Loyalists
29423,530,4,"234,04999999999998",4,1,1,6,Mid-Value,Potential Loyalists
29424,474,4,"93,7",4,1,1,6,Mid-Value,Potential Loyalists
29425,8,5,"480,95",5,1,1,7,Mid-Value,Potential Loyalists
29426,61,12,"503,1",5,3,1,9,High-Value,Champions
29427,930,2,"107,4",3,1,1,5,Low-Value,At Risk Customers
29428,183,6,"308,45",5,1,1,7,Mid-Value,Potential Loyalists
29431,694,1,"49,75",4,1,1,6,Mid-Value,Potential Loyalists
29433,1263,3,"116,35000000000001",2,1,1,4,Low-Value,Can't Lose
29434,292,5,"259,5",5,1,1,7,Mid-Value,Potential Loyalists
29435,915,3,"279,6",3,1,1,5,Low-Value,At Risk Customers
29436,1189,2,"68,95",2,1,1,4,Low-Value,Can't Lose
29437,389,4,"144,55",4,1,1,6,Mid-Value,Potential Loyalists
29438,82,2,"42,55",5,1,1,7,Mid-Value,Potential Loyalists
29439,1461,1,"122,0",1,1,1,3,Low-Value,Lost
29440,165,5,"185,29999999999998",5,1,1,7,Mid-Value,Potential Loyalists
29442,1123,3,"405,45000000000005",2,1,1,4,Low-Value,Can't Lose
29444,1266,5,"802,5500000000001",2,1,2,5,Low-Value,At Risk Customers
29445,555,6,"310,1",4,1,1,6,Mid-Value,Potential Loyalists
29447,918,1,"35,4",3,1,1,5,Low-Value,At Risk Customers
29451,1636,1,"76,6",1,1,1,3,Low-Value,Lost
29452,910,3,"357,3",3,1,1,5,Low-Value,At Risk Customers
29453,31,6,"264,85",5,1,1,7,Mid-Value,Potential Loyalists
29454,558,2,"375,29999999999995",4,1,1,6,Mid-Value,Potential Loyalists
29455,221,3,"214,15",5,1,1,7,Mid-Value,Potential Loyalists
29456,863,3,"136,6",3,1,1,5,Low-Value,At Risk Customers
29458,400,2,"30,0",4,1,1,6,Mid-Value,Potential Loyalists
29460,636,1,"10,65",4,1,1,6,Mid-Value,Potential Loyalists
29461,222,1,"43,05",5,1,1,7,Mid-Value,Potential Loyalists
29462,550,5,"139,5",4,1,1,6,Mid-Value,Potential Loyalists
29463,698,1,"19,1",4,1,1,6,Mid-Value,Potential Loyalists
29466,115,1,"11,35",5,1,1,7,Mid-Value,Potential Loyalists
29467,1005,2,"12,9",3,1,1,5,Low-Value,At Risk Customers
29468,271,6,"158,95",5,1,1,7,Mid-Value,Potential Loyalists
29469,143,3,"264,20000000000005",5,1,1,7,Mid-Value,Potential Loyalists
29470,739,12,"854,7",3,3,2,8,High-Value,Potential Loyalists
29472,683,1,"12,85",4,1,1,6,Mid-Value,Potential Loyalists
29473,281,12,"456,70000000000005",5,3,1,9,High-Value,Champions
29474,53,2,"111,4",5,1,1,7,Mid-Value,Potential Loyalists
29475,439,2,"62,5",4,1,1,6,Mid-Value,Potential Loyalists
29476,1770,1,"199,0",1,1,1,3,Low-Value,Lost
29477,1690,1,"96,3",1,1,1,3,Low-Value,Lost
29479,90,1,"52,25",5,1,1,7,Mid-Value,Potential Loyalists
29481,10,5,"462,0",5,1,1,7,Mid-Value,Potential Loyalists
29484,140,5,"691,9",5,1,2,8,High-Value,Potential Loyalists
29486,1497,2,"99,5",1,1,1,3,Low-Value,Lost
29487,1819,1,"20,4",1,1,1,3,Low-Value,Lost
29488,521,3,"133,15",4,1,1,6,Mid-Value,Potential Loyalists
29489,31,1,"26,3",5,1,1,7,Mid-Value,Potential Loyalists
29490,893,2,"1267,4",3,1,2,6,Mid-Value,Potential Loyalists
29491,194,3,"59,45",5,1,1,7,Mid-Value,Potential Loyalists
29492,38,2,"82,8",5,1,1,7,Mid-Value,Potential Loyalists
29493,296,1,"39,1",5,1,1,7,Mid-Value,Potential Loyalists
29494,1824,1,"37,3",1,1,1,3,Low-Value,Lost
29500,223,6,"273,04999999999995",5,1,1,7,Mid-Value,Potential Loyalists
29503,1655,1,"12,75",1,1,1,3,Low-Value,Lost
29504,32,4,"178,79999999999998",5,1,1,7,Mid-Value,Potential Loyalists
29505,864,1,"15,1",3,1,1,5,Low-Value,At Risk Customers
29508,374,9,"381,4",4,2,1,7,Mid-Value,Potential Loyalists
29509,108,6,"209,3",5,1,1,7,Mid-Value,Potential Loyalists
29510,5,2,"80,15",5,1,1,7,Mid-Value,Potential Loyalists
29511,123,7,"424,2",5,2,1,8,High-Value,Potential Loyalists
29515,579,2,"106,60000000000001",4,1,1,6,Mid-Value,Potential Loyalists
29518,257,2,"160,3",5,1,1,7,Mid-Value,Potential Loyalists
29521,15,10,"577,0",5,2,1,8,High-Value,Potential Loyalists
29524,27,1,"39,3",5,1,1,7,Mid-Value,Potential Loyalists
29526,558,1,"32,6",4,1,1,6,Mid-Value,Potential Loyalists
29527,1105,2,"89,10000000000001",2,1,1,4,Low-Value,Can't Lose
29529,64,5,"155,1",5,1,1,7,Mid-Value,Potential Loyalists
29530,726,3,"123,5",4,1,1,6,Mid-Value,Potential Loyalists
29531,930,1,"47,1",3,1,1,5,Low-Value,At Risk Customers
29533,1107,1,"261,1",2,1,1,4,Low-Value,Can't Lose
29534,818,4,"274,4",3,1,1,5,Low-Value,At Risk Customers
29536,240,2,"223,14999999999998",5,1,1,7,Mid-Value,Potential Loyalists
29538,306,2,"47,3",5,1,1,7,Mid-Value,Potential Loyalists
29539,48,3,"355,4",5,1,1,7,Mid-Value,Potential Loyalists
29540,14,5,"189,15",5,1,1,7,Mid-Value,Potential Loyalists
29541,51,2,"69,4",5,1,1,7,Mid-Value,Potential Loyalists
29542,136,2,"25,9",5,1,1,7,Mid-Value,Potential Loyalists
29543,1293,1,"23,9",2,1,1,4,Low-Value,Can't Lose
29544,19,4,"173,29999999999998",5,1,1,7,Mid-Value,Potential Loyalists
29548,23,6,"674,95",5,1,2,8,High-Value,Potential Loyalists
29550,35,2,"168,29999999999998",5,1,1,7,Mid-Value,Potential Loyalists
29551,54,1,"72,55",5,1,1,7,Mid-Value,Potential Loyalists
29552,216,3,"151,9",5,1,1,7,Mid-Value,Potential Loyalists
29553,999,3,"227,05",3,1,1,5,Low-Value,At Risk Customers
29554,123,8,"209,4",5,2,1,8,High-Value,Potential Loyalists
29555,515,3,"904,75",4,1,2,7,Mid-Value,Potential Loyalists
29556,1294,2,"254,25",2,1,1,4,Low-Value,Can't Lose
29557,229,6,"310,0",5,1,1,7,Mid-Value,Potential Loyalists
29559,867,2,"470,94999999999993",3,1,1,5,Low-Value,At Risk Customers
29561,518,1,"106,64999999999999",4,1,1,6,Mid-Value,Potential Loyalists
29562,904,7,"595,95",3,2,1,6,Mid-Value,Potential Loyalists
29566,752,1,"48,8",3,1,1,5,Low-Value,At Risk Customers
29567,528,4,"78,7",4,1,1,6,Mid-Value,Potential Loyalists
29568,410,5,"302,05",4,1,1,6,Mid-Value,Potential Loyalists
29569,668,8,"940,65",4,2,2,8,High-Value,Potential Loyalists
29570,83,8,"501,65",5,2,1,8,High-Value,Potential Loyalists
29573,257,1,"17,3",5,1,1,7,Mid-Value,Potential Loyalists
29574,416,5,"252,8",4,1,1,6,Mid-Value,Potential Loyalists
29575,1427,1,"7,4",2,1,1,4,Low-Value,Can't Lose
29576,369,2,"41,9",4,1,1,6,Mid-Value,Potential Loyalists
29577,349,3,"51,85",5,1,1,7,Mid-Value,Potential Loyalists
29578,125,2,"92,1",5,1,1,7,Mid-Value,Potential Loyalists
29580,92,8,"662,3",5,2,1,8,High-Value,Potential Loyalists
29585,123,4,"246,05",5,1,1,7,Mid-Value,Potential Loyalists
29586,5,10,"607,55",5,2,1,8,High-Value,Potential Loyalists
29587,4,1,"3,5",5,1,1,7,Mid-Value,Potential Loyalists
29589,18,3,"184,55",5,1,1,7,Mid-Value,Potential Loyalists
29590,1026,1,"22,3",3,1,1,5,Low-Value,At Risk Customers
29591,123,9,"339,9",5,2,1,8,High-Value,Potential Loyalists
29592,353,1,"58,35",5,1,1,7,Mid-Value,Potential Loyalists
29594,108,9,"387,15",5,2,1,8,High-Value,Potential Loyalists
29595,51,3,"214,95",5,1,1,7,Mid-Value,Potential Loyalists
29596,1048,2,"157,0",3,1,1,5,Low-Value,At Risk Customers
29597,684,2,"80,1",4,1,1,6,Mid-Value,Potential Loyalists
29599,389,2,"106,7",4,1,1,6,Mid-Value,Potential Loyalists
29600,291,6,"288,84999999999997",5,1,1,7,Mid-Value,Potential Loyalists
29601,1021,1,"18,7",3,1,1,5,Low-Value,At Risk Customers
29603,681,3,"109,6",4,1,1,6,Mid-Value,Potential Loyalists
29604,577,1,"126,3",4,1,1,6,Mid-Value,Potential Loyalists
29607,3,6,"346,7",5,1,1,7,Mid-Value,Potential Loyalists
29609,165,1,"50,2",5,1,1,7,Mid-Value,Potential Loyalists
29611,747,2,"151,05",3,1,1,5,Low-Value,At Risk Customers
29613,1705,1,"43,85",1,1,1,3,Low-Value,Lost
29614,340,2,"62,25",5,1,1,7,Mid-Value,Potential Loyalists
29615,1776,1,"38,3",1,1,1,3,Low-Value,Lost
29616,1223,1,"31,45",2,1,1,4,Low-Value,Can't Lose
29618,405,1,"58,6",4,1,1,6,Mid-Value,Potential Loyalists
29619,1123,3,"149,9",2,1,1,4,Low-Value,Can't Lose
29620,772,1,"77,85",3,1,1,5,Low-Value,At Risk Customers
29621,29,4,"241,39999999999998",5,1,1,7,Mid-Value,Potential Loyalists
29622,1519,1,"47,65",1,1,1,3,Low-Value,Lost
29623,243,6,"221,15",5,1,1,7,Mid-Value,Potential Loyalists
29624,740,7,"476,45",3,2,1,6,Mid-Value,Potential Loyalists
29625,994,1,"15,45",3,1,1,5,Low-Value,At Risk Customers
29626,848,3,"59,4",3,1,1,5,Low-Value,At Risk Customers
29627,49,10,"924,15",5,2,2,9,High-Value,Champions
29628,443,3,"246,05",4,1,1,6,Mid-Value,Potential Loyalists
29629,805,2,"71,0",3,1,1,5,Low-Value,At Risk Customers
29630,883,1,"100,6",3,1,1,5,Low-Value,At Risk Customers
29631,72,5,"568,05",5,1,1,7,Mid-Value,Potential Loyalists
29632,1282,2,"56,75",2,1,1,4,Low-Value,Can't Lose
29633,1404,1,"135,0",2,1,1,4,Low-Value,Can't Lose
29634,584,2,"55,2",4,1,1,6,Mid-Value,Potential Loyalists
29635,1346,2,"80,2",2,1,1,4,Low-Value,Can't Lose
29637,528,3,"569,55",4,1,1,6,Mid-Value,Potential Loyalists
29638,1305,4,"216,65",2,1,1,4,Low-Value,Can't Lose
29639,1129,1,"238,95",2,1,1,4,Low-Value,Can't Lose
29640,362,10,"653,35",5,2,1,8,High-Value,Potential Loyalists
29643,771,1,"10,3",3,1,1,5,Low-Value,At Risk Customers
29644,564,4,"238,65",4,1,1,6,Mid-Value,Potential Loyalists
29645,100,9,"575,7",5,2,1,8,High-Value,Potential Loyalists
29646,719,2,"218,85000000000002",4,1,1,6,Mid-Value,Potential Loyalists
29647,755,3,"380,0",3,1,1,5,Low-Value,At Risk Customers
29648,1189,1,"34,5",2,1,1,4,Low-Value,Can't Lose
29651,367,1,"125,8",4,1,1,6,Mid-Value,Potential Loyalists
29652,1220,3,"84,44999999999999",2,1,1,4,Low-Value,Can't Lose
29653,31,1,"43,0",5,1,1,7,Mid-Value,Potential Loyalists
29654,145,1,"28,4",5,1,1,7,Mid-Value,Potential Loyalists
29655,572,3,"95,45",4,1,1,6,Mid-Value,Potential Loyalists
29656,75,1,"6,55",5,1,1,7,Mid-Value,Potential Loyalists
29657,851,1,"24,3",3,1,1,5,Low-Value,At Risk Customers
29659,54,3,"203,25",5,1,1,7,Mid-Value,Potential Loyalists
29661,174,6,"395,05",5,1,1,7,Mid-Value,Potential Loyalists
29663,1558,1,"43,7",1,1,1,3,Low-Value,Lost
29667,367,2,"80,25",4,1,1,6,Mid-Value,Potential Loyalists
29668,440,8,"1077,15",4,2,2,8,High-Value,Potential Loyalists
29669,1237,4,"70,39999999999999",2,1,1,4,Low-Value,Can't Lose
29672,1235,2,"48,3",2,1,1,4,Low-Value,Can't Lose
29673,25,5,"426,70000000000005",5,1,1,7,Mid-Value,Potential Loyalists
29674,639,2,"35,4",4,1,1,6,Mid-Value,Potential Loyalists
29675,1187,2,"50,300000000000004",2,1,1,4,Low-Value,Can't Lose
29676,196,5,"390,6",5,1,1,7,Mid-Value,Potential Loyalists
29677,270,3,"638,7",5,1,1,7,Mid-Value,Potential Loyalists
29679,94,1,"24,3",5,1,1,7,Mid-Value,Potential Loyalists
29680,839,1,"26,15",3,1,1,5,Low-Value,At Risk Customers
29681,58,5,"595,6",5,1,1,7,Mid-Value,Potential Loyalists
29683,110,3,"144,2",5,1,1,7,Mid-Value,Potential Loyalists
29684,606,3,"271,95",4,1,1,6,Mid-Value,Potential Loyalists
29688,3,10,"628,5",5,2,1,8,High-Value,Potential Loyalists
29689,192,2,"130,8",5,1,1,7,Mid-Value,Potential Loyalists
29690,187,1,"15,3",5,1,1,7,Mid-Value,Potential Loyalists
29692,129,4,"449,20000000000005",5,1,1,7,Mid-Value,Potential Loyalists
29693,949,1,"30,9",3,1,1,5,Low-Value,At Risk Customers
29695,1473,2,"251,5",1,1,1,3,Low-Value,Lost
29696,803,3,"80,9",3,1,1,5,Low-Value,At Risk Customers
29697,186,2,"159,29999999999998",5,1,1,7,Mid-Value,Potential Loyalists
29698,1698,1,"51,75",1,1,1,3,Low-Value,Lost
29699,382,2,"125,7",4,1,1,6,Mid-Value,Potential Loyalists
29700,801,4,"206,7",3,1,1,5,Low-Value,At Risk Customers
29701,218,1,"39,1",5,1,1,7,Mid-Value,Potential Loyalists
29704,127,6,"351,95000000000005",5,1,1,7,Mid-Value,Potential Loyalists
29706,454,1,"68,2",4,1,1,6,Mid-Value,Potential Loyalists
29708,564,6,"303,6",4,1,1,6,Mid-Value,Potential Loyalists
29711,411,3,"60,9",4,1,1,6,Mid-Value,Potential Loyalists
29712,208,4,"179,75",5,1,1,7,Mid-Value,Potential Loyalists
29713,0,5,"151,29999999999998",5,1,1,7,Mid-Value,Potential Loyalists
29714,1184,1,"14,5",2,1,1,4,Low-Value,Can't Lose
29717,91,2,"294,45",5,1,1,7,Mid-Value,Potential Loyalists
29718,91,12,"532,55",5,3,1,9,High-Value,Champions
29719,253,3,"619,45",5,1,1,7,Mid-Value,Potential Loyalists
29721,758,2,"57,15",3,1,1,5,Low-Value,At Risk Customers
29724,1103,3,"134,45",2,1,1,4,Low-Value,Can't Lose
29725,691,2,"159,70000000000002",4,1,1,6,Mid-Value,Potential Loyalists
29726,507,2,"160,5",4,1,1,6,Mid-Value,Potential Loyalists
29730,221,5,"457,59999999999997",5,1,1,7,Mid-Value,Potential Loyalists
29732,162,5,"88,5",5,1,1,7,Mid-Value,Potential Loyalists
29733,454,9,"761,25",4,2,2,8,High-Value,Potential Loyalists
29734,763,6,"390,2",3,1,1,5,Low-Value,At Risk Customers
29735,880,2,"86,55000000000001",3,1,1,5,Low-Value,At Risk Customers
29737,1665,1,"286,0",1,1,1,3,Low-Value,Lost
29738,181,4,"459,0",5,1,1,7,Mid-Value,Potential Loyalists
29740,1289,3,"142,05",2,1,1,4,Low-Value,Can't Lose
29741,9,2,"89,4",5,1,1,7,Mid-Value,Potential Loyalists
29742,875,2,"215,75",3,1,1,5,Low-Value,At Risk Customers
29743,960,2,"48,6",3,1,1,5,Low-Value,At Risk Customers
29744,165,4,"245,75",5,1,1,7,Mid-Value,Potential Loyalists
29745,1666,1,"53,2",1,1,1,3,Low-Value,Lost
29747,245,4,"447,90000000000003",5,1,1,7,Mid-Value,Potential Loyalists
29748,1368,1,"17,2",2,1,1,4,Low-Value,Can't Lose
29751,127,4,"191,05",5,1,1,7,Mid-Value,Potential Loyalists
29752,207,8,"376,1",5,2,1,8,High-Value,Potential Loyalists
29753,282,6,"337,45",5,1,1,7,Mid-Value,Potential Loyalists
29755,466,10,"816,4",4,2,2,8,High-Value,Potential Loyalists
29756,244,4,"114,15",5,1,1,7,Mid-Value,Potential Loyalists
29758,1067,1,"21,75",3,1,1,5,Low-Value,At Risk Customers
29759,769,2,"107,95",3,1,1,5,Low-Value,At Risk Customers
29762,1687,1,"60,1",1,1,1,3,Low-Value,Lost
29763,707,1,"86,45",4,1,1,6,Mid-Value,Potential Loyalists
29765,12,6,"412,4",5,1,1,7,Mid-Value,Potential Loyalists
29767,481,1,"20,9",4,1,1,6,Mid-Value,Potential Loyalists
29768,1195,1,"16,45",2,1,1,4,Low-Value,Can't Lose
29769,176,12,"993,95",5,3,2,10,High-Value,Champions
29770,185,4,"290,5",5,1,1,7,Mid-Value,Potential Loyalists
29772,104,5,"238,35",5,1,1,7,Mid-Value,Potential Loyalists
29774,267,4,"337,45",5,1,1,7,Mid-Value,Potential Loyalists
29777,171,17,"1323,35",5,4,2,11,High-Value,Champions
29778,133,2,"33,800000000000004",5,1,1,7,Mid-Value,Potential Loyalists
29780,1238,3,"49,5",2,1,1,4,Low-Value,Can't Lose
29781,263,4,"122,55000000000001",5,1,1,7,Mid-Value,Potential Loyalists
29782,239,3,"40,5",5,1,1,7,Mid-Value,Potential Loyalists
29783,469,2,"137,2",4,1,1,6,Mid-Value,Potential Loyalists
29785,594,2,"76,44999999999999",4,1,1,6,Mid-Value,Potential Loyalists
29786,125,3,"50,25",5,1,1,7,Mid-Value,Potential Loyalists
29788,832,2,"144,95",3,1,1,5,Low-Value,At Risk Customers
29789,238,6,"273,1",5,1,1,7,Mid-Value,Potential Loyalists
29791,372,7,"360,8",4,2,1,7,Mid-Value,Potential Loyalists
29792,197,1,"10,8",5,1,1,7,Mid-Value,Potential Loyalists
29793,569,3,"151,75",4,1,1,6,Mid-Value,Potential Loyalists
29794,123,3,"217,85",5,1,1,7,Mid-Value,Potential Loyalists
29795,27,5,"123,14999999999999",5,1,1,7,Mid-Value,Potential Loyalists
29796,277,7,"393,9",5,2,1,8,High-Value,Potential Loyalists
29798,1335,3,"188,7",2,1,1,4,Low-Value,Can't Lose
29799,448,4,"165,6",4,1,1,6,Mid-Value,Potential Loyalists
29801,464,5,"294,45000000000005",4,1,1,6,Mid-Value,Potential Loyalists
29802,445,1,"5,55",4,1,1,6,Mid-Value,Potential Loyalists
29803,902,2,"41,25",3,1,1,5,Low-Value,At Risk Customers
29805,534,4,"139,6",4,1,1,6,Mid-Value,Potential Loyalists
29806,444,5,"127,05000000000001",4,1,1,6,Mid-Value,Potential Loyalists
29808,758,1,"84,0",3,1,1,5,Low-Value,At Risk Customers
29809,137,9,"745,75",5,2,2,9,High-Value,Champions
29810,207,2,"41,85",5,1,1,7,Mid-Value,Potential Loyalists
29812,771,1,"42,5",3,1,1,5,Low-Value,At Risk Customers
29813,511,2,"156,0",4,1,1,6,Mid-Value,Potential Loyalists
29815,1474,1,"45,6",1,1,1,3,Low-Value,Lost
29816,224,2,"60,55",5,1,1,7,Mid-Value,Potential Loyalists
29817,242,2,"109,55",5,1,1,7,Mid-Value,Potential Loyalists
29818,48,5,"577,15",5,1,1,7,Mid-Value,Potential Loyalists
29819,1133,3,"160,60000000000002",2,1,1,4,Low-Value,Can't Lose
29820,1776,1,"146,3",1,1,1,3,Low-Value,Lost
29821,1216,1,"105,6",2,1,1,4,Low-Value,Can't Lose
29822,73,3,"67,14999999999999",5,1,1,7,Mid-Value,Potential Loyalists
29823,920,1,"33,6",3,1,1,5,Low-Value,At Risk Customers
29825,985,1,"6,8",3,1,1,5,Low-Value,At Risk Customers
29826,988,1,"19,25",3,1,1,5,Low-Value,At Risk Customers
29828,406,4,"34,4",4,1,1,6,Mid-Value,Potential Loyalists
29830,177,2,"149,0",5,1,1,7,Mid-Value,Potential Loyalists
29832,602,1,"51,449999999999996",4,1,1,6,Mid-Value,Potential Loyalists
29834,127,7,"1063,01",5,2,2,9,High-Value,Champions
29835,1033,2,"112,1",3,1,1,5,Low-Value,At Risk Customers
29836,736,4,"229,35",3,1,1,5,Low-Value,At Risk Customers
29838,1154,3,"40,1",2,1,1,4,Low-Value,Can't Lose
29839,33,3,"313,59999999999997",5,1,1,7,Mid-Value,Potential Loyalists
29840,435,4,"516,6500000000001",4,1,1,6,Mid-Value,Potential Loyalists
29841,58,3,"36,65",5,1,1,7,Mid-Value,Potential Loyalists
29845,529,4,"239,25",4,1,1,6,Mid-Value,Potential Loyalists
29847,813,3,"201,84999999999997",3,1,1,5,Low-Value,At Risk Customers
29848,1587,2,"494,85",1,1,1,3,Low-Value,Lost
29849,1034,1,"39,8",3,1,1,5,Low-Value,At Risk Customers
29850,879,2,"137,05",3,1,1,5,Low-Value,At Risk Customers
29851,1761,1,"6,05",1,1,1,3,Low-Value,Lost
29853,750,4,"238,75",3,1,1,5,Low-Value,At Risk Customers
29854,280,4,"209,60000000000002",5,1,1,7,Mid-Value,Potential Loyalists
29855,938,2,"282,8",3,1,1,5,Low-Value,At Risk Customers
29857,317,3,"182,05",5,1,1,7,Mid-Value,Potential Loyalists
29858,440,1,"67,35",4,1,1,6,Mid-Value,Potential Loyalists
29859,19,6,"304,05",5,1,1,7,Mid-Value,Potential Loyalists
29861,176,6,"201,0",5,1,1,7,Mid-Value,Potential Loyalists
29862,55,6,"449,59999999999997",5,1,1,7,Mid-Value,Potential Loyalists
29864,813,3,"127,45",3,1,1,5,Low-Value,At Risk Customers
29868,367,5,"160,95",4,1,1,6,Mid-Value,Potential Loyalists
29869,764,7,"401,6",3,2,1,6,Mid-Value,Potential Loyalists
29870,582,1,"48,65",4,1,1,6,Mid-Value,Potential Loyalists
29871,188,2,"212,70000000000002",5,1,1,7,Mid-Value,Potential Loyalists
29872,900,1,"32,7",3,1,1,5,Low-Value,At Risk Customers
29873,227,5,"573,75",5,1,1,7,Mid-Value,Potential Loyalists
29875,25,3,"216,2",5,1,1,7,Mid-Value,Potential Loyalists
29876,1172,2,"159,75",2,1,1,4,Low-Value,Can't Lose
29877,1050,1,"96,75",3,1,1,5,Low-Value,At Risk Customers
29881,13,2,"69,1",5,1,1,7,Mid-Value,Potential Loyalists
29882,605,1,"102,30000000000001",4,1,1,6,Mid-Value,Potential Loyalists
29884,669,1,"2,75",4,1,1,6,Mid-Value,Potential Loyalists
29885,5,13,"557,0",5,3,1,9,High-Value,Champions
29888,13,2,"19,0",5,1,1,7,Mid-Value,Potential Loyalists
29889,832,1,"5,65",3,1,1,5,Low-Value,At Risk Customers
29891,1389,3,"200,6",2,1,1,4,Low-Value,Can't Lose
29892,626,4,"390,8",4,1,1,6,Mid-Value,Potential Loyalists
29895,497,1,"38,5",4,1,1,6,Mid-Value,Potential Loyalists
29896,947,1,"23,65",3,1,1,5,Low-Value,At Risk Customers
29897,366,6,"292,7",4,1,1,6,Mid-Value,Potential Loyalists
29898,102,2,"159,05",5,1,1,7,Mid-Value,Potential Loyalists
29901,1788,1,"9,95",1,1,1,3,Low-Value,Lost
29903,917,1,"67,25",3,1,1,5,Low-Value,At Risk Customers
29904,257,7,"142,65",5,2,1,8,High-Value,Potential Loyalists
29905,798,5,"202,0",3,1,1,5,Low-Value,At Risk Customers
29906,684,4,"253,09999999999997",4,1,1,6,Mid-Value,Potential Loyalists
29907,89,4,"62,6",5,1,1,7,Mid-Value,Potential Loyalists
29910,1404,1,"147,3",2,1,1,4,Low-Value,Can't Lose
29915,1313,1,"178,2",2,1,1,4,Low-Value,Can't Lose
29916,4,4,"326,40000000000003",5,1,1,7,Mid-Value,Potential Loyalists
29917,11,7,"454,9",5,2,1,8,High-Value,Potential Loyalists
29918,1142,2,"338,9",2,1,1,4,Low-Value,Can't Lose
29919,417,1,"24,1",4,1,1,6,Mid-Value,Potential Loyalists
29920,725,1,"40,75",4,1,1,6,Mid-Value,Potential Loyalists
29922,133,5,"224,2",5,1,1,7,Mid-Value,Potential Loyalists
29923,1384,2,"85,7",2,1,1,4,Low-Value,Can't Lose
29924,118,8,"464,4",5,2,1,8,High-Value,Potential Loyalists
29925,1272,3,"99,89999999999999",2,1,1,4,Low-Value,Can't Lose
29926,1347,3,"74,5",2,1,1,4,Low-Value,Can't Lose
29927,8,2,"114,05000000000001",5,1,1,7,Mid-Value,Potential Loyalists
29929,206,6,"538,4499999999999",5,1,1,7,Mid-Value,Potential Loyalists
29930,595,2,"67,9",4,1,1,6,Mid-Value,Potential Loyalists
29932,781,4,"598,85",3,1,1,5,Low-Value,At Risk Customers
29933,815,2,"129,45",3,1,1,5,Low-Value,At Risk Customers
29934,422,1,"250,5",4,1,1,6,Mid-Value,Potential Loyalists
29935,109,10,"696,45",5,2,2,9,High-Value,Champions
29937,1106,2,"90,15",2,1,1,4,Low-Value,Can't Lose
29938,338,5,"356,05",5,1,1,7,Mid-Value,Potential Loyalists
29939,373,3,"352,8",4,1,1,6,Mid-Value,Potential Loyalists
29940,358,5,"229,8",5,1,1,7,Mid-Value,Potential Loyalists
29943,65,3,"149,15",5,1,1,7,Mid-Value,Potential Loyalists
29944,83,8,"583,45",5,2,1,8,High-Value,Potential Loyalists
29945,956,1,"28,55",3,1,1,5,Low-Value,At Risk Customers
29947,552,2,"235,95",4,1,1,6,Mid-Value,Potential Loyalists
29948,76,2,"20,65",5,1,1,7,Mid-Value,Potential Loyalists
29949,1180,3,"822,5",2,1,2,5,Low-Value,At Risk Customers
29950,662,2,"79,1",4,1,1,6,Mid-Value,Potential Loyalists
29951,1694,1,"513,2",1,1,1,3,Low-Value,Lost
29953,214,1,"11,1",5,1,1,7,Mid-Value,Potential Loyalists
29954,72,4,"196,20000000000002",5,1,1,7,Mid-Value,Potential Loyalists
29955,201,1,"36,1",5,1,1,7,Mid-Value,Potential Loyalists
29956,598,1,"251,3",4,1,1,6,Mid-Value,Potential Loyalists
29961,1184,2,"80,4",2,1,1,4,Low-Value,Can't Lose
29962,580,2,"350,09999999999997",4,1,1,6,Mid-Value,Potential Loyalists
29964,1529,2,"33,8",1,1,1,3,Low-Value,Lost
29965,224,1,"9,55",5,1,1,7,Mid-Value,Potential Loyalists
29966,1017,1,"18,05",3,1,1,5,Low-Value,At Risk Customers
29967,733,1,"24,2",3,1,1,5,Low-Value,At Risk Customers
29968,991,1,"21,65",3,1,1,5,Low-Value,At Risk Customers
29973,1711,1,"33,25",1,1,1,3,Low-Value,Lost
29974,1144,1,"17,4",2,1,1,4,Low-Value,Can't Lose
29977,706,2,"841,0",4,1,2,7,Mid-Value,Potential Loyalists
29978,204,1,"68,2",5,1,1,7,Mid-Value,Potential Loyalists
29979,4,4,"286,25",5,1,1,7,Mid-Value,Potential Loyalists
29980,66,13,"810,75",5,3,2,10,High-Value,Champions
29981,711,2,"141,05",4,1,1,6,Mid-Value,Potential Loyalists
29984,521,10,"777,25",4,2,2,8,High-Value,Potential Loyalists
29985,123,4,"374,7",5,1,1,7,Mid-Value,Potential Loyalists
29993,951,3,"307,6",3,1,1,5,Low-Value,At Risk Customers
29995,1138,2,"270,5",2,1,1,4,Low-Value,Can't Lose
29996,32,6,"298,95",5,1,1,7,Mid-Value,Potential Loyalists
29997,137,1,"49,3",5,1,1,7,Mid-Value,Potential Loyalists
29999,154,3,"97,80000000000001",5,1,1,7,Mid-Value,Potential Loyalists
30000,348,5,"425,1",5,1,1,7,Mid-Value,Potential Loyalists
30001,696,2,"46,8",4,1,1,6,Mid-Value,Potential Loyalists
30002,806,4,"116,8",3,1,1,5,Low-Value,At Risk Customers
30006,731,8,"574,25",3,2,1,6,Mid-Value,Potential Loyalists
30007,781,5,"323,2",3,1,1,5,Low-Value,At Risk Customers
30009,225,1,"7,0",5,1,1,7,Mid-Value,Potential Loyalists
30011,47,2,"69,55",5,1,1,7,Mid-Value,Potential Loyalists
30012,264,1,"15,4",5,1,1,7,Mid-Value,Potential Loyalists
30014,144,4,"327,59999999999997",5,1,1,7,Mid-Value,Potential Loyalists
30015,1281,2,"101,1",2,1,1,4,Low-Value,Can't Lose
30016,763,3,"108,5",3,1,1,5,Low-Value,At Risk Customers
30018,358,3,"127,55",5,1,1,7,Mid-Value,Potential Loyalists
30019,515,1,"75,9",4,1,1,6,Mid-Value,Potential Loyalists
30022,781,2,"80,7",3,1,1,5,Low-Value,At Risk Customers
30023,754,2,"263,2",3,1,1,5,Low-Value,At Risk Customers
30025,1177,1,"58,5",2,1,1,4,Low-Value,Can't Lose
30026,814,4,"94,65",3,1,1,5,Low-Value,At Risk Customers
30027,262,4,"94,0",5,1,1,7,Mid-Value,Potential Loyalists
30028,955,3,"199,85000000000002",3,1,1,5,Low-Value,At Risk Customers
30031,130,2,"135,3",5,1,1,7,Mid-Value,Potential Loyalists
30033,1004,1,"112,85",3,1,1,5,Low-Value,At Risk Customers
30035,929,1,"84,9",3,1,1,5,Low-Value,At Risk Customers
30037,158,2,"107,1",5,1,1,7,Mid-Value,Potential Loyalists
30038,1116,2,"30,65",2,1,1,4,Low-Value,Can't Lose
30039,446,4,"104,9",4,1,1,6,Mid-Value,Potential Loyalists
30040,1485,2,"22,3",1,1,1,3,Low-Value,Lost
30041,175,3,"374,85",5,1,1,7,Mid-Value,Potential Loyalists
30042,346,4,"172,10000000000002",5,1,1,7,Mid-Value,Potential Loyalists
30044,66,7,"176,35",5,2,1,8,High-Value,Potential Loyalists
30047,1755,1,"11,0",1,1,1,3,Low-Value,Lost
30049,1666,1,"5,2",1,1,1,3,Low-Value,Lost
30051,1166,1,"27,75",2,1,1,4,Low-Value,Can't Lose
30052,0,5,"198,3",5,1,1,7,Mid-Value,Potential Loyalists
30054,1,7,"384,05",5,2,1,8,High-Value,Potential Loyalists
30056,756,5,"330,2",3,1,1,5,Low-Value,At Risk Customers
30057,357,2,"140,35000000000002",5,1,1,7,Mid-Value,Potential Loyalists
30059,4,8,"1117,85",5,2,2,9,High-Value,Champions
30060,1170,1,"2,9",2,1,1,4,Low-Value,Can't Lose
30061,678,2,"104,65",4,1,1,6,Mid-Value,Potential Loyalists
30062,19,2,"47,75",5,1,1,7,Mid-Value,Potential Loyalists
30063,259,17,"1815,95",5,4,3,12,High-Value,Champions
30066,1,5,"350,59999999999997",5,1,1,7,Mid-Value,Potential Loyalists
30067,1009,3,"158,45000000000002",3,1,1,5,Low-Value,At Risk Customers
30068,553,1,"129,9",4,1,1,6,Mid-Value,Potential Loyalists
30069,521,10,"433,3",4,2,1,7,Mid-Value,Potential Loyalists
30071,939,3,"59,25",3,1,1,5,Low-Value,At Risk Customers
30073,430,1,"83,4",4,1,1,6,Mid-Value,Potential Loyalists
30075,1032,1,"13,15",3,1,1,5,Low-Value,At Risk Customers
30077,132,6,"157,95",5,1,1,7,Mid-Value,Potential Loyalists
30079,1662,2,"216,10000000000002",1,1,1,3,Low-Value,Lost
30080,417,3,"218,2",4,1,1,6,Mid-Value,Potential Loyalists
30081,1432,2,"83,55",2,1,1,4,Low-Value,Can't Lose
30082,62,9,"748,5",5,2,2,9,High-Value,Champions
30084,36,7,"553,3",5,2,1,8,High-Value,Potential Loyalists
30085,4,3,"85,9",5,1,1,7,Mid-Value,Potential Loyalists
30086,209,2,"81,5",5,1,1,7,Mid-Value,Potential Loyalists
30089,1508,1,"172,8",1,1,1,3,Low-Value,Lost
30091,799,1,"10,3",3,1,1,5,Low-Value,At Risk Customers
30092,1366,1,"10,23",2,1,1,4,Low-Value,Can't Lose
30093,693,6,"241,85000000000002",4,1,1,6,Mid-Value,Potential Loyalists
30094,1128,1,"61,2",2,1,1,4,Low-Value,Can't Lose
30095,161,3,"154,8",5,1,1,7,Mid-Value,Potential Loyalists
30097,56,3,"109,44999999999999",5,1,1,7,Mid-Value,Potential Loyalists
30100,377,2,"28,85",4,1,1,6,Mid-Value,Potential Loyalists
30102,23,6,"331,5",5,1,1,7,Mid-Value,Potential Loyalists
30103,423,3,"183,15",4,1,1,6,Mid-Value,Potential Loyalists
30104,1593,1,"40,75",1,1,1,3,Low-Value,Lost
30105,367,12,"647,8",4,3,1,8,High-Value,Potential Loyalists
30106,146,7,"525,6",5,2,1,8,High-Value,Potential Loyalists
30107,560,5,"340,35",4,1,1,6,Mid-Value,Potential Loyalists
30109,525,1,"47,5",4,1,1,6,Mid-Value,Potential Loyalists
30111,181,3,"239,95",5,1,1,7,Mid-Value,Potential Loyalists
30112,258,3,"124,5",5,1,1,7,Mid-Value,Potential Loyalists
30116,764,1,"42,0",3,1,1,5,Low-Value,At Risk Customers
30118,1196,3,"160,0",2,1,1,4,Low-Value,Can't Lose
30120,365,2,"221,1",5,1,1,7,Mid-Value,Potential Loyalists
30121,4,13,"757,9",5,3,2,10,High-Value,Champions
30123,578,3,"388,25",4,1,1,6,Mid-Value,Potential Loyalists
30124,901,3,"44,65",3,1,1,5,Low-Value,At Risk Customers
30125,1046,2,"45,400000000000006",3,1,1,5,Low-Value,At Risk Customers
30126,507,1,"96,0",4,1,1,6,Mid-Value,Potential Loyalists
30128,869,2,"66,7",3,1,1,5,Low-Value,At Risk Customers
30130,8,4,"218,05",5,1,1,7,Mid-Value,Potential Loyalists
30132,89,3,"56,0",5,1,1,7,Mid-Value,Potential Loyalists
30133,110,9,"722,15",5,2,2,9,High-Value,Champions
30134,970,1,"5,8",3,1,1,5,Low-Value,At Risk Customers
30135,703,3,"466,75",4,1,1,6,Mid-Value,Potential Loyalists
30138,231,5,"229,70000000000002",5,1,1,7,Mid-Value,Potential Loyalists
30139,646,1,"31,6",4,1,1,6,Mid-Value,Potential Loyalists
30140,1312,1,"12,6",2,1,1,4,Low-Value,Can't Lose
30141,781,1,"43,7",3,1,1,5,Low-Value,At Risk Customers
30142,139,6,"129,15",5,1,1,7,Mid-Value,Potential Loyalists
30146,13,5,"300,09999999999997",5,1,1,7,Mid-Value,Potential Loyalists
30147,3,6,"367,45",5,1,1,7,Mid-Value,Potential Loyalists
30148,153,2,"112,44999999999999",5,1,1,7,Mid-Value,Potential Loyalists
30149,97,7,"354,05",5,2,1,8,High-Value,Potential Loyalists
30150,704,3,"168,6",4,1,1,6,Mid-Value,Potential Loyalists
30151,1211,1,"24,5",2,1,1,4,Low-Value,Can't Lose
30153,356,6,"396,3",5,1,1,7,Mid-Value,Potential Loyalists
30155,386,2,"92,25",4,1,1,6,Mid-Value,Potential Loyalists
30156,25,4,"216,4",5,1,1,7,Mid-Value,Potential Loyalists
30157,115,9,"519,75",5,2,1,8,High-Value,Potential Loyalists
30158,44,6,"307,45000000000005",5,1,1,7,Mid-Value,Potential Loyalists
30160,870,2,"25,299999999999997",3,1,1,5,Low-Value,At Risk Customers
30163,21,8,"651,25",5,2,1,8,High-Value,Potential Loyalists
30164,108,3,"152,9",5,1,1,7,Mid-Value,Potential Loyalists
30165,644,1,"250,7",4,1,1,6,Mid-Value,Potential Loyalists
30166,374,1,"41,9",4,1,1,6,Mid-Value,Potential Loyalists
30167,104,3,"131,8",5,1,1,7,Mid-Value,Potential Loyalists
30171,131,1,"18,6",5,1,1,7,Mid-Value,Potential Loyalists
30172,5,7,"298,0",5,2,1,8,High-Value,Potential Loyalists
30173,35,1,"27,05",5,1,1,7,Mid-Value,Potential Loyalists
30174,84,1,"23,45",5,1,1,7,Mid-Value,Potential Loyalists
30176,1779,1,"101,6",1,1,1,3,Low-Value,Lost
30177,426,14,"579,6",4,3,1,8,High-Value,Potential Loyalists
30179,647,1,"43,4",4,1,1,6,Mid-Value,Potential Loyalists
30181,1251,1,"9,5",2,1,1,4,Low-Value,Can't Lose
30182,427,2,"52,4",4,1,1,6,Mid-Value,Potential Loyalists
30184,979,1,"27,8",3,1,1,5,Low-Value,At Risk Customers
30186,1111,2,"146,25",2,1,1,4,Low-Value,Can't Lose
30187,95,2,"176,75",5,1,1,7,Mid-Value,Potential Loyalists
30188,31,3,"143,10000000000002",5,1,1,7,Mid-Value,Potential Loyalists
30189,1575,2,"51,150000000000006",1,1,1,3,Low-Value,Lost
30190,98,5,"508,35",5,1,1,7,Mid-Value,Potential Loyalists
30191,1366,1,"248,6",2,1,1,4,Low-Value,Can't Lose
30193,294,2,"81,05",5,1,1,7,Mid-Value,Potential Loyalists
30194,438,3,"383,0",4,1,1,6,Mid-Value,Potential Loyalists
30195,187,4,"366,1",5,1,1,7,Mid-Value,Potential Loyalists
30196,332,2,"81,4",5,1,1,7,Mid-Value,Potential Loyalists
30197,567,2,"60,650000000000006",4,1,1,6,Mid-Value,Potential Loyalists
30199,479,3,"80,9",4,1,1,6,Mid-Value,Potential Loyalists
30200,326,3,"268,35",5,1,1,7,Mid-Value,Potential Loyalists
30201,201,2,"76,05",5,1,1,7,Mid-Value,Potential Loyalists
30202,776,2,"72,3",3,1,1,5,Low-Value,At Risk Customers
30203,446,1,"12,1",4,1,1,6,Mid-Value,Potential Loyalists
30204,283,5,"134,9",5,1,1,7,Mid-Value,Potential Loyalists
30205,78,10,"263,95",5,2,1,8,High-Value,Potential Loyalists
30206,1609,1,"171,0",1,1,1,3,Low-Value,Lost
30207,1072,1,"135,4",3,1,1,5,Low-Value,At Risk Customers
30208,1,6,"300,75",5,1,1,7,Mid-Value,Potential Loyalists
30209,95,4,"202,95",5,1,1,7,Mid-Value,Potential Loyalists
30210,2,10,"292,3",5,2,1,8,High-Value,Potential Loyalists
30214,24,3,"87,05",5,1,1,7,Mid-Value,Potential Loyalists
30215,385,2,"207,35000000000002",4,1,1,6,Mid-Value,Potential Loyalists
30217,9,2,"325,9",5,1,1,7,Mid-Value,Potential Loyalists
30220,448,3,"143,35000000000002",4,1,1,6,Mid-Value,Potential Loyalists
30221,1114,3,"996,3000000000001",2,1,2,5,Low-Value,At Risk Customers
30222,132,5,"146,20000000000002",5,1,1,7,Mid-Value,Potential Loyalists
30224,1664,1,"18,3",1,1,1,3,Low-Value,Lost
30225,1315,2,"189,75",2,1,1,4,Low-Value,Can't Lose
30226,1031,2,"315,75",3,1,1,5,Low-Value,At Risk Customers
30227,348,6,"507,8",5,1,1,7,Mid-Value,Potential Loyalists
30228,52,4,"338,2",5,1,1,7,Mid-Value,Potential Loyalists
30232,757,2,"170,2",3,1,1,5,Low-Value,At Risk Customers
30234,1155,1,"31,95",2,1,1,4,Low-Value,Can't Lose
30238,1254,2,"133,85",2,1,1,4,Low-Value,Can't Lose
30240,552,2,"111,89999999999999",4,1,1,6,Mid-Value,Potential Loyalists
30243,894,2,"72,55000000000001",3,1,1,5,Low-Value,At Risk Customers
30245,437,3,"520,65",4,1,1,6,Mid-Value,Potential Loyalists
30246,529,3,"149,3",4,1,1,6,Mid-Value,Potential Loyalists
30247,901,1,"62,3",3,1,1,5,Low-Value,At Risk Customers
30250,143,10,"968,15",5,2,2,9,High-Value,Champions
30251,33,5,"139,2",5,1,1,7,Mid-Value,Potential Loyalists
30253,741,8,"709,85",3,2,2,7,Mid-Value,Potential Loyalists
30254,188,5,"395,7",5,1,1,7,Mid-Value,Potential Loyalists
30256,1072,1,"95,65",3,1,1,5,Low-Value,At Risk Customers
30257,939,3,"196,79999999999998",3,1,1,5,Low-Value,At Risk Customers
30258,572,7,"668,0",4,2,2,8,High-Value,Potential Loyalists
30262,1632,1,"51,9",1,1,1,3,Low-Value,Lost
30265,300,2,"35,2",5,1,1,7,Mid-Value,Potential Loyalists
30267,143,1,"81,5",5,1,1,7,Mid-Value,Potential Loyalists
30268,229,3,"531,2",5,1,1,7,Mid-Value,Potential Loyalists
30270,40,13,"417,0",5,3,1,9,High-Value,Champions
30271,785,2,"100,5",3,1,1,5,Low-Value,At Risk Customers
30272,342,1,"8,25",5,1,1,7,Mid-Value,Potential Loyalists
30274,1176,1,"5,05",2,1,1,4,Low-Value,Can't Lose
30277,1338,3,"52,599999999999994",2,1,1,4,Low-Value,Can't Lose
30279,206,1,"4,85",5,1,1,7,Mid-Value,Potential Loyalists
30283,1686,1,"552,0",1,1,1,3,Low-Value,Lost
30285,1023,2,"53,93000000000001",3,1,1,5,Low-Value,At Risk Customers
30286,28,4,"136,8",5,1,1,7,Mid-Value,Potential Loyalists
30287,778,7,"250,7",3,2,1,6,Mid-Value,Potential Loyalists
30290,420,3,"78,85",4,1,1,6,Mid-Value,Potential Loyalists
30291,224,1,"25,5",5,1,1,7,Mid-Value,Potential Loyalists
30292,263,3,"109,8",5,1,1,7,Mid-Value,Potential Loyalists
30293,24,7,"175,7",5,2,1,8,High-Value,Potential Loyalists
30295,156,1,"174,3",5,1,1,7,Mid-Value,Potential Loyalists
30296,788,3,"198,65",3,1,1,5,Low-Value,At Risk Customers
30298,29,1,"127,35000000000001",5,1,1,7,Mid-Value,Potential Loyalists
30299,87,4,"205,2",5,1,1,7,Mid-Value,Potential Loyalists
30300,1012,2,"146,86",3,1,1,5,Low-Value,At Risk Customers
30302,888,2,"111,0",3,1,1,5,Low-Value,At Risk Customers
30304,31,4,"227,0",5,1,1,7,Mid-Value,Potential Loyalists
30305,1144,2,"42,35",2,1,1,4,Low-Value,Can't Lose
30306,3,4,"212,2",5,1,1,7,Mid-Value,Potential Loyalists
30308,237,6,"430,4",5,1,1,7,Mid-Value,Potential Loyalists
30309,1083,1,"39,3",3,1,1,5,Low-Value,At Risk Customers
30311,56,12,"505,5",5,3,1,9,High-Value,Champions
30312,1274,1,"125,65",2,1,1,4,Low-Value,Can't Lose
30313,1605,1,"16,85",1,1,1,3,Low-Value,Lost
30314,358,4,"777,9",5,1,2,8,High-Value,Potential Loyalists
30317,825,3,"302,95",3,1,1,5,Low-Value,At Risk Customers
30318,851,6,"367,65",3,1,1,5,Low-Value,At Risk Customers
30319,499,2,"175,3",4,1,1,6,Mid-Value,Potential Loyalists
30320,1014,2,"126,75",3,1,1,5,Low-Value,At Risk Customers
30321,267,5,"269,5",5,1,1,7,Mid-Value,Potential Loyalists
30322,210,2,"54,199999999999996",5,1,1,7,Mid-Value,Potential Loyalists
30323,14,5,"438,2",5,1,1,7,Mid-Value,Potential Loyalists
30325,643,2,"118,25",4,1,1,6,Mid-Value,Potential Loyalists
30326,857,2,"205,70000000000002",3,1,1,5,Low-Value,At Risk Customers
30327,1172,2,"78,9",2,1,1,4,Low-Value,Can't Lose
30329,407,2,"86,75",4,1,1,6,Mid-Value,Potential Loyalists
30330,1105,1,"21,1",2,1,1,4,Low-Value,Can't Lose
30333,161,7,"259,95000000000005",5,2,1,8,High-Value,Potential Loyalists
30334,999,2,"101,6",3,1,1,5,Low-Value,At Risk Customers
30335,41,7,"482,0",5,2,1,8,High-Value,Potential Loyalists
30336,1476,1,"179,8",1,1,1,3,Low-Value,Lost
30337,1030,2,"38,25",3,1,1,5,Low-Value,At Risk Customers
30338,24,9,"862,8",5,2,2,9,High-Value,Champions
30339,872,2,"254,9",3,1,1,5,Low-Value,At Risk Customers
30340,192,3,"72,7",5,1,1,7,Mid-Value,Potential Loyalists
30341,402,1,"51,9",4,1,1,6,Mid-Value,Potential Loyalists
30342,1472,3,"123,5",1,1,1,3,Low-Value,Lost
30344,803,3,"116,60000000000001",3,1,1,5,Low-Value,At Risk Customers
30348,1440,1,"22,25",2,1,1,4,Low-Value,Can't Lose
30349,785,2,"1184,05",3,1,2,6,Mid-Value,Potential Loyalists
30350,280,3,"194,0",5,1,1,7,Mid-Value,Potential Loyalists
30351,880,3,"51,45",3,1,1,5,Low-Value,At Risk Customers
30354,125,4,"214,0",5,1,1,7,Mid-Value,Potential Loyalists
30355,302,4,"213,89999999999998",5,1,1,7,Mid-Value,Potential Loyalists
30356,615,3,"169,1",4,1,1,6,Mid-Value,Potential Loyalists
30357,752,6,"339,8",3,1,1,5,Low-Value,At Risk Customers
30358,1203,4,"141,65",2,1,1,4,Low-Value,Can't Lose
30362,436,6,"403,15",4,1,1,6,Mid-Value,Potential Loyalists
30364,1101,5,"228,6",2,1,1,4,Low-Value,Can't Lose
30366,90,4,"417,7",5,1,1,7,Mid-Value,Potential Loyalists
30370,768,3,"496,45",3,1,1,5,Low-Value,At Risk Customers
30373,89,3,"34,5",5,1,1,7,Mid-Value,Potential Loyalists
30376,18,2,"152,4",5,1,1,7,Mid-Value,Potential Loyalists
30377,9,7,"446,4",5,2,1,8,High-Value,Potential Loyalists
30378,206,4,"242,4",5,1,1,7,Mid-Value,Potential Loyalists
30379,446,3,"109,1",4,1,1,6,Mid-Value,Potential Loyalists
30381,133,5,"923,85",5,1,2,8,High-Value,Potential Loyalists
30383,120,5,"282,79999999999995",5,1,1,7,Mid-Value,Potential Loyalists
30384,411,2,"113,0",4,1,1,6,Mid-Value,Potential Loyalists
30385,164,1,"59,6",5,1,1,7,Mid-Value,Potential Loyalists
30386,20,3,"125,89999999999999",5,1,1,7,Mid-Value,Potential Loyalists
30387,807,2,"59,8",3,1,1,5,Low-Value,At Risk Customers
30388,1804,1,"91,0",1,1,1,3,Low-Value,Lost
30389,837,2,"77,6",3,1,1,5,Low-Value,At Risk Customers
30390,510,3,"47,15",4,1,1,6,Mid-Value,Potential Loyalists
30391,386,4,"220,5",4,1,1,6,Mid-Value,Potential Loyalists
30392,62,2,"107,0",5,1,1,7,Mid-Value,Potential Loyalists
30394,784,7,"1009,85",3,2,2,7,Mid-Value,Potential Loyalists
30396,409,3,"121,35000000000001",4,1,1,6,Mid-Value,Potential Loyalists
30397,862,14,"660,3",3,3,1,7,Mid-Value,Potential Loyalists
30399,21,1,"17,0",5,1,1,7,Mid-Value,Potential Loyalists
30400,1347,1,"29,8",2,1,1,4,Low-Value,Can't Lose
30401,488,1,"41,3",4,1,1,6,Mid-Value,Potential Loyalists
30402,1158,2,"53,1",2,1,1,4,Low-Value,Can't Lose
30403,419,10,"1015,25",4,2,2,8,High-Value,Potential Loyalists
30405,96,9,"810,4",5,2,2,9,High-Value,Champions
30406,217,1,"34,5",5,1,1,7,Mid-Value,Potential Loyalists
30407,1141,1,"14,3",2,1,1,4,Low-Value,Can't Lose
30408,3,1,"23,6",5,1,1,7,Mid-Value,Potential Loyalists
30409,109,2,"334,20000000000005",5,1,1,7,Mid-Value,Potential Loyalists
30410,623,1,"289,95",4,1,1,6,Mid-Value,Potential Loyalists
30411,330,4,"132,85",5,1,1,7,Mid-Value,Potential Loyalists
30413,164,1,"24,7",5,1,1,7,Mid-Value,Potential Loyalists
30414,420,6,"163,55",4,1,1,6,Mid-Value,Potential Loyalists
30416,669,11,"418,05",4,2,1,7,Mid-Value,Potential Loyalists
30418,19,2,"187,7",5,1,1,7,Mid-Value,Potential Loyalists
30420,592,3,"68,05",4,1,1,6,Mid-Value,Potential Loyalists
30421,17,10,"625,15",5,2,1,8,High-Value,Potential Loyalists
30422,43,6,"605,75",5,1,1,7,Mid-Value,Potential Loyalists
30423,821,4,"424,90000000000003",3,1,1,5,Low-Value,At Risk Customers
30425,1154,1,"9,7",2,1,1,4,Low-Value,Can't Lose
30429,12,3,"150,05",5,1,1,7,Mid-Value,Potential Loyalists
30432,1676,1,"77,0",1,1,1,3,Low-Value,Lost
30436,428,3,"496,29999999999995",4,1,1,6,Mid-Value,Potential Loyalists
30437,387,1,"41,4",4,1,1,6,Mid-Value,Potential Loyalists
30438,1764,1,"58,9",1,1,1,3,Low-Value,Lost
30439,419,2,"88,25",4,1,1,6,Mid-Value,Potential Loyalists
30442,703,1,"29,55",4,1,1,6,Mid-Value,Potential Loyalists
30443,1517,1,"6,8",1,1,1,3,Low-Value,Lost
30444,1608,2,"62,75",1,1,1,3,Low-Value,Lost
30445,587,3,"112,69999999999999",4,1,1,6,Mid-Value,Potential Loyalists
30448,67,6,"248,3",5,1,1,7,Mid-Value,Potential Loyalists
30450,24,4,"186,2",5,1,1,7,Mid-Value,Potential Loyalists
30451,335,2,"85,95",5,1,1,7,Mid-Value,Potential Loyalists
30454,1233,2,"29,150000000000002",2,1,1,4,Low-Value,Can't Lose
30455,1569,1,"66,5",1,1,1,3,Low-Value,Lost
30458,17,2,"304,79999999999995",5,1,1,7,Mid-Value,Potential Loyalists
30459,710,1,"103,6",4,1,1,6,Mid-Value,Potential Loyalists
30460,1104,2,"81,94999999999999",2,1,1,4,Low-Value,Can't Lose
30461,1238,1,"117,2",2,1,1,4,Low-Value,Can't Lose
30463,383,2,"53,25",4,1,1,6,Mid-Value,Potential Loyalists
30466,41,3,"176,70000000000002",5,1,1,7,Mid-Value,Potential Loyalists
30469,1163,1,"7,25",2,1,1,4,Low-Value,Can't Lose
30470,909,1,"75,75",3,1,1,5,Low-Value,At Risk Customers
30471,1270,1,"46,5",2,1,1,4,Low-Value,Can't Lose
30473,88,7,"791,6",5,2,2,9,High-Value,Champions
30474,178,5,"217,45",5,1,1,7,Mid-Value,Potential Loyalists
30475,144,3,"338,25",5,1,1,7,Mid-Value,Potential Loyalists
30476,173,1,"38,7",5,1,1,7,Mid-Value,Potential Loyalists
30478,241,11,"426,75",5,2,1,8,High-Value,Potential Loyalists
30480,1669,1,"482,0",1,1,1,3,Low-Value,Lost
30481,561,1,"47,4",4,1,1,6,Mid-Value,Potential Loyalists
30482,271,5,"232,20000000000002",5,1,1,7,Mid-Value,Potential Loyalists
30483,1033,6,"978,55",3,1,2,6,Mid-Value,Potential Loyalists
30484,248,15,"575,35",5,3,1,9,High-Value,Champions
30486,1173,3,"410,15",2,1,1,4,Low-Value,Can't Lose
30487,1681,1,"14,8",1,1,1,3,Low-Value,Lost
30488,11,8,"352,20000000000005",5,2,1,8,High-Value,Potential Loyalists
30489,826,4,"90,39999999999999",3,1,1,5,Low-Value,At Risk Customers
30491,46,8,"617,5500000000001",5,2,1,8,High-Value,Potential Loyalists
30492,164,2,"101,69999999999999",5,1,1,7,Mid-Value,Potential Loyalists
30493,432,2,"66,4",4,1,1,6,Mid-Value,Potential Loyalists
30495,435,2,"64,55",4,1,1,6,Mid-Value,Potential Loyalists
30496,227,6,"293,85",5,1,1,7,Mid-Value,Potential Loyalists
30498,43,6,"235,25",5,1,1,7,Mid-Value,Potential Loyalists
30500,976,2,"257,6",3,1,1,5,Low-Value,At Risk Customers
30502,81,1,"64,95",5,1,1,7,Mid-Value,Potential Loyalists
30503,19,1,"151,8",5,1,1,7,Mid-Value,Potential Loyalists
30506,755,6,"267,55",3,1,1,5,Low-Value,At Risk Customers
30508,199,3,"134,35000000000002",5,1,1,7,Mid-Value,Potential Loyalists
30509,1092,3,"528,6",3,1,1,5,Low-Value,At Risk Customers
30510,24,3,"107,1",5,1,1,7,Mid-Value,Potential Loyalists
30513,1326,2,"147,0",2,1,1,4,Low-Value,Can't Lose
30514,244,7,"599,65",5,2,1,8,High-Value,Potential Loyalists
30515,300,3,"158,95",5,1,1,7,Mid-Value,Potential Loyalists
30516,53,2,"82,94999999999999",5,1,1,7,Mid-Value,Potential Loyalists
30517,914,2,"148,35",3,1,1,5,Low-Value,At Risk Customers
30518,1293,1,"36,6",2,1,1,4,Low-Value,Can't Lose
30519,552,2,"27,05",4,1,1,6,Mid-Value,Potential Loyalists
30521,1249,1,"57,2",2,1,1,4,Low-Value,Can't Lose
30524,380,2,"264,2",4,1,1,6,Mid-Value,Potential Loyalists
30528,297,3,"326,85",5,1,1,7,Mid-Value,Potential Loyalists
30529,57,4,"352,35",5,1,1,7,Mid-Value,Potential Loyalists
30530,271,5,"217,45",5,1,1,7,Mid-Value,Potential Loyalists
30532,68,3,"102,44999999999999",5,1,1,7,Mid-Value,Potential Loyalists
30533,327,9,"627,0",5,2,1,8,High-Value,Potential Loyalists
30534,31,1,"7,5",5,1,1,7,Mid-Value,Potential Loyalists
30536,812,3,"172,35000000000002",3,1,1,5,Low-Value,At Risk Customers
30538,47,6,"678,35",5,1,2,8,High-Value,Potential Loyalists
30540,725,4,"214,75",4,1,1,6,Mid-Value,Potential Loyalists
30544,674,2,"63,0",4,1,1,6,Mid-Value,Potential Loyalists
30545,867,1,"157,0",3,1,1,5,Low-Value,At Risk Customers
30549,388,4,"182,9",4,1,1,6,Mid-Value,Potential Loyalists
30551,45,7,"847,35",5,2,2,9,High-Value,Champions
30554,1590,4,"515,4",1,1,1,3,Low-Value,Lost
30556,305,6,"738,0999999999999",5,1,2,8,High-Value,Potential Loyalists
30557,91,2,"45,85",5,1,1,7,Mid-Value,Potential Loyalists
30558,908,3,"713,8",3,1,2,6,Mid-Value,Potential Loyalists
30559,164,2,"76,65",5,1,1,7,Mid-Value,Potential Loyalists
30561,18,3,"108,6",5,1,1,7,Mid-Value,Potential Loyalists
30562,39,7,"328,45",5,2,1,8,High-Value,Potential Loyalists
30566,34,1,"24,9",5,1,1,7,Mid-Value,Potential Loyalists
30567,1486,1,"178,4",1,1,1,3,Low-Value,Lost
30568,580,1,"340,95000000000005",4,1,1,6,Mid-Value,Potential Loyalists
30570,24,2,"299,0",5,1,1,7,Mid-Value,Potential Loyalists
30572,204,3,"253,3",5,1,1,7,Mid-Value,Potential Loyalists
30574,1182,1,"8,25",2,1,1,4,Low-Value,Can't Lose
30575,370,2,"276,65",4,1,1,6,Mid-Value,Potential Loyalists
30577,907,2,"93,94999999999999",3,1,1,5,Low-Value,At Risk Customers
30579,108,2,"90,7",5,1,1,7,Mid-Value,Potential Loyalists
30582,55,3,"146,4",5,1,1,7,Mid-Value,Potential Loyalists
30583,64,15,"585,4",5,3,1,9,High-Value,Champions
30586,1122,4,"462,0",2,1,1,4,Low-Value,Can't Lose
30588,507,1,"39,1",4,1,1,6,Mid-Value,Potential Loyalists
30589,1033,3,"151,25",3,1,1,5,Low-Value,At Risk Customers
30590,613,1,"222,45000000000002",4,1,1,6,Mid-Value,Potential Loyalists
30591,515,2,"254,75",4,1,1,6,Mid-Value,Potential Loyalists
30593,85,6,"447,3",5,1,1,7,Mid-Value,Potential Loyalists
30595,637,3,"88,75",4,1,1,6,Mid-Value,Potential Loyalists
30596,25,6,"363,3",5,1,1,7,Mid-Value,Potential Loyalists
30597,1466,2,"44,1",1,1,1,3,Low-Value,Lost
30598,1035,3,"116,55",3,1,1,5,Low-Value,At Risk Customers
30599,150,6,"417,9",5,1,1,7,Mid-Value,Potential Loyalists
30600,521,2,"159,15",4,1,1,6,Mid-Value,Potential Loyalists
30602,52,1,"85,15",5,1,1,7,Mid-Value,Potential Loyalists
30605,254,7,"658,15",5,2,1,8,High-Value,Potential Loyalists
30607,397,4,"199,20000000000002",4,1,1,6,Mid-Value,Potential Loyalists
30611,517,3,"63,199999999999996",4,1,1,6,Mid-Value,Potential Loyalists
30612,555,1,"37,0",4,1,1,6,Mid-Value,Potential Loyalists
30613,1169,1,"14,35",2,1,1,4,Low-Value,Can't Lose
30616,765,2,"293,05",3,1,1,5,Low-Value,At Risk Customers
30618,18,7,"255,14999999999998",5,2,1,8,High-Value,Potential Loyalists
30619,124,8,"917,8",5,2,2,9,High-Value,Champions
30620,227,7,"403,85",5,2,1,8,High-Value,Potential Loyalists
30621,407,5,"145,70000000000002",4,1,1,6,Mid-Value,Potential Loyalists
30622,197,2,"114,75",5,1,1,7,Mid-Value,Potential Loyalists
30623,339,3,"55,4",5,1,1,7,Mid-Value,Potential Loyalists
30627,274,2,"77,4",5,1,1,7,Mid-Value,Potential Loyalists
30629,74,4,"90,05",5,1,1,7,Mid-Value,Potential Loyalists
30630,781,3,"380,75",3,1,1,5,Low-Value,At Risk Customers
30631,90,9,"900,4",5,2,2,9,High-Value,Champions
30632,19,3,"134,20000000000002",5,1,1,7,Mid-Value,Potential Loyalists
30633,453,4,"160,7",4,1,1,6,Mid-Value,Potential Loyalists
30634,792,6,"321,55",3,1,1,5,Low-Value,At Risk Customers
30636,402,4,"200,39999999999998",4,1,1,6,Mid-Value,Potential Loyalists
30638,437,1,"53,6",4,1,1,6,Mid-Value,Potential Loyalists
30639,407,1,"53,6",4,1,1,6,Mid-Value,Potential Loyalists
30640,840,1,"10,3",3,1,1,5,Low-Value,At Risk Customers
30641,1700,1,"66,0",1,1,1,3,Low-Value,Lost
30643,576,2,"23,35",4,1,1,6,Mid-Value,Potential Loyalists
30644,56,1,"43,4",5,1,1,7,Mid-Value,Potential Loyalists
30647,27,6,"316,3",5,1,1,7,Mid-Value,Potential Loyalists
30648,152,7,"224,4",5,2,1,8,High-Value,Potential Loyalists
30649,433,5,"232,5",4,1,1,6,Mid-Value,Potential Loyalists
30650,1698,2,"728,9",1,1,2,4,Low-Value,Can't Lose
30651,201,1,"312,6",5,1,1,7,Mid-Value,Potential Loyalists
30654,921,3,"336,95",3,1,1,5,Low-Value,At Risk Customers
30655,187,4,"356,9",5,1,1,7,Mid-Value,Potential Loyalists
30656,414,2,"626,6",4,1,1,6,Mid-Value,Potential Loyalists
30658,40,3,"68,05",5,1,1,7,Mid-Value,Potential Loyalists
30659,860,2,"532,1",3,1,1,5,Low-Value,At Risk Customers
30660,465,2,"57,55",4,1,1,6,Mid-Value,Potential Loyalists
30661,1254,4,"371,04999999999995",2,1,1,4,Low-Value,Can't Lose
30662,1466,1,"133,5",1,1,1,3,Low-Value,Lost
30666,581,2,"125,19999999999999",4,1,1,6,Mid-Value,Potential Loyalists
30667,78,4,"139,45",5,1,1,7,Mid-Value,Potential Loyalists
30668,522,2,"88,69999999999999",4,1,1,6,Mid-Value,Potential Loyalists
30669,803,1,"35,35",3,1,1,5,Low-Value,At Risk Customers
30670,1,8,"370,6",5,2,1,8,High-Value,Potential Loyalists
30671,40,15,"758,9",5,3,2,10,High-Value,Champions
30676,1100,3,"231,9",2,1,1,4,Low-Value,Can't Lose
30677,762,2,"170,95",3,1,1,5,Low-Value,At Risk Customers
30680,293,1,"33,6",5,1,1,7,Mid-Value,Potential Loyalists
30688,1294,1,"118,0",2,1,1,4,Low-Value,Can't Lose
30690,265,4,"127,35000000000001",5,1,1,7,Mid-Value,Potential Loyalists
30691,479,3,"54,25",4,1,1,6,Mid-Value,Potential Loyalists
30692,1815,1,"3,15",1,1,1,3,Low-Value,Lost
30694,776,3,"131,25",3,1,1,5,Low-Value,At Risk Customers
30695,1071,1,"20,0",3,1,1,5,Low-Value,At Risk Customers
30698,526,3,"322,05",4,1,1,6,Mid-Value,Potential Loyalists
30700,87,9,"669,0",5,2,2,9,High-Value,Champions
30701,140,7,"280,7",5,2,1,8,High-Value,Potential Loyalists
30702,444,5,"147,2",4,1,1,6,Mid-Value,Potential Loyalists
30703,1223,1,"15,149999999999999",2,1,1,4,Low-Value,Can't Lose
30704,7,3,"173,6",5,1,1,7,Mid-Value,Potential Loyalists
30705,252,4,"292,8",5,1,1,7,Mid-Value,Potential Loyalists
30706,1110,2,"84,05",2,1,1,4,Low-Value,Can't Lose
30707,1139,5,"170,25",2,1,1,4,Low-Value,Can't Lose
30709,1119,1,"199,0",2,1,1,4,Low-Value,Can't Lose
30710,703,4,"120,35",4,1,1,6,Mid-Value,Potential Loyalists
30711,1274,1,"14,65",2,1,1,4,Low-Value,Can't Lose
30714,378,6,"265,9",4,1,1,6,Mid-Value,Potential Loyalists
30716,24,9,"450,90000000000003",5,2,1,8,High-Value,Potential Loyalists
30719,487,4,"423,25",4,1,1,6,Mid-Value,Potential Loyalists
30720,115,9,"935,4",5,2,2,9,High-Value,Champions
30721,104,8,"370,29999999999995",5,2,1,8,High-Value,Potential Loyalists
30722,94,7,"570,9",5,2,1,8,High-Value,Potential Loyalists
30725,787,4,"73,65",3,1,1,5,Low-Value,At Risk Customers
30727,21,6,"246,35",5,1,1,7,Mid-Value,Potential Loyalists
30729,1,1,"180,0",5,1,1,7,Mid-Value,Potential Loyalists
30730,89,6,"1097,3",5,1,2,8,High-Value,Potential Loyalists
30731,440,1,"33,6",4,1,1,6,Mid-Value,Potential Loyalists
30732,236,4,"209,54999999999998",5,1,1,7,Mid-Value,Potential Loyalists
30734,846,3,"45,95",3,1,1,5,Low-Value,At Risk Customers
30735,878,3,"125,8",3,1,1,5,Low-Value,At Risk Customers
30737,230,3,"83,15",5,1,1,7,Mid-Value,Potential Loyalists
30740,165,3,"263,0",5,1,1,7,Mid-Value,Potential Loyalists
30741,624,2,"125,5",4,1,1,6,Mid-Value,Potential Loyalists
30744,916,4,"236,64999999999998",3,1,1,5,Low-Value,At Risk Customers
30745,708,3,"95,95",4,1,1,6,Mid-Value,Potential Loyalists
30748,103,1,"16,75",5,1,1,7,Mid-Value,Potential Loyalists
30750,326,2,"75,25",5,1,1,7,Mid-Value,Potential Loyalists
30751,864,1,"65,6",3,1,1,5,Low-Value,At Risk Customers
30753,127,5,"433,8",5,1,1,7,Mid-Value,Potential Loyalists
30755,1298,1,"57,5",2,1,1,4,Low-Value,Can't Lose
30757,93,2,"179,55",5,1,1,7,Mid-Value,Potential Loyalists
30758,32,7,"318,2",5,2,1,8,High-Value,Potential Loyalists
30759,223,3,"123,75",5,1,1,7,Mid-Value,Potential Loyalists
30760,1693,1,"84,75",1,1,1,3,Low-Value,Lost
30761,9,4,"116,10000000000001",5,1,1,7,Mid-Value,Potential Loyalists
30762,494,3,"652,45",4,1,1,6,Mid-Value,Potential Loyalists
30763,433,4,"158,75",4,1,1,6,Mid-Value,Potential Loyalists
30764,589,6,"419,05",4,1,1,6,Mid-Value,Potential Loyalists
30765,776,2,"164,0",3,1,1,5,Low-Value,At Risk Customers
30766,1589,1,"20,8",1,1,1,3,Low-Value,Lost
30769,61,7,"381,95",5,2,1,8,High-Value,Potential Loyalists
30770,1100,2,"82,4",2,1,1,4,Low-Value,Can't Lose
30772,946,1,"45,6",3,1,1,5,Low-Value,At Risk Customers
30774,1188,2,"204,24999999999997",2,1,1,4,Low-Value,Can't Lose
30775,1471,8,"1142,0",1,2,2,5,Low-Value,At Risk Customers
30777,66,5,"154,75",5,1,1,7,Mid-Value,Potential Loyalists
30778,1537,2,"120,4",1,1,1,3,Low-Value,Lost
30779,1586,1,"71,1",1,1,1,3,Low-Value,Lost
30780,880,6,"228,75",3,1,1,5,Low-Value,At Risk Customers
30785,236,5,"364,4",5,1,1,7,Mid-Value,Potential Loyalists
30786,320,1,"8,55",5,1,1,7,Mid-Value,Potential Loyalists
30787,324,3,"76,95",5,1,1,7,Mid-Value,Potential Loyalists
30788,392,2,"90,45",4,1,1,6,Mid-Value,Potential Loyalists
30789,1030,3,"89,55",3,1,1,5,Low-Value,At Risk Customers
30791,629,6,"312,9",4,1,1,6,Mid-Value,Potential Loyalists
30792,836,4,"437,65000000000003",3,1,1,5,Low-Value,At Risk Customers
30793,383,6,"341,1",4,1,1,6,Mid-Value,Potential Loyalists
30795,35,3,"95,05",5,1,1,7,Mid-Value,Potential Loyalists
30797,769,2,"68,15",3,1,1,5,Low-Value,At Risk Customers
30800,8,1,"17,85",5,1,1,7,Mid-Value,Potential Loyalists
30801,1039,1,"247,7",3,1,1,5,Low-Value,At Risk Customers
30802,151,3,"77,25",5,1,1,7,Mid-Value,Potential Loyalists
30804,221,2,"152,3",5,1,1,7,Mid-Value,Potential Loyalists
30805,550,3,"158,7",4,1,1,6,Mid-Value,Potential Loyalists
30806,1758,1,"6,5",1,1,1,3,Low-Value,Lost
30807,575,9,"559,65",4,2,1,7,Mid-Value,Potential Loyalists
30811,1502,1,"13,95",1,1,1,3,Low-Value,Lost
30812,7,3,"73,1",5,1,1,7,Mid-Value,Potential Loyalists
30813,45,6,"260,6",5,1,1,7,Mid-Value,Potential Loyalists
30815,1271,2,"556,9999999999999",2,1,1,4,Low-Value,Can't Lose
30816,45,7,"269,90000000000003",5,2,1,8,High-Value,Potential Loyalists
30817,1387,4,"172,05",2,1,1,4,Low-Value,Can't Lose
30821,60,2,"20,25",5,1,1,7,Mid-Value,Potential Loyalists
30822,1403,1,"72,0",2,1,1,4,Low-Value,Can't Lose
30824,54,4,"180,8",5,1,1,7,Mid-Value,Potential Loyalists
30826,776,1,"6,35",3,1,1,5,Low-Value,At Risk Customers
30828,103,6,"436,58",5,1,1,7,Mid-Value,Potential Loyalists
30829,148,1,"21,3",5,1,1,7,Mid-Value,Potential Loyalists
30830,728,1,"32,8",4,1,1,6,Mid-Value,Potential Loyalists
30836,5,7,"936,5",5,2,2,9,High-Value,Champions
30839,1104,1,"73,0",2,1,1,4,Low-Value,Can't Lose
30841,1385,1,"59,55",2,1,1,4,Low-Value,Can't Lose
30842,692,6,"455,5",4,1,1,6,Mid-Value,Potential Loyalists
30843,883,2,"164,9",3,1,1,5,Low-Value,At Risk Customers
30844,342,1,"7,9",5,1,1,7,Mid-Value,Potential Loyalists
30845,1246,1,"12,7",2,1,1,4,Low-Value,Can't Lose
30846,207,2,"491,34999999999997",5,1,1,7,Mid-Value,Potential Loyalists
30848,1219,1,"59,849999999999994",2,1,1,4,Low-Value,Can't Lose
30849,110,1,"93,8",5,1,1,7,Mid-Value,Potential Loyalists
30850,951,1,"64,94999999999999",3,1,1,5,Low-Value,At Risk Customers
30851,850,2,"40,85",3,1,1,5,Low-Value,At Risk Customers
30853,969,2,"38,05",3,1,1,5,Low-Value,At Risk Customers
30855,549,1,"67,8",4,1,1,6,Mid-Value,Potential Loyalists
30856,781,1,"30,35",3,1,1,5,Low-Value,At Risk Customers
30857,270,2,"208,75",5,1,1,7,Mid-Value,Potential Loyalists
30858,1398,1,"17,25",2,1,1,4,Low-Value,Can't Lose
30860,1145,1,"47,2",2,1,1,4,Low-Value,Can't Lose
30861,49,2,"33,1",5,1,1,7,Mid-Value,Potential Loyalists
30862,1365,2,"64,9",2,1,1,4,Low-Value,Can't Lose
30863,243,5,"327,05",5,1,1,7,Mid-Value,Potential Loyalists
30864,1163,1,"14,8",2,1,1,4,Low-Value,Can't Lose
30867,424,1,"57,05",4,1,1,6,Mid-Value,Potential Loyalists
30868,1238,2,"42,25",2,1,1,4,Low-Value,Can't Lose
30869,759,4,"221,7",3,1,1,5,Low-Value,At Risk Customers
30876,1611,1,"40,1",1,1,1,3,Low-Value,Lost
30877,220,2,"116,78999999999999",5,1,1,7,Mid-Value,Potential Loyalists
30879,220,2,"176,14999999999998",5,1,1,7,Mid-Value,Potential Loyalists
30882,382,2,"143,35",4,1,1,6,Mid-Value,Potential Loyalists
30883,798,4,"104,65",3,1,1,5,Low-Value,At Risk Customers
30884,378,1,"32,4",4,1,1,6,Mid-Value,Potential Loyalists
30885,383,1,"128,6",4,1,1,6,Mid-Value,Potential Loyalists
30888,53,10,"531,6",5,2,1,8,High-Value,Potential Loyalists
30889,666,3,"46,5",4,1,1,6,Mid-Value,Potential Loyalists
30890,409,5,"227,9",4,1,1,6,Mid-Value,Potential Loyalists
30891,59,2,"45,75",5,1,1,7,Mid-Value,Potential Loyalists
30892,16,7,"303,7",5,2,1,8,High-Value,Potential Loyalists
30893,259,1,"57,05",5,1,1,7,Mid-Value,Potential Loyalists
30896,83,3,"35,2",5,1,1,7,Mid-Value,Potential Loyalists
30897,1595,1,"25,9",1,1,1,3,Low-Value,Lost
30898,1233,4,"295,65",2,1,1,4,Low-Value,Can't Lose
30899,85,5,"149,5",5,1,1,7,Mid-Value,Potential Loyalists
30900,73,5,"101,8",5,1,1,7,Mid-Value,Potential Loyalists
30902,10,2,"214,8",5,1,1,7,Mid-Value,Potential Loyalists
30904,52,9,"357,2",5,2,1,8,High-Value,Potential Loyalists
30906,31,7,"457,6",5,2,1,8,High-Value,Potential Loyalists
30908,1255,1,"93,8",2,1,1,4,Low-Value,Can't Lose
30909,610,1,"1,25",4,1,1,6,Mid-Value,Potential Loyalists
30910,63,3,"109,95",5,1,1,7,Mid-Value,Potential Loyalists
30911,15,3,"390,95",5,1,1,7,Mid-Value,Potential Loyalists
30913,169,7,"513,1500000000001",5,2,1,8,High-Value,Potential Loyalists
30916,519,1,"119,3",4,1,1,6,Mid-Value,Potential Loyalists
30918,24,3,"169,3",5,1,1,7,Mid-Value,Potential Loyalists
30921,24,18,"1064,55",5,4,2,11,High-Value,Champions
30922,964,2,"62,75",3,1,1,5,Low-Value,At Risk Customers
30923,181,13,"858,75",5,3,2,10,High-Value,Champions
30924,78,6,"534,1",5,1,1,7,Mid-Value,Potential Loyalists
30925,355,2,"62,050000000000004",5,1,1,7,Mid-Value,Potential Loyalists
30927,236,6,"780,8499999999999",5,1,2,8,High-Value,Potential Loyalists
30930,384,2,"72,3",4,1,1,6,Mid-Value,Potential Loyalists
30933,780,2,"25,15",3,1,1,5,Low-Value,At Risk Customers
30934,330,3,"313,95",5,1,1,7,Mid-Value,Potential Loyalists
30935,1201,2,"110,69999999999999",2,1,1,4,Low-Value,Can't Lose
30936,1281,2,"38,5",2,1,1,4,Low-Value,Can't Lose
30938,1011,1,"5,95",3,1,1,5,Low-Value,At Risk Customers
30939,720,3,"290,85",4,1,1,6,Mid-Value,Potential Loyalists
30942,379,6,"116,39999999999999",4,1,1,6,Mid-Value,Potential Loyalists
30943,566,2,"35,0",4,1,1,6,Mid-Value,Potential Loyalists
30944,465,2,"65,3",4,1,1,6,Mid-Value,Potential Loyalists
30946,508,2,"190,15",4,1,1,6,Mid-Value,Potential Loyalists
30948,642,2,"272,4",4,1,1,6,Mid-Value,Potential Loyalists
30950,186,1,"82,0",5,1,1,7,Mid-Value,Potential Loyalists
30953,1229,1,"87,9",2,1,1,4,Low-Value,Can't Lose
30955,1689,1,"4,4",1,1,1,3,Low-Value,Lost
30956,95,1,"70,6",5,1,1,7,Mid-Value,Potential Loyalists
30957,168,2,"189,4",5,1,1,7,Mid-Value,Potential Loyalists
30958,229,3,"311,55",5,1,1,7,Mid-Value,Potential Loyalists
30959,166,6,"436,05",5,1,1,7,Mid-Value,Potential Loyalists
30960,1666,2,"120,69999999999999",1,1,1,3,Low-Value,Lost
30961,174,1,"211,1",5,1,1,7,Mid-Value,Potential Loyalists
30964,27,1,"50,4",5,1,1,7,Mid-Value,Potential Loyalists
30966,1447,1,"43,3",2,1,1,4,Low-Value,Can't Lose
30968,1193,1,"16,3",2,1,1,4,Low-Value,Can't Lose
30969,666,1,"0,7",4,1,1,6,Mid-Value,Potential Loyalists
30970,873,1,"65,69999999999999",3,1,1,5,Low-Value,At Risk Customers
30971,13,9,"574,45",5,2,1,8,High-Value,Potential Loyalists
30972,361,8,"868,3499999999999",5,2,2,9,High-Value,Champions
30975,143,9,"373,05",5,2,1,8,High-Value,Potential Loyalists
30976,174,3,"125,67999999999999",5,1,1,7,Mid-Value,Potential Loyalists
30977,668,1,"146,2",4,1,1,6,Mid-Value,Potential Loyalists
30978,512,4,"89,7",4,1,1,6,Mid-Value,Potential Loyalists
30979,145,3,"360,6",5,1,1,7,Mid-Value,Potential Loyalists
30981,12,8,"646,75",5,2,1,8,High-Value,Potential Loyalists
30983,393,3,"154,25",4,1,1,6,Mid-Value,Potential Loyalists
30984,407,8,"583,5999999999999",4,2,1,7,Mid-Value,Potential Loyalists
30987,1141,2,"45,55",2,1,1,4,Low-Value,Can't Lose
30988,743,7,"406,95",3,2,1,6,Mid-Value,Potential Loyalists
30989,591,4,"140,15",4,1,1,6,Mid-Value,Potential Loyalists
30991,149,2,"114,55000000000001",5,1,1,7,Mid-Value,Potential Loyalists
30992,1403,1,"58,55",2,1,1,4,Low-Value,Can't Lose
30993,1341,4,"176,38",2,1,1,4,Low-Value,Can't Lose
30994,1389,1,"31,7",2,1,1,4,Low-Value,Can't Lose
30995,60,4,"321,55",5,1,1,7,Mid-Value,Potential Loyalists
30997,7,5,"83,5",5,1,1,7,Mid-Value,Potential Loyalists
30999,122,4,"239,2",5,1,1,7,Mid-Value,Potential Loyalists
31002,176,2,"151,4",5,1,1,7,Mid-Value,Potential Loyalists
31006,1474,2,"150,9",1,1,1,3,Low-Value,Lost
31007,47,5,"338,85",5,1,1,7,Mid-Value,Potential Loyalists
31008,3,2,"93,44999999999999",5,1,1,7,Mid-Value,Potential Loyalists
31009,308,2,"72,1",5,1,1,7,Mid-Value,Potential Loyalists
31012,1117,2,"151,7",2,1,1,4,Low-Value,Can't Lose
31013,1667,1,"113,69999999999999",1,1,1,3,Low-Value,Lost
31014,538,4,"245,75",4,1,1,6,Mid-Value,Potential Loyalists
31015,603,2,"227,14999999999998",4,1,1,6,Mid-Value,Potential Loyalists
31016,1743,1,"10,7",1,1,1,3,Low-Value,Lost
31017,422,4,"338,59999999999997",4,1,1,6,Mid-Value,Potential Loyalists
31018,771,8,"574,55",3,2,1,6,Mid-Value,Potential Loyalists
31019,290,4,"76,9",5,1,1,7,Mid-Value,Potential Loyalists
31021,1001,1,"1,35",3,1,1,5,Low-Value,At Risk Customers
31022,34,5,"243,05",5,1,1,7,Mid-Value,Potential Loyalists
31023,645,1,"7,2",4,1,1,6,Mid-Value,Potential Loyalists
31025,766,2,"57,15",3,1,1,5,Low-Value,At Risk Customers
31027,27,6,"218,5",5,1,1,7,Mid-Value,Potential Loyalists
31033,1435,1,"41,5",2,1,1,4,Low-Value,Can't Lose
31034,890,1,"208,75",3,1,1,5,Low-Value,At Risk Customers
31035,195,2,"240,5",5,1,1,7,Mid-Value,Potential Loyalists
31036,1516,2,"127,55",1,1,1,3,Low-Value,Lost
31037,1599,1,"73,6",1,1,1,3,Low-Value,Lost
31038,831,2,"60,75",3,1,1,5,Low-Value,At Risk Customers
31039,171,7,"557,55",5,2,1,8,High-Value,Potential Loyalists
31040,284,5,"116,0",5,1,1,7,Mid-Value,Potential Loyalists
31041,1370,1,"18,3",2,1,1,4,Low-Value,Can't Lose
31042,694,1,"17,25",4,1,1,6,Mid-Value,Potential Loyalists
31043,332,3,"93,65",5,1,1,7,Mid-Value,Potential Loyalists
31045,228,5,"286,75",5,1,1,7,Mid-Value,Potential Loyalists
31047,1442,1,"19,25",2,1,1,4,Low-Value,Can't Lose
31048,1123,2,"16,3",2,1,1,4,Low-Value,Can't Lose
31049,15,3,"140,0",5,1,1,7,Mid-Value,Potential Loyalists
31050,1612,1,"50,4",1,1,1,3,Low-Value,Lost
31051,19,5,"89,33",5,1,1,7,Mid-Value,Potential Loyalists
31052,192,5,"818,0",5,1,2,8,High-Value,Potential Loyalists
31053,805,4,"102,95",3,1,1,5,Low-Value,At Risk Customers
31055,554,4,"348,20000000000005",4,1,1,6,Mid-Value,Potential Loyalists
31058,223,5,"296,5",5,1,1,7,Mid-Value,Potential Loyalists
31059,1477,1,"144,9",1,1,1,3,Low-Value,Lost
31060,143,7,"280,05",5,2,1,8,High-Value,Potential Loyalists
31061,276,9,"670,3",5,2,2,9,High-Value,Champions
31062,743,3,"251,95000000000002",3,1,1,5,Low-Value,At Risk Customers
31063,335,1,"41,75",5,1,1,7,Mid-Value,Potential Loyalists
31064,766,7,"319,75",3,2,1,6,Mid-Value,Potential Loyalists
31065,487,8,"360,6",4,2,1,7,Mid-Value,Potential Loyalists
31066,548,6,"820,05",4,1,2,7,Mid-Value,Potential Loyalists
31067,142,2,"102,8",5,1,1,7,Mid-Value,Potential Loyalists
31068,290,3,"225,14999999999998",5,1,1,7,Mid-Value,Potential Loyalists
31069,39,4,"108,1",5,1,1,7,Mid-Value,Potential Loyalists
31070,614,1,"58,0",4,1,1,6,Mid-Value,Potential Loyalists
31071,505,3,"176,65",4,1,1,6,Mid-Value,Potential Loyalists
31074,99,7,"621,55",5,2,1,8,High-Value,Potential Loyalists
31075,103,2,"63,45",5,1,1,7,Mid-Value,Potential Loyalists
31076,1,2,"441,79999999999995",5,1,1,7,Mid-Value,Potential Loyalists
31078,1282,2,"87,4",2,1,1,4,Low-Value,Can't Lose
31079,10,2,"145,75",5,1,1,7,Mid-Value,Potential Loyalists
31080,43,1,"51,7",5,1,1,7,Mid-Value,Potential Loyalists
31081,412,4,"207,35000000000002",4,1,1,6,Mid-Value,Potential Loyalists
31083,126,7,"286,0",5,2,1,8,High-Value,Potential Loyalists
31085,461,3,"121,70000000000002",4,1,1,6,Mid-Value,Potential Loyalists
31086,779,1,"28,7",3,1,1,5,Low-Value,At Risk Customers
31088,80,1,"3,1",5,1,1,7,Mid-Value,Potential Loyalists
31089,902,4,"334,5",3,1,1,5,Low-Value,At Risk Customers
31090,1606,1,"170,2",1,1,1,3,Low-Value,Lost
31093,1743,1,"7,7",1,1,1,3,Low-Value,Lost
31095,229,3,"428,7",5,1,1,7,Mid-Value,Potential Loyalists
31098,47,1,"91,15",5,1,1,7,Mid-Value,Potential Loyalists
31101,726,1,"50,849999999999994",4,1,1,6,Mid-Value,Potential Loyalists
31102,1550,2,"231,1",1,1,1,3,Low-Value,Lost
31104,554,5,"240,85",4,1,1,6,Mid-Value,Potential Loyalists
31105,38,10,"1315,95",5,2,2,9,High-Value,Champions
31106,735,2,"156,1",3,1,1,5,Low-Value,At Risk Customers
31107,1436,1,"5,05",2,1,1,4,Low-Value,Can't Lose
31108,1586,1,"79,65",1,1,1,3,Low-Value,Lost
31110,1386,2,"74,45",2,1,1,4,Low-Value,Can't Lose
31111,368,4,"126,85000000000001",4,1,1,6,Mid-Value,Potential Loyalists
31112,24,7,"693,6999999999999",5,2,2,9,High-Value,Champions
31116,2,3,"291,09999999999997",5,1,1,7,Mid-Value,Potential Loyalists
31123,231,4,"96,30000000000001",5,1,1,7,Mid-Value,Potential Loyalists
31124,10,3,"113,1",5,1,1,7,Mid-Value,Potential Loyalists
31125,208,2,"216,60000000000002",5,1,1,7,Mid-Value,Potential Loyalists
31126,1363,1,"33,6",2,1,1,4,Low-Value,Can't Lose
31128,48,4,"94,95",5,1,1,7,Mid-Value,Potential Loyalists
31129,304,4,"168,64999999999998",5,1,1,7,Mid-Value,Potential Loyalists
31130,913,4,"262,85",3,1,1,5,Low-Value,At Risk Customers
31131,334,4,"92,35",5,1,1,7,Mid-Value,Potential Loyalists
31132,166,1,"103,4",5,1,1,7,Mid-Value,Potential Loyalists
31133,1215,1,"11,7",2,1,1,4,Low-Value,Can't Lose
31134,233,2,"74,6",5,1,1,7,Mid-Value,Potential Loyalists
31135,108,7,"840,85",5,2,2,9,High-Value,Champions
31136,753,2,"23,2",3,1,1,5,Low-Value,At Risk Customers
31138,1638,2,"35,3",1,1,1,3,Low-Value,Lost
31139,80,3,"112,05000000000001",5,1,1,7,Mid-Value,Potential Loyalists
31140,272,1,"11,0",5,1,1,7,Mid-Value,Potential Loyalists
31141,1817,1,"37,15",1,1,1,3,Low-Value,Lost
31145,890,2,"122,14999999999999",3,1,1,5,Low-Value,At Risk Customers
31146,633,4,"142,75",4,1,1,6,Mid-Value,Potential Loyalists
31147,265,4,"111,55000000000001",5,1,1,7,Mid-Value,Potential Loyalists
31148,1503,1,"22,4",1,1,1,3,Low-Value,Lost
31150,12,6,"674,85",5,1,2,8,High-Value,Potential Loyalists
31151,335,4,"114,65",5,1,1,7,Mid-Value,Potential Loyalists
31152,589,3,"95,65",4,1,1,6,Mid-Value,Potential Loyalists
31155,1715,1,"8,3",1,1,1,3,Low-Value,Lost
31157,1721,1,"17,7",1,1,1,3,Low-Value,Lost
31158,609,1,"20,6",4,1,1,6,Mid-Value,Potential Loyalists
31159,69,3,"76,9",5,1,1,7,Mid-Value,Potential Loyalists
31160,571,1,"52,5",4,1,1,6,Mid-Value,Potential Loyalists
31165,208,3,"67,3",5,1,1,7,Mid-Value,Potential Loyalists
31168,246,2,"67,05",5,1,1,7,Mid-Value,Potential Loyalists
31170,36,6,"347,2",5,1,1,7,Mid-Value,Potential Loyalists
31171,38,4,"328,45000000000005",5,1,1,7,Mid-Value,Potential Loyalists
31172,591,2,"313,35",4,1,1,6,Mid-Value,Potential Loyalists
31173,487,5,"305,84999999999997",4,1,1,6,Mid-Value,Potential Loyalists
31174,137,2,"314,5",5,1,1,7,Mid-Value,Potential Loyalists
31175,638,3,"37,150000000000006",4,1,1,6,Mid-Value,Potential Loyalists
31177,694,3,"187,55",4,1,1,6,Mid-Value,Potential Loyalists
31179,139,5,"360,5",5,1,1,7,Mid-Value,Potential Loyalists
31180,1,7,"260,45",5,2,1,8,High-Value,Potential Loyalists
31181,1208,1,"31,15",2,1,1,4,Low-Value,Can't Lose
31182,174,9,"552,9499999999999",5,2,1,8,High-Value,Potential Loyalists
31184,194,2,"75,75",5,1,1,7,Mid-Value,Potential Loyalists
31186,1483,1,"135,0",1,1,1,3,Low-Value,Lost
31188,68,1,"19,9",5,1,1,7,Mid-Value,Potential Loyalists
31189,22,2,"136,14999999999998",5,1,1,7,Mid-Value,Potential Loyalists
31190,1345,1,"303,7",2,1,1,4,Low-Value,Can't Lose
31191,39,10,"315,95",5,2,1,8,High-Value,Potential Loyalists
31194,972,1,"9,65",3,1,1,5,Low-Value,At Risk Customers
31195,220,5,"400,85",5,1,1,7,Mid-Value,Potential Loyalists
31196,767,3,"227,05",3,1,1,5,Low-Value,At Risk Customers
31197,1316,1,"1,35",2,1,1,4,Low-Value,Can't Lose
31198,71,4,"118,4",5,1,1,7,Mid-Value,Potential Loyalists
31199,1474,1,"22,2",1,1,1,3,Low-Value,Lost
31200,549,3,"94,8",4,1,1,6,Mid-Value,Potential Loyalists
31201,1084,2,"65,9",3,1,1,5,Low-Value,At Risk Customers
31202,38,5,"212,25",5,1,1,7,Mid-Value,Potential Loyalists
31204,45,1,"39,6",5,1,1,7,Mid-Value,Potential Loyalists
31206,88,4,"457,3999999999999",5,1,1,7,Mid-Value,Potential Loyalists
31209,1100,1,"120,25",2,1,1,4,Low-Value,Can't Lose
31213,142,4,"482,4",5,1,1,7,Mid-Value,Potential Loyalists
31214,123,2,"171,1",5,1,1,7,Mid-Value,Potential Loyalists
31215,164,1,"15,5",5,1,1,7,Mid-Value,Potential Loyalists
31216,409,3,"50,45",4,1,1,6,Mid-Value,Potential Loyalists
31217,577,9,"514,05",4,2,1,7,Mid-Value,Potential Loyalists
31218,481,3,"81,5",4,1,1,6,Mid-Value,Potential Loyalists
31222,362,1,"39,3",5,1,1,7,Mid-Value,Potential Loyalists
31223,404,3,"93,65",4,1,1,6,Mid-Value,Potential Loyalists
31224,1729,1,"61,9",1,1,1,3,Low-Value,Lost
31226,186,3,"176,15",5,1,1,7,Mid-Value,Potential Loyalists
31227,995,3,"47,35",3,1,1,5,Low-Value,At Risk Customers
31228,544,6,"488,25",4,1,1,6,Mid-Value,Potential Loyalists
31229,491,4,"112,35",4,1,1,6,Mid-Value,Potential Loyalists
31230,616,2,"43,0",4,1,1,6,Mid-Value,Potential Loyalists
31231,127,7,"690,1500000000001",5,2,2,9,High-Value,Champions
31233,99,3,"88,2",5,1,1,7,Mid-Value,Potential Loyalists
31234,278,4,"120,8",5,1,1,7,Mid-Value,Potential Loyalists
31236,25,1,"45,3",5,1,1,7,Mid-Value,Potential Loyalists
31237,476,2,"281,75",4,1,1,6,Mid-Value,Potential Loyalists
31238,517,2,"127,44999999999999",4,1,1,6,Mid-Value,Potential Loyalists
31241,367,5,"213,95",4,1,1,6,Mid-Value,Potential Loyalists
31243,594,1,"121,64999999999999",4,1,1,6,Mid-Value,Potential Loyalists
31244,82,2,"306,35",5,1,1,7,Mid-Value,Potential Loyalists
31245,1139,3,"65,69999999999999",2,1,1,4,Low-Value,Can't Lose
31246,543,2,"163,65",4,1,1,6,Mid-Value,Potential Loyalists
31247,61,3,"93,25",5,1,1,7,Mid-Value,Potential Loyalists
31248,131,5,"152,2",5,1,1,7,Mid-Value,Potential Loyalists
31249,74,3,"128,75",5,1,1,7,Mid-Value,Potential Loyalists
31251,161,7,"354,3",5,2,1,8,High-Value,Potential Loyalists
31253,24,5,"386,7",5,1,1,7,Mid-Value,Potential Loyalists
31255,1447,1,"107,2",2,1,1,4,Low-Value,Can't Lose
31259,21,4,"168,25",5,1,1,7,Mid-Value,Potential Loyalists
31260,1262,2,"425,2",2,1,1,4,Low-Value,Can't Lose
31264,560,3,"107,6",4,1,1,6,Mid-Value,Potential Loyalists
31265,929,2,"597,6",3,1,1,5,Low-Value,At Risk Customers
31266,0,7,"251,15",5,2,1,8,High-Value,Potential Loyalists
31268,505,2,"52,25",4,1,1,6,Mid-Value,Potential Loyalists
31270,44,1,"120,8",5,1,1,7,Mid-Value,Potential Loyalists
31273,1000,1,"4,85",3,1,1,5,Low-Value,At Risk Customers
31274,1021,1,"239,6",3,1,1,5,Low-Value,At Risk Customers
31275,346,9,"303,4",5,2,1,8,High-Value,Potential Loyalists
31276,263,2,"156,5",5,1,1,7,Mid-Value,Potential Loyalists
31277,416,4,"114,05",4,1,1,6,Mid-Value,Potential Loyalists
31279,164,6,"409,4",5,1,1,7,Mid-Value,Potential Loyalists
31280,826,1,"38,8",3,1,1,5,Low-Value,At Risk Customers
31282,377,4,"481,65000000000003",4,1,1,6,Mid-Value,Potential Loyalists
31283,253,3,"134,14999999999998",5,1,1,7,Mid-Value,Potential Loyalists
31284,859,1,"35,55",3,1,1,5,Low-Value,At Risk Customers
31285,794,1,"43,4",3,1,1,5,Low-Value,At Risk Customers
31287,49,11,"566,75",5,2,1,8,High-Value,Potential Loyalists
31290,675,3,"161,35",4,1,1,6,Mid-Value,Potential Loyalists
31292,414,1,"20,0",4,1,1,6,Mid-Value,Potential Loyalists
31294,436,8,"1510,3500000000001",4,2,3,9,High-Value,Champions
31297,1598,1,"108,0",1,1,1,3,Low-Value,Lost
31298,103,7,"276,0",5,2,1,8,High-Value,Potential Loyalists
31299,671,2,"86,75",4,1,1,6,Mid-Value,Potential Loyalists
31302,382,4,"76,25",4,1,1,6,Mid-Value,Potential Loyalists
31305,1134,4,"125,85",2,1,1,4,Low-Value,Can't Lose
31306,77,3,"359,50000000000006",5,1,1,7,Mid-Value,Potential Loyalists
31307,110,6,"296,3",5,1,1,7,Mid-Value,Potential Loyalists
31308,167,9,"213,6",5,2,1,8,High-Value,Potential Loyalists
31310,74,4,"148,35",5,1,1,7,Mid-Value,Potential Loyalists
31311,1459,2,"121,35",2,1,1,4,Low-Value,Can't Lose
31312,785,5,"172,45",3,1,1,5,Low-Value,At Risk Customers
31313,136,1,"30,0",5,1,1,7,Mid-Value,Potential Loyalists
31314,1529,3,"189,54999999999998",1,1,1,3,Low-Value,Lost
31315,588,1,"33,25",4,1,1,6,Mid-Value,Potential Loyalists
31319,1261,5,"363,0",2,1,1,4,Low-Value,Can't Lose
31320,1733,1,"202,04999999999998",1,1,1,3,Low-Value,Lost
31321,1419,3,"116,3",2,1,1,4,Low-Value,Can't Lose
31324,1614,1,"52,2",1,1,1,3,Low-Value,Lost
31325,150,2,"323,0",5,1,1,7,Mid-Value,Potential Loyalists
31326,56,6,"464,15",5,1,1,7,Mid-Value,Potential Loyalists
31327,1148,3,"109,25",2,1,1,4,Low-Value,Can't Lose
31328,162,4,"130,3",5,1,1,7,Mid-Value,Potential Loyalists
31329,1205,2,"181,1",2,1,1,4,Low-Value,Can't Lose
31330,162,4,"176,53",5,1,1,7,Mid-Value,Potential Loyalists
31332,14,9,"519,6500000000001",5,2,1,8,High-Value,Potential Loyalists
31333,0,3,"305,0",5,1,1,7,Mid-Value,Potential Loyalists
31337,60,5,"103,35",5,1,1,7,Mid-Value,Potential Loyalists
31338,803,7,"476,25",3,2,1,6,Mid-Value,Potential Loyalists
31342,163,3,"197,3",5,1,1,7,Mid-Value,Potential Loyalists
31344,426,1,"9,95",4,1,1,6,Mid-Value,Potential Loyalists
31345,407,6,"477,55",4,1,1,6,Mid-Value,Potential Loyalists
31346,1470,1,"72,2",1,1,1,3,Low-Value,Lost
31349,10,1,"48,45",5,1,1,7,Mid-Value,Potential Loyalists
31350,746,3,"210,45000000000002",3,1,1,5,Low-Value,At Risk Customers
31351,44,5,"169,05",5,1,1,7,Mid-Value,Potential Loyalists
31352,732,1,"61,0",3,1,1,5,Low-Value,At Risk Customers
31353,32,4,"345,45",5,1,1,7,Mid-Value,Potential Loyalists
31358,274,10,"1061,8999999999999",5,2,2,9,High-Value,Champions
31361,396,2,"68,0",4,1,1,6,Mid-Value,Potential Loyalists
31364,1816,1,"44,1",1,1,1,3,Low-Value,Lost
31366,734,7,"454,85",3,2,1,6,Mid-Value,Potential Loyalists
31370,496,1,"35,1",4,1,1,6,Mid-Value,Potential Loyalists
31371,715,5,"156,45",4,1,1,6,Mid-Value,Potential Loyalists
31372,242,3,"282,95000000000005",5,1,1,7,Mid-Value,Potential Loyalists
31373,435,4,"428,6",4,1,1,6,Mid-Value,Potential Loyalists
31374,970,5,"218,85",3,1,1,5,Low-Value,At Risk Customers
31375,178,1,"181,4",5,1,1,7,Mid-Value,Potential Loyalists
31376,721,1,"19,8",4,1,1,6,Mid-Value,Potential Loyalists
31377,1155,1,"96,6",2,1,1,4,Low-Value,Can't Lose
31378,1502,2,"86,44999999999999",1,1,1,3,Low-Value,Lost
31381,1485,2,"193,2",1,1,1,3,Low-Value,Lost
31383,7,10,"470,25",5,2,1,8,High-Value,Potential Loyalists
31384,1169,3,"141,29999999999998",2,1,1,4,Low-Value,Can't Lose
31385,293,3,"112,95",5,1,1,7,Mid-Value,Potential Loyalists
31386,267,2,"78,75",5,1,1,7,Mid-Value,Potential Loyalists
31387,699,4,"442,25",4,1,1,6,Mid-Value,Potential Loyalists
31388,1457,1,"133,5",2,1,1,4,Low-Value,Can't Lose
31389,8,4,"602,55",5,1,1,7,Mid-Value,Potential Loyalists
31391,731,12,"1215,2",3,3,2,8,High-Value,Potential Loyalists
31392,1687,1,"44,6",1,1,1,3,Low-Value,Lost
31395,369,2,"12,899999999999999",4,1,1,6,Mid-Value,Potential Loyalists
31396,196,6,"184,35000000000002",5,1,1,7,Mid-Value,Potential Loyalists
31397,749,4,"80,35",3,1,1,5,Low-Value,At Risk Customers
31399,1019,1,"21,1",3,1,1,5,Low-Value,At Risk Customers
31400,987,1,"11,75",3,1,1,5,Low-Value,At Risk Customers
31401,551,4,"555,8499999999999",4,1,1,6,Mid-Value,Potential Loyalists
31402,926,1,"63,1",3,1,1,5,Low-Value,At Risk Customers
31403,372,4,"59,260000000000005",4,1,1,6,Mid-Value,Potential Loyalists
31405,435,4,"53,2",4,1,1,6,Mid-Value,Potential Loyalists
31406,1228,1,"227,3",2,1,1,4,Low-Value,Can't Lose
31409,306,4,"109,95",5,1,1,7,Mid-Value,Potential Loyalists
31411,1064,1,"43,55",3,1,1,5,Low-Value,At Risk Customers
31413,607,3,"135,89999999999998",4,1,1,6,Mid-Value,Potential Loyalists
31414,559,4,"288,25",4,1,1,6,Mid-Value,Potential Loyalists
31415,91,7,"212,15",5,2,1,8,High-Value,Potential Loyalists
31419,399,3,"209,25",4,1,1,6,Mid-Value,Potential Loyalists
31420,962,3,"95,1",3,1,1,5,Low-Value,At Risk Customers
31421,396,3,"185,95000000000002",4,1,1,6,Mid-Value,Potential Loyalists
31422,868,2,"140,75",3,1,1,5,Low-Value,At Risk Customers
31423,542,5,"364,2",4,1,1,6,Mid-Value,Potential Loyalists
31424,85,11,"472,25",5,2,1,8,High-Value,Potential Loyalists
31425,208,1,"88,8",5,1,1,7,Mid-Value,Potential Loyalists
31427,14,7,"921,9000000000001",5,2,2,9,High-Value,Champions
31428,1327,3,"170,04999999999998",2,1,1,4,Low-Value,Can't Lose
31430,1350,2,"181,35000000000002",2,1,1,4,Low-Value,Can't Lose
31432,243,5,"245,25",5,1,1,7,Mid-Value,Potential Loyalists
31434,263,4,"171,15",5,1,1,7,Mid-Value,Potential Loyalists
31436,291,5,"438,95000000000005",5,1,1,7,Mid-Value,Potential Loyalists
31437,1461,1,"7,0",1,1,1,3,Low-Value,Lost
31439,488,1,"84,3",4,1,1,6,Mid-Value,Potential Loyalists
31440,235,5,"434,9",5,1,1,7,Mid-Value,Potential Loyalists
31442,920,2,"241,5",3,1,1,5,Low-Value,At Risk Customers
31443,570,1,"5,8",4,1,1,6,Mid-Value,Potential Loyalists
31446,1393,3,"227,75",2,1,1,4,Low-Value,Can't Lose
31447,1618,2,"79,10000000000001",1,1,1,3,Low-Value,Lost
31449,389,5,"196,55",4,1,1,6,Mid-Value,Potential Loyalists
31452,1561,2,"64,6",1,1,1,3,Low-Value,Lost
31453,1173,3,"225,59999999999997",2,1,1,4,Low-Value,Can't Lose
31455,70,2,"69,6",5,1,1,7,Mid-Value,Potential Loyalists
31456,138,5,"249,64999999999998",5,1,1,7,Mid-Value,Potential Loyalists
31457,354,5,"305,3",5,1,1,7,Mid-Value,Potential Loyalists
31461,939,3,"186,0",3,1,1,5,Low-Value,At Risk Customers
31462,244,2,"139,95",5,1,1,7,Mid-Value,Potential Loyalists
31463,51,3,"76,55000000000001",5,1,1,7,Mid-Value,Potential Loyalists
31466,1729,1,"38,9",1,1,1,3,Low-Value,Lost
31467,929,3,"54,900000000000006",3,1,1,5,Low-Value,At Risk Customers
31468,662,4,"578,75",4,1,1,6,Mid-Value,Potential Loyalists
31471,1476,3,"214,75",1,1,1,3,Low-Value,Lost
31472,911,5,"90,15",3,1,1,5,Low-Value,At Risk Customers
31473,446,2,"54,0",4,1,1,6,Mid-Value,Potential Loyalists
31474,1443,1,"9,75",2,1,1,4,Low-Value,Can't Lose
31476,26,2,"133,9",5,1,1,7,Mid-Value,Potential Loyalists
31477,370,5,"376,35",4,1,1,6,Mid-Value,Potential Loyalists
31479,831,5,"379,45",3,1,1,5,Low-Value,At Risk Customers
31482,326,1,"8,45",5,1,1,7,Mid-Value,Potential Loyalists
31484,857,4,"227,55",3,1,1,5,Low-Value,At Risk Customers
31485,794,3,"157,85",3,1,1,5,Low-Value,At Risk Customers
31486,81,9,"406,3",5,2,1,8,High-Value,Potential Loyalists
31487,549,5,"479,5",4,1,1,6,Mid-Value,Potential Loyalists
31488,985,1,"157,2",3,1,1,5,Low-Value,At Risk Customers
31489,6,1,"36,8",5,1,1,7,Mid-Value,Potential Loyalists
31490,59,3,"158,05",5,1,1,7,Mid-Value,Potential Loyalists
31491,1604,2,"354,8",1,1,1,3,Low-Value,Lost
31493,615,5,"178,2",4,1,1,6,Mid-Value,Potential Loyalists
31495,1547,2,"55,45",1,1,1,3,Low-Value,Lost
31496,1530,1,"90,7",1,1,1,3,Low-Value,Lost
31498,1169,3,"109,45",2,1,1,4,Low-Value,Can't Lose
31499,332,4,"62,4",5,1,1,7,Mid-Value,Potential Loyalists
31500,346,1,"174,3",5,1,1,7,Mid-Value,Potential Loyalists
31501,53,2,"31,549999999999997",5,1,1,7,Mid-Value,Potential Loyalists
31502,571,1,"64,4",4,1,1,6,Mid-Value,Potential Loyalists
31504,143,2,"139,5",5,1,1,7,Mid-Value,Potential Loyalists
31505,55,9,"459,75",5,2,1,8,High-Value,Potential Loyalists
31506,259,6,"502,6",5,1,1,7,Mid-Value,Potential Loyalists
31507,21,5,"246,5",5,1,1,7,Mid-Value,Potential Loyalists
31510,513,1,"53,4",4,1,1,6,Mid-Value,Potential Loyalists
31511,869,1,"21,4",3,1,1,5,Low-Value,At Risk Customers
31512,1311,1,"3,8",2,1,1,4,Low-Value,Can't Lose
31514,1769,1,"32,25",1,1,1,3,Low-Value,Lost
31519,487,4,"3261,3",4,1,5,10,High-Value,Champions
31520,407,2,"135,25",4,1,1,6,Mid-Value,Potential Loyalists
31523,1488,1,"56,6",1,1,1,3,Low-Value,Lost
31524,196,5,"235,10000000000002",5,1,1,7,Mid-Value,Potential Loyalists
31528,107,14,"1597,6",5,3,3,11,High-Value,Champions
31530,67,5,"298,3",5,1,1,7,Mid-Value,Potential Loyalists
31533,1542,2,"238,4",1,1,1,3,Low-Value,Lost
31534,15,7,"435,75",5,2,1,8,High-Value,Potential Loyalists
31535,7,9,"485,45",5,2,1,8,High-Value,Potential Loyalists
31536,196,3,"578,3",5,1,1,7,Mid-Value,Potential Loyalists
31537,480,15,"829,4499999999999",4,3,2,9,High-Value,Champions
31538,859,2,"172,70000000000002",3,1,1,5,Low-Value,At Risk Customers
31539,226,2,"19,0",5,1,1,7,Mid-Value,Potential Loyalists
31540,1287,1,"270,0",2,1,1,4,Low-Value,Can't Lose
31541,365,3,"309,65",5,1,1,7,Mid-Value,Potential Loyalists
31543,1591,1,"6,3",1,1,1,3,Low-Value,Lost
31548,613,2,"132,05",4,1,1,6,Mid-Value,Potential Loyalists
31549,652,3,"30,35",4,1,1,6,Mid-Value,Potential Loyalists
31550,303,1,"59,65",5,1,1,7,Mid-Value,Potential Loyalists
31551,108,4,"153,75",5,1,1,7,Mid-Value,Potential Loyalists
31552,87,5,"256,85",5,1,1,7,Mid-Value,Potential Loyalists
31553,149,8,"373,6",5,2,1,8,High-Value,Potential Loyalists
31554,536,12,"693,6",4,3,2,9,High-Value,Champions
31555,837,1,"18,5",3,1,1,5,Low-Value,At Risk Customers
31557,231,2,"272,0",5,1,1,7,Mid-Value,Potential Loyalists
31558,39,6,"126,0",5,1,1,7,Mid-Value,Potential Loyalists
31562,1529,1,"46,0",1,1,1,3,Low-Value,Lost
31563,473,4,"172,0",4,1,1,6,Mid-Value,Potential Loyalists
31564,1099,1,"19,0",2,1,1,4,Low-Value,Can't Lose
31565,142,2,"122,8",5,1,1,7,Mid-Value,Potential Loyalists
31567,399,9,"542,4",4,2,1,7,Mid-Value,Potential Loyalists
31568,36,2,"164,10000000000002",5,1,1,7,Mid-Value,Potential Loyalists
31569,1623,1,"7,949999999999999",1,1,1,3,Low-Value,Lost
31572,892,2,"17,85",3,1,1,5,Low-Value,At Risk Customers
31574,1691,1,"12,75",1,1,1,3,Low-Value,Lost
31575,1090,2,"25,549999999999997",3,1,1,5,Low-Value,At Risk Customers
31576,26,5,"181,45000000000002",5,1,1,7,Mid-Value,Potential Loyalists
31577,36,5,"75,7",5,1,1,7,Mid-Value,Potential Loyalists
31578,100,2,"23,799999999999997",5,1,1,7,Mid-Value,Potential Loyalists
31580,1240,1,"60,7",2,1,1,4,Low-Value,Can't Lose
31582,1380,2,"263,3",2,1,1,4,Low-Value,Can't Lose
31588,320,2,"32,5",5,1,1,7,Mid-Value,Potential Loyalists
31589,817,2,"201,85",3,1,1,5,Low-Value,At Risk Customers
31591,1179,3,"199,35",2,1,1,4,Low-Value,Can't Lose
31592,244,1,"16,1",5,1,1,7,Mid-Value,Potential Loyalists
31593,445,5,"276,95",4,1,1,6,Mid-Value,Potential Loyalists
31594,535,3,"111,35",4,1,1,6,Mid-Value,Potential Loyalists
31595,455,10,"592,95",4,2,1,7,Mid-Value,Potential Loyalists
31596,695,3,"269,45",4,1,1,6,Mid-Value,Potential Loyalists
31598,740,1,"159,14999999999998",3,1,1,5,Low-Value,At Risk Customers
31601,520,4,"409,85",4,1,1,6,Mid-Value,Potential Loyalists
31605,31,10,"615,45",5,2,1,8,High-Value,Potential Loyalists
31606,2,11,"380,65000000000003",5,2,1,8,High-Value,Potential Loyalists
31608,771,3,"50,050000000000004",3,1,1,5,Low-Value,At Risk Customers
31610,1230,4,"474,9",2,1,1,4,Low-Value,Can't Lose
31612,554,1,"100,8",4,1,1,6,Mid-Value,Potential Loyalists
31616,67,1,"12,2",5,1,1,7,Mid-Value,Potential Loyalists
31617,336,2,"204,8",5,1,1,7,Mid-Value,Potential Loyalists
31618,924,5,"435,65",3,1,1,5,Low-Value,At Risk Customers
31619,1494,2,"49,35",1,1,1,3,Low-Value,Lost
31620,72,2,"14,5",5,1,1,7,Mid-Value,Potential Loyalists
31621,854,3,"99,7",3,1,1,5,Low-Value,At Risk Customers
31622,882,1,"237,0",3,1,1,5,Low-Value,At Risk Customers
31625,504,8,"492,4",4,2,1,7,Mid-Value,Potential Loyalists
31627,749,4,"409,35",3,1,1,5,Low-Value,At Risk Customers
31628,223,3,"168,05",5,1,1,7,Mid-Value,Potential Loyalists
31629,942,1,"38,3",3,1,1,5,Low-Value,At Risk Customers
31631,17,4,"326,7",5,1,1,7,Mid-Value,Potential Loyalists
31632,498,4,"119,55",4,1,1,6,Mid-Value,Potential Loyalists
31633,847,1,"398,0",3,1,1,5,Low-Value,At Risk Customers
31635,917,2,"170,8",3,1,1,5,Low-Value,At Risk Customers
31636,417,2,"54,75",4,1,1,6,Mid-Value,Potential Loyalists
31638,640,2,"195,85",4,1,1,6,Mid-Value,Potential Loyalists
31640,11,11,"1031,0",5,2,2,9,High-Value,Champions
31642,560,1,"49,349999999999994",4,1,1,6,Mid-Value,Potential Loyalists
31643,894,2,"274,9",3,1,1,5,Low-Value,At Risk Customers
31644,502,4,"1306,3",4,1,2,7,Mid-Value,Potential Loyalists
31646,48,5,"121,6",5,1,1,7,Mid-Value,Potential Loyalists
31647,1639,1,"482,0",1,1,1,3,Low-Value,Lost
31649,1702,1,"22,45",1,1,1,3,Low-Value,Lost
31651,464,6,"249,1",4,1,1,6,Mid-Value,Potential Loyalists
31654,885,2,"88,2",3,1,1,5,Low-Value,At Risk Customers
31655,984,1,"67,9",3,1,1,5,Low-Value,At Risk Customers
31656,474,5,"260,55",4,1,1,6,Mid-Value,Potential Loyalists
31659,1667,1,"57,6",1,1,1,3,Low-Value,Lost
31660,54,1,"5,6",5,1,1,7,Mid-Value,Potential Loyalists
31661,491,2,"103,75",4,1,1,6,Mid-Value,Potential Loyalists
31662,561,1,"63,0",4,1,1,6,Mid-Value,Potential Loyalists
31663,73,5,"392,45",5,1,1,7,Mid-Value,Potential Loyalists
31665,134,1,"24,299999999999997",5,1,1,7,Mid-Value,Potential Loyalists
31666,180,3,"274,55",5,1,1,7,Mid-Value,Potential Loyalists
31667,1263,1,"46,2",2,1,1,4,Low-Value,Can't Lose
31668,95,4,"598,4",5,1,1,7,Mid-Value,Potential Loyalists
31670,1702,1,"23,85",1,1,1,3,Low-Value,Lost
31671,206,1,"243,2",5,1,1,7,Mid-Value,Potential Loyalists
31672,381,9,"404,9",4,2,1,7,Mid-Value,Potential Loyalists
31673,243,1,"10,55",5,1,1,7,Mid-Value,Potential Loyalists
31675,751,2,"61,400000000000006",3,1,1,5,Low-Value,At Risk Customers
31677,85,5,"145,95",5,1,1,7,Mid-Value,Potential Loyalists
31680,308,6,"240,1",5,1,1,7,Mid-Value,Potential Loyalists
31682,160,6,"328,8",5,1,1,7,Mid-Value,Potential Loyalists
31683,234,5,"167,45",5,1,1,7,Mid-Value,Potential Loyalists
31685,3,2,"27,200000000000003",5,1,1,7,Mid-Value,Potential Loyalists
31686,176,6,"142,05",5,1,1,7,Mid-Value,Potential Loyalists
31687,1136,2,"100,55",2,1,1,4,Low-Value,Can't Lose
31688,67,3,"170,35000000000002",5,1,1,7,Mid-Value,Potential Loyalists
31689,29,11,"810,1500000000001",5,2,2,9,High-Value,Champions
31690,1381,1,"35,95",2,1,1,4,Low-Value,Can't Lose
31691,745,1,"41,0",3,1,1,5,Low-Value,At Risk Customers
31693,1104,1,"227,2",2,1,1,4,Low-Value,Can't Lose
31696,395,6,"194,5",4,1,1,6,Mid-Value,Potential Loyalists
31697,370,5,"235,45",4,1,1,6,Mid-Value,Potential Loyalists
31698,1227,1,"52,8",2,1,1,4,Low-Value,Can't Lose
31699,949,1,"270,0",3,1,1,5,Low-Value,At Risk Customers
31700,1179,2,"66,80000000000001",2,1,1,4,Low-Value,Can't Lose
31704,1044,1,"90,7",3,1,1,5,Low-Value,At Risk Customers
31705,509,2,"35,15",4,1,1,6,Mid-Value,Potential Loyalists
31707,23,1,"127,95",5,1,1,7,Mid-Value,Potential Loyalists
31708,616,3,"444,05",4,1,1,6,Mid-Value,Potential Loyalists
31709,189,2,"122,4",5,1,1,7,Mid-Value,Potential Loyalists
31710,505,2,"91,89999999999999",4,1,1,6,Mid-Value,Potential Loyalists
31711,1572,1,"64,95",1,1,1,3,Low-Value,Lost
31712,298,8,"325,5",5,2,1,8,High-Value,Potential Loyalists
31713,474,1,"54,0",4,1,1,6,Mid-Value,Potential Loyalists
31715,456,2,"275,45",4,1,1,6,Mid-Value,Potential Loyalists
31717,151,3,"346,65",5,1,1,7,Mid-Value,Potential Loyalists
31720,612,2,"236,4",4,1,1,6,Mid-Value,Potential Loyalists
31721,354,9,"233,55",5,2,1,8,High-Value,Potential Loyalists
31725,140,2,"139,35",5,1,1,7,Mid-Value,Potential Loyalists
31726,991,1,"6,45",3,1,1,5,Low-Value,At Risk Customers
31728,21,2,"245,7",5,1,1,7,Mid-Value,Potential Loyalists
31732,1132,2,"173,54999999999998",2,1,1,4,Low-Value,Can't Lose
31734,27,2,"511,35",5,1,1,7,Mid-Value,Potential Loyalists
31735,741,2,"47,099999999999994",3,1,1,5,Low-Value,At Risk Customers
31736,392,4,"521,65",4,1,1,6,Mid-Value,Potential Loyalists
31737,11,3,"168,8",5,1,1,7,Mid-Value,Potential Loyalists
31738,149,1,"134,7",5,1,1,7,Mid-Value,Potential Loyalists
31739,1134,1,"22,1",2,1,1,4,Low-Value,Can't Lose
31740,1036,1,"15,05",3,1,1,5,Low-Value,At Risk Customers
31742,8,6,"1484,3",5,1,3,9,High-Value,Champions
31744,788,4,"102,2",3,1,1,5,Low-Value,At Risk Customers
31745,1094,1,"109,55",3,1,1,5,Low-Value,At Risk Customers
31746,459,4,"168,45",4,1,1,6,Mid-Value,Potential Loyalists
31749,745,2,"206,25",3,1,1,5,Low-Value,At Risk Customers
31752,889,1,"162,8",3,1,1,5,Low-Value,At Risk Customers
31753,369,2,"29,700000000000003",4,1,1,6,Mid-Value,Potential Loyalists
31754,240,4,"246,05",5,1,1,7,Mid-Value,Potential Loyalists
31755,283,3,"82,9",5,1,1,7,Mid-Value,Potential Loyalists
31756,5,21,"1189,5",5,4,2,11,High-Value,Champions
31757,1556,1,"6,2",1,1,1,3,Low-Value,Lost
31762,274,4,"71,55",5,1,1,7,Mid-Value,Potential Loyalists
31765,34,5,"258,45",5,1,1,7,Mid-Value,Potential Loyalists
31767,1319,1,"18,6",2,1,1,4,Low-Value,Can't Lose
31768,409,5,"296,7",4,1,1,6,Mid-Value,Potential Loyalists
31769,110,6,"289,8",5,1,1,7,Mid-Value,Potential Loyalists
31770,255,4,"544,0999999999999",5,1,1,7,Mid-Value,Potential Loyalists
31771,395,9,"876,85",4,2,2,8,High-Value,Potential Loyalists
31772,40,9,"336,05",5,2,1,8,High-Value,Potential Loyalists
31774,370,8,"578,2",4,2,1,7,Mid-Value,Potential Loyalists
31776,49,8,"560,9",5,2,1,8,High-Value,Potential Loyalists
31777,1284,2,"92,60000000000001",2,1,1,4,Low-Value,Can't Lose
31779,1118,1,"411,8",2,1,1,4,Low-Value,Can't Lose
31780,28,4,"147,05",5,1,1,7,Mid-Value,Potential Loyalists
31782,1005,2,"241,6",3,1,1,5,Low-Value,At Risk Customers
31783,1737,1,"17,9",1,1,1,3,Low-Value,Lost
31786,428,1,"61,0",4,1,1,6,Mid-Value,Potential Loyalists
31787,1675,2,"100,55",1,1,1,3,Low-Value,Lost
31788,409,3,"346,9",4,1,1,6,Mid-Value,Potential Loyalists
31792,23,3,"96,35",5,1,1,7,Mid-Value,Potential Loyalists
31796,1148,3,"169,85000000000002",2,1,1,4,Low-Value,Can't Lose
31797,1380,1,"21,4",2,1,1,4,Low-Value,Can't Lose
31798,181,4,"131,9",5,1,1,7,Mid-Value,Potential Loyalists
31799,372,6,"402,96",4,1,1,6,Mid-Value,Potential Loyalists
31801,294,3,"134,95",5,1,1,7,Mid-Value,Potential Loyalists
31802,579,4,"218,64999999999998",4,1,1,6,Mid-Value,Potential Loyalists
31803,1631,1,"0,7",1,1,1,3,Low-Value,Lost
31806,160,2,"417,15",5,1,1,7,Mid-Value,Potential Loyalists
31807,749,2,"72,05",3,1,1,5,Low-Value,At Risk Customers
31811,56,2,"14,0",5,1,1,7,Mid-Value,Potential Loyalists
31812,325,1,"149,1",5,1,1,7,Mid-Value,Potential Loyalists
31814,845,1,"233,2",3,1,1,5,Low-Value,At Risk Customers
31816,178,6,"265,35",5,1,1,7,Mid-Value,Potential Loyalists
31819,1547,1,"40,0",1,1,1,3,Low-Value,Lost
31820,607,3,"94,1",4,1,1,6,Mid-Value,Potential Loyalists
31821,1518,1,"22,3",1,1,1,3,Low-Value,Lost
31822,998,5,"153,85",3,1,1,5,Low-Value,At Risk Customers
31824,533,6,"237,79999999999998",4,1,1,6,Mid-Value,Potential Loyalists
31826,282,5,"123,55000000000001",5,1,1,7,Mid-Value,Potential Loyalists
31827,946,2,"130,9",3,1,1,5,Low-Value,At Risk Customers
31829,825,1,"104,1",3,1,1,5,Low-Value,At Risk Customers
31830,41,4,"374,49999999999994",5,1,1,7,Mid-Value,Potential Loyalists
31831,462,7,"247,55",4,2,1,7,Mid-Value,Potential Loyalists
31832,943,2,"58,75",3,1,1,5,Low-Value,At Risk Customers
31833,316,3,"88,65",5,1,1,7,Mid-Value,Potential Loyalists
31834,432,3,"96,65",4,1,1,6,Mid-Value,Potential Loyalists
31838,439,1,"8,7",4,1,1,6,Mid-Value,Potential Loyalists
31839,487,1,"8,7",4,1,1,6,Mid-Value,Potential Loyalists
31840,82,5,"256,05",5,1,1,7,Mid-Value,Potential Loyalists
31841,601,7,"493,55",4,2,1,7,Mid-Value,Potential Loyalists
31844,601,5,"181,85000000000002",4,1,1,6,Mid-Value,Potential Loyalists
31845,107,4,"66,1",5,1,1,7,Mid-Value,Potential Loyalists
31846,1594,1,"19,9",1,1,1,3,Low-Value,Lost
31848,225,6,"165,45000000000002",5,1,1,7,Mid-Value,Potential Loyalists
31849,497,7,"462,7",4,2,1,7,Mid-Value,Potential Loyalists
31850,956,1,"20,25",3,1,1,5,Low-Value,At Risk Customers
31853,1572,1,"23,7",1,1,1,3,Low-Value,Lost
31854,972,5,"203,10000000000002",3,1,1,5,Low-Value,At Risk Customers
31855,786,4,"119,65",3,1,1,5,Low-Value,At Risk Customers
31857,763,2,"280,75",3,1,1,5,Low-Value,At Risk Customers
31859,280,2,"104,3",5,1,1,7,Mid-Value,Potential Loyalists
31860,826,2,"54,25",3,1,1,5,Low-Value,At Risk Customers
31861,768,3,"230,61",3,1,1,5,Low-Value,At Risk Customers
31862,55,10,"689,2",5,2,2,9,High-Value,Champions
31863,264,5,"331,3",5,1,1,7,Mid-Value,Potential Loyalists
31867,413,5,"124,4",4,1,1,6,Mid-Value,Potential Loyalists
31868,297,5,"235,89999999999998",5,1,1,7,Mid-Value,Potential Loyalists
31869,259,5,"307,15",5,1,1,7,Mid-Value,Potential Loyalists
31870,95,5,"450,8",5,1,1,7,Mid-Value,Potential Loyalists
31871,238,2,"138,29999999999998",5,1,1,7,Mid-Value,Potential Loyalists
31872,575,2,"33,95",4,1,1,6,Mid-Value,Potential Loyalists
31874,28,3,"236,95",5,1,1,7,Mid-Value,Potential Loyalists
31875,935,1,"31,2",3,1,1,5,Low-Value,At Risk Customers
31877,213,5,"303,04999999999995",5,1,1,7,Mid-Value,Potential Loyalists
31879,681,4,"193,4",4,1,1,6,Mid-Value,Potential Loyalists
31880,1128,3,"132,9",2,1,1,4,Low-Value,Can't Lose
31881,343,3,"210,9",5,1,1,7,Mid-Value,Potential Loyalists
31882,238,1,"58,650000000000006",5,1,1,7,Mid-Value,Potential Loyalists
31884,564,3,"74,0",4,1,1,6,Mid-Value,Potential Loyalists
31886,1116,2,"140,8",2,1,1,4,Low-Value,Can't Lose
31888,225,5,"146,15",5,1,1,7,Mid-Value,Potential Loyalists
31892,365,1,"121,0",5,1,1,7,Mid-Value,Potential Loyalists
31893,434,1,"68,2",4,1,1,6,Mid-Value,Potential Loyalists
31894,1313,1,"39,9",2,1,1,4,Low-Value,Can't Lose
31895,45,4,"111,35000000000001",5,1,1,7,Mid-Value,Potential Loyalists
31899,529,1,"75,75",4,1,1,6,Mid-Value,Potential Loyalists
31902,828,1,"57,45",3,1,1,5,Low-Value,At Risk Customers
31903,1125,1,"17,2",2,1,1,4,Low-Value,Can't Lose
31905,605,2,"95,05000000000001",4,1,1,6,Mid-Value,Potential Loyalists
31907,57,10,"480,65",5,2,1,8,High-Value,Potential Loyalists
31909,70,1,"60,75",5,1,1,7,Mid-Value,Potential Loyalists
31910,489,6,"375,75",4,1,1,6,Mid-Value,Potential Loyalists
31912,940,2,"170,75",3,1,1,5,Low-Value,At Risk Customers
31913,1055,1,"4,6",3,1,1,5,Low-Value,At Risk Customers
31914,1110,2,"133,0",2,1,1,4,Low-Value,Can't Lose
31915,374,2,"107,65",4,1,1,6,Mid-Value,Potential Loyalists
31916,181,2,"59,7",5,1,1,7,Mid-Value,Potential Loyalists
31917,392,3,"389,80000000000007",4,1,1,6,Mid-Value,Potential Loyalists
31919,421,1,"211,1",4,1,1,6,Mid-Value,Potential Loyalists
31921,509,3,"160,5",4,1,1,6,Mid-Value,Potential Loyalists
31922,760,2,"128,5",3,1,1,5,Low-Value,At Risk Customers
31923,671,2,"56,099999999999994",4,1,1,6,Mid-Value,Potential Loyalists
31925,659,3,"54,75",4,1,1,6,Mid-Value,Potential Loyalists
31928,97,4,"239,45",5,1,1,7,Mid-Value,Potential Loyalists
31929,179,3,"244,35000000000002",5,1,1,7,Mid-Value,Potential Loyalists
31930,75,1,"9,85",5,1,1,7,Mid-Value,Potential Loyalists
31932,1336,1,"87,1",2,1,1,4,Low-Value,Can't Lose
31934,411,3,"122,2",4,1,1,6,Mid-Value,Potential Loyalists
31936,7,3,"189,29999999999998",5,1,1,7,Mid-Value,Potential Loyalists
31937,1028,2,"173,9",3,1,1,5,Low-Value,At Risk Customers
31940,203,2,"97,25",5,1,1,7,Mid-Value,Potential Loyalists
31944,255,5,"343,1",5,1,1,7,Mid-Value,Potential Loyalists
31945,355,2,"58,4",5,1,1,7,Mid-Value,Potential Loyalists
31948,20,6,"208,4",5,1,1,7,Mid-Value,Potential Loyalists
31950,371,2,"91,2",4,1,1,6,Mid-Value,Potential Loyalists
31952,193,6,"543,65",5,1,1,7,Mid-Value,Potential Loyalists
31954,120,6,"193,4",5,1,1,7,Mid-Value,Potential Loyalists
31956,48,6,"692,25",5,1,2,8,High-Value,Potential Loyalists
31957,1658,1,"305,0",1,1,1,3,Low-Value,Lost
31958,53,7,"492,1",5,2,1,8,High-Value,Potential Loyalists
31960,513,2,"39,9",4,1,1,6,Mid-Value,Potential Loyalists
31964,111,6,"362,55",5,1,1,7,Mid-Value,Potential Loyalists
31965,48,7,"801,9",5,2,2,9,High-Value,Champions
31966,547,3,"176,2",4,1,1,6,Mid-Value,Potential Loyalists
31967,152,2,"24,5",5,1,1,7,Mid-Value,Potential Loyalists
31968,18,4,"134,8",5,1,1,7,Mid-Value,Potential Loyalists
31969,73,4,"175,35",5,1,1,7,Mid-Value,Potential Loyalists
31970,25,3,"169,35",5,1,1,7,Mid-Value,Potential Loyalists
31972,1142,1,"5,3",2,1,1,4,Low-Value,Can't Lose
31975,230,1,"207,0",5,1,1,7,Mid-Value,Potential Loyalists
31976,65,4,"120,5",5,1,1,7,Mid-Value,Potential Loyalists
31977,196,2,"212,10000000000002",5,1,1,7,Mid-Value,Potential Loyalists
31978,53,8,"844,25",5,2,2,9,High-Value,Champions
31979,44,3,"147,2",5,1,1,7,Mid-Value,Potential Loyalists
31980,3,6,"159,3",5,1,1,7,Mid-Value,Potential Loyalists
31981,954,1,"113,85000000000001",3,1,1,5,Low-Value,At Risk Customers
31982,1266,2,"81,6",2,1,1,4,Low-Value,Can't Lose
31985,78,5,"210,7",5,1,1,7,Mid-Value,Potential Loyalists
31987,1261,2,"115,5",2,1,1,4,Low-Value,Can't Lose
31989,194,4,"149,28",5,1,1,7,Mid-Value,Potential Loyalists
31990,128,5,"274,70000000000005",5,1,1,7,Mid-Value,Potential Loyalists
31991,513,2,"29,5",4,1,1,6,Mid-Value,Potential Loyalists
31993,1729,2,"137,45",1,1,1,3,Low-Value,Lost
31995,1191,4,"272,45",2,1,1,4,Low-Value,Can't Lose
31996,4,2,"142,45",5,1,1,7,Mid-Value,Potential Loyalists
31997,374,1,"44,400000000000006",4,1,1,6,Mid-Value,Potential Loyalists
31998,35,5,"199,8",5,1,1,7,Mid-Value,Potential Loyalists
31999,677,1,"37,8",4,1,1,6,Mid-Value,Potential Loyalists
32000,872,3,"53,599999999999994",3,1,1,5,Low-Value,At Risk Customers
32001,747,6,"197,28",3,1,1,5,Low-Value,At Risk Customers
32004,44,9,"370,95",5,2,1,8,High-Value,Potential Loyalists
32005,1136,7,"232,75",2,2,1,5,Low-Value,At Risk Customers
32006,1669,2,"152,14999999999998",1,1,1,3,Low-Value,Lost
32007,228,3,"159,95000000000002",5,1,1,7,Mid-Value,Potential Loyalists
32008,160,5,"181,5",5,1,1,7,Mid-Value,Potential Loyalists
32009,763,2,"12,25",3,1,1,5,Low-Value,At Risk Customers
32010,203,1,"6,6000000000000005",5,1,1,7,Mid-Value,Potential Loyalists
32011,1232,3,"64,05",2,1,1,4,Low-Value,Can't Lose
32012,196,2,"100,95",5,1,1,7,Mid-Value,Potential Loyalists
32014,836,4,"581,3",3,1,1,5,Low-Value,At Risk Customers
32015,773,3,"31,95",3,1,1,5,Low-Value,At Risk Customers
32016,102,3,"282,54999999999995",5,1,1,7,Mid-Value,Potential Loyalists
32017,360,5,"280,45",5,1,1,7,Mid-Value,Potential Loyalists
32018,282,2,"90,55",5,1,1,7,Mid-Value,Potential Loyalists
32019,461,3,"145,14999999999998",4,1,1,6,Mid-Value,Potential Loyalists
32020,338,3,"88,65",5,1,1,7,Mid-Value,Potential Loyalists
32023,514,2,"227,5",4,1,1,6,Mid-Value,Potential Loyalists
32024,1427,1,"17,25",2,1,1,4,Low-Value,Can't Lose
32025,1056,7,"679,65",3,2,2,7,Mid-Value,Potential Loyalists
32026,211,1,"63,9",5,1,1,7,Mid-Value,Potential Loyalists
32027,922,3,"185,8",3,1,1,5,Low-Value,At Risk Customers
32028,951,2,"81,89999999999999",3,1,1,5,Low-Value,At Risk Customers
32029,750,2,"71,7",3,1,1,5,Low-Value,At Risk Customers
32031,3,8,"572,3499999999999",5,2,1,8,High-Value,Potential Loyalists
32033,782,2,"270,35",3,1,1,5,Low-Value,At Risk Customers
32037,1566,1,"5,25",1,1,1,3,Low-Value,Lost
32038,304,5,"531,35",5,1,1,7,Mid-Value,Potential Loyalists
32039,553,3,"72,15",4,1,1,6,Mid-Value,Potential Loyalists
32040,170,4,"288,0",5,1,1,7,Mid-Value,Potential Loyalists
32041,262,3,"318,55",5,1,1,7,Mid-Value,Potential Loyalists
32042,754,3,"111,2",3,1,1,5,Low-Value,At Risk Customers
32044,235,1,"18,6",5,1,1,7,Mid-Value,Potential Loyalists
32047,292,2,"64,35",5,1,1,7,Mid-Value,Potential Loyalists
32049,876,8,"440,95000000000005",3,2,1,6,Mid-Value,Potential Loyalists
32050,962,3,"244,85000000000002",3,1,1,5,Low-Value,At Risk Customers
32054,301,10,"551,5",5,2,1,8,High-Value,Potential Loyalists
32055,572,4,"241,15",4,1,1,6,Mid-Value,Potential Loyalists
32056,274,4,"169,45",5,1,1,7,Mid-Value,Potential Loyalists
32058,326,2,"145,0",5,1,1,7,Mid-Value,Potential Loyalists
32059,1677,1,"76,35",1,1,1,3,Low-Value,Lost
32060,979,2,"367,25",3,1,1,5,Low-Value,At Risk Customers
32063,118,9,"365,54999999999995",5,2,1,8,High-Value,Potential Loyalists
32066,744,7,"444,55",3,2,1,6,Mid-Value,Potential Loyalists
32067,935,1,"124,75",3,1,1,5,Low-Value,At Risk Customers
32068,245,11,"558,4",5,2,1,8,High-Value,Potential Loyalists
32070,1285,2,"216,8",2,1,1,4,Low-Value,Can't Lose
32071,454,7,"403,75",4,2,1,7,Mid-Value,Potential Loyalists
32072,647,3,"120,3",4,1,1,6,Mid-Value,Potential Loyalists
32073,122,5,"217,75",5,1,1,7,Mid-Value,Potential Loyalists
32077,332,4,"262,4",5,1,1,7,Mid-Value,Potential Loyalists
32079,414,3,"216,15",4,1,1,6,Mid-Value,Potential Loyalists
32080,396,3,"164,0",4,1,1,6,Mid-Value,Potential Loyalists
32082,84,8,"442,65000000000003",5,2,1,8,High-Value,Potential Loyalists
32083,764,5,"122,8",3,1,1,5,Low-Value,At Risk Customers
32084,313,2,"114,45",5,1,1,7,Mid-Value,Potential Loyalists
32085,900,1,"61,199999999999996",3,1,1,5,Low-Value,At Risk Customers
32086,400,3,"85,3",4,1,1,6,Mid-Value,Potential Loyalists
32087,1648,1,"47,9",1,1,1,3,Low-Value,Lost
32088,104,3,"62,2",5,1,1,7,Mid-Value,Potential Loyalists
32089,1500,2,"63,00000000000001",1,1,1,3,Low-Value,Lost
32091,25,7,"165,60000000000002",5,2,1,8,High-Value,Potential Loyalists
32093,881,1,"70,1",3,1,1,5,Low-Value,At Risk Customers
32094,25,3,"137,3",5,1,1,7,Mid-Value,Potential Loyalists
32096,419,5,"450,6",4,1,1,6,Mid-Value,Potential Loyalists
32098,351,3,"169,75",5,1,1,7,Mid-Value,Potential Loyalists
32099,775,2,"186,25",3,1,1,5,Low-Value,At Risk Customers
32101,1601,1,"519,75",1,1,1,3,Low-Value,Lost
32103,553,1,"496,2",4,1,1,6,Mid-Value,Potential Loyalists
32104,1149,1,"23,25",2,1,1,4,Low-Value,Can't Lose
32105,282,1,"31,4",5,1,1,7,Mid-Value,Potential Loyalists
32106,3,5,"481,15",5,1,1,7,Mid-Value,Potential Loyalists
32107,606,3,"388,75",4,1,1,6,Mid-Value,Potential Loyalists
32108,682,1,"125,15",4,1,1,6,Mid-Value,Potential Loyalists
32109,1781,1,"20,05",1,1,1,3,Low-Value,Lost
32110,41,4,"65,6",5,1,1,7,Mid-Value,Potential Loyalists
32111,41,1,"12,15",5,1,1,7,Mid-Value,Potential Loyalists
32112,11,1,"23,1",5,1,1,7,Mid-Value,Potential Loyalists
32114,1799,1,"9,75",1,1,1,3,Low-Value,Lost
32115,42,7,"414,2",5,2,1,8,High-Value,Potential Loyalists
32117,1093,1,"4,7",3,1,1,5,Low-Value,At Risk Customers
32118,832,4,"124,85",3,1,1,5,Low-Value,At Risk Customers
32120,361,1,"11,4",5,1,1,7,Mid-Value,Potential Loyalists
32121,776,2,"195,4",3,1,1,5,Low-Value,At Risk Customers
32122,134,6,"333,3",5,1,1,7,Mid-Value,Potential Loyalists
32123,844,6,"389,45",3,1,1,5,Low-Value,At Risk Customers
32126,108,5,"466,75000000000006",5,1,1,7,Mid-Value,Potential Loyalists
32127,1226,1,"33,3",2,1,1,4,Low-Value,Can't Lose
32128,1071,2,"172,25",3,1,1,5,Low-Value,At Risk Customers
32129,162,4,"232,6",5,1,1,7,Mid-Value,Potential Loyalists
32130,18,3,"215,25",5,1,1,7,Mid-Value,Potential Loyalists
32131,1113,1,"16,2",2,1,1,4,Low-Value,Can't Lose
32134,1252,2,"73,15",2,1,1,4,Low-Value,Can't Lose
32136,762,4,"139,65",3,1,1,5,Low-Value,At Risk Customers
32137,1314,2,"124,3",2,1,1,4,Low-Value,Can't Lose
32138,18,3,"243,64999999999998",5,1,1,7,Mid-Value,Potential Loyalists
32139,262,3,"174,65",5,1,1,7,Mid-Value,Potential Loyalists
32140,564,3,"125,3",4,1,1,6,Mid-Value,Potential Loyalists
32141,69,2,"71,75",5,1,1,7,Mid-Value,Potential Loyalists
32143,403,4,"172,25",4,1,1,6,Mid-Value,Potential Loyalists
32144,221,9,"1071,25",5,2,2,9,High-Value,Champions
32146,225,3,"74,19999999999999",5,1,1,7,Mid-Value,Potential Loyalists
32150,566,3,"34,95",4,1,1,6,Mid-Value,Potential Loyalists
32151,1700,1,"118,2",1,1,1,3,Low-Value,Lost
32154,777,2,"17,85",3,1,1,5,Low-Value,At Risk Customers
32155,929,2,"138,05",3,1,1,5,Low-Value,At Risk Customers
32157,259,2,"19,5",5,1,1,7,Mid-Value,Potential Loyalists
32158,27,11,"533,15",5,2,1,8,High-Value,Potential Loyalists
32160,110,1,"21,5",5,1,1,7,Mid-Value,Potential Loyalists
32161,1607,1,"7,7",1,1,1,3,Low-Value,Lost
32163,13,4,"293,05",5,1,1,7,Mid-Value,Potential Loyalists
32164,117,10,"837,55",5,2,2,9,High-Value,Champions
32165,171,1,"39,3",5,1,1,7,Mid-Value,Potential Loyalists
32169,188,2,"105,15",5,1,1,7,Mid-Value,Potential Loyalists
32170,1531,1,"15,0",1,1,1,3,Low-Value,Lost
32172,463,1,"199,0",4,1,1,6,Mid-Value,Potential Loyalists
32173,508,3,"62,25",4,1,1,6,Mid-Value,Potential Loyalists
32174,876,1,"7,0",3,1,1,5,Low-Value,At Risk Customers
32175,266,3,"132,8",5,1,1,7,Mid-Value,Potential Loyalists
32176,407,6,"343,35",4,1,1,6,Mid-Value,Potential Loyalists
32179,99,2,"59,4",5,1,1,7,Mid-Value,Potential Loyalists
32180,24,3,"173,5",5,1,1,7,Mid-Value,Potential Loyalists
32181,403,1,"23,85",4,1,1,6,Mid-Value,Potential Loyalists
32182,1018,6,"298,05",3,1,1,5,Low-Value,At Risk Customers
32184,369,2,"323,6",4,1,1,6,Mid-Value,Potential Loyalists
32185,813,3,"96,65",3,1,1,5,Low-Value,At Risk Customers
32187,126,3,"74,5",5,1,1,7,Mid-Value,Potential Loyalists
32188,106,6,"231,29999999999998",5,1,1,7,Mid-Value,Potential Loyalists
32189,665,3,"144,45",4,1,1,6,Mid-Value,Potential Loyalists
32190,53,6,"359,0",5,1,1,7,Mid-Value,Potential Loyalists
32191,295,1,"19,05",5,1,1,7,Mid-Value,Potential Loyalists
32192,773,3,"180,8",3,1,1,5,Low-Value,At Risk Customers
32193,46,11,"767,95",5,2,2,9,High-Value,Champions
32195,183,6,"260,6",5,1,1,7,Mid-Value,Potential Loyalists
32196,826,6,"401,15000000000003",3,1,1,5,Low-Value,At Risk Customers
32198,1691,1,"57,35",1,1,1,3,Low-Value,Lost
32200,679,4,"265,4",4,1,1,6,Mid-Value,Potential Loyalists
32202,715,3,"212,2",4,1,1,6,Mid-Value,Potential Loyalists
32204,645,4,"256,5",4,1,1,6,Mid-Value,Potential Loyalists
32206,706,3,"250,35",4,1,1,6,Mid-Value,Potential Loyalists
32207,60,7,"262,9",5,2,1,8,High-Value,Potential Loyalists
32209,248,3,"58,35",5,1,1,7,Mid-Value,Potential Loyalists
32210,1189,1,"14,9",2,1,1,4,Low-Value,Can't Lose
32211,1312,1,"68,8",2,1,1,4,Low-Value,Can't Lose
32213,1371,1,"7,7",2,1,1,4,Low-Value,Can't Lose
32214,18,5,"533,1",5,1,1,7,Mid-Value,Potential Loyalists
32215,136,3,"105,8",5,1,1,7,Mid-Value,Potential Loyalists
32216,526,3,"106,35000000000001",4,1,1,6,Mid-Value,Potential Loyalists
32217,24,1,"7,5",5,1,1,7,Mid-Value,Potential Loyalists
32218,874,2,"37,4",3,1,1,5,Low-Value,At Risk Customers
32219,434,1,"12,6",4,1,1,6,Mid-Value,Potential Loyalists
32220,906,1,"32,8",3,1,1,5,Low-Value,At Risk Customers
32221,960,1,"144,14999999999998",3,1,1,5,Low-Value,At Risk Customers
32223,186,4,"118,5",5,1,1,7,Mid-Value,Potential Loyalists
32224,868,2,"79,55000000000001",3,1,1,5,Low-Value,At Risk Customers
32226,1122,1,"469,1",2,1,1,4,Low-Value,Can't Lose
32227,45,2,"33,55",5,1,1,7,Mid-Value,Potential Loyalists
32228,73,5,"284,85",5,1,1,7,Mid-Value,Potential Loyalists
32229,928,3,"182,15",3,1,1,5,Low-Value,At Risk Customers
32231,130,1,"114,14999999999999",5,1,1,7,Mid-Value,Potential Loyalists
32232,752,3,"164,55",3,1,1,5,Low-Value,At Risk Customers
32233,919,2,"45,7",3,1,1,5,Low-Value,At Risk Customers
32236,811,3,"57,65",3,1,1,5,Low-Value,At Risk Customers
32237,25,4,"191,65",5,1,1,7,Mid-Value,Potential Loyalists
32239,902,3,"146,15",3,1,1,5,Low-Value,At Risk Customers
32241,994,1,"16,8",3,1,1,5,Low-Value,At Risk Customers
32242,1166,4,"211,9",2,1,1,4,Low-Value,Can't Lose
32243,131,3,"173,85",5,1,1,7,Mid-Value,Potential Loyalists
32244,734,4,"322,65",3,1,1,5,Low-Value,At Risk Customers
32245,314,4,"193,5",5,1,1,7,Mid-Value,Potential Loyalists
32246,378,6,"367,85",4,1,1,6,Mid-Value,Potential Loyalists
32247,717,3,"134,0",4,1,1,6,Mid-Value,Potential Loyalists
32249,60,3,"176,15",5,1,1,7,Mid-Value,Potential Loyalists
32250,745,1,"19,9",3,1,1,5,Low-Value,At Risk Customers
32251,656,3,"257,9",4,1,1,6,Mid-Value,Potential Loyalists
32252,284,7,"275,9",5,2,1,8,High-Value,Potential Loyalists
32254,75,5,"511,84999999999997",5,1,1,7,Mid-Value,Potential Loyalists
32255,94,12,"729,95",5,3,2,10,High-Value,Champions
32256,1202,1,"48,1",2,1,1,4,Low-Value,Can't Lose
32257,368,4,"370,1",4,1,1,6,Mid-Value,Potential Loyalists
32258,377,7,"292,70000000000005",4,2,1,7,Mid-Value,Potential Loyalists
32260,1100,2,"356,2",2,1,1,4,Low-Value,Can't Lose
32261,1242,1,"15,7",2,1,1,4,Low-Value,Can't Lose
32262,1114,2,"69,7",2,1,1,4,Low-Value,Can't Lose
32264,743,3,"99,44999999999999",3,1,1,5,Low-Value,At Risk Customers
32265,741,4,"625,6999999999999",3,1,1,5,Low-Value,At Risk Customers
32266,853,3,"47,35",3,1,1,5,Low-Value,At Risk Customers
32267,69,6,"479,25",5,1,1,7,Mid-Value,Potential Loyalists
32269,1670,1,"24,450000000000003",1,1,1,3,Low-Value,Lost
32270,465,4,"229,89999999999998",4,1,1,6,Mid-Value,Potential Loyalists
32272,414,1,"8,25",4,1,1,6,Mid-Value,Potential Loyalists
32273,374,1,"81,5",4,1,1,6,Mid-Value,Potential Loyalists
32275,103,2,"110,1",5,1,1,7,Mid-Value,Potential Loyalists
32276,480,5,"192,95",4,1,1,6,Mid-Value,Potential Loyalists
32277,132,1,"38,7",5,1,1,7,Mid-Value,Potential Loyalists
32279,873,3,"541,5999999999999",3,1,1,5,Low-Value,At Risk Customers
32282,122,1,"84,3",5,1,1,7,Mid-Value,Potential Loyalists
32283,612,2,"102,7",4,1,1,6,Mid-Value,Potential Loyalists
32284,491,5,"233,45",4,1,1,6,Mid-Value,Potential Loyalists
32285,756,3,"54,2",3,1,1,5,Low-Value,At Risk Customers
32286,239,2,"130,45",5,1,1,7,Mid-Value,Potential Loyalists
32288,320,7,"380,6",5,2,1,8,High-Value,Potential Loyalists
32289,779,2,"75,69999999999999",3,1,1,5,Low-Value,At Risk Customers
32290,74,7,"162,70000000000002",5,2,1,8,High-Value,Potential Loyalists
32292,430,3,"170,7",4,1,1,6,Mid-Value,Potential Loyalists
32293,944,1,"85,3",3,1,1,5,Low-Value,At Risk Customers
32295,1332,1,"63,449999999999996",2,1,1,4,Low-Value,Can't Lose
32296,1247,1,"144,7",2,1,1,4,Low-Value,Can't Lose
32298,1589,1,"31,4",1,1,1,3,Low-Value,Lost
32299,381,8,"1397,4",4,2,3,9,High-Value,Champions
32300,160,8,"1248,8500000000001",5,2,2,9,High-Value,Champions
32301,159,15,"1170,95",5,3,2,10,High-Value,Champions
32304,58,2,"42,9",5,1,1,7,Mid-Value,Potential Loyalists
32306,1782,1,"23,1",1,1,1,3,Low-Value,Lost
32307,872,6,"566,8",3,1,1,5,Low-Value,At Risk Customers
32309,204,4,"188,2",5,1,1,7,Mid-Value,Potential Loyalists
32311,1251,2,"97,39999999999999",2,1,1,4,Low-Value,Can't Lose
32313,963,3,"127,1",3,1,1,5,Low-Value,At Risk Customers
32315,25,2,"325,6",5,1,1,7,Mid-Value,Potential Loyalists
32317,481,10,"993,95",4,2,2,8,High-Value,Potential Loyalists
32318,851,2,"30,700000000000003",3,1,1,5,Low-Value,At Risk Customers
32319,503,3,"135,15",4,1,1,6,Mid-Value,Potential Loyalists
32320,230,4,"249,05",5,1,1,7,Mid-Value,Potential Loyalists
32322,1056,3,"219,5",3,1,1,5,Low-Value,At Risk Customers
32324,1133,5,"157,15",2,1,1,4,Low-Value,Can't Lose
32325,770,3,"245,35",3,1,1,5,Low-Value,At Risk Customers
32327,337,7,"226,55",5,2,1,8,High-Value,Potential Loyalists
32329,175,3,"94,35000000000001",5,1,1,7,Mid-Value,Potential Loyalists
32331,82,8,"769,55",5,2,2,9,High-Value,Champions
32332,39,13,"956,1",5,3,2,10,High-Value,Champions
32334,1366,2,"313,3",2,1,1,4,Low-Value,Can't Lose
32335,3,3,"129,8",5,1,1,7,Mid-Value,Potential Loyalists
32337,1560,1,"61,15",1,1,1,3,Low-Value,Lost
32338,455,9,"338,3",4,2,1,7,Mid-Value,Potential Loyalists
32340,1489,1,"184,2",1,1,1,3,Low-Value,Lost
32341,891,2,"525,0",3,1,1,5,Low-Value,At Risk Customers
32343,41,4,"608,6",5,1,1,7,Mid-Value,Potential Loyalists
32344,862,2,"106,9",3,1,1,5,Low-Value,At Risk Customers
32345,392,7,"674,8",4,2,2,8,High-Value,Potential Loyalists
32348,19,3,"365,4",5,1,1,7,Mid-Value,Potential Loyalists
32351,605,4,"168,35",4,1,1,6,Mid-Value,Potential Loyalists
32352,854,3,"125,89999999999999",3,1,1,5,Low-Value,At Risk Customers
32354,1561,1,"50,4",1,1,1,3,Low-Value,Lost
32355,914,6,"195,2",3,1,1,5,Low-Value,At Risk Customers
32356,225,4,"401,95",5,1,1,7,Mid-Value,Potential Loyalists
32357,36,4,"259,3",5,1,1,7,Mid-Value,Potential Loyalists
32361,462,4,"451,4",4,1,1,6,Mid-Value,Potential Loyalists
32362,133,1,"80,25",5,1,1,7,Mid-Value,Potential Loyalists
32364,306,6,"295,05",5,1,1,7,Mid-Value,Potential Loyalists
32365,1463,2,"147,25",1,1,1,3,Low-Value,Lost
32366,385,4,"302,8",4,1,1,6,Mid-Value,Potential Loyalists
32368,51,3,"88,1",5,1,1,7,Mid-Value,Potential Loyalists
32369,814,2,"83,69999999999999",3,1,1,5,Low-Value,At Risk Customers
32370,369,9,"1127,35",4,2,2,8,High-Value,Potential Loyalists
32373,969,1,"52,8",3,1,1,5,Low-Value,At Risk Customers
32374,204,4,"266,3",5,1,1,7,Mid-Value,Potential Loyalists
32375,789,2,"34,9",3,1,1,5,Low-Value,At Risk Customers
32376,1509,2,"136,3",1,1,1,3,Low-Value,Lost
32379,673,1,"100,75",4,1,1,6,Mid-Value,Potential Loyalists
32381,612,4,"208,4",4,1,1,6,Mid-Value,Potential Loyalists
32382,482,2,"38,95",4,1,1,6,Mid-Value,Potential Loyalists
32384,30,2,"103,15",5,1,1,7,Mid-Value,Potential Loyalists
32385,708,3,"55,6",4,1,1,6,Mid-Value,Potential Loyalists
32387,921,2,"25,15",3,1,1,5,Low-Value,At Risk Customers
32389,266,2,"111,8",5,1,1,7,Mid-Value,Potential Loyalists
32391,1637,1,"28,6",1,1,1,3,Low-Value,Lost
32392,103,5,"97,6",5,1,1,7,Mid-Value,Potential Loyalists
32393,1378,1,"35,6",2,1,1,4,Low-Value,Can't Lose
32396,427,1,"69,1",4,1,1,6,Mid-Value,Potential Loyalists
32397,663,3,"164,65",4,1,1,6,Mid-Value,Potential Loyalists
32400,1394,1,"9,3",2,1,1,4,Low-Value,Can't Lose
32403,532,6,"239,75",4,1,1,6,Mid-Value,Potential Loyalists
32404,406,3,"115,5",4,1,1,6,Mid-Value,Potential Loyalists
32406,939,2,"103,05000000000001",3,1,1,5,Low-Value,At Risk Customers
32407,1217,2,"73,14999999999999",2,1,1,4,Low-Value,Can't Lose
32410,1275,2,"89,25",2,1,1,4,Low-Value,Can't Lose
32411,447,2,"174,60000000000002",4,1,1,6,Mid-Value,Potential Loyalists
32412,1322,5,"118,25",2,1,1,4,Low-Value,Can't Lose
32413,288,2,"137,0",5,1,1,7,Mid-Value,Potential Loyalists
32414,531,2,"81,2",4,1,1,6,Mid-Value,Potential Loyalists
32416,234,4,"183,35",5,1,1,7,Mid-Value,Potential Loyalists
32417,312,4,"111,1",5,1,1,7,Mid-Value,Potential Loyalists
32418,1024,2,"136,45",3,1,1,5,Low-Value,At Risk Customers
32419,878,1,"5,8",3,1,1,5,Low-Value,At Risk Customers
32420,146,4,"120,39999999999999",5,1,1,7,Mid-Value,Potential Loyalists
32421,165,2,"18,3",5,1,1,7,Mid-Value,Potential Loyalists
32422,198,1,"6,1",5,1,1,7,Mid-Value,Potential Loyalists
32424,242,6,"543,0999999999999",5,1,1,7,Mid-Value,Potential Loyalists
32425,1243,2,"122,85",2,1,1,4,Low-Value,Can't Lose
32426,108,4,"710,85",5,1,2,8,High-Value,Potential Loyalists
32428,77,3,"87,0",5,1,1,7,Mid-Value,Potential Loyalists
32429,1617,3,"114,25",1,1,1,3,Low-Value,Lost
32430,854,2,"178,95",3,1,1,5,Low-Value,At Risk Customers
32431,851,9,"416,75",3,2,1,6,Mid-Value,Potential Loyalists
32434,918,4,"57,64999999999999",3,1,1,5,Low-Value,At Risk Customers
32436,1477,1,"109,1",1,1,1,3,Low-Value,Lost
32437,11,4,"499,40000000000003",5,1,1,7,Mid-Value,Potential Loyalists
32438,31,7,"282,9",5,2,1,8,High-Value,Potential Loyalists
32440,488,2,"284,6",4,1,1,6,Mid-Value,Potential Loyalists
32441,21,3,"80,95",5,1,1,7,Mid-Value,Potential Loyalists
32443,516,2,"92,94999999999999",4,1,1,6,Mid-Value,Potential Loyalists
32444,1542,2,"295,1",1,1,1,3,Low-Value,Lost
32445,211,1,"42,75",5,1,1,7,Mid-Value,Potential Loyalists
32446,45,2,"202,45",5,1,1,7,Mid-Value,Potential Loyalists
32447,338,2,"54,6",5,1,1,7,Mid-Value,Potential Loyalists
32448,238,4,"194,8",5,1,1,7,Mid-Value,Potential Loyalists
32450,488,1,"13,5",4,1,1,6,Mid-Value,Potential Loyalists
32451,187,3,"36,05",5,1,1,7,Mid-Value,Potential Loyalists
32453,244,2,"611,05",5,1,1,7,Mid-Value,Potential Loyalists
32454,29,4,"136,1",5,1,1,7,Mid-Value,Potential Loyalists
32456,242,3,"129,05",5,1,1,7,Mid-Value,Potential Loyalists
32457,1180,1,"12,8",2,1,1,4,Low-Value,Can't Lose
32458,141,3,"341,09999999999997",5,1,1,7,Mid-Value,Potential Loyalists
32459,426,5,"248,29999999999998",4,1,1,6,Mid-Value,Potential Loyalists
32460,655,2,"29,55",4,1,1,6,Mid-Value,Potential Loyalists
32462,476,3,"774,65",4,1,2,7,Mid-Value,Potential Loyalists
32464,498,9,"632,05",4,2,1,7,Mid-Value,Potential Loyalists
32465,422,7,"382,85",4,2,1,7,Mid-Value,Potential Loyalists
32467,446,8,"331,65",4,2,1,7,Mid-Value,Potential Loyalists
32469,203,2,"106,85",5,1,1,7,Mid-Value,Potential Loyalists
32470,367,4,"115,85",4,1,1,6,Mid-Value,Potential Loyalists
32473,41,4,"216,3",5,1,1,7,Mid-Value,Potential Loyalists
32477,854,4,"337,65",3,1,1,5,Low-Value,At Risk Customers
32479,31,3,"268,9",5,1,1,7,Mid-Value,Potential Loyalists
32480,153,1,"54,0",5,1,1,7,Mid-Value,Potential Loyalists
32481,808,5,"364,5",3,1,1,5,Low-Value,At Risk Customers
32485,824,1,"6,6",3,1,1,5,Low-Value,At Risk Customers
32487,130,2,"51,0",5,1,1,7,Mid-Value,Potential Loyalists
32489,11,7,"337,85",5,2,1,8,High-Value,Potential Loyalists
32490,171,3,"133,35",5,1,1,7,Mid-Value,Potential Loyalists
32492,1598,1,"483,59999999999997",1,1,1,3,Low-Value,Lost
32494,887,1,"92,2",3,1,1,5,Low-Value,At Risk Customers
32496,514,3,"120,69999999999999",4,1,1,6,Mid-Value,Potential Loyalists
32497,2,6,"235,4",5,1,1,7,Mid-Value,Potential Loyalists
32498,155,2,"52,55",5,1,1,7,Mid-Value,Potential Loyalists
32499,773,10,"377,35",3,2,1,6,Mid-Value,Potential Loyalists
32500,997,1,"66,3",3,1,1,5,Low-Value,At Risk Customers
32502,404,7,"610,3",4,2,1,7,Mid-Value,Potential Loyalists
32504,990,1,"10,05",3,1,1,5,Low-Value,At Risk Customers
32505,483,1,"14,75",4,1,1,6,Mid-Value,Potential Loyalists
32507,1347,1,"16,25",2,1,1,4,Low-Value,Can't Lose
32510,320,3,"79,35",5,1,1,7,Mid-Value,Potential Loyalists
32511,31,4,"239,38",5,1,1,7,Mid-Value,Potential Loyalists
32512,1160,2,"12,0",2,1,1,4,Low-Value,Can't Lose
32513,140,2,"57,2",5,1,1,7,Mid-Value,Potential Loyalists
32514,546,4,"186,65",4,1,1,6,Mid-Value,Potential Loyalists
32516,286,3,"123,94999999999999",5,1,1,7,Mid-Value,Potential Loyalists
32517,183,2,"89,65",5,1,1,7,Mid-Value,Potential Loyalists
32518,997,1,"71,55",3,1,1,5,Low-Value,At Risk Customers
32520,62,2,"48,5",5,1,1,7,Mid-Value,Potential Loyalists
32522,1144,2,"146,85",2,1,1,4,Low-Value,Can't Lose
32523,304,3,"588,5",5,1,1,7,Mid-Value,Potential Loyalists
32526,557,1,"15,4",4,1,1,6,Mid-Value,Potential Loyalists
32527,932,1,"52,2",3,1,1,5,Low-Value,At Risk Customers
32529,481,9,"161,45",4,2,1,7,Mid-Value,Potential Loyalists
32531,531,2,"122,2",4,1,1,6,Mid-Value,Potential Loyalists
32533,1072,4,"222,45",3,1,1,5,Low-Value,At Risk Customers
32534,1242,1,"621,0",2,1,1,4,Low-Value,Can't Lose
32536,88,5,"245,65",5,1,1,7,Mid-Value,Potential Loyalists
32537,946,1,"18,0",3,1,1,5,Low-Value,At Risk Customers
32542,397,2,"43,45",4,1,1,6,Mid-Value,Potential Loyalists
32544,235,2,"126,3",5,1,1,7,Mid-Value,Potential Loyalists
32545,477,7,"679,1999999999999",4,2,2,8,High-Value,Potential Loyalists
32546,1472,1,"19,8",1,1,1,3,Low-Value,Lost
32547,1715,1,"27,6",1,1,1,3,Low-Value,Lost
32548,220,3,"108,2",5,1,1,7,Mid-Value,Potential Loyalists
32549,51,5,"128,2",5,1,1,7,Mid-Value,Potential Loyalists
32550,4,5,"422,7",5,1,1,7,Mid-Value,Potential Loyalists
32551,425,2,"91,15",4,1,1,6,Mid-Value,Potential Loyalists
32554,34,6,"236,14999999999998",5,1,1,7,Mid-Value,Potential Loyalists
32556,216,6,"435,8",5,1,1,7,Mid-Value,Potential Loyalists
32559,62,2,"81,85",5,1,1,7,Mid-Value,Potential Loyalists
32560,514,4,"65,9",4,1,1,6,Mid-Value,Potential Loyalists
32561,599,7,"136,39000000000001",4,2,1,7,Mid-Value,Potential Loyalists
32562,89,2,"86,75",5,1,1,7,Mid-Value,Potential Loyalists
32563,418,4,"209,35",4,1,1,6,Mid-Value,Potential Loyalists
32564,652,1,"17,25",4,1,1,6,Mid-Value,Potential Loyalists
32565,1118,2,"83,65",2,1,1,4,Low-Value,Can't Lose
32566,171,2,"89,75",5,1,1,7,Mid-Value,Potential Loyalists
32567,1186,1,"40,75",2,1,1,4,Low-Value,Can't Lose
32568,776,6,"170,04999999999998",3,1,1,5,Low-Value,At Risk Customers
32569,41,6,"251,45",5,1,1,7,Mid-Value,Potential Loyalists
32571,386,5,"177,25",4,1,1,6,Mid-Value,Potential Loyalists
32572,18,3,"86,44999999999999",5,1,1,7,Mid-Value,Potential Loyalists
32574,973,3,"179,64999999999998",3,1,1,5,Low-Value,At Risk Customers
32575,562,3,"296,1",4,1,1,6,Mid-Value,Potential Loyalists
32576,541,3,"784,15",4,1,2,7,Mid-Value,Potential Loyalists
32578,124,2,"150,75",5,1,1,7,Mid-Value,Potential Loyalists
32581,270,5,"111,55",5,1,1,7,Mid-Value,Potential Loyalists
32584,1006,2,"16,2",3,1,1,5,Low-Value,At Risk Customers
32589,494,4,"125,10000000000001",4,1,1,6,Mid-Value,Potential Loyalists
32590,46,3,"84,35000000000001",5,1,1,7,Mid-Value,Potential Loyalists
32592,64,3,"304,8",5,1,1,7,Mid-Value,Potential Loyalists
32593,1397,1,"3,5",2,1,1,4,Low-Value,Can't Lose
32594,601,10,"1430,35",4,2,3,9,High-Value,Champions
32596,767,2,"59,8",3,1,1,5,Low-Value,At Risk Customers
32598,207,4,"161,05",5,1,1,7,Mid-Value,Potential Loyalists
32600,1350,1,"42,8",2,1,1,4,Low-Value,Can't Lose
32601,251,3,"86,3",5,1,1,7,Mid-Value,Potential Loyalists
32603,78,4,"151,45",5,1,1,7,Mid-Value,Potential Loyalists
32604,412,1,"16,75",4,1,1,6,Mid-Value,Potential Loyalists
32605,241,6,"1041,15",5,1,2,8,High-Value,Potential Loyalists
32609,1314,3,"233,6",2,1,1,4,Low-Value,Can't Lose
32610,138,3,"238,5",5,1,1,7,Mid-Value,Potential Loyalists
32612,219,2,"106,45",5,1,1,7,Mid-Value,Potential Loyalists
32614,664,2,"102,7",4,1,1,6,Mid-Value,Potential Loyalists
32615,766,3,"103,5",3,1,1,5,Low-Value,At Risk Customers
32616,418,4,"1115,5",4,1,2,7,Mid-Value,Potential Loyalists
32617,258,2,"219,0",5,1,1,7,Mid-Value,Potential Loyalists
32619,816,4,"180,85000000000002",3,1,1,5,Low-Value,At Risk Customers
32620,183,4,"167,55",5,1,1,7,Mid-Value,Potential Loyalists
32621,556,1,"62,1",4,1,1,6,Mid-Value,Potential Loyalists
32623,742,1,"31,9",3,1,1,5,Low-Value,At Risk Customers
32624,559,5,"167,25",4,1,1,6,Mid-Value,Potential Loyalists
32626,613,3,"191,0",4,1,1,6,Mid-Value,Potential Loyalists
32627,1746,1,"20,95",1,1,1,3,Low-Value,Lost
32628,152,4,"306,35",5,1,1,7,Mid-Value,Potential Loyalists
32630,1471,2,"405,4",1,1,1,3,Low-Value,Lost
32631,1656,1,"9,3",1,1,1,3,Low-Value,Lost
32632,1069,2,"56,7",3,1,1,5,Low-Value,At Risk Customers
32634,958,1,"49,800000000000004",3,1,1,5,Low-Value,At Risk Customers
32635,1496,1,"17,55",1,1,1,3,Low-Value,Lost
32636,144,4,"278,55",5,1,1,7,Mid-Value,Potential Loyalists
32638,32,8,"560,3",5,2,1,8,High-Value,Potential Loyalists
32640,253,2,"233,1",5,1,1,7,Mid-Value,Potential Loyalists
32641,1700,1,"60,65",1,1,1,3,Low-Value,Lost
32642,714,1,"11,75",4,1,1,6,Mid-Value,Potential Loyalists
32643,591,2,"169,5",4,1,1,6,Mid-Value,Potential Loyalists
32645,1261,2,"24,25",2,1,1,4,Low-Value,Can't Lose
32647,1474,4,"520,05",1,1,1,3,Low-Value,Lost
32648,772,1,"10,0",3,1,1,5,Low-Value,At Risk Customers
32649,20,5,"325,05",5,1,1,7,Mid-Value,Potential Loyalists
32650,902,1,"57,4",3,1,1,5,Low-Value,At Risk Customers
32651,417,5,"786,35",4,1,2,7,Mid-Value,Potential Loyalists
32652,443,3,"383,45",4,1,1,6,Mid-Value,Potential Loyalists
32654,80,11,"559,55",5,2,1,8,High-Value,Potential Loyalists
32655,1091,1,"35,25",3,1,1,5,Low-Value,At Risk Customers
32657,1494,1,"18,75",1,1,1,3,Low-Value,Lost
32659,501,3,"354,65",4,1,1,6,Mid-Value,Potential Loyalists
32660,396,3,"150,7",4,1,1,6,Mid-Value,Potential Loyalists
32662,85,1,"48,6",5,1,1,7,Mid-Value,Potential Loyalists
32665,1259,1,"81,6",2,1,1,4,Low-Value,Can't Lose
32666,26,2,"278,75",5,1,1,7,Mid-Value,Potential Loyalists
32667,1488,1,"144,0",1,1,1,3,Low-Value,Lost
32668,379,3,"250,40000000000003",4,1,1,6,Mid-Value,Potential Loyalists
32669,1141,1,"46,65",2,1,1,4,Low-Value,Can't Lose
32670,392,6,"606,4",4,1,1,6,Mid-Value,Potential Loyalists
32671,302,10,"589,55",5,2,1,8,High-Value,Potential Loyalists
32672,481,1,"68,0",4,1,1,6,Mid-Value,Potential Loyalists
32673,503,10,"504,95",4,2,1,7,Mid-Value,Potential Loyalists
32677,214,4,"196,75",5,1,1,7,Mid-Value,Potential Loyalists
32678,575,5,"264,0",4,1,1,6,Mid-Value,Potential Loyalists
32681,182,6,"165,95",5,1,1,7,Mid-Value,Potential Loyalists
32682,232,2,"83,1",5,1,1,7,Mid-Value,Potential Loyalists
32683,102,6,"568,6",5,1,1,7,Mid-Value,Potential Loyalists
32684,231,2,"60,550000000000004",5,1,1,7,Mid-Value,Potential Loyalists
32685,572,1,"193,75",4,1,1,6,Mid-Value,Potential Loyalists
32686,279,4,"196,55",5,1,1,7,Mid-Value,Potential Loyalists
32689,440,2,"29,3",4,1,1,6,Mid-Value,Potential Loyalists
32692,566,1,"315,15",4,1,1,6,Mid-Value,Potential Loyalists
32693,201,1,"123,89999999999999",5,1,1,7,Mid-Value,Potential Loyalists
32696,1463,2,"41,8",1,1,1,3,Low-Value,Lost
32697,158,4,"161,7",5,1,1,7,Mid-Value,Potential Loyalists
32700,645,2,"37,2",4,1,1,6,Mid-Value,Potential Loyalists
32702,512,1,"59,7",4,1,1,6,Mid-Value,Potential Loyalists
32703,638,5,"193,15",4,1,1,6,Mid-Value,Potential Loyalists
32704,488,1,"73,65",4,1,1,6,Mid-Value,Potential Loyalists
32708,35,6,"620,7",5,1,1,7,Mid-Value,Potential Loyalists
32709,883,1,"24,299999999999997",3,1,1,5,Low-Value,At Risk Customers
32710,61,3,"100,2",5,1,1,7,Mid-Value,Potential Loyalists
32711,1545,2,"78,65",1,1,1,3,Low-Value,Lost
32712,1748,1,"70,05",1,1,1,3,Low-Value,Lost
32714,338,1,"48,45",5,1,1,7,Mid-Value,Potential Loyalists
32716,404,4,"406,65",4,1,1,6,Mid-Value,Potential Loyalists
32717,569,3,"528,45",4,1,1,6,Mid-Value,Potential Loyalists
32719,1225,2,"130,4",2,1,1,4,Low-Value,Can't Lose
32720,35,7,"570,05",5,2,1,8,High-Value,Potential Loyalists
32721,915,1,"398,0",3,1,1,5,Low-Value,At Risk Customers
32722,752,1,"48,45",3,1,1,5,Low-Value,At Risk Customers
32723,150,1,"1,4",5,1,1,7,Mid-Value,Potential Loyalists
32725,1113,2,"44,7",2,1,1,4,Low-Value,Can't Lose
32726,138,2,"139,1",5,1,1,7,Mid-Value,Potential Loyalists
32727,1083,2,"97,95",3,1,1,5,Low-Value,At Risk Customers
32731,731,2,"127,5",3,1,1,5,Low-Value,At Risk Customers
32733,47,8,"236,45",5,2,1,8,High-Value,Potential Loyalists
32734,1159,1,"159,4",2,1,1,4,Low-Value,Can't Lose
32735,528,6,"933,1999999999999",4,1,2,7,Mid-Value,Potential Loyalists
32736,554,5,"353,15",4,1,1,6,Mid-Value,Potential Loyalists
32737,228,6,"412,95",5,1,1,7,Mid-Value,Potential Loyalists
32738,164,5,"167,9",5,1,1,7,Mid-Value,Potential Loyalists
32739,65,5,"266,45",5,1,1,7,Mid-Value,Potential Loyalists
32742,509,3,"126,0",4,1,1,6,Mid-Value,Potential Loyalists
32743,1478,1,"48,2",1,1,1,3,Low-Value,Lost
32746,236,3,"117,75",5,1,1,7,Mid-Value,Potential Loyalists
32747,598,2,"145,0",4,1,1,6,Mid-Value,Potential Loyalists
32748,437,5,"242,9",4,1,1,6,Mid-Value,Potential Loyalists
32749,41,6,"174,1",5,1,1,7,Mid-Value,Potential Loyalists
32753,633,2,"46,75",4,1,1,6,Mid-Value,Potential Loyalists
32756,860,3,"127,1",3,1,1,5,Low-Value,At Risk Customers
32760,1767,1,"23,35",1,1,1,3,Low-Value,Lost
32761,174,2,"81,1",5,1,1,7,Mid-Value,Potential Loyalists
32762,420,5,"215,5",4,1,1,6,Mid-Value,Potential Loyalists
32763,140,5,"304,9",5,1,1,7,Mid-Value,Potential Loyalists
32764,2,2,"68,75",5,1,1,7,Mid-Value,Potential Loyalists
32766,7,4,"202,70000000000002",5,1,1,7,Mid-Value,Potential Loyalists
32767,765,5,"222,3",3,1,1,5,Low-Value,At Risk Customers
32768,278,2,"65,85",5,1,1,7,Mid-Value,Potential Loyalists
32770,74,1,"34,65",5,1,1,7,Mid-Value,Potential Loyalists
32771,844,1,"44,25",3,1,1,5,Low-Value,At Risk Customers
32772,80,1,"251,3",5,1,1,7,Mid-Value,Potential Loyalists
32773,1445,2,"120,35",2,1,1,4,Low-Value,Can't Lose
32775,803,6,"545,05",3,1,1,5,Low-Value,At Risk Customers
32776,15,4,"444,09999999999997",5,1,1,7,Mid-Value,Potential Loyalists
32777,1823,1,"8,75",1,1,1,3,Low-Value,Lost
32778,1292,1,"39,5",2,1,1,4,Low-Value,Can't Lose
32779,871,1,"100,8",3,1,1,5,Low-Value,At Risk Customers
32780,339,3,"203,55",5,1,1,7,Mid-Value,Potential Loyalists
32782,772,1,"90,8",3,1,1,5,Low-Value,At Risk Customers
32783,768,7,"467,6",3,2,1,6,Mid-Value,Potential Loyalists
32784,1524,4,"335,2",1,1,1,3,Low-Value,Lost
32785,132,2,"56,5",5,1,1,7,Mid-Value,Potential Loyalists
32786,274,1,"22,8",5,1,1,7,Mid-Value,Potential Loyalists
32791,173,4,"115,85000000000001",5,1,1,7,Mid-Value,Potential Loyalists
32792,878,1,"67,55",3,1,1,5,Low-Value,At Risk Customers
32793,910,4,"122,05",3,1,1,5,Low-Value,At Risk Customers
32794,570,2,"215,95",4,1,1,6,Mid-Value,Potential Loyalists
32795,1131,3,"147,85000000000002",2,1,1,4,Low-Value,Can't Lose
32796,197,4,"85,35",5,1,1,7,Mid-Value,Potential Loyalists
32797,1112,1,"132,6",2,1,1,4,Low-Value,Can't Lose
32798,66,5,"160,4",5,1,1,7,Mid-Value,Potential Loyalists
32799,1492,1,"80,6",1,1,1,3,Low-Value,Lost
32801,783,2,"70,15",3,1,1,5,Low-Value,At Risk Customers
32804,1695,1,"36,0",1,1,1,3,Low-Value,Lost
32805,82,5,"1351,4",5,1,3,9,High-Value,Champions
32806,1088,4,"100,85",3,1,1,5,Low-Value,At Risk Customers
32807,557,3,"59,4",4,1,1,6,Mid-Value,Potential Loyalists
32808,623,6,"461,34999999999997",4,1,1,6,Mid-Value,Potential Loyalists
32809,381,1,"6,3",4,1,1,6,Mid-Value,Potential Loyalists
32810,35,2,"47,6",5,1,1,7,Mid-Value,Potential Loyalists
32812,1176,3,"318,45",2,1,1,4,Low-Value,Can't Lose
32813,1006,1,"31,95",3,1,1,5,Low-Value,At Risk Customers
32814,708,3,"39,15",4,1,1,6,Mid-Value,Potential Loyalists
32815,1478,1,"26,7",1,1,1,3,Low-Value,Lost
32816,29,4,"410,4",5,1,1,7,Mid-Value,Potential Loyalists
32817,256,1,"16,0",5,1,1,7,Mid-Value,Potential Loyalists
32819,1132,1,"18,45",2,1,1,4,Low-Value,Can't Lose
32820,862,5,"667,0",3,1,2,6,Mid-Value,Potential Loyalists
32821,1089,2,"164,4",3,1,1,5,Low-Value,At Risk Customers
32823,845,1,"19,5",3,1,1,5,Low-Value,At Risk Customers
32825,971,2,"209,75",3,1,1,5,Low-Value,At Risk Customers
32826,215,1,"16,7",5,1,1,7,Mid-Value,Potential Loyalists
32828,182,6,"433,1",5,1,1,7,Mid-Value,Potential Loyalists
32829,158,4,"116,39999999999999",5,1,1,7,Mid-Value,Potential Loyalists
32831,1632,1,"10,85",1,1,1,3,Low-Value,Lost
32832,875,3,"174,5",3,1,1,5,Low-Value,At Risk Customers
32834,841,4,"290,0",3,1,1,5,Low-Value,At Risk Customers
32835,142,3,"66,6",5,1,1,7,Mid-Value,Potential Loyalists
32840,24,12,"1018,5999999999999",5,3,2,10,High-Value,Champions
32841,62,14,"827,25",5,3,2,10,High-Value,Champions
32842,79,4,"184,2",5,1,1,7,Mid-Value,Potential Loyalists
32845,1385,1,"97,05",2,1,1,4,Low-Value,Can't Lose
32846,871,4,"86,25",3,1,1,5,Low-Value,At Risk Customers
32847,919,1,"350,4",3,1,1,5,Low-Value,At Risk Customers
32848,53,6,"406,4",5,1,1,7,Mid-Value,Potential Loyalists
32849,109,1,"57,4",5,1,1,7,Mid-Value,Potential Loyalists
32850,1440,1,"12,5",2,1,1,4,Low-Value,Can't Lose
32855,899,1,"58,800000000000004",3,1,1,5,Low-Value,At Risk Customers
32858,970,2,"175,55",3,1,1,5,Low-Value,At Risk Customers
32859,182,4,"241,64999999999998",5,1,1,7,Mid-Value,Potential Loyalists
32860,571,2,"7,85",4,1,1,6,Mid-Value,Potential Loyalists
32861,130,2,"9,6",5,1,1,7,Mid-Value,Potential Loyalists
32862,163,9,"413,55",5,2,1,8,High-Value,Potential Loyalists
32863,791,5,"133,75",3,1,1,5,Low-Value,At Risk Customers
32864,1368,1,"25,7",2,1,1,4,Low-Value,Can't Lose
32868,249,3,"285,1",5,1,1,7,Mid-Value,Potential Loyalists
32869,1116,2,"109,95",2,1,1,4,Low-Value,Can't Lose
32870,48,6,"412,75",5,1,1,7,Mid-Value,Potential Loyalists
32871,1259,1,"38,75",2,1,1,4,Low-Value,Can't Lose
32872,697,6,"675,1500000000001",4,1,2,7,Mid-Value,Potential Loyalists
32874,374,14,"609,3",4,3,1,8,High-Value,Potential Loyalists
32876,494,3,"89,80000000000001",4,1,1,6,Mid-Value,Potential Loyalists
32877,19,4,"332,95000000000005",5,1,1,7,Mid-Value,Potential Loyalists
32878,85,2,"70,65",5,1,1,7,Mid-Value,Potential Loyalists
32880,201,4,"362,25",5,1,1,7,Mid-Value,Potential Loyalists
32883,1602,2,"101,4",1,1,1,3,Low-Value,Lost
32884,889,4,"116,99999999999999",3,1,1,5,Low-Value,At Risk Customers
32886,738,2,"147,1",3,1,1,5,Low-Value,At Risk Customers
32887,65,2,"48,7",5,1,1,7,Mid-Value,Potential Loyalists
32888,32,1,"8,05",5,1,1,7,Mid-Value,Potential Loyalists
32889,517,4,"225,05",4,1,1,6,Mid-Value,Potential Loyalists
32891,1013,2,"515,25",3,1,1,5,Low-Value,At Risk Customers
32893,311,1,"29,25",5,1,1,7,Mid-Value,Potential Loyalists
32895,1512,1,"4,0",1,1,1,3,Low-Value,Lost
32897,413,2,"64,30000000000001",4,1,1,6,Mid-Value,Potential Loyalists
32898,416,3,"204,55",4,1,1,6,Mid-Value,Potential Loyalists
32899,314,2,"47,150000000000006",5,1,1,7,Mid-Value,Potential Loyalists
32900,265,1,"49,0",5,1,1,7,Mid-Value,Potential Loyalists
32901,1107,4,"79,85",2,1,1,4,Low-Value,Can't Lose
32902,101,2,"290,05",5,1,1,7,Mid-Value,Potential Loyalists
32905,1804,1,"31,4",1,1,1,3,Low-Value,Lost
32906,770,3,"131,15",3,1,1,5,Low-Value,At Risk Customers
32908,706,1,"21,7",4,1,1,6,Mid-Value,Potential Loyalists
32910,949,2,"36,95",3,1,1,5,Low-Value,At Risk Customers
32911,817,2,"9,55",3,1,1,5,Low-Value,At Risk Customers
32913,637,4,"1152,85",4,1,2,7,Mid-Value,Potential Loyalists
32914,531,4,"145,05",4,1,1,6,Mid-Value,Potential Loyalists
32916,321,1,"13,25",5,1,1,7,Mid-Value,Potential Loyalists
32918,1544,2,"90,4",1,1,1,3,Low-Value,Lost
32919,77,6,"195,4",5,1,1,7,Mid-Value,Potential Loyalists
32920,1082,1,"17,8",3,1,1,5,Low-Value,At Risk Customers
32921,1117,5,"165,6",2,1,1,4,Low-Value,Can't Lose
32922,1228,2,"157,9",2,1,1,4,Low-Value,Can't Lose
32923,873,2,"145,6",3,1,1,5,Low-Value,At Risk Customers
32924,756,1,"70,0",3,1,1,5,Low-Value,At Risk Customers
32925,1131,2,"107,69999999999999",2,1,1,4,Low-Value,Can't Lose
32926,252,1,"26,4",5,1,1,7,Mid-Value,Potential Loyalists
32928,1092,1,"34,8",3,1,1,5,Low-Value,At Risk Customers
32929,784,1,"10,9",3,1,1,5,Low-Value,At Risk Customers
32930,1161,5,"370,85",2,1,1,4,Low-Value,Can't Lose
32931,126,3,"373,85",5,1,1,7,Mid-Value,Potential Loyalists
32933,253,4,"173,39999999999998",5,1,1,7,Mid-Value,Potential Loyalists
32935,780,6,"361,6",3,1,1,5,Low-Value,At Risk Customers
32939,558,8,"697,0",4,2,2,8,High-Value,Potential Loyalists
32941,173,2,"101,75",5,1,1,7,Mid-Value,Potential Loyalists
32942,36,4,"217,1",5,1,1,7,Mid-Value,Potential Loyalists
32944,103,3,"29,2",5,1,1,7,Mid-Value,Potential Loyalists
32945,750,1,"7,5",3,1,1,5,Low-Value,At Risk Customers
32947,444,2,"67,75",4,1,1,6,Mid-Value,Potential Loyalists
32948,874,7,"646,05",3,2,1,6,Mid-Value,Potential Loyalists
32950,650,1,"11,75",4,1,1,6,Mid-Value,Potential Loyalists
32952,1077,2,"65,9",3,1,1,5,Low-Value,At Risk Customers
32953,47,4,"175,1",5,1,1,7,Mid-Value,Potential Loyalists
32954,790,5,"99,55",3,1,1,5,Low-Value,At Risk Customers
32955,239,4,"133,20000000000002",5,1,1,7,Mid-Value,Potential Loyalists
32956,10,6,"446,9",5,1,1,7,Mid-Value,Potential Loyalists
32960,522,3,"336,8",4,1,1,6,Mid-Value,Potential Loyalists
32964,537,6,"290,8",4,1,1,6,Mid-Value,Potential Loyalists
32965,1177,1,"14,65",2,1,1,4,Low-Value,Can't Lose
32967,394,6,"247,4",4,1,1,6,Mid-Value,Potential Loyalists
32968,864,1,"81,3",3,1,1,5,Low-Value,At Risk Customers
32969,298,4,"396,6",5,1,1,7,Mid-Value,Potential Loyalists
32971,1720,1,"263,0",1,1,1,3,Low-Value,Lost
32974,553,3,"184,45",4,1,1,6,Mid-Value,Potential Loyalists
32975,1,3,"85,15",5,1,1,7,Mid-Value,Potential Loyalists
32977,743,4,"188,85",3,1,1,5,Low-Value,At Risk Customers
32979,1097,2,"121,85",2,1,1,4,Low-Value,Can't Lose
32980,760,1,"47,8",3,1,1,5,Low-Value,At Risk Customers
32981,682,3,"510,79999999999995",4,1,1,6,Mid-Value,Potential Loyalists
32982,740,5,"185,25",3,1,1,5,Low-Value,At Risk Customers
32983,406,7,"710,75",4,2,2,8,High-Value,Potential Loyalists
32984,56,4,"153,4",5,1,1,7,Mid-Value,Potential Loyalists
32985,367,6,"1038,35",4,1,2,7,Mid-Value,Potential Loyalists
32987,477,1,"17,7",4,1,1,6,Mid-Value,Potential Loyalists
32988,104,3,"136,4",5,1,1,7,Mid-Value,Potential Loyalists
32990,899,2,"57,0",3,1,1,5,Low-Value,At Risk Customers
32991,13,2,"33,55",5,1,1,7,Mid-Value,Potential Loyalists
32992,205,1,"53,9",5,1,1,7,Mid-Value,Potential Loyalists
32993,1638,2,"99,95",1,1,1,3,Low-Value,Lost
32996,407,4,"59,65",4,1,1,6,Mid-Value,Potential Loyalists
32997,69,2,"104,15",5,1,1,7,Mid-Value,Potential Loyalists
32999,462,2,"164,54999999999998",4,1,1,6,Mid-Value,Potential Loyalists
33000,473,5,"299,5",4,1,1,6,Mid-Value,Potential Loyalists
33001,347,1,"78,5",5,1,1,7,Mid-Value,Potential Loyalists
33003,724,2,"83,05",4,1,1,6,Mid-Value,Potential Loyalists
33006,1667,2,"250,2",1,1,1,3,Low-Value,Lost
33007,256,5,"240,79999999999998",5,1,1,7,Mid-Value,Potential Loyalists
33009,845,2,"135,1",3,1,1,5,Low-Value,At Risk Customers
33010,504,3,"331,0",4,1,1,6,Mid-Value,Potential Loyalists
33012,945,2,"392,35",3,1,1,5,Low-Value,At Risk Customers
33013,189,2,"156,05",5,1,1,7,Mid-Value,Potential Loyalists
33014,756,1,"19,9",3,1,1,5,Low-Value,At Risk Customers
33015,1136,1,"5,4",2,1,1,4,Low-Value,Can't Lose
33016,1620,1,"92,25",1,1,1,3,Low-Value,Lost
33017,657,2,"49,85",4,1,1,6,Mid-Value,Potential Loyalists
33020,17,2,"51,949999999999996",5,1,1,7,Mid-Value,Potential Loyalists
33021,179,4,"230,5",5,1,1,7,Mid-Value,Potential Loyalists
33022,760,1,"60,0",3,1,1,5,Low-Value,At Risk Customers
33023,17,6,"503,2",5,1,1,7,Mid-Value,Potential Loyalists
33024,250,1,"26,1",5,1,1,7,Mid-Value,Potential Loyalists
33025,1119,2,"54,3",2,1,1,4,Low-Value,Can't Lose
33028,28,5,"213,65",5,1,1,7,Mid-Value,Potential Loyalists
33029,797,10,"523,85",3,2,1,6,Mid-Value,Potential Loyalists
33031,46,8,"392,25",5,2,1,8,High-Value,Potential Loyalists
33034,854,2,"320,7",3,1,1,5,Low-Value,At Risk Customers
33035,43,1,"117,1",5,1,1,7,Mid-Value,Potential Loyalists
33036,1117,12,"487,65",2,3,1,6,Mid-Value,Potential Loyalists
33037,470,7,"247,25",4,2,1,7,Mid-Value,Potential Loyalists
33039,1155,3,"45,0",2,1,1,4,Low-Value,Can't Lose
33040,584,5,"434,7",4,1,1,6,Mid-Value,Potential Loyalists
33041,1019,2,"114,5",3,1,1,5,Low-Value,At Risk Customers
33043,812,1,"20,5",3,1,1,5,Low-Value,At Risk Customers
33045,265,3,"700,5",5,1,2,8,High-Value,Potential Loyalists
33047,1235,1,"103,5",2,1,1,4,Low-Value,Can't Lose
33051,190,2,"13,95",5,1,1,7,Mid-Value,Potential Loyalists
33053,570,3,"121,1",4,1,1,6,Mid-Value,Potential Loyalists
33054,119,3,"49,5",5,1,1,7,Mid-Value,Potential Loyalists
33055,724,1,"28,25",4,1,1,6,Mid-Value,Potential Loyalists
33056,261,3,"233,75",5,1,1,7,Mid-Value,Potential Loyalists
33057,881,1,"37,5",3,1,1,5,Low-Value,At Risk Customers
33059,1569,2,"90,14999999999999",1,1,1,3,Low-Value,Lost
33063,353,1,"6,55",5,1,1,7,Mid-Value,Potential Loyalists
33064,277,10,"926,6",5,2,2,9,High-Value,Champions
33066,13,1,"16,0",5,1,1,7,Mid-Value,Potential Loyalists
33067,179,5,"189,50000000000003",5,1,1,7,Mid-Value,Potential Loyalists
33069,286,5,"460,9",5,1,1,7,Mid-Value,Potential Loyalists
33070,160,4,"123,75",5,1,1,7,Mid-Value,Potential Loyalists
33071,391,5,"327,35",4,1,1,6,Mid-Value,Potential Loyalists
33072,734,3,"134,7",3,1,1,5,Low-Value,At Risk Customers
33073,571,1,"52,7",4,1,1,6,Mid-Value,Potential Loyalists
33074,315,4,"383,25",5,1,1,7,Mid-Value,Potential Loyalists
33076,981,5,"745,65",3,1,2,6,Mid-Value,Potential Loyalists
33077,1506,2,"21,4",1,1,1,3,Low-Value,Lost
33078,35,4,"211,0",5,1,1,7,Mid-Value,Potential Loyalists
33079,252,4,"814,3",5,1,2,8,High-Value,Potential Loyalists
33080,467,3,"309,55",4,1,1,6,Mid-Value,Potential Loyalists
33081,74,9,"520,95",5,2,1,8,High-Value,Potential Loyalists
33082,744,1,"19,8",3,1,1,5,Low-Value,At Risk Customers
33083,458,4,"497,3",4,1,1,6,Mid-Value,Potential Loyalists
33085,40,5,"181,0",5,1,1,7,Mid-Value,Potential Loyalists
33089,1219,2,"22,700000000000003",2,1,1,4,Low-Value,Can't Lose
33090,1744,1,"42,45",1,1,1,3,Low-Value,Lost
33092,935,1,"111,5",3,1,1,5,Low-Value,At Risk Customers
33094,1359,1,"411,8",2,1,1,4,Low-Value,Can't Lose
33096,893,2,"141,70000000000002",3,1,1,5,Low-Value,At Risk Customers
33097,235,3,"175,45",5,1,1,7,Mid-Value,Potential Loyalists
33100,628,2,"243,1",4,1,1,6,Mid-Value,Potential Loyalists
33101,349,2,"193,0",5,1,1,7,Mid-Value,Potential Loyalists
33103,638,2,"41,9",4,1,1,6,Mid-Value,Potential Loyalists
33104,1254,1,"102,4",2,1,1,4,Low-Value,Can't Lose
33108,190,3,"182,05",5,1,1,7,Mid-Value,Potential Loyalists
33110,615,2,"92,25",4,1,1,6,Mid-Value,Potential Loyalists
33111,1016,2,"36,95",3,1,1,5,Low-Value,At Risk Customers
33113,759,1,"331,95000000000005",3,1,1,5,Low-Value,At Risk Customers
33115,262,5,"205,45",5,1,1,7,Mid-Value,Potential Loyalists
33116,353,5,"286,15",5,1,1,7,Mid-Value,Potential Loyalists
33117,385,4,"181,35",4,1,1,6,Mid-Value,Potential Loyalists
33118,186,6,"148,75",5,1,1,7,Mid-Value,Potential Loyalists
33119,908,1,"71,9",3,1,1,5,Low-Value,At Risk Customers
33120,370,6,"1011,9",4,1,2,7,Mid-Value,Potential Loyalists
33121,1267,3,"1099,6",2,1,2,5,Low-Value,At Risk Customers
33122,1092,4,"277,95",3,1,1,5,Low-Value,At Risk Customers
33123,1163,2,"64,5",2,1,1,4,Low-Value,Can't Lose
33128,387,2,"25,9",4,1,1,6,Mid-Value,Potential Loyalists
33129,737,4,"389,6",3,1,1,5,Low-Value,At Risk Customers
33130,144,8,"194,95",5,2,1,8,High-Value,Potential Loyalists
33131,137,4,"344,75",5,1,1,7,Mid-Value,Potential Loyalists
33132,8,3,"114,30000000000001",5,1,1,7,Mid-Value,Potential Loyalists
33133,36,13,"696,5",5,3,2,10,High-Value,Champions
33135,871,3,"129,6",3,1,1,5,Low-Value,At Risk Customers
33136,490,1,"102,30000000000001",4,1,1,6,Mid-Value,Potential Loyalists
33137,57,1,"0,6",5,1,1,7,Mid-Value,Potential Loyalists
33139,765,3,"82,39999999999999",3,1,1,5,Low-Value,At Risk Customers
33140,1145,1,"22,05",2,1,1,4,Low-Value,Can't Lose
33141,924,2,"331,95",3,1,1,5,Low-Value,At Risk Customers
33142,480,5,"208,1",4,1,1,6,Mid-Value,Potential Loyalists
33143,134,3,"60,85",5,1,1,7,Mid-Value,Potential Loyalists
33147,47,10,"471,55",5,2,1,8,High-Value,Potential Loyalists
33149,1165,6,"276,6",2,1,1,4,Low-Value,Can't Lose
33151,1704,1,"23,7",1,1,1,3,Low-Value,Lost
33157,450,2,"80,64999999999999",4,1,1,6,Mid-Value,Potential Loyalists
33158,45,2,"32,4",5,1,1,7,Mid-Value,Potential Loyalists
33159,541,2,"196,3",4,1,1,6,Mid-Value,Potential Loyalists
33161,177,1,"22,8",5,1,1,7,Mid-Value,Potential Loyalists
33163,571,4,"257,6",4,1,1,6,Mid-Value,Potential Loyalists
33164,854,2,"137,95",3,1,1,5,Low-Value,At Risk Customers
33165,1640,3,"154,34999999999997",1,1,1,3,Low-Value,Lost
33166,472,1,"183,4",4,1,1,6,Mid-Value,Potential Loyalists
33169,308,5,"251,85000000000002",5,1,1,7,Mid-Value,Potential Loyalists
33173,952,4,"97,15",3,1,1,5,Low-Value,At Risk Customers
33174,88,5,"595,65",5,1,1,7,Mid-Value,Potential Loyalists
33175,748,1,"116,6",3,1,1,5,Low-Value,At Risk Customers
33176,764,1,"34,5",3,1,1,5,Low-Value,At Risk Customers
33178,698,8,"883,8",4,2,2,8,High-Value,Potential Loyalists
33179,852,1,"60,0",3,1,1,5,Low-Value,At Risk Customers
33182,334,1,"39,25",5,1,1,7,Mid-Value,Potential Loyalists
33185,18,8,"292,7",5,2,1,8,High-Value,Potential Loyalists
33186,91,4,"184,65",5,1,1,7,Mid-Value,Potential Loyalists
33188,53,4,"151,85",5,1,1,7,Mid-Value,Potential Loyalists
33189,175,9,"941,7",5,2,2,9,High-Value,Champions
33190,365,6,"444,1",5,1,1,7,Mid-Value,Potential Loyalists
33192,427,3,"239,84999999999997",4,1,1,6,Mid-Value,Potential Loyalists
33197,150,7,"685,35",5,2,2,9,High-Value,Champions
33199,1155,5,"226,75",2,1,1,4,Low-Value,Can't Lose
33200,290,4,"223,39999999999998",5,1,1,7,Mid-Value,Potential Loyalists
33203,1077,5,"130,64999999999998",3,1,1,5,Low-Value,At Risk Customers
33204,1060,2,"91,69999999999999",3,1,1,5,Low-Value,At Risk Customers
33205,190,1,"17,6",5,1,1,7,Mid-Value,Potential Loyalists
33206,539,3,"321,7",4,1,1,6,Mid-Value,Potential Loyalists
33207,223,7,"391,35",5,2,1,8,High-Value,Potential Loyalists
33210,404,4,"413,85",4,1,1,6,Mid-Value,Potential Loyalists
33211,172,4,"366,79999999999995",5,1,1,7,Mid-Value,Potential Loyalists
33214,63,3,"37,85",5,1,1,7,Mid-Value,Potential Loyalists
33215,45,4,"203,05",5,1,1,7,Mid-Value,Potential Loyalists
33217,511,6,"378,0",4,1,1,6,Mid-Value,Potential Loyalists
33219,178,6,"121,25",5,1,1,7,Mid-Value,Potential Loyalists
33221,763,1,"313,9",3,1,1,5,Low-Value,At Risk Customers
33224,769,5,"315,75",3,1,1,5,Low-Value,At Risk Customers
33225,1738,2,"133,8",1,1,1,3,Low-Value,Lost
33226,124,3,"178,65",5,1,1,7,Mid-Value,Potential Loyalists
33228,628,1,"30,8",4,1,1,6,Mid-Value,Potential Loyalists
33229,561,2,"121,80000000000001",4,1,1,6,Mid-Value,Potential Loyalists
33232,1357,1,"17,1",2,1,1,4,Low-Value,Can't Lose
33236,859,3,"215,5",3,1,1,5,Low-Value,At Risk Customers
33237,148,9,"791,3",5,2,2,9,High-Value,Champions
33238,967,2,"171,0",3,1,1,5,Low-Value,At Risk Customers
33242,406,2,"32,7",4,1,1,6,Mid-Value,Potential Loyalists
33245,250,3,"124,6",5,1,1,7,Mid-Value,Potential Loyalists
33246,231,3,"102,5",5,1,1,7,Mid-Value,Potential Loyalists
33247,1011,3,"201,95000000000002",3,1,1,5,Low-Value,At Risk Customers
33248,285,2,"58,55",5,1,1,7,Mid-Value,Potential Loyalists
33249,1351,1,"108,0",2,1,1,4,Low-Value,Can't Lose
33252,160,3,"59,400000000000006",5,1,1,7,Mid-Value,Potential Loyalists
33253,130,3,"179,6",5,1,1,7,Mid-Value,Potential Loyalists
33254,727,1,"42,0",4,1,1,6,Mid-Value,Potential Loyalists
33256,747,2,"243,8",3,1,1,5,Low-Value,At Risk Customers
33257,1223,1,"15,149999999999999",2,1,1,4,Low-Value,Can't Lose
33258,1806,1,"17,9",1,1,1,3,Low-Value,Lost
33259,558,4,"205,15",4,1,1,6,Mid-Value,Potential Loyalists
33260,742,2,"95,9",3,1,1,5,Low-Value,At Risk Customers
33261,1228,1,"438,45000000000005",2,1,1,4,Low-Value,Can't Lose
33262,10,11,"532,5",5,2,1,8,High-Value,Potential Loyalists
33266,2,10,"654,8",5,2,1,8,High-Value,Potential Loyalists
33267,1155,2,"49,28",2,1,1,4,Low-Value,Can't Lose
33268,969,3,"77,6",3,1,1,5,Low-Value,At Risk Customers
33269,1193,2,"41,2",2,1,1,4,Low-Value,Can't Lose
33271,354,3,"106,55000000000001",5,1,1,7,Mid-Value,Potential Loyalists
33272,526,2,"233,3",4,1,1,6,Mid-Value,Potential Loyalists
33273,400,1,"158,10000000000002",4,1,1,6,Mid-Value,Potential Loyalists
33274,17,3,"127,35",5,1,1,7,Mid-Value,Potential Loyalists
33276,547,2,"11,95",4,1,1,6,Mid-Value,Potential Loyalists
33278,1029,1,"20,25",3,1,1,5,Low-Value,At Risk Customers
33280,76,5,"136,55",5,1,1,7,Mid-Value,Potential Loyalists
33281,230,2,"114,1",5,1,1,7,Mid-Value,Potential Loyalists
33284,876,4,"125,94999999999999",3,1,1,5,Low-Value,At Risk Customers
33285,0,1,"95,7",5,1,1,7,Mid-Value,Potential Loyalists
33287,449,1,"16,55",4,1,1,6,Mid-Value,Potential Loyalists
33288,1513,1,"148,85",1,1,1,3,Low-Value,Lost
33289,1035,1,"14,35",3,1,1,5,Low-Value,At Risk Customers
33290,556,6,"269,84999999999997",4,1,1,6,Mid-Value,Potential Loyalists
33291,731,1,"22,8",3,1,1,5,Low-Value,At Risk Customers
33292,609,1,"15,9",4,1,1,6,Mid-Value,Potential Loyalists
33293,179,2,"281,75",5,1,1,7,Mid-Value,Potential Loyalists
33294,828,3,"105,6",3,1,1,5,Low-Value,At Risk Customers
33296,133,2,"117,1",5,1,1,7,Mid-Value,Potential Loyalists
33297,129,3,"45,05",5,1,1,7,Mid-Value,Potential Loyalists
33299,42,1,"63,2",5,1,1,7,Mid-Value,Potential Loyalists
33300,191,1,"34,5",5,1,1,7,Mid-Value,Potential Loyalists
33301,783,5,"554,6",3,1,1,5,Low-Value,At Risk Customers
33302,503,4,"259,95",4,1,1,6,Mid-Value,Potential Loyalists
33303,877,2,"229,2",3,1,1,5,Low-Value,At Risk Customers
33304,399,7,"336,84999999999997",4,2,1,7,Mid-Value,Potential Loyalists
33306,276,4,"94,6",5,1,1,7,Mid-Value,Potential Loyalists
33307,781,2,"3,35",3,1,1,5,Low-Value,At Risk Customers
33308,795,1,"4,75",3,1,1,5,Low-Value,At Risk Customers
33309,596,1,"270,0",4,1,1,6,Mid-Value,Potential Loyalists
33311,353,7,"255,29999999999998",5,2,1,8,High-Value,Potential Loyalists
33312,1114,1,"151,0",2,1,1,4,Low-Value,Can't Lose
33313,285,4,"391,25",5,1,1,7,Mid-Value,Potential Loyalists
33314,668,2,"54,55",4,1,1,6,Mid-Value,Potential Loyalists
33316,124,4,"313,5",5,1,1,7,Mid-Value,Potential Loyalists
33317,362,1,"14,05",5,1,1,7,Mid-Value,Potential Loyalists
33318,1331,3,"214,45",2,1,1,4,Low-Value,Can't Lose
33319,463,6,"451,2",4,1,1,6,Mid-Value,Potential Loyalists
33320,36,5,"608,65",5,1,1,7,Mid-Value,Potential Loyalists
33321,744,6,"657,2",3,1,1,5,Low-Value,At Risk Customers
33322,1217,3,"155,9",2,1,1,4,Low-Value,Can't Lose
33324,428,3,"171,45",4,1,1,6,Mid-Value,Potential Loyalists
33325,389,7,"519,75",4,2,1,7,Mid-Value,Potential Loyalists
33327,440,1,"37,0",4,1,1,6,Mid-Value,Potential Loyalists
33329,325,3,"94,0",5,1,1,7,Mid-Value,Potential Loyalists
33330,811,1,"77,0",3,1,1,5,Low-Value,At Risk Customers
33333,536,5,"225,65",4,1,1,6,Mid-Value,Potential Loyalists
33334,117,1,"12,6",5,1,1,7,Mid-Value,Potential Loyalists
33336,1793,1,"6,5",1,1,1,3,Low-Value,Lost
33337,630,3,"44,65",4,1,1,6,Mid-Value,Potential Loyalists
33338,1508,1,"2,6",1,1,1,3,Low-Value,Lost
33340,485,2,"77,44999999999999",4,1,1,6,Mid-Value,Potential Loyalists
33342,200,3,"108,89999999999999",5,1,1,7,Mid-Value,Potential Loyalists
33343,132,2,"226,05",5,1,1,7,Mid-Value,Potential Loyalists
33345,971,1,"110,65",3,1,1,5,Low-Value,At Risk Customers
33346,618,2,"31,05",4,1,1,6,Mid-Value,Potential Loyalists
33349,769,5,"205,20000000000002",3,1,1,5,Low-Value,At Risk Customers
33350,971,5,"160,8",3,1,1,5,Low-Value,At Risk Customers
33351,394,3,"174,39999999999998",4,1,1,6,Mid-Value,Potential Loyalists
33352,496,5,"418,8",4,1,1,6,Mid-Value,Potential Loyalists
33353,249,3,"83,5",5,1,1,7,Mid-Value,Potential Loyalists
33354,215,5,"157,85",5,1,1,7,Mid-Value,Potential Loyalists
33355,197,1,"188,1",5,1,1,7,Mid-Value,Potential Loyalists
33356,55,7,"445,4",5,2,1,8,High-Value,Potential Loyalists
33357,263,1,"51,85",5,1,1,7,Mid-Value,Potential Loyalists
33359,253,2,"124,8",5,1,1,7,Mid-Value,Potential Loyalists
33360,679,1,"1,35",4,1,1,6,Mid-Value,Potential Loyalists
33361,475,6,"729,25",4,1,2,7,Mid-Value,Potential Loyalists
33362,87,12,"636,6999999999999",5,3,1,9,High-Value,Champions
33363,10,7,"421,7",5,2,1,8,High-Value,Potential Loyalists
33367,284,4,"153,6",5,1,1,7,Mid-Value,Potential Loyalists
33368,761,2,"184,25000000000003",3,1,1,5,Low-Value,At Risk Customers
33370,779,2,"170,25",3,1,1,5,Low-Value,At Risk Customers
33371,1250,2,"615,1500000000001",2,1,1,4,Low-Value,Can't Lose
33372,73,13,"847,25",5,3,2,10,High-Value,Champions
33373,937,3,"350,04999999999995",3,1,1,5,Low-Value,At Risk Customers
33375,402,2,"105,3",4,1,1,6,Mid-Value,Potential Loyalists
33376,950,2,"71,55",3,1,1,5,Low-Value,At Risk Customers
33378,783,8,"280,8",3,2,1,6,Mid-Value,Potential Loyalists
33380,1561,3,"172,75",1,1,1,3,Low-Value,Lost
33383,470,7,"169,5",4,2,1,7,Mid-Value,Potential Loyalists
33384,804,1,"39,0",3,1,1,5,Low-Value,At Risk Customers
33385,1098,1,"41,8",2,1,1,4,Low-Value,Can't Lose
33386,652,1,"39,05",4,1,1,6,Mid-Value,Potential Loyalists
33387,427,3,"62,5",4,1,1,6,Mid-Value,Potential Loyalists
33388,443,3,"186,75",4,1,1,6,Mid-Value,Potential Loyalists
33390,1531,1,"48,1",1,1,1,3,Low-Value,Lost
33391,126,8,"406,5",5,2,1,8,High-Value,Potential Loyalists
33393,183,2,"32,6",5,1,1,7,Mid-Value,Potential Loyalists
33395,825,1,"162,6",3,1,1,5,Low-Value,At Risk Customers
33396,516,3,"76,6",4,1,1,6,Mid-Value,Potential Loyalists
33397,198,2,"101,19999999999999",5,1,1,7,Mid-Value,Potential Loyalists
33398,21,7,"215,35000000000002",5,2,1,8,High-Value,Potential Loyalists
33399,26,4,"87,95",5,1,1,7,Mid-Value,Potential Loyalists
33400,434,2,"439,59999999999997",4,1,1,6,Mid-Value,Potential Loyalists
33401,450,2,"85,44999999999999",4,1,1,6,Mid-Value,Potential Loyalists
33404,359,1,"21,15",5,1,1,7,Mid-Value,Potential Loyalists
33405,945,1,"11,75",3,1,1,5,Low-Value,At Risk Customers
33408,261,3,"360,4",5,1,1,7,Mid-Value,Potential Loyalists
33409,424,1,"64,3",4,1,1,6,Mid-Value,Potential Loyalists
33410,391,7,"536,5999999999999",4,2,1,7,Mid-Value,Potential Loyalists
33412,725,3,"102,55",4,1,1,6,Mid-Value,Potential Loyalists
33413,454,10,"350,3",4,2,1,7,Mid-Value,Potential Loyalists
33414,8,8,"651,1",5,2,1,8,High-Value,Potential Loyalists
33415,1499,3,"127,99999999999999",1,1,1,3,Low-Value,Lost
33417,802,2,"31,15",3,1,1,5,Low-Value,At Risk Customers
33418,60,4,"172,45",5,1,1,7,Mid-Value,Potential Loyalists
33421,1007,2,"252,6",3,1,1,5,Low-Value,At Risk Customers
33422,930,2,"77,65",3,1,1,5,Low-Value,At Risk Customers
33423,362,3,"267,4",5,1,1,7,Mid-Value,Potential Loyalists
33425,389,3,"114,4",4,1,1,6,Mid-Value,Potential Loyalists
33426,115,4,"179,25",5,1,1,7,Mid-Value,Potential Loyalists
33427,185,4,"307,04999999999995",5,1,1,7,Mid-Value,Potential Loyalists
33431,1430,1,"22,1",2,1,1,4,Low-Value,Can't Lose
33432,2,1,"48,8",5,1,1,7,Mid-Value,Potential Loyalists
33433,126,1,"12,9",5,1,1,7,Mid-Value,Potential Loyalists
33434,304,3,"271,1",5,1,1,7,Mid-Value,Potential Loyalists
33435,684,2,"121,15",4,1,1,6,Mid-Value,Potential Loyalists
33436,421,12,"498,15",4,3,1,8,High-Value,Potential Loyalists
33437,478,2,"145,55",4,1,1,6,Mid-Value,Potential Loyalists
33438,93,2,"79,39999999999999",5,1,1,7,Mid-Value,Potential Loyalists
33439,973,3,"99,1",3,1,1,5,Low-Value,At Risk Customers
33440,82,3,"130,9",5,1,1,7,Mid-Value,Potential Loyalists
33441,11,3,"136,75",5,1,1,7,Mid-Value,Potential Loyalists
33447,590,3,"235,15",4,1,1,6,Mid-Value,Potential Loyalists
33448,1108,1,"117,0",2,1,1,4,Low-Value,Can't Lose
33451,73,3,"145,89999999999998",5,1,1,7,Mid-Value,Potential Loyalists
33452,18,3,"225,75",5,1,1,7,Mid-Value,Potential Loyalists
33453,413,4,"259,15",4,1,1,6,Mid-Value,Potential Loyalists
33454,760,1,"103,1",3,1,1,5,Low-Value,At Risk Customers
33455,576,4,"281,7",4,1,1,6,Mid-Value,Potential Loyalists
33456,486,2,"537,1999999999999",4,1,1,6,Mid-Value,Potential Loyalists
33457,677,1,"16,75",4,1,1,6,Mid-Value,Potential Loyalists
33459,747,2,"152,1",3,1,1,5,Low-Value,At Risk Customers
33460,283,6,"223,95",5,1,1,7,Mid-Value,Potential Loyalists
33461,767,3,"67,45",3,1,1,5,Low-Value,At Risk Customers
33462,41,3,"52,2",5,1,1,7,Mid-Value,Potential Loyalists
33463,383,2,"57,6",4,1,1,6,Mid-Value,Potential Loyalists
33464,403,4,"358,29999999999995",4,1,1,6,Mid-Value,Potential Loyalists
33465,31,7,"162,55",5,2,1,8,High-Value,Potential Loyalists
33467,1049,4,"372,95000000000005",3,1,1,5,Low-Value,At Risk Customers
33468,109,2,"49,050000000000004",5,1,1,7,Mid-Value,Potential Loyalists
33469,508,3,"47,599999999999994",4,1,1,6,Mid-Value,Potential Loyalists
33470,47,6,"383,2",5,1,1,7,Mid-Value,Potential Loyalists
33471,834,2,"48,1",3,1,1,5,Low-Value,At Risk Customers
33473,1679,3,"41,65",1,1,1,3,Low-Value,Lost
33474,1062,5,"472,19999999999993",3,1,1,5,Low-Value,At Risk Customers
33481,64,1,"20,35",5,1,1,7,Mid-Value,Potential Loyalists
33482,181,1,"69,0",5,1,1,7,Mid-Value,Potential Loyalists
33483,691,3,"515,0",4,1,1,6,Mid-Value,Potential Loyalists
33485,1219,1,"254,39999999999998",2,1,1,4,Low-Value,Can't Lose
33486,760,4,"450,25",3,1,1,5,Low-Value,At Risk Customers
33487,22,4,"176,55",5,1,1,7,Mid-Value,Potential Loyalists
33491,1505,1,"81,44999999999999",1,1,1,3,Low-Value,Lost
33492,383,3,"95,15",4,1,1,6,Mid-Value,Potential Loyalists
33494,1086,3,"89,6",3,1,1,5,Low-Value,At Risk Customers
33496,475,4,"202,55",4,1,1,6,Mid-Value,Potential Loyalists
33497,399,6,"281,4",4,1,1,6,Mid-Value,Potential Loyalists
33498,1105,2,"24,65",2,1,1,4,Low-Value,Can't Lose
33499,993,3,"61,6",3,1,1,5,Low-Value,At Risk Customers
33502,631,2,"45,95",4,1,1,6,Mid-Value,Potential Loyalists
33503,298,6,"825,5500000000001",5,1,2,8,High-Value,Potential Loyalists
33504,1,7,"402,1",5,2,1,8,High-Value,Potential Loyalists
33506,635,2,"337,9",4,1,1,6,Mid-Value,Potential Loyalists
33507,29,14,"1029,0",5,3,2,10,High-Value,Champions
33508,911,3,"158,9",3,1,1,5,Low-Value,At Risk Customers
33511,17,7,"823,25",5,2,2,9,High-Value,Champions
33513,242,4,"185,65",5,1,1,7,Mid-Value,Potential Loyalists
33515,1082,2,"34,5",3,1,1,5,Low-Value,At Risk Customers
33516,904,4,"403,09999999999997",3,1,1,5,Low-Value,At Risk Customers
33520,137,2,"147,70000000000002",5,1,1,7,Mid-Value,Potential Loyalists
33521,1251,1,"245,5",2,1,1,4,Low-Value,Can't Lose
33522,1100,3,"112,1",2,1,1,4,Low-Value,Can't Lose
33524,1598,1,"281,1",1,1,1,3,Low-Value,Lost
33528,1106,1,"98,10000000000001",2,1,1,4,Low-Value,Can't Lose
33530,61,11,"469,15",5,2,1,8,High-Value,Potential Loyalists
33533,8,4,"418,20000000000005",5,1,1,7,Mid-Value,Potential Loyalists
33534,601,2,"70,5",4,1,1,6,Mid-Value,Potential Loyalists
33536,101,3,"60,849999999999994",5,1,1,7,Mid-Value,Potential Loyalists
33537,1684,1,"9,95",1,1,1,3,Low-Value,Lost
33539,454,3,"116,3",4,1,1,6,Mid-Value,Potential Loyalists
33540,75,7,"358,15",5,2,1,8,High-Value,Potential Loyalists
33542,104,4,"312,40000000000003",5,1,1,7,Mid-Value,Potential Loyalists
33543,207,2,"84,80000000000001",5,1,1,7,Mid-Value,Potential Loyalists
33544,6,3,"196,29999999999998",5,1,1,7,Mid-Value,Potential Loyalists
33548,909,1,"15,4",3,1,1,5,Low-Value,At Risk Customers
33549,599,2,"71,2",4,1,1,6,Mid-Value,Potential Loyalists
33550,68,3,"272,7",5,1,1,7,Mid-Value,Potential Loyalists
33551,668,4,"230,3",4,1,1,6,Mid-Value,Potential Loyalists
33552,572,2,"13,45",4,1,1,6,Mid-Value,Potential Loyalists
33554,1018,2,"83,65",3,1,1,5,Low-Value,At Risk Customers
33555,261,1,"73,6",5,1,1,7,Mid-Value,Potential Loyalists
33557,1628,1,"36,6",1,1,1,3,Low-Value,Lost
33558,316,3,"145,0",5,1,1,7,Mid-Value,Potential Loyalists
33559,966,1,"90,4",3,1,1,5,Low-Value,At Risk Customers
33560,1417,2,"199,14999999999998",2,1,1,4,Low-Value,Can't Lose
33562,531,2,"42,7",4,1,1,6,Mid-Value,Potential Loyalists
33563,1373,2,"56,15",2,1,1,4,Low-Value,Can't Lose
33564,322,3,"61,6",5,1,1,7,Mid-Value,Potential Loyalists
33565,70,4,"369,2",5,1,1,7,Mid-Value,Potential Loyalists
33566,797,2,"24,95",3,1,1,5,Low-Value,At Risk Customers
33567,1813,1,"31,65",1,1,1,3,Low-Value,Lost
33568,225,13,"576,75",5,3,1,9,High-Value,Champions
33569,1243,1,"218,2",2,1,1,4,Low-Value,Can't Lose
33570,973,1,"64,35",3,1,1,5,Low-Value,At Risk Customers
33571,572,2,"226,1",4,1,1,6,Mid-Value,Potential Loyalists
33572,115,6,"705,85",5,1,2,8,High-Value,Potential Loyalists
33573,767,3,"109,35",3,1,1,5,Low-Value,At Risk Customers
33574,361,9,"723,95",5,2,2,9,High-Value,Champions
33575,76,6,"80,64999999999999",5,1,1,7,Mid-Value,Potential Loyalists
33576,1609,2,"134,3",1,1,1,3,Low-Value,Lost
33577,488,2,"83,8",4,1,1,6,Mid-Value,Potential Loyalists
33578,390,4,"85,94999999999999",4,1,1,6,Mid-Value,Potential Loyalists
33579,790,2,"84,35",3,1,1,5,Low-Value,At Risk Customers
33580,109,5,"106,7",5,1,1,7,Mid-Value,Potential Loyalists
33582,1452,1,"24,2",2,1,1,4,Low-Value,Can't Lose
33583,140,1,"15,4",5,1,1,7,Mid-Value,Potential Loyalists
33584,1812,1,"18,9",1,1,1,3,Low-Value,Lost
33586,773,3,"58,6",3,1,1,5,Low-Value,At Risk Customers
33587,1528,2,"47,4",1,1,1,3,Low-Value,Lost
33588,510,2,"65,7",4,1,1,6,Mid-Value,Potential Loyalists
33592,162,13,"1362,5",5,3,3,11,High-Value,Champions
33593,439,3,"256,25",4,1,1,6,Mid-Value,Potential Loyalists
33594,1619,1,"31,4",1,1,1,3,Low-Value,Lost
33595,378,4,"661,3",4,1,1,6,Mid-Value,Potential Loyalists
33596,1184,1,"56,35",2,1,1,4,Low-Value,Can't Lose
33597,1389,1,"10,1",2,1,1,4,Low-Value,Can't Lose
33599,893,1,"8,5",3,1,1,5,Low-Value,At Risk Customers
33600,131,2,"292,3",5,1,1,7,Mid-Value,Potential Loyalists
33601,106,3,"72,6",5,1,1,7,Mid-Value,Potential Loyalists
33603,1051,3,"250,65",3,1,1,5,Low-Value,At Risk Customers
33604,318,3,"843,25",5,1,2,8,High-Value,Potential Loyalists
33605,490,2,"272,75",4,1,1,6,Mid-Value,Potential Loyalists
33607,98,1,"8,2",5,1,1,7,Mid-Value,Potential Loyalists
33609,1658,1,"51,9",1,1,1,3,Low-Value,Lost
33610,629,4,"271,35",4,1,1,6,Mid-Value,Potential Loyalists
33611,24,12,"568,1",5,3,1,9,High-Value,Champions
33612,817,4,"441,05",3,1,1,5,Low-Value,At Risk Customers
33614,14,3,"144,25",5,1,1,7,Mid-Value,Potential Loyalists
33615,245,5,"411,59999999999997",5,1,1,7,Mid-Value,Potential Loyalists
33616,279,3,"124,7",5,1,1,7,Mid-Value,Potential Loyalists
33617,437,3,"109,6",4,1,1,6,Mid-Value,Potential Loyalists
33618,280,4,"107,80000000000001",5,1,1,7,Mid-Value,Potential Loyalists
33619,916,5,"268,6",3,1,1,5,Low-Value,At Risk Customers
33620,1113,4,"139,8",2,1,1,4,Low-Value,Can't Lose
33621,368,8,"418,15",4,2,1,7,Mid-Value,Potential Loyalists
33623,280,1,"253,2",5,1,1,7,Mid-Value,Potential Loyalists
33625,884,5,"390,05",3,1,1,5,Low-Value,At Risk Customers
33627,355,5,"210,7",5,1,1,7,Mid-Value,Potential Loyalists
33628,592,1,"14,4",4,1,1,6,Mid-Value,Potential Loyalists
33629,763,4,"137,75",3,1,1,5,Low-Value,At Risk Customers
33634,174,9,"568,95",5,2,1,8,High-Value,Potential Loyalists
33635,1197,1,"58,9",2,1,1,4,Low-Value,Can't Lose
33638,1115,2,"70,80000000000001",2,1,1,4,Low-Value,Can't Lose
33641,197,10,"276,05",5,2,1,8,High-Value,Potential Loyalists
33642,589,3,"289,65",4,1,1,6,Mid-Value,Potential Loyalists
33643,132,8,"1272,65",5,2,2,9,High-Value,Champions
33644,271,8,"515,2",5,2,1,8,High-Value,Potential Loyalists
33646,269,6,"183,35000000000002",5,1,1,7,Mid-Value,Potential Loyalists
33647,210,4,"131,2",5,1,1,7,Mid-Value,Potential Loyalists
33648,339,1,"193,5",5,1,1,7,Mid-Value,Potential Loyalists
33649,974,1,"118,19999999999999",3,1,1,5,Low-Value,At Risk Customers
33651,1297,4,"905,5500000000001",2,1,2,5,Low-Value,At Risk Customers
33652,4,7,"271,9",5,2,1,8,High-Value,Potential Loyalists
33653,740,2,"426,55",3,1,1,5,Low-Value,At Risk Customers
33654,265,3,"139,25",5,1,1,7,Mid-Value,Potential Loyalists
33655,625,2,"137,45",4,1,1,6,Mid-Value,Potential Loyalists
33656,160,5,"602,8",5,1,1,7,Mid-Value,Potential Loyalists
33657,955,4,"136,35",3,1,1,5,Low-Value,At Risk Customers
33658,879,1,"40,2",3,1,1,5,Low-Value,At Risk Customers
33660,1655,1,"16,1",1,1,1,3,Low-Value,Lost
33662,785,7,"200,65",3,2,1,6,Mid-Value,Potential Loyalists
33665,179,1,"34,35",5,1,1,7,Mid-Value,Potential Loyalists
33666,936,1,"102,0",3,1,1,5,Low-Value,At Risk Customers
33668,1586,1,"34,5",1,1,1,3,Low-Value,Lost
33670,82,3,"267,2",5,1,1,7,Mid-Value,Potential Loyalists
33673,19,5,"165,35",5,1,1,7,Mid-Value,Potential Loyalists
33674,65,6,"465,0",5,1,1,7,Mid-Value,Potential Loyalists
33675,1667,1,"63,9",1,1,1,3,Low-Value,Lost
33676,552,5,"114,55",4,1,1,6,Mid-Value,Potential Loyalists
33677,1171,4,"339,6",2,1,1,4,Low-Value,Can't Lose
33679,473,9,"641,55",4,2,1,7,Mid-Value,Potential Loyalists
33682,187,3,"268,3",5,1,1,7,Mid-Value,Potential Loyalists
33683,948,2,"38,6",3,1,1,5,Low-Value,At Risk Customers
33685,920,3,"278,9",3,1,1,5,Low-Value,At Risk Customers
33686,812,1,"102,6",3,1,1,5,Low-Value,At Risk Customers
33687,166,5,"85,85",5,1,1,7,Mid-Value,Potential Loyalists
33688,856,1,"11,1",3,1,1,5,Low-Value,At Risk Customers
33690,1133,6,"265,5",2,1,1,4,Low-Value,Can't Lose
33691,1568,1,"3,6",1,1,1,3,Low-Value,Lost
33692,2,2,"290,79999999999995",5,1,1,7,Mid-Value,Potential Loyalists
33695,197,4,"71,39999999999999",5,1,1,7,Mid-Value,Potential Loyalists
33697,1050,2,"88,8",3,1,1,5,Low-Value,At Risk Customers
33698,1614,4,"239,25",1,1,1,3,Low-Value,Lost
33699,790,5,"194,75",3,1,1,5,Low-Value,At Risk Customers
33702,544,3,"406,35",4,1,1,6,Mid-Value,Potential Loyalists
33703,28,5,"196,15",5,1,1,7,Mid-Value,Potential Loyalists
33704,8,4,"117,6",5,1,1,7,Mid-Value,Potential Loyalists
33707,381,4,"168,45",4,1,1,6,Mid-Value,Potential Loyalists
33708,666,3,"126,2",4,1,1,6,Mid-Value,Potential Loyalists
33709,685,4,"348,3",4,1,1,6,Mid-Value,Potential Loyalists
33710,53,5,"254,1",5,1,1,7,Mid-Value,Potential Loyalists
33712,44,2,"65,2",5,1,1,7,Mid-Value,Potential Loyalists
33713,177,2,"244,29999999999998",5,1,1,7,Mid-Value,Potential Loyalists
33714,794,5,"237,3",3,1,1,5,Low-Value,At Risk Customers
33715,858,3,"358,1",3,1,1,5,Low-Value,At Risk Customers
33716,1539,1,"12,1",1,1,1,3,Low-Value,Lost
33717,1356,1,"28,4",2,1,1,4,Low-Value,Can't Lose
33721,57,1,"17,8",5,1,1,7,Mid-Value,Potential Loyalists
33723,404,3,"143,95",4,1,1,6,Mid-Value,Potential Loyalists
33724,301,4,"120,9",5,1,1,7,Mid-Value,Potential Loyalists
33725,0,11,"548,9",5,2,1,8,High-Value,Potential Loyalists
33729,113,6,"389,25000000000006",5,1,1,7,Mid-Value,Potential Loyalists
33730,78,1,"16,3",5,1,1,7,Mid-Value,Potential Loyalists
33734,116,4,"113,8",5,1,1,7,Mid-Value,Potential Loyalists
33735,393,4,"591,5",4,1,1,6,Mid-Value,Potential Loyalists
33736,347,3,"80,6",5,1,1,7,Mid-Value,Potential Loyalists
33737,394,1,"42,6",4,1,1,6,Mid-Value,Potential Loyalists
33738,230,3,"316,4",5,1,1,7,Mid-Value,Potential Loyalists
33739,28,2,"185,85000000000002",5,1,1,7,Mid-Value,Potential Loyalists
33740,136,6,"419,25",5,1,1,7,Mid-Value,Potential Loyalists
33742,256,2,"71,2",5,1,1,7,Mid-Value,Potential Loyalists
33743,747,11,"1153,3",3,2,2,7,Mid-Value,Potential Loyalists
33745,146,2,"32,849999999999994",5,1,1,7,Mid-Value,Potential Loyalists
33746,130,6,"682,45",5,1,2,8,High-Value,Potential Loyalists
33747,285,4,"344,45",5,1,1,7,Mid-Value,Potential Loyalists
33752,352,2,"38,75",5,1,1,7,Mid-Value,Potential Loyalists
33755,785,3,"127,8",3,1,1,5,Low-Value,At Risk Customers
33756,1821,1,"14,85",1,1,1,3,Low-Value,Lost
33757,757,2,"115,5",3,1,1,5,Low-Value,At Risk Customers
33758,16,16,"583,8",5,3,1,9,High-Value,Champions
33760,1596,1,"80,25",1,1,1,3,Low-Value,Lost
33764,1468,1,"49,349999999999994",1,1,1,3,Low-Value,Lost
33765,302,1,"29,6",5,1,1,7,Mid-Value,Potential Loyalists
33766,69,3,"62,349999999999994",5,1,1,7,Mid-Value,Potential Loyalists
33771,296,1,"12,5",5,1,1,7,Mid-Value,Potential Loyalists
33773,74,3,"329,34999999999997",5,1,1,7,Mid-Value,Potential Loyalists
33774,501,2,"336,8",4,1,1,6,Mid-Value,Potential Loyalists
33775,1404,1,"54,5",2,1,1,4,Low-Value,Can't Lose
33776,201,2,"86,44999999999999",5,1,1,7,Mid-Value,Potential Loyalists
33777,104,4,"315,5",5,1,1,7,Mid-Value,Potential Loyalists
33778,153,5,"467,8",5,1,1,7,Mid-Value,Potential Loyalists
33779,385,6,"189,85",4,1,1,6,Mid-Value,Potential Loyalists
33780,407,3,"132,35",4,1,1,6,Mid-Value,Potential Loyalists
33781,205,3,"50,1",5,1,1,7,Mid-Value,Potential Loyalists
33783,339,1,"272,3",5,1,1,7,Mid-Value,Potential Loyalists
33784,487,3,"103,75",4,1,1,6,Mid-Value,Potential Loyalists
33785,237,3,"101,2",5,1,1,7,Mid-Value,Potential Loyalists
33786,965,1,"173,3",3,1,1,5,Low-Value,At Risk Customers
33787,43,9,"710,8",5,2,2,9,High-Value,Champions
33788,815,2,"35,75",3,1,1,5,Low-Value,At Risk Customers
33789,48,3,"250,0",5,1,1,7,Mid-Value,Potential Loyalists
33790,156,3,"212,25",5,1,1,7,Mid-Value,Potential Loyalists
33791,1410,1,"57,2",2,1,1,4,Low-Value,Can't Lose
33792,118,2,"164,55",5,1,1,7,Mid-Value,Potential Loyalists
33793,108,13,"1031,4",5,3,2,10,High-Value,Champions
33794,822,2,"84,6",3,1,1,5,Low-Value,At Risk Customers
33795,8,9,"647,85",5,2,1,8,High-Value,Potential Loyalists
33796,414,2,"27,3",4,1,1,6,Mid-Value,Potential Loyalists
33797,706,3,"146,20000000000002",4,1,1,6,Mid-Value,Potential Loyalists
33798,568,4,"140,15",4,1,1,6,Mid-Value,Potential Loyalists
33800,393,5,"196,35",4,1,1,6,Mid-Value,Potential Loyalists
33803,469,4,"168,05",4,1,1,6,Mid-Value,Potential Loyalists
33804,685,2,"394,75",4,1,1,6,Mid-Value,Potential Loyalists
33805,591,3,"428,9",4,1,1,6,Mid-Value,Potential Loyalists
33806,540,4,"464,70000000000005",4,1,1,6,Mid-Value,Potential Loyalists
33808,8,1,"35,1",5,1,1,7,Mid-Value,Potential Loyalists
33809,475,3,"81,25",4,1,1,6,Mid-Value,Potential Loyalists
33810,320,6,"432,55",5,1,1,7,Mid-Value,Potential Loyalists
33811,333,1,"19,75",5,1,1,7,Mid-Value,Potential Loyalists
33812,338,2,"87,8",5,1,1,7,Mid-Value,Potential Loyalists
33813,124,4,"270,4",5,1,1,7,Mid-Value,Potential Loyalists
33814,29,3,"206,05",5,1,1,7,Mid-Value,Potential Loyalists
33815,302,2,"10,85",5,1,1,7,Mid-Value,Potential Loyalists
33817,437,4,"326,54999999999995",4,1,1,6,Mid-Value,Potential Loyalists
33818,334,3,"217,34999999999997",5,1,1,7,Mid-Value,Potential Loyalists
33820,1122,6,"215,03",2,1,1,4,Low-Value,Can't Lose
33821,622,4,"116,6",4,1,1,6,Mid-Value,Potential Loyalists
33822,184,2,"119,2",5,1,1,7,Mid-Value,Potential Loyalists
33823,117,4,"284,75",5,1,1,7,Mid-Value,Potential Loyalists
33824,399,2,"189,3",4,1,1,6,Mid-Value,Potential Loyalists
33825,64,8,"146,35",5,2,1,8,High-Value,Potential Loyalists
33827,1663,1,"182,0",1,1,1,3,Low-Value,Lost
33828,286,2,"53,8",5,1,1,7,Mid-Value,Potential Loyalists
33829,515,1,"46,9",4,1,1,6,Mid-Value,Potential Loyalists
33831,137,8,"323,79999999999995",5,2,1,8,High-Value,Potential Loyalists
33835,814,5,"273,3",3,1,1,5,Low-Value,At Risk Customers
33839,146,6,"343,25",5,1,1,7,Mid-Value,Potential Loyalists
33841,768,2,"201,35000000000002",3,1,1,5,Low-Value,At Risk Customers
33842,1642,5,"291,75",1,1,1,3,Low-Value,Lost
33843,91,2,"244,9",5,1,1,7,Mid-Value,Potential Loyalists
33846,561,4,"133,5",4,1,1,6,Mid-Value,Potential Loyalists
33847,112,2,"92,75",5,1,1,7,Mid-Value,Potential Loyalists
33848,702,3,"217,1",4,1,1,6,Mid-Value,Potential Loyalists
33850,14,2,"28,95",5,1,1,7,Mid-Value,Potential Loyalists
33852,1289,1,"51,0",2,1,1,4,Low-Value,Can't Lose
33853,732,2,"195,3",3,1,1,5,Low-Value,At Risk Customers
33854,485,2,"45,45",4,1,1,6,Mid-Value,Potential Loyalists
33856,357,2,"244,15",5,1,1,7,Mid-Value,Potential Loyalists
33857,313,7,"1148,95",5,2,2,9,High-Value,Champions
33858,368,4,"157,9",4,1,1,6,Mid-Value,Potential Loyalists
33861,732,8,"730,55",3,2,2,7,Mid-Value,Potential Loyalists
33862,191,2,"162,45000000000002",5,1,1,7,Mid-Value,Potential Loyalists
33863,1504,1,"37,0",1,1,1,3,Low-Value,Lost
33864,681,4,"104,3",4,1,1,6,Mid-Value,Potential Loyalists
33866,1644,1,"16,7",1,1,1,3,Low-Value,Lost
33869,1055,3,"95,25",3,1,1,5,Low-Value,At Risk Customers
33873,474,2,"194,20000000000002",4,1,1,6,Mid-Value,Potential Loyalists
33875,12,2,"22,9",5,1,1,7,Mid-Value,Potential Loyalists
33878,822,4,"85,6",3,1,1,5,Low-Value,At Risk Customers
33879,159,4,"503,84999999999997",5,1,1,7,Mid-Value,Potential Loyalists
33880,78,3,"181,50000000000003",5,1,1,7,Mid-Value,Potential Loyalists
33886,649,3,"278,6",4,1,1,6,Mid-Value,Potential Loyalists
33887,447,5,"150,85",4,1,1,6,Mid-Value,Potential Loyalists
33892,990,2,"27,8",3,1,1,5,Low-Value,At Risk Customers
33896,486,3,"109,25",4,1,1,6,Mid-Value,Potential Loyalists
33897,904,1,"2,0",3,1,1,5,Low-Value,At Risk Customers
33900,41,1,"15,8",5,1,1,7,Mid-Value,Potential Loyalists
33903,1499,1,"73,8",1,1,1,3,Low-Value,Lost
33904,899,1,"50,400000000000006",3,1,1,5,Low-Value,At Risk Customers
33905,67,9,"449,3",5,2,1,8,High-Value,Potential Loyalists
33906,21,5,"259,3",5,1,1,7,Mid-Value,Potential Loyalists
33907,235,1,"17,1",5,1,1,7,Mid-Value,Potential Loyalists
33909,1267,3,"152,0",2,1,1,4,Low-Value,Can't Lose
33910,1021,1,"23,75",3,1,1,5,Low-Value,At Risk Customers
33911,63,9,"433,09999999999997",5,2,1,8,High-Value,Potential Loyalists
33912,131,3,"151,85",5,1,1,7,Mid-Value,Potential Loyalists
33913,173,2,"261,95000000000005",5,1,1,7,Mid-Value,Potential Loyalists
33914,513,3,"389,25",4,1,1,6,Mid-Value,Potential Loyalists
33915,934,2,"284,45",3,1,1,5,Low-Value,At Risk Customers
33916,435,1,"5,6",4,1,1,6,Mid-Value,Potential Loyalists
33917,1446,1,"2,95",2,1,1,4,Low-Value,Can't Lose
33918,586,2,"309,69999999999993",4,1,1,6,Mid-Value,Potential Loyalists
33919,264,2,"62,15",5,1,1,7,Mid-Value,Potential Loyalists
33920,1575,1,"91,5",1,1,1,3,Low-Value,Lost
33921,43,6,"138,9",5,1,1,7,Mid-Value,Potential Loyalists
33922,1452,3,"126,3",2,1,1,4,Low-Value,Can't Lose
33923,64,4,"539,35",5,1,1,7,Mid-Value,Potential Loyalists
33925,155,1,"38,9",5,1,1,7,Mid-Value,Potential Loyalists
33927,125,4,"274,65",5,1,1,7,Mid-Value,Potential Loyalists
33928,263,2,"54,1",5,1,1,7,Mid-Value,Potential Loyalists
33929,305,3,"335,20000000000005",5,1,1,7,Mid-Value,Potential Loyalists
33932,237,1,"19,85",5,1,1,7,Mid-Value,Potential Loyalists
33933,1405,1,"45,2",2,1,1,4,Low-Value,Can't Lose
33935,4,2,"42,699999999999996",5,1,1,7,Mid-Value,Potential Loyalists
33936,1718,1,"12,45",1,1,1,3,Low-Value,Lost
33937,790,2,"55,85",3,1,1,5,Low-Value,At Risk Customers
33939,498,3,"250,5",4,1,1,6,Mid-Value,Potential Loyalists
33940,194,5,"185,0",5,1,1,7,Mid-Value,Potential Loyalists
33941,829,4,"182,3",3,1,1,5,Low-Value,At Risk Customers
33942,733,3,"233,85",3,1,1,5,Low-Value,At Risk Customers
33943,376,6,"551,1",4,1,1,6,Mid-Value,Potential Loyalists
33944,69,3,"485,75",5,1,1,7,Mid-Value,Potential Loyalists
33945,786,3,"60,6",3,1,1,5,Low-Value,At Risk Customers
33946,129,8,"586,5500000000001",5,2,1,8,High-Value,Potential Loyalists
33948,308,4,"396,7",5,1,1,7,Mid-Value,Potential Loyalists
33949,1338,1,"35,2",2,1,1,4,Low-Value,Can't Lose
33950,1635,1,"65,7",1,1,1,3,Low-Value,Lost
33951,56,1,"7,75",5,1,1,7,Mid-Value,Potential Loyalists
33952,326,3,"50,95",5,1,1,7,Mid-Value,Potential Loyalists
33953,1159,2,"51,05",2,1,1,4,Low-Value,Can't Lose
33954,526,2,"154,55",4,1,1,6,Mid-Value,Potential Loyalists
33955,349,5,"491,2",5,1,1,7,Mid-Value,Potential Loyalists
33956,241,10,"797,25",5,2,2,9,High-Value,Champions
33957,531,5,"378,35",4,1,1,6,Mid-Value,Potential Loyalists
33959,780,1,"58,6",3,1,1,5,Low-Value,At Risk Customers
33960,1546,1,"7,7",1,1,1,3,Low-Value,Lost
33962,73,6,"417,8",5,1,1,7,Mid-Value,Potential Loyalists
33964,9,1,"70,0",5,1,1,7,Mid-Value,Potential Loyalists
33965,171,7,"496,90000000000003",5,2,1,8,High-Value,Potential Loyalists
33966,1191,7,"293,05",2,2,1,5,Low-Value,At Risk Customers
33968,1534,1,"67,2",1,1,1,3,Low-Value,Lost
33969,663,1,"45,0",4,1,1,6,Mid-Value,Potential Loyalists
33970,39,5,"166,35000000000002",5,1,1,7,Mid-Value,Potential Loyalists
33971,825,4,"348,0",3,1,1,5,Low-Value,At Risk Customers
33972,264,8,"312,9",5,2,1,8,High-Value,Potential Loyalists
33973,1425,1,"12,1",2,1,1,4,Low-Value,Can't Lose
33974,22,3,"254,64999999999998",5,1,1,7,Mid-Value,Potential Loyalists
33975,956,2,"25,05",3,1,1,5,Low-Value,At Risk Customers
33976,196,2,"253,85",5,1,1,7,Mid-Value,Potential Loyalists
33978,129,4,"132,6",5,1,1,7,Mid-Value,Potential Loyalists
33979,1613,2,"38,8",1,1,1,3,Low-Value,Lost
33980,80,3,"188,0",5,1,1,7,Mid-Value,Potential Loyalists
33982,26,6,"638,05",5,1,1,7,Mid-Value,Potential Loyalists
33983,1291,2,"102,75",2,1,1,4,Low-Value,Can't Lose
33984,346,4,"747,4",5,1,2,8,High-Value,Potential Loyalists
33985,396,2,"32,7",4,1,1,6,Mid-Value,Potential Loyalists
33986,272,5,"340,40000000000003",5,1,1,7,Mid-Value,Potential Loyalists
33987,425,1,"5,95",4,1,1,6,Mid-Value,Potential Loyalists
33989,949,3,"205,0",3,1,1,5,Low-Value,At Risk Customers
33990,837,5,"408,4",3,1,1,5,Low-Value,At Risk Customers
33992,321,6,"373,54999999999995",5,1,1,7,Mid-Value,Potential Loyalists
33998,553,5,"739,9",4,1,2,7,Mid-Value,Potential Loyalists
33999,1811,1,"64,25",1,1,1,3,Low-Value,Lost
34000,524,1,"100,8",4,1,1,6,Mid-Value,Potential Loyalists
34002,1048,2,"50,2",3,1,1,5,Low-Value,At Risk Customers
34003,203,1,"75,30000000000001",5,1,1,7,Mid-Value,Potential Loyalists
34004,1165,1,"14,35",2,1,1,4,Low-Value,Can't Lose
34005,295,6,"343,3",5,1,1,7,Mid-Value,Potential Loyalists
34007,1105,1,"34,1",2,1,1,4,Low-Value,Can't Lose
34010,639,1,"103,35000000000001",4,1,1,6,Mid-Value,Potential Loyalists
34011,644,3,"182,7",4,1,1,6,Mid-Value,Potential Loyalists
34012,70,3,"53,45",5,1,1,7,Mid-Value,Potential Loyalists
34014,31,2,"90,75",5,1,1,7,Mid-Value,Potential Loyalists
34016,182,2,"142,7",5,1,1,7,Mid-Value,Potential Loyalists
34017,1316,1,"7,25",2,1,1,4,Low-Value,Can't Lose
34018,1333,2,"120,6",2,1,1,4,Low-Value,Can't Lose
34019,425,2,"33,3",4,1,1,6,Mid-Value,Potential Loyalists
34020,208,1,"61,6",5,1,1,7,Mid-Value,Potential Loyalists
34021,346,3,"226,85",5,1,1,7,Mid-Value,Potential Loyalists
34022,47,2,"24,15",5,1,1,7,Mid-Value,Potential Loyalists
34023,500,4,"205,6",4,1,1,6,Mid-Value,Potential Loyalists
34024,1516,2,"173,54999999999998",1,1,1,3,Low-Value,Lost
34026,659,5,"95,25",4,1,1,6,Mid-Value,Potential Loyalists
34027,281,1,"106,6",5,1,1,7,Mid-Value,Potential Loyalists
34032,39,6,"246,0",5,1,1,7,Mid-Value,Potential Loyalists
34035,836,2,"418,5",3,1,1,5,Low-Value,At Risk Customers
34036,238,4,"268,2",5,1,1,7,Mid-Value,Potential Loyalists
34037,251,9,"487,26",5,2,1,8,High-Value,Potential Loyalists
34038,499,5,"529,9",4,1,1,6,Mid-Value,Potential Loyalists
34039,167,5,"269,09999999999997",5,1,1,7,Mid-Value,Potential Loyalists
34043,349,3,"205,7",5,1,1,7,Mid-Value,Potential Loyalists
34044,50,2,"137,1",5,1,1,7,Mid-Value,Potential Loyalists
34045,792,1,"54,85",3,1,1,5,Low-Value,At Risk Customers
34046,1092,1,"15,4",3,1,1,5,Low-Value,At Risk Customers
34047,557,1,"60,7",4,1,1,6,Mid-Value,Potential Loyalists
34050,118,3,"76,85",5,1,1,7,Mid-Value,Potential Loyalists
34051,67,5,"156,3",5,1,1,7,Mid-Value,Potential Loyalists
34052,1222,1,"50,3",2,1,1,4,Low-Value,Can't Lose
34054,9,2,"50,1",5,1,1,7,Mid-Value,Potential Loyalists
34055,50,4,"209,55",5,1,1,7,Mid-Value,Potential Loyalists
34057,1172,1,"58,8",2,1,1,4,Low-Value,Can't Lose
34058,28,4,"270,1",5,1,1,7,Mid-Value,Potential Loyalists
34059,1069,1,"205,9",3,1,1,5,Low-Value,At Risk Customers
34064,62,8,"398,25",5,2,1,8,High-Value,Potential Loyalists
34066,82,6,"434,2",5,1,1,7,Mid-Value,Potential Loyalists
34067,985,1,"135,0",3,1,1,5,Low-Value,At Risk Customers
34069,1069,1,"25,4",3,1,1,5,Low-Value,At Risk Customers
34070,1023,1,"118,5",3,1,1,5,Low-Value,At Risk Customers
34071,381,1,"82,8",4,1,1,6,Mid-Value,Potential Loyalists
34072,662,1,"34,9",4,1,1,6,Mid-Value,Potential Loyalists
34073,678,3,"52,9",4,1,1,6,Mid-Value,Potential Loyalists
34074,1544,1,"34,5",1,1,1,3,Low-Value,Lost
34076,1431,1,"24,8",2,1,1,4,Low-Value,Can't Lose
34078,196,1,"98,39999999999999",5,1,1,7,Mid-Value,Potential Loyalists
34079,172,1,"84,9",5,1,1,7,Mid-Value,Potential Loyalists
34080,1001,1,"11,3",3,1,1,5,Low-Value,At Risk Customers
34081,592,2,"43,25",4,1,1,6,Mid-Value,Potential Loyalists
34083,19,4,"103,85",5,1,1,7,Mid-Value,Potential Loyalists
34084,947,2,"118,25",3,1,1,5,Low-Value,At Risk Customers
34087,554,2,"305,1",4,1,1,6,Mid-Value,Potential Loyalists
34088,674,2,"24,15",4,1,1,6,Mid-Value,Potential Loyalists
34089,50,3,"122,35",5,1,1,7,Mid-Value,Potential Loyalists
34091,319,6,"277,05",5,1,1,7,Mid-Value,Potential Loyalists
34092,18,7,"594,8499999999999",5,2,1,8,High-Value,Potential Loyalists
34093,443,3,"64,5",4,1,1,6,Mid-Value,Potential Loyalists
34094,106,6,"279,15",5,1,1,7,Mid-Value,Potential Loyalists
34095,173,1,"103,7",5,1,1,7,Mid-Value,Potential Loyalists
34098,171,5,"318,0",5,1,1,7,Mid-Value,Potential Loyalists
34099,3,4,"132,65",5,1,1,7,Mid-Value,Potential Loyalists
34102,24,5,"242,5",5,1,1,7,Mid-Value,Potential Loyalists
34103,1796,1,"69,1",1,1,1,3,Low-Value,Lost
34104,1121,1,"17,25",2,1,1,4,Low-Value,Can't Lose
34105,1032,3,"177,75",3,1,1,5,Low-Value,At Risk Customers
34109,883,2,"198,29999999999998",3,1,1,5,Low-Value,At Risk Customers
34110,762,4,"873,85",3,1,2,6,Mid-Value,Potential Loyalists
34114,1379,1,"14,5",2,1,1,4,Low-Value,Can't Lose
34120,1016,1,"19,15",3,1,1,5,Low-Value,At Risk Customers
34121,816,3,"142,2",3,1,1,5,Low-Value,At Risk Customers
34122,1623,2,"62,099999999999994",1,1,1,3,Low-Value,Lost
34123,77,4,"229,35",5,1,1,7,Mid-Value,Potential Loyalists
34128,960,1,"34,2",3,1,1,5,Low-Value,At Risk Customers
34129,771,2,"50,2",3,1,1,5,Low-Value,At Risk Customers
34130,257,3,"227,6",5,1,1,7,Mid-Value,Potential Loyalists
34131,339,3,"71,1",5,1,1,7,Mid-Value,Potential Loyalists
34132,1702,1,"31,799999999999997",1,1,1,3,Low-Value,Lost
34133,379,3,"206,25",4,1,1,6,Mid-Value,Potential Loyalists
34135,1426,1,"4,35",2,1,1,4,Low-Value,Can't Lose
34136,4,6,"136,65",5,1,1,7,Mid-Value,Potential Loyalists
34137,43,2,"55,4",5,1,1,7,Mid-Value,Potential Loyalists
34138,3,4,"116,44999999999999",5,1,1,7,Mid-Value,Potential Loyalists
34139,182,2,"105,2",5,1,1,7,Mid-Value,Potential Loyalists
34140,493,3,"350,65",4,1,1,6,Mid-Value,Potential Loyalists
34141,228,2,"209,4",5,1,1,7,Mid-Value,Potential Loyalists
34142,19,6,"657,75",5,1,1,7,Mid-Value,Potential Loyalists
34143,542,2,"235,14999999999998",4,1,1,6,Mid-Value,Potential Loyalists
34145,367,4,"486,8",4,1,1,6,Mid-Value,Potential Loyalists
34147,766,6,"207,95",3,1,1,5,Low-Value,At Risk Customers
34148,437,9,"486,6",4,2,1,7,Mid-Value,Potential Loyalists
34149,504,1,"12,85",4,1,1,6,Mid-Value,Potential Loyalists
34151,943,1,"244,0",3,1,1,5,Low-Value,At Risk Customers
34153,774,3,"245,85",3,1,1,5,Low-Value,At Risk Customers
34154,951,2,"28,8",3,1,1,5,Low-Value,At Risk Customers
34155,10,1,"5,5",5,1,1,7,Mid-Value,Potential Loyalists
34157,544,2,"340,35",4,1,1,6,Mid-Value,Potential Loyalists
34159,781,1,"53,6",3,1,1,5,Low-Value,At Risk Customers
34160,778,2,"207,8",3,1,1,5,Low-Value,At Risk Customers
34161,1746,1,"15,9",1,1,1,3,Low-Value,Lost
34163,889,2,"409,5",3,1,1,5,Low-Value,At Risk Customers
34164,165,1,"23,65",5,1,1,7,Mid-Value,Potential Loyalists
34165,1233,4,"221,75",2,1,1,4,Low-Value,Can't Lose
34166,250,2,"113,5",5,1,1,7,Mid-Value,Potential Loyalists
34167,1641,1,"5,6",1,1,1,3,Low-Value,Lost
34169,80,15,"678,75",5,3,2,10,High-Value,Champions
34171,22,3,"81,8",5,1,1,7,Mid-Value,Potential Loyalists
34172,305,3,"272,85",5,1,1,7,Mid-Value,Potential Loyalists
34173,258,7,"158,0",5,2,1,8,High-Value,Potential Loyalists
34174,865,1,"183,3",3,1,1,5,Low-Value,At Risk Customers
34175,200,7,"253,45",5,2,1,8,High-Value,Potential Loyalists
34176,186,8,"668,45",5,2,2,9,High-Value,Champions
34177,902,2,"178,6",3,1,1,5,Low-Value,At Risk Customers
34178,235,7,"390,0",5,2,1,8,High-Value,Potential Loyalists
34179,80,3,"807,4499999999999",5,1,2,8,High-Value,Potential Loyalists
34180,688,3,"432,05",4,1,1,6,Mid-Value,Potential Loyalists
34181,1727,1,"5,6",1,1,1,3,Low-Value,Lost
34183,30,3,"378,70000000000005",5,1,1,7,Mid-Value,Potential Loyalists
34185,428,3,"107,10000000000001",4,1,1,6,Mid-Value,Potential Loyalists
34186,1536,2,"68,05",1,1,1,3,Low-Value,Lost
34187,718,3,"279,3",4,1,1,6,Mid-Value,Potential Loyalists
34190,147,5,"425,3",5,1,1,7,Mid-Value,Potential Loyalists
34191,336,2,"98,5",5,1,1,7,Mid-Value,Potential Loyalists
34192,596,4,"352,4",4,1,1,6,Mid-Value,Potential Loyalists
34193,752,5,"121,6",3,1,1,5,Low-Value,At Risk Customers
34194,379,4,"90,60000000000001",4,1,1,6,Mid-Value,Potential Loyalists
34196,1600,3,"92,45000000000002",1,1,1,3,Low-Value,Lost
34197,123,1,"35,6",5,1,1,7,Mid-Value,Potential Loyalists
34200,195,5,"598,75",5,1,1,7,Mid-Value,Potential Loyalists
34201,31,2,"51,75000000000001",5,1,1,7,Mid-Value,Potential Loyalists
34202,914,2,"114,30000000000001",3,1,1,5,Low-Value,At Risk Customers
34203,1274,1,"52,55",2,1,1,4,Low-Value,Can't Lose
34205,54,2,"199,0",5,1,1,7,Mid-Value,Potential Loyalists
34206,374,4,"146,7",4,1,1,6,Mid-Value,Potential Loyalists
34207,63,3,"95,0",5,1,1,7,Mid-Value,Potential Loyalists
34210,130,9,"282,1",5,2,1,8,High-Value,Potential Loyalists
34211,6,3,"249,0",5,1,1,7,Mid-Value,Potential Loyalists
34214,139,8,"629,0",5,2,1,8,High-Value,Potential Loyalists
34215,1067,3,"202,55",3,1,1,5,Low-Value,At Risk Customers
34216,214,7,"332,90000000000003",5,2,1,8,High-Value,Potential Loyalists
34217,587,2,"62,3",4,1,1,6,Mid-Value,Potential Loyalists
34218,819,4,"183,6",3,1,1,5,Low-Value,At Risk Customers
34219,4,4,"141,15",5,1,1,7,Mid-Value,Potential Loyalists
34220,1653,2,"76,8",1,1,1,3,Low-Value,Lost
34221,109,5,"301,65",5,1,1,7,Mid-Value,Potential Loyalists
34222,122,4,"275,4",5,1,1,7,Mid-Value,Potential Loyalists
34223,461,1,"49,95",4,1,1,6,Mid-Value,Potential Loyalists
34224,769,2,"13,95",3,1,1,5,Low-Value,At Risk Customers
34226,121,5,"252,25",5,1,1,7,Mid-Value,Potential Loyalists
34228,486,3,"123,45",4,1,1,6,Mid-Value,Potential Loyalists
34229,750,4,"198,2",3,1,1,5,Low-Value,At Risk Customers
34231,598,1,"49,55",4,1,1,6,Mid-Value,Potential Loyalists
34233,47,4,"95,6",5,1,1,7,Mid-Value,Potential Loyalists
34234,893,9,"698,9",3,2,2,7,Mid-Value,Potential Loyalists
34235,96,3,"112,65",5,1,1,7,Mid-Value,Potential Loyalists
34236,152,2,"171,3",5,1,1,7,Mid-Value,Potential Loyalists
34237,458,5,"310,84999999999997",4,1,1,6,Mid-Value,Potential Loyalists
34238,1497,2,"140,15",1,1,1,3,Low-Value,Lost
34239,26,15,"459,05",5,3,1,9,High-Value,Champions
34241,1119,1,"26,0",2,1,1,4,Low-Value,Can't Lose
34242,381,3,"611,45",4,1,1,6,Mid-Value,Potential Loyalists
34243,634,1,"67,35",4,1,1,6,Mid-Value,Potential Loyalists
34245,368,6,"510,45000000000005",4,1,1,6,Mid-Value,Potential Loyalists
34247,177,1,"22,7",5,1,1,7,Mid-Value,Potential Loyalists
34248,370,3,"81,0",4,1,1,6,Mid-Value,Potential Loyalists
34249,527,4,"255,55",4,1,1,6,Mid-Value,Potential Loyalists
34252,224,4,"127,6",5,1,1,7,Mid-Value,Potential Loyalists
34254,147,3,"183,05",5,1,1,7,Mid-Value,Potential Loyalists
34255,578,2,"208,45",4,1,1,6,Mid-Value,Potential Loyalists
34256,237,2,"65,05000000000001",5,1,1,7,Mid-Value,Potential Loyalists
34257,129,3,"201,1",5,1,1,7,Mid-Value,Potential Loyalists
34264,185,2,"106,60000000000001",5,1,1,7,Mid-Value,Potential Loyalists
34266,384,4,"331,65000000000003",4,1,1,6,Mid-Value,Potential Loyalists
34267,508,2,"39,8",4,1,1,6,Mid-Value,Potential Loyalists
34270,1424,1,"27,55",2,1,1,4,Low-Value,Can't Lose
34271,412,8,"892,25",4,2,2,8,High-Value,Potential Loyalists
34272,1114,3,"650,8",2,1,1,4,Low-Value,Can't Lose
34273,403,5,"156,65",4,1,1,6,Mid-Value,Potential Loyalists
34275,114,3,"135,4",5,1,1,7,Mid-Value,Potential Loyalists
34278,927,2,"104,3",3,1,1,5,Low-Value,At Risk Customers
34279,302,1,"6,25",5,1,1,7,Mid-Value,Potential Loyalists
34281,1580,1,"7,25",1,1,1,3,Low-Value,Lost
34284,712,5,"89,6",4,1,1,6,Mid-Value,Potential Loyalists
34286,435,1,"24,7",4,1,1,6,Mid-Value,Potential Loyalists
34287,1552,1,"58,6",1,1,1,3,Low-Value,Lost
34288,185,6,"545,25",5,1,1,7,Mid-Value,Potential Loyalists
34289,523,3,"158,9",4,1,1,6,Mid-Value,Potential Loyalists
34290,422,4,"134,9",4,1,1,6,Mid-Value,Potential Loyalists
34292,1782,1,"48,05",1,1,1,3,Low-Value,Lost
34293,913,1,"31,1",3,1,1,5,Low-Value,At Risk Customers
34294,1023,3,"210,4",3,1,1,5,Low-Value,At Risk Customers
34297,1590,1,"80,0",1,1,1,3,Low-Value,Lost
34298,125,4,"392,40000000000003",5,1,1,7,Mid-Value,Potential Loyalists
34300,18,4,"365,05",5,1,1,7,Mid-Value,Potential Loyalists
34301,698,6,"440,95",4,1,1,6,Mid-Value,Potential Loyalists
34302,885,1,"70,35",3,1,1,5,Low-Value,At Risk Customers
34303,216,3,"237,3",5,1,1,7,Mid-Value,Potential Loyalists
34304,864,6,"789,1",3,1,2,6,Mid-Value,Potential Loyalists
34306,876,2,"46,099999999999994",3,1,1,5,Low-Value,At Risk Customers
34309,1179,2,"154,6",2,1,1,4,Low-Value,Can't Lose
34315,876,2,"362,3",3,1,1,5,Low-Value,At Risk Customers
34316,130,4,"231,75",5,1,1,7,Mid-Value,Potential Loyalists
34318,420,5,"529,5",4,1,1,6,Mid-Value,Potential Loyalists
34320,144,5,"299,8",5,1,1,7,Mid-Value,Potential Loyalists
34323,315,2,"496,7",5,1,1,7,Mid-Value,Potential Loyalists
34324,2,3,"105,19999999999999",5,1,1,7,Mid-Value,Potential Loyalists
34327,1106,2,"213,7",2,1,1,4,Low-Value,Can't Lose
34328,83,4,"478,8",5,1,1,7,Mid-Value,Potential Loyalists
34329,1424,1,"12,75",2,1,1,4,Low-Value,Can't Lose
34334,511,4,"173,8",4,1,1,6,Mid-Value,Potential Loyalists
34335,105,2,"33,05",5,1,1,7,Mid-Value,Potential Loyalists
34336,808,3,"237,25",3,1,1,5,Low-Value,At Risk Customers
34338,1200,2,"34,650000000000006",2,1,1,4,Low-Value,Can't Lose
34339,781,3,"129,0",3,1,1,5,Low-Value,At Risk Customers
34340,756,5,"343,79999999999995",3,1,1,5,Low-Value,At Risk Customers
34342,350,4,"239,75",5,1,1,7,Mid-Value,Potential Loyalists
34344,214,1,"5,95",5,1,1,7,Mid-Value,Potential Loyalists
34346,805,2,"52,6",3,1,1,5,Low-Value,At Risk Customers
34348,262,15,"987,4",5,3,2,10,High-Value,Champions
34349,2,3,"137,14999999999998",5,1,1,7,Mid-Value,Potential Loyalists
34350,313,12,"778,4",5,3,2,10,High-Value,Champions
34353,883,4,"411,95",3,1,1,5,Low-Value,At Risk Customers
34354,17,4,"57,3",5,1,1,7,Mid-Value,Potential Loyalists
34357,773,1,"25,25",3,1,1,5,Low-Value,At Risk Customers
34358,1075,1,"11,4",3,1,1,5,Low-Value,At Risk Customers
34360,375,2,"264,15",4,1,1,6,Mid-Value,Potential Loyalists
34361,487,3,"85,64999999999999",4,1,1,6,Mid-Value,Potential Loyalists
34363,69,9,"724,45",5,2,2,9,High-Value,Champions
34364,769,1,"18,7",3,1,1,5,Low-Value,At Risk Customers
34367,761,2,"199,54999999999998",3,1,1,5,Low-Value,At Risk Customers
34368,537,1,"58,6",4,1,1,6,Mid-Value,Potential Loyalists
34370,335,2,"4,15",5,1,1,7,Mid-Value,Potential Loyalists
34371,554,3,"157,4",4,1,1,6,Mid-Value,Potential Loyalists
34372,311,3,"111,89999999999999",5,1,1,7,Mid-Value,Potential Loyalists
34373,4,7,"235,65",5,2,1,8,High-Value,Potential Loyalists
34374,101,2,"33,8",5,1,1,7,Mid-Value,Potential Loyalists
34377,125,6,"333,25",5,1,1,7,Mid-Value,Potential Loyalists
34378,236,7,"375,65",5,2,1,8,High-Value,Potential Loyalists
34381,178,8,"536,95",5,2,1,8,High-Value,Potential Loyalists
34382,49,1,"19,35",5,1,1,7,Mid-Value,Potential Loyalists
34383,756,4,"207,95",3,1,1,5,Low-Value,At Risk Customers
34387,410,2,"24,65",4,1,1,6,Mid-Value,Potential Loyalists
34388,1012,1,"48,45",3,1,1,5,Low-Value,At Risk Customers
34389,88,1,"5,8",5,1,1,7,Mid-Value,Potential Loyalists
34390,106,3,"220,25",5,1,1,7,Mid-Value,Potential Loyalists
34391,1636,3,"72,95",1,1,1,3,Low-Value,Lost
34392,755,2,"48,45",3,1,1,5,Low-Value,At Risk Customers
34393,1413,1,"55,2",2,1,1,4,Low-Value,Can't Lose
34394,195,3,"67,6",5,1,1,7,Mid-Value,Potential Loyalists
34397,746,2,"359,9",3,1,1,5,Low-Value,At Risk Customers
34399,121,8,"218,0",5,2,1,8,High-Value,Potential Loyalists
34400,148,2,"259,55",5,1,1,7,Mid-Value,Potential Loyalists
34401,150,3,"125,7",5,1,1,7,Mid-Value,Potential Loyalists
34403,60,2,"37,1",5,1,1,7,Mid-Value,Potential Loyalists
34404,42,4,"233,70000000000002",5,1,1,7,Mid-Value,Potential Loyalists
34408,334,2,"160,89999999999998",5,1,1,7,Mid-Value,Potential Loyalists
34409,1051,2,"102,75",3,1,1,5,Low-Value,At Risk Customers
34410,26,2,"57,3",5,1,1,7,Mid-Value,Potential Loyalists
34413,827,2,"21,85",3,1,1,5,Low-Value,At Risk Customers
34417,147,3,"525,05",5,1,1,7,Mid-Value,Potential Loyalists
34420,843,2,"282,3",3,1,1,5,Low-Value,At Risk Customers
34422,878,2,"321,04999999999995",3,1,1,5,Low-Value,At Risk Customers
34423,1287,2,"212,04999999999998",2,1,1,4,Low-Value,Can't Lose
34424,955,1,"30,0",3,1,1,5,Low-Value,At Risk Customers
34426,1176,1,"29,7",2,1,1,4,Low-Value,Can't Lose
34427,290,7,"508,0",5,2,1,8,High-Value,Potential Loyalists
34428,69,2,"62,45",5,1,1,7,Mid-Value,Potential Loyalists
34429,11,6,"860,0999999999999",5,1,2,8,High-Value,Potential Loyalists
34430,1293,1,"10,95",2,1,1,4,Low-Value,Can't Lose
34431,886,2,"520,0",3,1,1,5,Low-Value,At Risk Customers
34434,45,7,"170,5",5,2,1,8,High-Value,Potential Loyalists
34435,434,2,"82,3",4,1,1,6,Mid-Value,Potential Loyalists
34437,195,1,"3,6",5,1,1,7,Mid-Value,Potential Loyalists
34438,1023,1,"2,9",3,1,1,5,Low-Value,At Risk Customers
34440,304,3,"56,8",5,1,1,7,Mid-Value,Potential Loyalists
34444,488,4,"549,85",4,1,1,6,Mid-Value,Potential Loyalists
34445,1109,2,"96,55",2,1,1,4,Low-Value,Can't Lose
34446,84,4,"175,5",5,1,1,7,Mid-Value,Potential Loyalists
34447,173,2,"64,60000000000001",5,1,1,7,Mid-Value,Potential Loyalists
34448,4,4,"691,2",5,1,2,8,High-Value,Potential Loyalists
34450,264,10,"1894,3",5,2,3,10,High-Value,Champions
34452,75,5,"287,85",5,1,1,7,Mid-Value,Potential Loyalists
34455,412,2,"53,15",4,1,1,6,Mid-Value,Potential Loyalists
34456,932,1,"100,2",3,1,1,5,Low-Value,At Risk Customers
34457,164,6,"207,45",5,1,1,7,Mid-Value,Potential Loyalists
34458,696,3,"62,349999999999994",4,1,1,6,Mid-Value,Potential Loyalists
34460,197,1,"5,4",5,1,1,7,Mid-Value,Potential Loyalists
34461,164,2,"43,1",5,1,1,7,Mid-Value,Potential Loyalists
34462,608,1,"17,25",4,1,1,6,Mid-Value,Potential Loyalists
34463,603,4,"151,10000000000002",4,1,1,6,Mid-Value,Potential Loyalists
34464,370,4,"235,6",4,1,1,6,Mid-Value,Potential Loyalists
34465,1281,1,"31,45",2,1,1,4,Low-Value,Can't Lose
34466,115,4,"554,45",5,1,1,7,Mid-Value,Potential Loyalists
34467,230,4,"201,3",5,1,1,7,Mid-Value,Potential Loyalists
34468,432,1,"27,7",4,1,1,6,Mid-Value,Potential Loyalists
34469,138,5,"414,45000000000005",5,1,1,7,Mid-Value,Potential Loyalists
34470,609,3,"330,4",4,1,1,6,Mid-Value,Potential Loyalists
34472,1359,1,"44,25",2,1,1,4,Low-Value,Can't Lose
34473,938,3,"469,3",3,1,1,5,Low-Value,At Risk Customers
34474,256,3,"98,4",5,1,1,7,Mid-Value,Potential Loyalists
34475,662,5,"522,15",4,1,1,6,Mid-Value,Potential Loyalists
34477,507,1,"23,0",4,1,1,6,Mid-Value,Potential Loyalists
34478,99,9,"447,59999999999997",5,2,1,8,High-Value,Potential Loyalists
34485,379,2,"93,2",4,1,1,6,Mid-Value,Potential Loyalists
34486,312,1,"11,0",5,1,1,7,Mid-Value,Potential Loyalists
34487,499,3,"262,7",4,1,1,6,Mid-Value,Potential Loyalists
34488,500,3,"185,0",4,1,1,6,Mid-Value,Potential Loyalists
34493,544,4,"369,55",4,1,1,6,Mid-Value,Potential Loyalists
34494,168,5,"237,3",5,1,1,7,Mid-Value,Potential Loyalists
34496,152,1,"101,0",5,1,1,7,Mid-Value,Potential Loyalists
34498,232,4,"402,45",5,1,1,7,Mid-Value,Potential Loyalists
34503,522,5,"153,65",4,1,1,6,Mid-Value,Potential Loyalists
34504,195,8,"346,6",5,2,1,8,High-Value,Potential Loyalists
34505,193,8,"267,95",5,2,1,8,High-Value,Potential Loyalists
34506,1798,1,"15,4",1,1,1,3,Low-Value,Lost
34508,1437,1,"7,5",2,1,1,4,Low-Value,Can't Lose
34510,620,1,"68,69999999999999",4,1,1,6,Mid-Value,Potential Loyalists
34511,332,1,"24,05",5,1,1,7,Mid-Value,Potential Loyalists
34512,15,4,"247,65",5,1,1,7,Mid-Value,Potential Loyalists
34515,3,9,"483,95",5,2,1,8,High-Value,Potential Loyalists
34516,1336,1,"124,5",2,1,1,4,Low-Value,Can't Lose
34517,1131,3,"87,19999999999999",2,1,1,4,Low-Value,Can't Lose
34518,584,1,"18,15",4,1,1,6,Mid-Value,Potential Loyalists
34520,1183,3,"178,54999999999998",2,1,1,4,Low-Value,Can't Lose
34521,249,3,"97,75",5,1,1,7,Mid-Value,Potential Loyalists
34523,239,1,"154,95",5,1,1,7,Mid-Value,Potential Loyalists
34525,944,4,"82,05",3,1,1,5,Low-Value,At Risk Customers
34526,353,7,"361,7",5,2,1,8,High-Value,Potential Loyalists
34528,309,12,"674,05",5,3,2,10,High-Value,Champions
34532,301,1,"14,4",5,1,1,7,Mid-Value,Potential Loyalists
34533,1274,1,"48,2",2,1,1,4,Low-Value,Can't Lose
34535,361,8,"352,85",5,2,1,8,High-Value,Potential Loyalists
34536,158,3,"107,25",5,1,1,7,Mid-Value,Potential Loyalists
34537,544,2,"79,35000000000001",4,1,1,6,Mid-Value,Potential Loyalists
34538,406,2,"114,65",4,1,1,6,Mid-Value,Potential Loyalists
34542,764,5,"494,95",3,1,1,5,Low-Value,At Risk Customers
34544,227,6,"445,70000000000005",5,1,1,7,Mid-Value,Potential Loyalists
34545,25,5,"355,45",5,1,1,7,Mid-Value,Potential Loyalists
34547,165,1,"144,3",5,1,1,7,Mid-Value,Potential Loyalists
34548,42,3,"95,95",5,1,1,7,Mid-Value,Potential Loyalists
34550,743,1,"15,5",3,1,1,5,Low-Value,At Risk Customers
34551,608,4,"525,85",4,1,1,6,Mid-Value,Potential Loyalists
34552,21,2,"237,5",5,1,1,7,Mid-Value,Potential Loyalists
34553,61,11,"665,1500000000001",5,2,2,9,High-Value,Champions
34554,628,2,"157,15",4,1,1,6,Mid-Value,Potential Loyalists
34556,503,2,"20,15",4,1,1,6,Mid-Value,Potential Loyalists
34557,523,1,"56,5",4,1,1,6,Mid-Value,Potential Loyalists
34560,22,10,"1009,1000000000001",5,2,2,9,High-Value,Champions
34561,161,1,"91,5",5,1,1,7,Mid-Value,Potential Loyalists
34562,217,1,"34,9",5,1,1,7,Mid-Value,Potential Loyalists
34563,842,1,"80,6",3,1,1,5,Low-Value,At Risk Customers
34564,83,3,"81,80000000000001",5,1,1,7,Mid-Value,Potential Loyalists
34566,403,6,"639,15",4,1,1,6,Mid-Value,Potential Loyalists
34567,500,5,"381,4",4,1,1,6,Mid-Value,Potential Loyalists
34569,858,3,"268,6",3,1,1,5,Low-Value,At Risk Customers
34570,431,1,"44,25",4,1,1,6,Mid-Value,Potential Loyalists
34572,995,1,"52,8",3,1,1,5,Low-Value,At Risk Customers
34573,197,6,"292,9",5,1,1,7,Mid-Value,Potential Loyalists
34576,430,8,"1055,4",4,2,2,8,High-Value,Potential Loyalists
34577,390,2,"24,799999999999997",4,1,1,6,Mid-Value,Potential Loyalists
34579,101,3,"274,65",5,1,1,7,Mid-Value,Potential Loyalists
34580,642,4,"350,7",4,1,1,6,Mid-Value,Potential Loyalists
34581,235,4,"386,50000000000006",5,1,1,7,Mid-Value,Potential Loyalists
34582,1661,1,"433,95000000000005",1,1,1,3,Low-Value,Lost
34583,892,3,"203,3",3,1,1,5,Low-Value,At Risk Customers
34585,49,4,"286,79999999999995",5,1,1,7,Mid-Value,Potential Loyalists
34587,389,2,"50,8",4,1,1,6,Mid-Value,Potential Loyalists
34588,390,13,"551,3",4,3,1,8,High-Value,Potential Loyalists
34589,734,2,"647,15",3,1,1,5,Low-Value,At Risk Customers
34591,791,3,"118,30000000000001",3,1,1,5,Low-Value,At Risk Customers
34592,1084,1,"52,4",3,1,1,5,Low-Value,At Risk Customers
34593,295,2,"55,65",5,1,1,7,Mid-Value,Potential Loyalists
34595,1147,1,"3,1",2,1,1,4,Low-Value,Can't Lose
34596,879,1,"143,55",3,1,1,5,Low-Value,At Risk Customers
34598,467,2,"154,75",4,1,1,6,Mid-Value,Potential Loyalists
34599,80,6,"283,2",5,1,1,7,Mid-Value,Potential Loyalists
34600,894,2,"62,45",3,1,1,5,Low-Value,At Risk Customers
34601,27,7,"406,09999999999997",5,2,1,8,High-Value,Potential Loyalists
34603,34,4,"332,6",5,1,1,7,Mid-Value,Potential Loyalists
34604,564,3,"137,35000000000002",4,1,1,6,Mid-Value,Potential Loyalists
34605,102,4,"141,75",5,1,1,7,Mid-Value,Potential Loyalists
34607,578,1,"204,6",4,1,1,6,Mid-Value,Potential Loyalists
34608,977,6,"525,8",3,1,1,5,Low-Value,At Risk Customers
34610,414,3,"938,7",4,1,2,7,Mid-Value,Potential Loyalists
34611,5,5,"194,75",5,1,1,7,Mid-Value,Potential Loyalists
34612,162,8,"873,4",5,2,2,9,High-Value,Champions
34613,1489,1,"153,4",1,1,1,3,Low-Value,Lost
34615,1123,6,"915,2",2,1,2,5,Low-Value,At Risk Customers
34616,253,1,"28,7",5,1,1,7,Mid-Value,Potential Loyalists
34619,60,6,"439,2",5,1,1,7,Mid-Value,Potential Loyalists
34620,1057,2,"47,900000000000006",3,1,1,5,Low-Value,At Risk Customers
34621,298,2,"34,75",5,1,1,7,Mid-Value,Potential Loyalists
34622,105,2,"168,95",5,1,1,7,Mid-Value,Potential Loyalists
34624,1305,1,"122,69999999999999",2,1,1,4,Low-Value,Can't Lose
34625,779,3,"345,6",3,1,1,5,Low-Value,At Risk Customers
34626,854,7,"224,89999999999998",3,2,1,6,Mid-Value,Potential Loyalists
34627,526,1,"20,46",4,1,1,6,Mid-Value,Potential Loyalists
34628,1571,2,"71,9",1,1,1,3,Low-Value,Lost
34629,514,1,"33,1",4,1,1,6,Mid-Value,Potential Loyalists
34631,16,4,"421,6",5,1,1,7,Mid-Value,Potential Loyalists
34633,1126,1,"134,1",2,1,1,4,Low-Value,Can't Lose
34634,141,1,"57,1",5,1,1,7,Mid-Value,Potential Loyalists
34636,507,5,"365,65",4,1,1,6,Mid-Value,Potential Loyalists
34638,1075,3,"26,45",3,1,1,5,Low-Value,At Risk Customers
34640,502,2,"135,3",4,1,1,6,Mid-Value,Potential Loyalists
34641,61,2,"154,25",5,1,1,7,Mid-Value,Potential Loyalists
34644,89,4,"295,75",5,1,1,7,Mid-Value,Potential Loyalists
34645,732,3,"184,25",3,1,1,5,Low-Value,At Risk Customers
34646,94,1,"41,8",5,1,1,7,Mid-Value,Potential Loyalists
34647,39,2,"63,55",5,1,1,7,Mid-Value,Potential Loyalists
34648,1221,3,"117,69999999999999",2,1,1,4,Low-Value,Can't Lose
34649,250,5,"399,0",5,1,1,7,Mid-Value,Potential Loyalists
34650,1109,2,"311,6",2,1,1,4,Low-Value,Can't Lose
34651,946,3,"408,8",3,1,1,5,Low-Value,At Risk Customers
34652,10,5,"239,1",5,1,1,7,Mid-Value,Potential Loyalists
34654,25,1,"18,15",5,1,1,7,Mid-Value,Potential Loyalists
34656,340,1,"22,8",5,1,1,7,Mid-Value,Potential Loyalists
34657,138,1,"316,1",5,1,1,7,Mid-Value,Potential Loyalists
34658,19,5,"248,05",5,1,1,7,Mid-Value,Potential Loyalists
34659,363,5,"261,55",5,1,1,7,Mid-Value,Potential Loyalists
34663,8,7,"355,85",5,2,1,8,High-Value,Potential Loyalists
34665,555,3,"296,70000000000005",4,1,1,6,Mid-Value,Potential Loyalists
34668,936,3,"245,04999999999998",3,1,1,5,Low-Value,At Risk Customers
34670,538,4,"352,35",4,1,1,6,Mid-Value,Potential Loyalists
34671,837,1,"75,7",3,1,1,5,Low-Value,At Risk Customers
34672,185,2,"275,95",5,1,1,7,Mid-Value,Potential Loyalists
34674,172,5,"518,5",5,1,1,7,Mid-Value,Potential Loyalists
34675,1272,1,"5,95",2,1,1,4,Low-Value,Can't Lose
34676,277,2,"32,25",5,1,1,7,Mid-Value,Potential Loyalists
34677,864,1,"43,75",3,1,1,5,Low-Value,At Risk Customers
34681,39,5,"93,3",5,1,1,7,Mid-Value,Potential Loyalists
34683,136,2,"512,8",5,1,1,7,Mid-Value,Potential Loyalists
34684,700,1,"17,7",4,1,1,6,Mid-Value,Potential Loyalists
34685,766,3,"202,35000000000002",3,1,1,5,Low-Value,At Risk Customers
34686,62,3,"199,85",5,1,1,7,Mid-Value,Potential Loyalists
34687,449,1,"24,0",4,1,1,6,Mid-Value,Potential Loyalists
34689,573,2,"175,4",4,1,1,6,Mid-Value,Potential Loyalists
34690,122,7,"339,4",5,2,1,8,High-Value,Potential Loyalists
34693,103,3,"110,05",5,1,1,7,Mid-Value,Potential Loyalists
34695,852,1,"15,5",3,1,1,5,Low-Value,At Risk Customers
34697,608,1,"117,2",4,1,1,6,Mid-Value,Potential Loyalists
34698,581,5,"131,7",4,1,1,6,Mid-Value,Potential Loyalists
34701,571,1,"2,55",4,1,1,6,Mid-Value,Potential Loyalists
34702,1801,1,"21,45",1,1,1,3,Low-Value,Lost
34703,585,2,"102,8",4,1,1,6,Mid-Value,Potential Loyalists
34705,966,1,"10,85",3,1,1,5,Low-Value,At Risk Customers
34706,193,8,"457,5",5,2,1,8,High-Value,Potential Loyalists
34707,529,2,"69,85000000000001",4,1,1,6,Mid-Value,Potential Loyalists
34708,596,1,"82,25",4,1,1,6,Mid-Value,Potential Loyalists
34709,1603,1,"38,9",1,1,1,3,Low-Value,Lost
34710,424,4,"92,7",4,1,1,6,Mid-Value,Potential Loyalists
34711,130,7,"732,05",5,2,2,9,High-Value,Champions
34712,505,1,"70,6",4,1,1,6,Mid-Value,Potential Loyalists
34713,1352,2,"176,10000000000002",2,1,1,4,Low-Value,Can't Lose
34716,66,3,"188,6",5,1,1,7,Mid-Value,Potential Loyalists
34717,49,1,"22,9",5,1,1,7,Mid-Value,Potential Loyalists
34718,37,3,"143,25",5,1,1,7,Mid-Value,Potential Loyalists
34719,845,2,"42,5",3,1,1,5,Low-Value,At Risk Customers
34720,435,2,"118,65",4,1,1,6,Mid-Value,Potential Loyalists
34721,694,7,"366,65",4,2,1,7,Mid-Value,Potential Loyalists
34722,75,6,"206,85000000000002",5,1,1,7,Mid-Value,Potential Loyalists
34723,13,18,"1347,6",5,4,3,12,High-Value,Champions
34725,829,1,"15,0",3,1,1,5,Low-Value,At Risk Customers
34726,794,7,"123,3",3,2,1,6,Mid-Value,Potential Loyalists
34730,930,2,"157,15",3,1,1,5,Low-Value,At Risk Customers
34731,59,8,"771,0",5,2,2,9,High-Value,Champions
34732,255,5,"247,1",5,1,1,7,Mid-Value,Potential Loyalists
34733,179,2,"27,3",5,1,1,7,Mid-Value,Potential Loyalists
34734,1415,1,"18,4",2,1,1,4,Low-Value,Can't Lose
34735,213,3,"412,90000000000003",5,1,1,7,Mid-Value,Potential Loyalists
34737,1039,1,"171,6",3,1,1,5,Low-Value,At Risk Customers
34742,12,1,"19,35",5,1,1,7,Mid-Value,Potential Loyalists
34743,791,1,"18,15",3,1,1,5,Low-Value,At Risk Customers
34744,25,10,"454,65",5,2,1,8,High-Value,Potential Loyalists
34746,547,3,"125,64999999999999",4,1,1,6,Mid-Value,Potential Loyalists
34749,755,5,"432,25",3,1,1,5,Low-Value,At Risk Customers
34751,50,2,"624,85",5,1,1,7,Mid-Value,Potential Loyalists
34752,333,3,"131,65",5,1,1,7,Mid-Value,Potential Loyalists
34753,181,5,"267,4",5,1,1,7,Mid-Value,Potential Loyalists
34756,41,7,"275,7",5,2,1,8,High-Value,Potential Loyalists
34758,412,2,"120,1",4,1,1,6,Mid-Value,Potential Loyalists
34760,617,2,"90,95",4,1,1,6,Mid-Value,Potential Loyalists
34764,73,1,"66,5",5,1,1,7,Mid-Value,Potential Loyalists
34765,1315,2,"107,85",2,1,1,4,Low-Value,Can't Lose
34766,1053,3,"73,94999999999999",3,1,1,5,Low-Value,At Risk Customers
34767,340,4,"172,64999999999998",5,1,1,7,Mid-Value,Potential Loyalists
34768,558,1,"48,2",4,1,1,6,Mid-Value,Potential Loyalists
34769,400,9,"548,25",4,2,1,7,Mid-Value,Potential Loyalists
34770,113,1,"35,95",5,1,1,7,Mid-Value,Potential Loyalists
34771,342,1,"26,9",5,1,1,7,Mid-Value,Potential Loyalists
34773,238,4,"355,8",5,1,1,7,Mid-Value,Potential Loyalists
34775,526,8,"526,0",4,2,1,7,Mid-Value,Potential Loyalists
34776,600,2,"108,05",4,1,1,6,Mid-Value,Potential Loyalists
34777,285,2,"20,450000000000003",5,1,1,7,Mid-Value,Potential Loyalists
34778,631,2,"134,0",4,1,1,6,Mid-Value,Potential Loyalists
34780,1686,2,"52,65",1,1,1,3,Low-Value,Lost
34781,612,3,"283,85",4,1,1,6,Mid-Value,Potential Loyalists
34783,181,2,"66,9",5,1,1,7,Mid-Value,Potential Loyalists
34785,1146,2,"121,75",2,1,1,4,Low-Value,Can't Lose
34787,578,1,"416,8",4,1,1,6,Mid-Value,Potential Loyalists
34788,1160,1,"28,85",2,1,1,4,Low-Value,Can't Lose
34789,156,3,"143,75",5,1,1,7,Mid-Value,Potential Loyalists
34790,1207,2,"51,75",2,1,1,4,Low-Value,Can't Lose
34791,440,1,"14,0",4,1,1,6,Mid-Value,Potential Loyalists
34792,222,2,"112,0",5,1,1,7,Mid-Value,Potential Loyalists
34793,286,7,"530,9",5,2,1,8,High-Value,Potential Loyalists
34798,30,8,"642,45",5,2,1,8,High-Value,Potential Loyalists
34801,980,2,"128,6",3,1,1,5,Low-Value,At Risk Customers
34803,760,6,"158,3",3,1,1,5,Low-Value,At Risk Customers
34806,104,8,"601,2",5,2,1,8,High-Value,Potential Loyalists
34807,1124,1,"43,1",2,1,1,4,Low-Value,Can't Lose
34808,42,1,"10,23",5,1,1,7,Mid-Value,Potential Loyalists
34810,225,3,"87,6",5,1,1,7,Mid-Value,Potential Loyalists
34813,740,3,"87,05000000000001",3,1,1,5,Low-Value,At Risk Customers
34815,142,6,"637,05",5,1,1,7,Mid-Value,Potential Loyalists
34816,38,2,"145,2",5,1,1,7,Mid-Value,Potential Loyalists
34817,15,1,"57,3",5,1,1,7,Mid-Value,Potential Loyalists
34819,80,6,"246,8",5,1,1,7,Mid-Value,Potential Loyalists
34820,456,1,"28,9",4,1,1,6,Mid-Value,Potential Loyalists
34821,3,2,"65,3",5,1,1,7,Mid-Value,Potential Loyalists
34824,703,8,"382,5",4,2,1,7,Mid-Value,Potential Loyalists
34825,81,3,"153,25",5,1,1,7,Mid-Value,Potential Loyalists
34826,647,1,"6,1",4,1,1,6,Mid-Value,Potential Loyalists
34828,1223,4,"256,7",2,1,1,4,Low-Value,Can't Lose
34829,34,4,"204,0",5,1,1,7,Mid-Value,Potential Loyalists
34830,602,1,"83,5",4,1,1,6,Mid-Value,Potential Loyalists
34831,12,10,"411,35",5,2,1,8,High-Value,Potential Loyalists
34834,461,8,"1175,0",4,2,2,8,High-Value,Potential Loyalists
34835,579,2,"177,85",4,1,1,6,Mid-Value,Potential Loyalists
34836,1349,1,"29,3",2,1,1,4,Low-Value,Can't Lose
34837,684,1,"37,35",4,1,1,6,Mid-Value,Potential Loyalists
34840,717,3,"31,2",4,1,1,6,Mid-Value,Potential Loyalists
34842,20,4,"272,1",5,1,1,7,Mid-Value,Potential Loyalists
34843,1151,1,"61,5",2,1,1,4,Low-Value,Can't Lose
34844,629,2,"162,4",4,1,1,6,Mid-Value,Potential Loyalists
34845,269,1,"10,65",5,1,1,7,Mid-Value,Potential Loyalists
34847,1511,2,"99,2",1,1,1,3,Low-Value,Lost
34849,389,2,"48,7",4,1,1,6,Mid-Value,Potential Loyalists
34850,885,4,"184,1",3,1,1,5,Low-Value,At Risk Customers
34851,458,1,"34,2",4,1,1,6,Mid-Value,Potential Loyalists
34852,78,10,"927,35",5,2,2,9,High-Value,Champions
34853,179,2,"79,6",5,1,1,7,Mid-Value,Potential Loyalists
34854,142,1,"31,2",5,1,1,7,Mid-Value,Potential Loyalists
34855,496,1,"62,1",4,1,1,6,Mid-Value,Potential Loyalists
34856,269,8,"333,5",5,2,1,8,High-Value,Potential Loyalists
34859,573,3,"199,0",4,1,1,6,Mid-Value,Potential Loyalists
34860,1166,4,"78,55000000000001",2,1,1,4,Low-Value,Can't Lose
34861,1463,1,"53,4",1,1,1,3,Low-Value,Lost
34862,942,2,"36,9",3,1,1,5,Low-Value,At Risk Customers
34863,425,3,"396,45",4,1,1,6,Mid-Value,Potential Loyalists
34866,156,4,"301,35",5,1,1,7,Mid-Value,Potential Loyalists
34867,270,2,"49,3",5,1,1,7,Mid-Value,Potential Loyalists
34868,1093,1,"6,8",3,1,1,5,Low-Value,At Risk Customers
34869,557,6,"475,65",4,1,1,6,Mid-Value,Potential Loyalists
34873,168,10,"713,5",5,2,2,9,High-Value,Champions
34874,1257,1,"111,8",2,1,1,4,Low-Value,Can't Lose
34875,243,4,"153,45",5,1,1,7,Mid-Value,Potential Loyalists
34877,920,2,"125,15",3,1,1,5,Low-Value,At Risk Customers
34878,276,2,"29,65",5,1,1,7,Mid-Value,Potential Loyalists
34880,873,1,"75,7",3,1,1,5,Low-Value,At Risk Customers
34882,1220,1,"83,8",2,1,1,4,Low-Value,Can't Lose
34883,871,3,"53,1",3,1,1,5,Low-Value,At Risk Customers
34884,1170,2,"201,5",2,1,1,4,Low-Value,Can't Lose
34885,385,3,"116,9",4,1,1,6,Mid-Value,Potential Loyalists
34887,804,2,"165,2",3,1,1,5,Low-Value,At Risk Customers
34888,739,3,"346,5",3,1,1,5,Low-Value,At Risk Customers
34891,76,6,"350,8",5,1,1,7,Mid-Value,Potential Loyalists
34892,318,1,"31,4",5,1,1,7,Mid-Value,Potential Loyalists
34894,1537,1,"8,55",1,1,1,3,Low-Value,Lost
34896,293,4,"173,8",5,1,1,7,Mid-Value,Potential Loyalists
34898,951,2,"31,4",3,1,1,5,Low-Value,At Risk Customers
34899,242,3,"498,90000000000003",5,1,1,7,Mid-Value,Potential Loyalists
34901,853,3,"208,1",3,1,1,5,Low-Value,At Risk Customers
34902,359,2,"271,2",5,1,1,7,Mid-Value,Potential Loyalists
34903,773,1,"13,5",3,1,1,5,Low-Value,At Risk Customers
34905,621,4,"223,2",4,1,1,6,Mid-Value,Potential Loyalists
34907,48,13,"1085,7",5,3,2,10,High-Value,Champions
34908,1173,3,"363,0",2,1,1,4,Low-Value,Can't Lose
34909,1262,1,"172,8",2,1,1,4,Low-Value,Can't Lose
34910,1474,1,"106,8",1,1,1,3,Low-Value,Lost
34911,912,2,"181,4",3,1,1,5,Low-Value,At Risk Customers
34913,545,3,"92,1",4,1,1,6,Mid-Value,Potential Loyalists
34914,130,7,"552,4",5,2,1,8,High-Value,Potential Loyalists
34915,1158,3,"211,7",2,1,1,4,Low-Value,Can't Lose
34917,186,5,"1154,85",5,1,2,8,High-Value,Potential Loyalists
34918,386,4,"274,7",4,1,1,6,Mid-Value,Potential Loyalists
34919,1013,3,"137,5",3,1,1,5,Low-Value,At Risk Customers
34920,26,4,"196,35000000000002",5,1,1,7,Mid-Value,Potential Loyalists
34921,1329,1,"77,25",2,1,1,4,Low-Value,Can't Lose
34923,1194,1,"3,0",2,1,1,4,Low-Value,Can't Lose
34928,230,2,"92,1",5,1,1,7,Mid-Value,Potential Loyalists
34929,999,1,"11,6",3,1,1,5,Low-Value,At Risk Customers
34931,83,15,"937,9",5,3,2,10,High-Value,Champions
34932,266,1,"7,7",5,1,1,7,Mid-Value,Potential Loyalists
34933,42,4,"669,75",5,1,2,8,High-Value,Potential Loyalists
34934,423,1,"22,65",4,1,1,6,Mid-Value,Potential Loyalists
34938,727,2,"377,6",4,1,1,6,Mid-Value,Potential Loyalists
34939,770,1,"52,3",3,1,1,5,Low-Value,At Risk Customers
34943,728,4,"782,3999999999999",4,1,2,7,Mid-Value,Potential Loyalists
34944,822,3,"266,7",3,1,1,5,Low-Value,At Risk Customers
34945,458,3,"17,7",4,1,1,6,Mid-Value,Potential Loyalists
34946,894,1,"57,0",3,1,1,5,Low-Value,At Risk Customers
34949,853,1,"350,4",3,1,1,5,Low-Value,At Risk Customers
34950,1436,1,"26,8",2,1,1,4,Low-Value,Can't Lose
34951,733,4,"433,8",3,1,1,5,Low-Value,At Risk Customers
34952,347,2,"96,75",5,1,1,7,Mid-Value,Potential Loyalists
34954,130,7,"424,7",5,2,1,8,High-Value,Potential Loyalists
34955,329,3,"411,2",5,1,1,7,Mid-Value,Potential Loyalists
34956,546,1,"21,9",4,1,1,6,Mid-Value,Potential Loyalists
34958,60,6,"317,85",5,1,1,7,Mid-Value,Potential Loyalists
34959,1733,1,"16,05",1,1,1,3,Low-Value,Lost
34960,1326,4,"183,1",2,1,1,4,Low-Value,Can't Lose
34961,920,1,"40,8",3,1,1,5,Low-Value,At Risk Customers
34962,741,1,"30,35",3,1,1,5,Low-Value,At Risk Customers
34963,54,5,"213,81",5,1,1,7,Mid-Value,Potential Loyalists
34964,251,7,"375,1",5,2,1,8,High-Value,Potential Loyalists
34965,137,3,"81,30000000000001",5,1,1,7,Mid-Value,Potential Loyalists
34969,578,1,"376,95000000000005",4,1,1,6,Mid-Value,Potential Loyalists
34970,644,1,"475,20000000000005",4,1,1,6,Mid-Value,Potential Loyalists
34971,1103,3,"152,25",2,1,1,4,Low-Value,Can't Lose
34972,432,4,"63,35",4,1,1,6,Mid-Value,Potential Loyalists
34974,14,4,"462,90000000000003",5,1,1,7,Mid-Value,Potential Loyalists
34975,173,4,"285,05",5,1,1,7,Mid-Value,Potential Loyalists
34976,521,3,"200,89999999999998",4,1,1,6,Mid-Value,Potential Loyalists
34977,519,5,"372,4",4,1,1,6,Mid-Value,Potential Loyalists
34978,1177,2,"71,35",2,1,1,4,Low-Value,Can't Lose
34980,268,1,"23,25",5,1,1,7,Mid-Value,Potential Loyalists
34982,136,1,"55,6",5,1,1,7,Mid-Value,Potential Loyalists
34983,26,3,"185,64999999999998",5,1,1,7,Mid-Value,Potential Loyalists
34984,23,5,"292,5",5,1,1,7,Mid-Value,Potential Loyalists
34985,3,6,"357,20000000000005",5,1,1,7,Mid-Value,Potential Loyalists
34986,528,2,"461,35",4,1,1,6,Mid-Value,Potential Loyalists
34989,245,7,"372,09999999999997",5,2,1,8,High-Value,Potential Loyalists
34990,455,5,"606,2",4,1,1,6,Mid-Value,Potential Loyalists
34992,1324,3,"213,25",2,1,1,4,Low-Value,Can't Lose
34994,495,3,"70,80000000000001",4,1,1,6,Mid-Value,Potential Loyalists
34995,1050,1,"59,2",3,1,1,5,Low-Value,At Risk Customers
34996,809,2,"30,199999999999996",3,1,1,5,Low-Value,At Risk Customers
34998,753,1,"552,9",3,1,1,5,Low-Value,At Risk Customers
35001,266,1,"80,55000000000001",5,1,1,7,Mid-Value,Potential Loyalists
35002,595,2,"158,9",4,1,1,6,Mid-Value,Potential Loyalists
35003,186,5,"299,9",5,1,1,7,Mid-Value,Potential Loyalists
35004,0,2,"315,95",5,1,1,7,Mid-Value,Potential Loyalists
35005,24,7,"375,9",5,2,1,8,High-Value,Potential Loyalists
35006,413,2,"78,7",4,1,1,6,Mid-Value,Potential Loyalists
35007,1403,2,"136,95",2,1,1,4,Low-Value,Can't Lose
35009,194,4,"570,5999999999999",5,1,1,7,Mid-Value,Potential Loyalists
35010,180,7,"303,85",5,2,1,8,High-Value,Potential Loyalists
35011,929,2,"79,15",3,1,1,5,Low-Value,At Risk Customers
35012,306,4,"146,75",5,1,1,7,Mid-Value,Potential Loyalists
35013,314,7,"319,15",5,2,1,8,High-Value,Potential Loyalists
35014,42,7,"628,85",5,2,1,8,High-Value,Potential Loyalists
35015,524,2,"95,9",4,1,1,6,Mid-Value,Potential Loyalists
35017,82,2,"90,55000000000001",5,1,1,7,Mid-Value,Potential Loyalists
35019,61,6,"247,79999999999998",5,1,1,7,Mid-Value,Potential Loyalists
35020,1686,1,"125,1",1,1,1,3,Low-Value,Lost
35023,4,9,"805,9",5,2,2,9,High-Value,Champions
35024,1123,4,"457,54999999999995",2,1,1,4,Low-Value,Can't Lose
35025,1131,4,"94,0",2,1,1,4,Low-Value,Can't Lose
35029,445,9,"213,45",4,2,1,7,Mid-Value,Potential Loyalists
35030,383,7,"619,7",4,2,1,7,Mid-Value,Potential Loyalists
35031,800,4,"318,0",3,1,1,5,Low-Value,At Risk Customers
35032,98,4,"400,8",5,1,1,7,Mid-Value,Potential Loyalists
35034,116,10,"735,3",5,2,2,9,High-Value,Champions
35035,1140,2,"670,1",2,1,2,5,Low-Value,At Risk Customers
35036,140,3,"35,35",5,1,1,7,Mid-Value,Potential Loyalists
35037,724,2,"322,75",4,1,1,6,Mid-Value,Potential Loyalists
35039,446,1,"10,6",4,1,1,6,Mid-Value,Potential Loyalists
35040,453,5,"127,19999999999999",4,1,1,6,Mid-Value,Potential Loyalists
35042,49,8,"340,65",5,2,1,8,High-Value,Potential Loyalists
35043,588,1,"20,65",4,1,1,6,Mid-Value,Potential Loyalists
35044,1,4,"88,85",5,1,1,7,Mid-Value,Potential Loyalists
35045,372,1,"15,4",4,1,1,6,Mid-Value,Potential Loyalists
35046,1272,1,"58,5",2,1,1,4,Low-Value,Can't Lose
35047,311,2,"33,25",5,1,1,7,Mid-Value,Potential Loyalists
35049,1629,1,"45,5",1,1,1,3,Low-Value,Lost
35050,162,1,"44,9",5,1,1,7,Mid-Value,Potential Loyalists
35051,582,6,"195,05",4,1,1,6,Mid-Value,Potential Loyalists
35052,521,5,"188,55",4,1,1,6,Mid-Value,Potential Loyalists
35053,110,5,"344,9",5,1,1,7,Mid-Value,Potential Loyalists
35054,1504,1,"149,9",1,1,1,3,Low-Value,Lost
35057,136,8,"1048,5",5,2,2,9,High-Value,Champions
35058,539,1,"48,6",4,1,1,6,Mid-Value,Potential Loyalists
35062,1748,1,"22,9",1,1,1,3,Low-Value,Lost
35063,892,3,"969,5",3,1,2,6,Mid-Value,Potential Loyalists
35066,19,9,"362,35",5,2,1,8,High-Value,Potential Loyalists
35068,1073,1,"141,9",3,1,1,5,Low-Value,At Risk Customers
35069,1279,1,"36,900000000000006",2,1,1,4,Low-Value,Can't Lose
35071,52,7,"1082,2",5,2,2,9,High-Value,Champions
35072,166,4,"415,95",5,1,1,7,Mid-Value,Potential Loyalists
35074,215,2,"111,3",5,1,1,7,Mid-Value,Potential Loyalists
35075,826,3,"50,25",3,1,1,5,Low-Value,At Risk Customers
35076,805,5,"244,0",3,1,1,5,Low-Value,At Risk Customers
35077,1680,1,"16,950000000000003",1,1,1,3,Low-Value,Lost
35081,690,1,"10,3",4,1,1,6,Mid-Value,Potential Loyalists
35082,388,1,"70,1",4,1,1,6,Mid-Value,Potential Loyalists
35083,216,4,"143,95",5,1,1,7,Mid-Value,Potential Loyalists
35084,139,4,"387,65",5,1,1,7,Mid-Value,Potential Loyalists
35085,297,10,"740,0500000000001",5,2,2,9,High-Value,Champions
35087,304,1,"10,6",5,1,1,7,Mid-Value,Potential Loyalists
35088,1228,3,"265,75",2,1,1,4,Low-Value,Can't Lose
35091,928,1,"41,0",3,1,1,5,Low-Value,At Risk Customers
35092,228,5,"225,8",5,1,1,7,Mid-Value,Potential Loyalists
35095,407,3,"61,45",4,1,1,6,Mid-Value,Potential Loyalists
35096,936,5,"1048,15",3,1,2,6,Mid-Value,Potential Loyalists
35097,629,5,"273,15",4,1,1,6,Mid-Value,Potential Loyalists
35099,629,6,"101,39999999999999",4,1,1,6,Mid-Value,Potential Loyalists
35100,374,3,"195,6",4,1,1,6,Mid-Value,Potential Loyalists
35101,1265,1,"20,2",2,1,1,4,Low-Value,Can't Lose
35102,710,2,"18,3",4,1,1,6,Mid-Value,Potential Loyalists
35103,979,6,"533,5",3,1,1,5,Low-Value,At Risk Customers
35105,219,4,"130,75",5,1,1,7,Mid-Value,Potential Loyalists
35106,1089,2,"492,05",3,1,1,5,Low-Value,At Risk Customers
35107,526,3,"131,8",4,1,1,6,Mid-Value,Potential Loyalists
35111,766,2,"159,35",3,1,1,5,Low-Value,At Risk Customers
35112,306,2,"43,4",5,1,1,7,Mid-Value,Potential Loyalists
35117,242,3,"197,64999999999998",5,1,1,7,Mid-Value,Potential Loyalists
35118,389,5,"276,55",4,1,1,6,Mid-Value,Potential Loyalists
35120,859,2,"210,3",3,1,1,5,Low-Value,At Risk Customers
35121,1175,2,"189,3",2,1,1,4,Low-Value,Can't Lose
35122,363,2,"118,85000000000001",5,1,1,7,Mid-Value,Potential Loyalists
35125,1158,2,"52,400000000000006",2,1,1,4,Low-Value,Can't Lose
35126,1373,4,"123,3",2,1,1,4,Low-Value,Can't Lose
35127,1051,1,"63,05",3,1,1,5,Low-Value,At Risk Customers
35128,1074,2,"183,0",3,1,1,5,Low-Value,At Risk Customers
35129,890,2,"188,9",3,1,1,5,Low-Value,At Risk Customers
35132,61,4,"142,6",5,1,1,7,Mid-Value,Potential Loyalists
35133,1090,1,"196,7",3,1,1,5,Low-Value,At Risk Customers
35134,700,3,"191,75",4,1,1,6,Mid-Value,Potential Loyalists
35136,381,7,"310,5",4,2,1,7,Mid-Value,Potential Loyalists
35137,750,1,"338,54999999999995",3,1,1,5,Low-Value,At Risk Customers
35139,21,7,"459,75",5,2,1,8,High-Value,Potential Loyalists
35141,172,3,"163,95",5,1,1,7,Mid-Value,Potential Loyalists
35142,202,8,"882,2",5,2,2,9,High-Value,Champions
35143,843,5,"160,45",3,1,1,5,Low-Value,At Risk Customers
35144,81,4,"127,29999999999998",5,1,1,7,Mid-Value,Potential Loyalists
35145,365,3,"134,55",5,1,1,7,Mid-Value,Potential Loyalists
35148,1446,1,"42,0",2,1,1,4,Low-Value,Can't Lose
35150,302,1,"1,25",5,1,1,7,Mid-Value,Potential Loyalists
35151,56,7,"386,7",5,2,1,8,High-Value,Potential Loyalists
35155,214,7,"145,45000000000002",5,2,1,8,High-Value,Potential Loyalists
35156,221,2,"67,5",5,1,1,7,Mid-Value,Potential Loyalists
35160,11,4,"955,8499999999999",5,1,2,8,High-Value,Potential Loyalists
35161,200,6,"620,75",5,1,1,7,Mid-Value,Potential Loyalists
35162,1127,1,"9,65",2,1,1,4,Low-Value,Can't Lose
35165,743,3,"104,45",3,1,1,5,Low-Value,At Risk Customers
35166,116,7,"494,70000000000005",5,2,1,8,High-Value,Potential Loyalists
35168,76,3,"50,400000000000006",5,1,1,7,Mid-Value,Potential Loyalists
35169,1434,2,"120,44999999999999",2,1,1,4,Low-Value,Can't Lose
35172,618,1,"14,8",4,1,1,6,Mid-Value,Potential Loyalists
35173,144,6,"966,2",5,1,2,8,High-Value,Potential Loyalists
35174,186,7,"286,75",5,2,1,8,High-Value,Potential Loyalists
35178,617,1,"32,9",4,1,1,6,Mid-Value,Potential Loyalists
35179,496,3,"381,92999999999995",4,1,1,6,Mid-Value,Potential Loyalists
35180,283,3,"318,3",5,1,1,7,Mid-Value,Potential Loyalists
35182,398,6,"485,75",4,1,1,6,Mid-Value,Potential Loyalists
35183,36,4,"133,2",5,1,1,7,Mid-Value,Potential Loyalists
35184,606,2,"116,4",4,1,1,6,Mid-Value,Potential Loyalists
35185,12,3,"313,8",5,1,1,7,Mid-Value,Potential Loyalists
35186,1650,1,"33,4",1,1,1,3,Low-Value,Lost
35188,435,5,"397,15",4,1,1,6,Mid-Value,Potential Loyalists
35189,1163,2,"107,6",2,1,1,4,Low-Value,Can't Lose
35190,999,1,"109,4",3,1,1,5,Low-Value,At Risk Customers
35191,601,10,"405,25",4,2,1,7,Mid-Value,Potential Loyalists
35192,280,3,"55,8",5,1,1,7,Mid-Value,Potential Loyalists
35194,807,2,"91,30000000000001",3,1,1,5,Low-Value,At Risk Customers
35196,1734,1,"151,55",1,1,1,3,Low-Value,Lost
35198,1407,1,"35,35",2,1,1,4,Low-Value,Can't Lose
35199,769,3,"155,20000000000002",3,1,1,5,Low-Value,At Risk Customers
35201,999,1,"17,05",3,1,1,5,Low-Value,At Risk Customers
35204,265,3,"397,34999999999997",5,1,1,7,Mid-Value,Potential Loyalists
35205,602,6,"317,95",4,1,1,6,Mid-Value,Potential Loyalists
35207,69,8,"470,9",5,2,1,8,High-Value,Potential Loyalists
35208,137,4,"236,95",5,1,1,7,Mid-Value,Potential Loyalists
35210,1626,1,"201,3",1,1,1,3,Low-Value,Lost
35211,228,2,"86,8",5,1,1,7,Mid-Value,Potential Loyalists
35212,254,2,"72,15",5,1,1,7,Mid-Value,Potential Loyalists
35213,453,4,"61,400000000000006",4,1,1,6,Mid-Value,Potential Loyalists
35214,38,7,"435,95",5,2,1,8,High-Value,Potential Loyalists
35215,25,5,"326,7",5,1,1,7,Mid-Value,Potential Loyalists
35218,18,4,"104,7",5,1,1,7,Mid-Value,Potential Loyalists
35219,351,6,"549,9",5,1,1,7,Mid-Value,Potential Loyalists
35220,945,2,"176,75",3,1,1,5,Low-Value,At Risk Customers
35221,601,1,"8,9",4,1,1,6,Mid-Value,Potential Loyalists
35223,453,5,"516,3000000000001",4,1,1,6,Mid-Value,Potential Loyalists
35224,147,3,"141,5",5,1,1,7,Mid-Value,Potential Loyalists
35225,123,4,"482,8",5,1,1,7,Mid-Value,Potential Loyalists
35226,1453,1,"23,6",2,1,1,4,Low-Value,Can't Lose
35227,1106,1,"91,5",2,1,1,4,Low-Value,Can't Lose
35228,18,6,"1862,5",5,1,3,9,High-Value,Champions
35229,61,3,"58,9",5,1,1,7,Mid-Value,Potential Loyalists
35233,214,1,"35,55",5,1,1,7,Mid-Value,Potential Loyalists
35235,699,5,"315,0",4,1,1,6,Mid-Value,Potential Loyalists
35237,500,2,"347,85",4,1,1,6,Mid-Value,Potential Loyalists
35238,1619,1,"34,05",1,1,1,3,Low-Value,Lost
35239,7,7,"254,79999999999998",5,2,1,8,High-Value,Potential Loyalists
35240,152,3,"317,25",5,1,1,7,Mid-Value,Potential Loyalists
35242,351,1,"476,6",5,1,1,7,Mid-Value,Potential Loyalists
35243,563,1,"118,8",4,1,1,6,Mid-Value,Potential Loyalists
35244,441,3,"106,94999999999999",4,1,1,6,Mid-Value,Potential Loyalists
35245,20,3,"124,44999999999999",5,1,1,7,Mid-Value,Potential Loyalists
35246,482,1,"58,9",4,1,1,6,Mid-Value,Potential Loyalists
35247,31,4,"262,3",5,1,1,7,Mid-Value,Potential Loyalists
35248,56,4,"201,8",5,1,1,7,Mid-Value,Potential Loyalists
35249,523,2,"30,2",4,1,1,6,Mid-Value,Potential Loyalists
35250,822,4,"403,85",3,1,1,5,Low-Value,At Risk Customers
35251,269,8,"179,05",5,2,1,8,High-Value,Potential Loyalists
35252,76,3,"104,3",5,1,1,7,Mid-Value,Potential Loyalists
35253,1463,1,"173,2",1,1,1,3,Low-Value,Lost
35257,375,4,"130,85000000000002",4,1,1,6,Mid-Value,Potential Loyalists
35258,95,5,"489,35",5,1,1,7,Mid-Value,Potential Loyalists
35259,28,3,"176,75",5,1,1,7,Mid-Value,Potential Loyalists
35262,1236,1,"92,0",2,1,1,4,Low-Value,Can't Lose
35263,14,7,"1051,8500000000001",5,2,2,9,High-Value,Champions
35264,818,2,"17,6",3,1,1,5,Low-Value,At Risk Customers
35265,1326,1,"53,099999999999994",2,1,1,4,Low-Value,Can't Lose
35266,1538,3,"76,2",1,1,1,3,Low-Value,Lost
35267,192,4,"124,65",5,1,1,7,Mid-Value,Potential Loyalists
35269,965,3,"716,4",3,1,2,6,Mid-Value,Potential Loyalists
35270,81,3,"187,6",5,1,1,7,Mid-Value,Potential Loyalists
35271,877,2,"74,1",3,1,1,5,Low-Value,At Risk Customers
35272,1063,1,"2,95",3,1,1,5,Low-Value,At Risk Customers
35274,183,2,"47,150000000000006",5,1,1,7,Mid-Value,Potential Loyalists
35275,86,3,"137,3",5,1,1,7,Mid-Value,Potential Loyalists
35276,213,2,"116,15",5,1,1,7,Mid-Value,Potential Loyalists
35277,1287,1,"17,85",2,1,1,4,Low-Value,Can't Lose
35278,1106,2,"66,15",2,1,1,4,Low-Value,Can't Lose
35279,476,4,"73,75",4,1,1,6,Mid-Value,Potential Loyalists
35281,286,3,"147,35",5,1,1,7,Mid-Value,Potential Loyalists
35282,634,5,"485,25",4,1,1,6,Mid-Value,Potential Loyalists
35283,164,4,"138,85",5,1,1,7,Mid-Value,Potential Loyalists
35285,101,8,"721,45",5,2,2,9,High-Value,Champions
35286,171,5,"227,95",5,1,1,7,Mid-Value,Potential Loyalists
35288,395,4,"392,8",4,1,1,6,Mid-Value,Potential Loyalists
35289,810,1,"42,45",3,1,1,5,Low-Value,At Risk Customers
35290,791,1,"14,15",3,1,1,5,Low-Value,At Risk Customers
35291,165,6,"333,95",5,1,1,7,Mid-Value,Potential Loyalists
35292,155,5,"251,14999999999998",5,1,1,7,Mid-Value,Potential Loyalists
35293,910,1,"18,2",3,1,1,5,Low-Value,At Risk Customers
35295,133,4,"465,55",5,1,1,7,Mid-Value,Potential Loyalists
35296,11,1,"255,45000000000002",5,1,1,7,Mid-Value,Potential Loyalists
35297,1016,1,"135,4",3,1,1,5,Low-Value,At Risk Customers
35298,1484,1,"179,6",1,1,1,3,Low-Value,Lost
35299,547,1,"36,7",4,1,1,6,Mid-Value,Potential Loyalists
35303,293,2,"62,65",5,1,1,7,Mid-Value,Potential Loyalists
35304,967,1,"405,0",3,1,1,5,Low-Value,At Risk Customers
35305,190,3,"133,6",5,1,1,7,Mid-Value,Potential Loyalists
35307,525,6,"154,7",4,1,1,6,Mid-Value,Potential Loyalists
35308,232,2,"71,9",5,1,1,7,Mid-Value,Potential Loyalists
35310,840,2,"321,85",3,1,1,5,Low-Value,At Risk Customers
35311,1799,1,"2,95",1,1,1,3,Low-Value,Lost
35312,89,2,"104,25",5,1,1,7,Mid-Value,Potential Loyalists
35313,48,6,"773,15",5,1,2,8,High-Value,Potential Loyalists
35314,784,7,"354,25",3,2,1,6,Mid-Value,Potential Loyalists
35316,901,2,"109,7",3,1,1,5,Low-Value,At Risk Customers
35317,163,7,"468,55",5,2,1,8,High-Value,Potential Loyalists
35318,17,2,"82,44999999999999",5,1,1,7,Mid-Value,Potential Loyalists
35319,500,3,"124,85",4,1,1,6,Mid-Value,Potential Loyalists
35321,25,5,"386,85",5,1,1,7,Mid-Value,Potential Loyalists
35322,774,2,"139,5",3,1,1,5,Low-Value,At Risk Customers
35323,409,3,"64,45",4,1,1,6,Mid-Value,Potential Loyalists
35326,837,1,"31,9",3,1,1,5,Low-Value,At Risk Customers
35327,248,7,"593,9499999999999",5,2,1,8,High-Value,Potential Loyalists
35329,1597,1,"55,5",1,1,1,3,Low-Value,Lost
35331,166,6,"1121,4",5,1,2,8,High-Value,Potential Loyalists
35332,67,7,"549,4",5,2,1,8,High-Value,Potential Loyalists
35333,439,1,"1,0",4,1,1,6,Mid-Value,Potential Loyalists
35334,832,8,"245,05",3,2,1,6,Mid-Value,Potential Loyalists
35335,732,5,"318,6",3,1,1,5,Low-Value,At Risk Customers
35336,283,3,"105,35000000000001",5,1,1,7,Mid-Value,Potential Loyalists
35337,29,8,"828,9499999999999",5,2,2,9,High-Value,Champions
35338,103,2,"61,75",5,1,1,7,Mid-Value,Potential Loyalists
35339,220,2,"404,1",5,1,1,7,Mid-Value,Potential Loyalists
35340,410,2,"69,15",4,1,1,6,Mid-Value,Potential Loyalists
35343,762,1,"50,55",3,1,1,5,Low-Value,At Risk Customers
35344,564,3,"438,1",4,1,1,6,Mid-Value,Potential Loyalists
35345,1526,3,"231,7",1,1,1,3,Low-Value,Lost
35346,432,3,"223,35000000000002",4,1,1,6,Mid-Value,Potential Loyalists
35347,1785,1,"17,7",1,1,1,3,Low-Value,Lost
35348,820,1,"14,35",3,1,1,5,Low-Value,At Risk Customers
35349,84,2,"241,45",5,1,1,7,Mid-Value,Potential Loyalists
35353,305,2,"54,85",5,1,1,7,Mid-Value,Potential Loyalists
35354,1629,2,"174,3",1,1,1,3,Low-Value,Lost
35355,370,1,"24,2",4,1,1,6,Mid-Value,Potential Loyalists
35357,413,6,"273,6",4,1,1,6,Mid-Value,Potential Loyalists
35358,214,5,"163,54999999999998",5,1,1,7,Mid-Value,Potential Loyalists
35360,4,4,"199,95",5,1,1,7,Mid-Value,Potential Loyalists
35362,10,1,"85,4",5,1,1,7,Mid-Value,Potential Loyalists
35363,447,4,"315,05",4,1,1,6,Mid-Value,Potential Loyalists
35365,123,3,"45,349999999999994",5,1,1,7,Mid-Value,Potential Loyalists
35366,227,5,"215,55",5,1,1,7,Mid-Value,Potential Loyalists
35367,679,3,"77,85",4,1,1,6,Mid-Value,Potential Loyalists
35368,403,3,"168,04999999999998",4,1,1,6,Mid-Value,Potential Loyalists
35369,1575,1,"60,1",1,1,1,3,Low-Value,Lost
35370,1158,1,"13,5",2,1,1,4,Low-Value,Can't Lose
35371,903,1,"7,25",3,1,1,5,Low-Value,At Risk Customers
35372,594,3,"271,70000000000005",4,1,1,6,Mid-Value,Potential Loyalists
35373,789,1,"37,8",3,1,1,5,Low-Value,At Risk Customers
35376,1476,1,"156,2",1,1,1,3,Low-Value,Lost
35377,794,4,"561,2",3,1,1,5,Low-Value,At Risk Customers
35379,40,6,"425,05",5,1,1,7,Mid-Value,Potential Loyalists
35380,106,3,"69,95",5,1,1,7,Mid-Value,Potential Loyalists
35381,242,5,"297,55",5,1,1,7,Mid-Value,Potential Loyalists
35382,734,3,"268,4",3,1,1,5,Low-Value,At Risk Customers
35384,812,1,"9,3",3,1,1,5,Low-Value,At Risk Customers
35385,927,3,"485,7",3,1,1,5,Low-Value,At Risk Customers
35387,111,4,"337,8",5,1,1,7,Mid-Value,Potential Loyalists
35388,314,6,"244,05",5,1,1,7,Mid-Value,Potential Loyalists
35390,970,1,"35,400000000000006",3,1,1,5,Low-Value,At Risk Customers
35393,536,1,"83,5",4,1,1,6,Mid-Value,Potential Loyalists
35394,866,1,"81,4",3,1,1,5,Low-Value,At Risk Customers
35397,239,1,"30,95",5,1,1,7,Mid-Value,Potential Loyalists
35398,182,5,"225,74999999999997",5,1,1,7,Mid-Value,Potential Loyalists
35401,845,1,"182,55",3,1,1,5,Low-Value,At Risk Customers
35402,150,1,"110,4",5,1,1,7,Mid-Value,Potential Loyalists
35403,107,7,"704,2",5,2,2,9,High-Value,Champions
35404,949,5,"310,9",3,1,1,5,Low-Value,At Risk Customers
35405,193,1,"70,9",5,1,1,7,Mid-Value,Potential Loyalists
35406,367,7,"466,8",4,2,1,7,Mid-Value,Potential Loyalists
35411,241,9,"393,85",5,2,1,8,High-Value,Potential Loyalists
35413,126,6,"1121,05",5,1,2,8,High-Value,Potential Loyalists
35415,77,1,"20,2",5,1,1,7,Mid-Value,Potential Loyalists
35416,350,8,"237,75",5,2,1,8,High-Value,Potential Loyalists
35417,247,4,"191,0",5,1,1,7,Mid-Value,Potential Loyalists
35418,27,7,"324,7",5,2,1,8,High-Value,Potential Loyalists
35419,1358,2,"93,15",2,1,1,4,Low-Value,Can't Lose
35420,14,3,"130,85",5,1,1,7,Mid-Value,Potential Loyalists
35421,71,2,"66,25",5,1,1,7,Mid-Value,Potential Loyalists
35423,26,3,"270,45",5,1,1,7,Mid-Value,Potential Loyalists
35424,631,5,"204,0",4,1,1,6,Mid-Value,Potential Loyalists
35426,117,1,"26,55",5,1,1,7,Mid-Value,Potential Loyalists
35427,1789,1,"43,9",1,1,1,3,Low-Value,Lost
35429,87,3,"216,89999999999998",5,1,1,7,Mid-Value,Potential Loyalists
35432,1157,9,"464,7",2,2,1,5,Low-Value,At Risk Customers
35434,689,5,"477,84999999999997",4,1,1,6,Mid-Value,Potential Loyalists
35435,100,5,"151,75",5,1,1,7,Mid-Value,Potential Loyalists
35436,802,3,"184,7",3,1,1,5,Low-Value,At Risk Customers
35437,334,5,"286,75",5,1,1,7,Mid-Value,Potential Loyalists
35438,32,3,"127,5",5,1,1,7,Mid-Value,Potential Loyalists
35441,619,4,"66,15",4,1,1,6,Mid-Value,Potential Loyalists
35443,516,4,"579,1",4,1,1,6,Mid-Value,Potential Loyalists
35445,855,2,"57,3",3,1,1,5,Low-Value,At Risk Customers
35446,42,8,"331,79999999999995",5,2,1,8,High-Value,Potential Loyalists
35447,1818,1,"53,4",1,1,1,3,Low-Value,Lost
35448,810,6,"455,3",3,1,1,5,Low-Value,At Risk Customers
35450,403,5,"412,8",4,1,1,6,Mid-Value,Potential Loyalists
35451,150,5,"286,45",5,1,1,7,Mid-Value,Potential Loyalists
35452,164,1,"17,549999999999997",5,1,1,7,Mid-Value,Potential Loyalists
35457,1343,1,"63,8",2,1,1,4,Low-Value,Can't Lose
35459,114,5,"472,1",5,1,1,7,Mid-Value,Potential Loyalists
35460,1024,5,"203,5",3,1,1,5,Low-Value,At Risk Customers
35462,1734,1,"51,0",1,1,1,3,Low-Value,Lost
35463,26,4,"186,39999999999998",5,1,1,7,Mid-Value,Potential Loyalists
35464,1312,1,"61,949999999999996",2,1,1,4,Low-Value,Can't Lose
35465,753,1,"41,4",3,1,1,5,Low-Value,At Risk Customers
35466,52,9,"231,05",5,2,1,8,High-Value,Potential Loyalists
35468,570,4,"644,3",4,1,1,6,Mid-Value,Potential Loyalists
35469,725,2,"261,59999999999997",4,1,1,6,Mid-Value,Potential Loyalists
35470,1706,1,"82,75",1,1,1,3,Low-Value,Lost
35471,1011,2,"50,199999999999996",3,1,1,5,Low-Value,At Risk Customers
35473,71,8,"822,9499999999999",5,2,2,9,High-Value,Champions
35474,45,1,"13,25",5,1,1,7,Mid-Value,Potential Loyalists
35476,234,3,"369,65",5,1,1,7,Mid-Value,Potential Loyalists
35477,1496,1,"91,5",1,1,1,3,Low-Value,Lost
35479,167,3,"151,35",5,1,1,7,Mid-Value,Potential Loyalists
35482,789,6,"398,05",3,1,1,5,Low-Value,At Risk Customers
35484,1536,4,"348,95",1,1,1,3,Low-Value,Lost
35485,5,7,"240,15",5,2,1,8,High-Value,Potential Loyalists
35486,791,4,"128,05",3,1,1,5,Low-Value,At Risk Customers
35487,208,1,"238,3",5,1,1,7,Mid-Value,Potential Loyalists
35488,878,3,"55,05",3,1,1,5,Low-Value,At Risk Customers
35489,378,2,"87,85000000000001",4,1,1,6,Mid-Value,Potential Loyalists
35490,304,2,"73,5",5,1,1,7,Mid-Value,Potential Loyalists
35491,1521,1,"72,75",1,1,1,3,Low-Value,Lost
35492,180,12,"980,25",5,3,2,10,High-Value,Champions
35495,122,3,"406,29999999999995",5,1,1,7,Mid-Value,Potential Loyalists
35496,956,1,"7,0",3,1,1,5,Low-Value,At Risk Customers
35500,395,3,"1108,8",4,1,2,7,Mid-Value,Potential Loyalists
35501,220,5,"213,05",5,1,1,7,Mid-Value,Potential Loyalists
35503,740,7,"346,0",3,2,1,6,Mid-Value,Potential Loyalists
35504,437,6,"423,85",4,1,1,6,Mid-Value,Potential Loyalists
35506,235,8,"674,1",5,2,2,9,High-Value,Champions
35507,896,2,"109,25",3,1,1,5,Low-Value,At Risk Customers
35509,602,6,"388,54999999999995",4,1,1,6,Mid-Value,Potential Loyalists
35510,661,2,"61,75",4,1,1,6,Mid-Value,Potential Loyalists
35511,222,4,"187,4",5,1,1,7,Mid-Value,Potential Loyalists
35512,552,3,"191,7",4,1,1,6,Mid-Value,Potential Loyalists
35513,8,1,"3,45",5,1,1,7,Mid-Value,Potential Loyalists
35514,102,4,"299,65",5,1,1,7,Mid-Value,Potential Loyalists
35515,470,3,"120,54999999999998",4,1,1,6,Mid-Value,Potential Loyalists
35516,1195,4,"182,75",2,1,1,4,Low-Value,Can't Lose
35517,404,2,"82,05",4,1,1,6,Mid-Value,Potential Loyalists
35518,678,4,"70,6",4,1,1,6,Mid-Value,Potential Loyalists
35519,60,6,"278,9",5,1,1,7,Mid-Value,Potential Loyalists
35523,7,6,"646,15",5,1,1,7,Mid-Value,Potential Loyalists
35525,49,2,"30,45",5,1,1,7,Mid-Value,Potential Loyalists
35526,787,1,"47,2",3,1,1,5,Low-Value,At Risk Customers
35527,1197,2,"138,95",2,1,1,4,Low-Value,Can't Lose
35529,634,1,"41,8",4,1,1,6,Mid-Value,Potential Loyalists
35530,1240,1,"164,5",2,1,1,4,Low-Value,Can't Lose
35532,47,1,"114,2",5,1,1,7,Mid-Value,Potential Loyalists
35533,956,1,"153,4",3,1,1,5,Low-Value,At Risk Customers
35534,573,1,"20,6",4,1,1,6,Mid-Value,Potential Loyalists
35535,469,1,"36,85",4,1,1,6,Mid-Value,Potential Loyalists
35536,388,5,"551,8",4,1,1,6,Mid-Value,Potential Loyalists
35537,52,5,"378,8",5,1,1,7,Mid-Value,Potential Loyalists
35538,1131,2,"31,75",2,1,1,4,Low-Value,Can't Lose
35540,577,1,"119,85000000000001",4,1,1,6,Mid-Value,Potential Loyalists
35542,587,5,"297,65",4,1,1,6,Mid-Value,Potential Loyalists
35546,24,3,"141,0",5,1,1,7,Mid-Value,Potential Loyalists
35547,14,4,"366,05",5,1,1,7,Mid-Value,Potential Loyalists
35548,1052,1,"42,8",3,1,1,5,Low-Value,At Risk Customers
35549,479,2,"123,55",4,1,1,6,Mid-Value,Potential Loyalists
35550,138,4,"113,9",5,1,1,7,Mid-Value,Potential Loyalists
35552,1739,1,"40,65",1,1,1,3,Low-Value,Lost
35553,88,1,"10,55",5,1,1,7,Mid-Value,Potential Loyalists
35555,1050,1,"13,15",3,1,1,5,Low-Value,At Risk Customers
35557,67,2,"55,9",5,1,1,7,Mid-Value,Potential Loyalists
35559,830,3,"92,5",3,1,1,5,Low-Value,At Risk Customers
35560,911,1,"59,9",3,1,1,5,Low-Value,At Risk Customers
35564,24,5,"383,65",5,1,1,7,Mid-Value,Potential Loyalists
35565,893,1,"87,7",3,1,1,5,Low-Value,At Risk Customers
35566,77,7,"945,75",5,2,2,9,High-Value,Champions
35567,1449,1,"247,7",2,1,1,4,Low-Value,Can't Lose
35569,1738,2,"88,6",1,1,1,3,Low-Value,Lost
35572,315,1,"30,8",5,1,1,7,Mid-Value,Potential Loyalists
35573,1025,3,"130,0",3,1,1,5,Low-Value,At Risk Customers
35574,756,5,"186,5",3,1,1,5,Low-Value,At Risk Customers
35578,555,3,"203,4",4,1,1,6,Mid-Value,Potential Loyalists
35582,128,2,"82,85",5,1,1,7,Mid-Value,Potential Loyalists
35583,149,2,"139,35",5,1,1,7,Mid-Value,Potential Loyalists
35584,65,5,"144,85",5,1,1,7,Mid-Value,Potential Loyalists
35586,113,8,"686,75",5,2,2,9,High-Value,Champions
35587,348,1,"170,7",5,1,1,7,Mid-Value,Potential Loyalists
35589,54,2,"135,1",5,1,1,7,Mid-Value,Potential Loyalists
35590,845,5,"431,75",3,1,1,5,Low-Value,At Risk Customers
35593,871,2,"120,0",3,1,1,5,Low-Value,At Risk Customers
35595,54,9,"416,85",5,2,1,8,High-Value,Potential Loyalists
35596,723,3,"495,9",4,1,1,6,Mid-Value,Potential Loyalists
35597,85,4,"252,7",5,1,1,7,Mid-Value,Potential Loyalists
35598,24,4,"262,5",5,1,1,7,Mid-Value,Potential Loyalists
35599,325,7,"745,0",5,2,2,9,High-Value,Champions
35600,778,5,"308,05",3,1,1,5,Low-Value,At Risk Customers
35601,92,3,"164,4",5,1,1,7,Mid-Value,Potential Loyalists
35602,353,5,"318,0",5,1,1,7,Mid-Value,Potential Loyalists
35605,47,7,"343,2",5,2,1,8,High-Value,Potential Loyalists
35606,432,2,"64,45",4,1,1,6,Mid-Value,Potential Loyalists
35608,332,5,"439,45",5,1,1,7,Mid-Value,Potential Loyalists
35610,158,4,"447,05",5,1,1,7,Mid-Value,Potential Loyalists
35612,250,4,"411,0",5,1,1,7,Mid-Value,Potential Loyalists
35614,414,3,"93,05000000000001",4,1,1,6,Mid-Value,Potential Loyalists
35616,378,2,"108,80000000000001",4,1,1,6,Mid-Value,Potential Loyalists
35618,375,1,"69,7",4,1,1,6,Mid-Value,Potential Loyalists
35619,251,3,"195,8",5,1,1,7,Mid-Value,Potential Loyalists
35620,1272,2,"52,8",2,1,1,4,Low-Value,Can't Lose
35622,938,3,"131,5",3,1,1,5,Low-Value,At Risk Customers
35624,386,6,"508,25",4,1,1,6,Mid-Value,Potential Loyalists
35626,34,9,"599,8",5,2,1,8,High-Value,Potential Loyalists
35627,193,2,"78,69999999999999",5,1,1,7,Mid-Value,Potential Loyalists
35629,1233,1,"117,8",2,1,1,4,Low-Value,Can't Lose
35630,74,4,"517,25",5,1,1,7,Mid-Value,Potential Loyalists
35631,993,2,"85,55",3,1,1,5,Low-Value,At Risk Customers
35632,1376,1,"12,1",2,1,1,4,Low-Value,Can't Lose
35633,122,8,"458,1",5,2,1,8,High-Value,Potential Loyalists
35634,3,5,"321,45",5,1,1,7,Mid-Value,Potential Loyalists
35636,591,2,"64,6",4,1,1,6,Mid-Value,Potential Loyalists
35639,229,4,"569,25",5,1,1,7,Mid-Value,Potential Loyalists
35640,115,2,"132,7",5,1,1,7,Mid-Value,Potential Loyalists
35641,56,3,"106,15",5,1,1,7,Mid-Value,Potential Loyalists
35642,710,2,"74,85",4,1,1,6,Mid-Value,Potential Loyalists
35643,699,3,"49,3",4,1,1,6,Mid-Value,Potential Loyalists
35645,353,3,"137,3",5,1,1,7,Mid-Value,Potential Loyalists
35647,31,7,"222,85",5,2,1,8,High-Value,Potential Loyalists
35648,1029,4,"681,2",3,1,2,6,Mid-Value,Potential Loyalists
35650,431,3,"202,75000000000003",4,1,1,6,Mid-Value,Potential Loyalists
35652,17,4,"425,25",5,1,1,7,Mid-Value,Potential Loyalists
35653,256,5,"269,35",5,1,1,7,Mid-Value,Potential Loyalists
35654,206,3,"265,5",5,1,1,7,Mid-Value,Potential Loyalists
35655,55,5,"648,7",5,1,1,7,Mid-Value,Potential Loyalists
35656,798,1,"23,65",3,1,1,5,Low-Value,At Risk Customers
35657,857,4,"405,0",3,1,1,5,Low-Value,At Risk Customers
35658,305,6,"427,95",5,1,1,7,Mid-Value,Potential Loyalists
35659,146,1,"4,4",5,1,1,7,Mid-Value,Potential Loyalists
35660,87,3,"124,35",5,1,1,7,Mid-Value,Potential Loyalists
35661,251,2,"60,5",5,1,1,7,Mid-Value,Potential Loyalists
35662,255,7,"591,55",5,2,1,8,High-Value,Potential Loyalists
35664,968,2,"155,85000000000002",3,1,1,5,Low-Value,At Risk Customers
35665,12,12,"674,5",5,3,2,10,High-Value,Champions
35668,475,2,"81,44999999999999",4,1,1,6,Mid-Value,Potential Loyalists
35675,377,4,"105,2",4,1,1,6,Mid-Value,Potential Loyalists
35676,29,9,"403,45000000000005",5,2,1,8,High-Value,Potential Loyalists
35678,415,7,"341,3",4,2,1,7,Mid-Value,Potential Loyalists
35679,1434,1,"35,4",2,1,1,4,Low-Value,Can't Lose
35680,1325,4,"146,6",2,1,1,4,Low-Value,Can't Lose
35682,323,9,"309,9",5,2,1,8,High-Value,Potential Loyalists
35683,891,2,"158,2",3,1,1,5,Low-Value,At Risk Customers
35685,412,6,"987,0500000000001",4,1,2,7,Mid-Value,Potential Loyalists
35687,39,3,"116,0",5,1,1,7,Mid-Value,Potential Loyalists
35690,564,2,"199,95",4,1,1,6,Mid-Value,Potential Loyalists
35691,199,1,"238,3",5,1,1,7,Mid-Value,Potential Loyalists
35692,25,1,"35,2",5,1,1,7,Mid-Value,Potential Loyalists
35693,1765,1,"78,15",1,1,1,3,Low-Value,Lost
35694,237,3,"463,45",5,1,1,7,Mid-Value,Potential Loyalists
35695,362,5,"171,15",5,1,1,7,Mid-Value,Potential Loyalists
35696,295,3,"395,29999999999995",5,1,1,7,Mid-Value,Potential Loyalists
35700,1124,2,"53,45",2,1,1,4,Low-Value,Can't Lose
35701,134,3,"440,65000000000003",5,1,1,7,Mid-Value,Potential Loyalists
35702,24,9,"527,75",5,2,1,8,High-Value,Potential Loyalists
35705,199,4,"225,95000000000002",5,1,1,7,Mid-Value,Potential Loyalists
35706,10,9,"887,1500000000001",5,2,2,9,High-Value,Champions
35707,325,2,"20,549999999999997",5,1,1,7,Mid-Value,Potential Loyalists
35708,53,14,"1205,0",5,3,2,10,High-Value,Champions
35710,15,5,"248,7",5,1,1,7,Mid-Value,Potential Loyalists
35712,1089,1,"292,4",3,1,1,5,Low-Value,At Risk Customers
35713,110,4,"417,0",5,1,1,7,Mid-Value,Potential Loyalists
35714,1077,1,"245,8",3,1,1,5,Low-Value,At Risk Customers
35715,360,4,"351,95",5,1,1,7,Mid-Value,Potential Loyalists
35716,582,3,"41,65",4,1,1,6,Mid-Value,Potential Loyalists
35717,21,5,"267,25",5,1,1,7,Mid-Value,Potential Loyalists
35719,210,4,"344,15",5,1,1,7,Mid-Value,Potential Loyalists
35721,394,4,"256,70000000000005",4,1,1,6,Mid-Value,Potential Loyalists
35722,165,3,"189,7",5,1,1,7,Mid-Value,Potential Loyalists
35723,399,5,"390,20000000000005",4,1,1,6,Mid-Value,Potential Loyalists
35727,309,3,"392,25",5,1,1,7,Mid-Value,Potential Loyalists
35728,1,1,"17,25",5,1,1,7,Mid-Value,Potential Loyalists
35729,287,1,"69,25",5,1,1,7,Mid-Value,Potential Loyalists
35730,1229,4,"355,1",2,1,1,4,Low-Value,Can't Lose
35731,80,7,"357,2",5,2,1,8,High-Value,Potential Loyalists
35733,1152,5,"316,29999999999995",2,1,1,4,Low-Value,Can't Lose
35735,145,5,"845,4",5,1,2,8,High-Value,Potential Loyalists
35736,985,1,"18,9",3,1,1,5,Low-Value,At Risk Customers
35741,157,3,"74,95",5,1,1,7,Mid-Value,Potential Loyalists
35746,434,3,"1016,55",4,1,2,7,Mid-Value,Potential Loyalists
35747,84,8,"328,1",5,2,1,8,High-Value,Potential Loyalists
35749,536,5,"244,89999999999998",4,1,1,6,Mid-Value,Potential Loyalists
35750,1241,2,"162,1",2,1,1,4,Low-Value,Can't Lose
35752,566,4,"230,2",4,1,1,6,Mid-Value,Potential Loyalists
35753,1665,1,"7,0",1,1,1,3,Low-Value,Lost
35754,146,12,"556,1",5,3,1,9,High-Value,Champions
35756,1311,1,"24,4",2,1,1,4,Low-Value,Can't Lose
35757,560,4,"110,35",4,1,1,6,Mid-Value,Potential Loyalists
35758,242,2,"268,05",5,1,1,7,Mid-Value,Potential Loyalists
35759,577,2,"25,35",4,1,1,6,Mid-Value,Potential Loyalists
35762,120,2,"226,64999999999998",5,1,1,7,Mid-Value,Potential Loyalists
35765,658,2,"116,6",4,1,1,6,Mid-Value,Potential Loyalists
35767,804,4,"156,10000000000002",3,1,1,5,Low-Value,At Risk Customers
35768,1154,2,"36,5",2,1,1,4,Low-Value,Can't Lose
35769,503,2,"121,05000000000001",4,1,1,6,Mid-Value,Potential Loyalists
35772,208,9,"661,8",5,2,1,8,High-Value,Potential Loyalists
35774,1,4,"107,55",5,1,1,7,Mid-Value,Potential Loyalists
35780,863,3,"645,7",3,1,1,5,Low-Value,At Risk Customers
35783,561,3,"276,5",4,1,1,6,Mid-Value,Potential Loyalists
35784,1155,2,"131,0",2,1,1,4,Low-Value,Can't Lose
35785,889,5,"296,85",3,1,1,5,Low-Value,At Risk Customers
35786,737,1,"72,6",3,1,1,5,Low-Value,At Risk Customers
35787,486,3,"160,45",4,1,1,6,Mid-Value,Potential Loyalists
35788,180,2,"119,60000000000001",5,1,1,7,Mid-Value,Potential Loyalists
35791,325,5,"52,35",5,1,1,7,Mid-Value,Potential Loyalists
35793,104,8,"740,25",5,2,2,9,High-Value,Champions
35795,1672,1,"30,25",1,1,1,3,Low-Value,Lost
35796,710,1,"43,15",4,1,1,6,Mid-Value,Potential Loyalists
35797,237,3,"48,6",5,1,1,7,Mid-Value,Potential Loyalists
35799,199,6,"544,05",5,1,1,7,Mid-Value,Potential Loyalists
35801,37,2,"70,35",5,1,1,7,Mid-Value,Potential Loyalists
35802,1171,1,"2,9",2,1,1,4,Low-Value,Can't Lose
35804,300,3,"69,44999999999999",5,1,1,7,Mid-Value,Potential Loyalists
35805,305,12,"1382,5",5,3,3,11,High-Value,Champions
35806,160,3,"178,35",5,1,1,7,Mid-Value,Potential Loyalists
35808,774,3,"107,9",3,1,1,5,Low-Value,At Risk Customers
35809,657,1,"30,5",4,1,1,6,Mid-Value,Potential Loyalists
35810,1341,1,"43,45",2,1,1,4,Low-Value,Can't Lose
35811,157,3,"215,25",5,1,1,7,Mid-Value,Potential Loyalists
35812,21,5,"113,35",5,1,1,7,Mid-Value,Potential Loyalists
35813,553,4,"171,65",4,1,1,6,Mid-Value,Potential Loyalists
35814,747,2,"398,1",3,1,1,5,Low-Value,At Risk Customers
35815,912,1,"51,2",3,1,1,5,Low-Value,At Risk Customers
35816,838,3,"52,849999999999994",3,1,1,5,Low-Value,At Risk Customers
35817,1344,1,"48,8",2,1,1,4,Low-Value,Can't Lose
35818,866,4,"284,1",3,1,1,5,Low-Value,At Risk Customers
35820,1233,2,"113,5",2,1,1,4,Low-Value,Can't Lose
35821,433,6,"161,4",4,1,1,6,Mid-Value,Potential Loyalists
35822,345,3,"70,15",5,1,1,7,Mid-Value,Potential Loyalists
35823,1144,2,"71,1",2,1,1,4,Low-Value,Can't Lose
35824,619,1,"2,2",4,1,1,6,Mid-Value,Potential Loyalists
35825,448,2,"40,3",4,1,1,6,Mid-Value,Potential Loyalists
35827,278,6,"162,7",5,1,1,7,Mid-Value,Potential Loyalists
35828,1692,2,"61,9",1,1,1,3,Low-Value,Lost
35829,1049,1,"14,5",3,1,1,5,Low-Value,At Risk Customers
35831,257,1,"43,55",5,1,1,7,Mid-Value,Potential Loyalists
35832,26,9,"405,1",5,2,1,8,High-Value,Potential Loyalists
35833,33,5,"202,45",5,1,1,7,Mid-Value,Potential Loyalists
35834,271,3,"186,15000000000003",5,1,1,7,Mid-Value,Potential Loyalists
35835,1515,2,"550,7",1,1,1,3,Low-Value,Lost
35838,439,10,"469,6",4,2,1,7,Mid-Value,Potential Loyalists
35841,361,6,"313,3",5,1,1,7,Mid-Value,Potential Loyalists
35843,1485,1,"547,5",1,1,1,3,Low-Value,Lost
35844,593,5,"695,35",4,1,2,7,Mid-Value,Potential Loyalists
35845,1155,1,"15,4",2,1,1,4,Low-Value,Can't Lose
35847,853,1,"23,9",3,1,1,5,Low-Value,At Risk Customers
35848,1359,3,"187,14999999999998",2,1,1,4,Low-Value,Can't Lose
35849,49,8,"453,05",5,2,1,8,High-Value,Potential Loyalists
35850,1270,2,"17,75",2,1,1,4,Low-Value,Can't Lose
35852,775,2,"62,75",3,1,1,5,Low-Value,At Risk Customers
35853,216,6,"446,2",5,1,1,7,Mid-Value,Potential Loyalists
35855,263,9,"471,3",5,2,1,8,High-Value,Potential Loyalists
35856,88,1,"122,0",5,1,1,7,Mid-Value,Potential Loyalists
35857,1057,1,"27,2",3,1,1,5,Low-Value,At Risk Customers
35859,956,2,"92,10000000000001",3,1,1,5,Low-Value,At Risk Customers
35860,1650,1,"16,35",1,1,1,3,Low-Value,Lost
35862,562,6,"152,5",4,1,1,6,Mid-Value,Potential Loyalists
35864,563,1,"210,75",4,1,1,6,Mid-Value,Potential Loyalists
35865,36,2,"22,6",5,1,1,7,Mid-Value,Potential Loyalists
35870,416,10,"442,7",4,2,1,7,Mid-Value,Potential Loyalists
35871,577,1,"31,2",4,1,1,6,Mid-Value,Potential Loyalists
35872,116,3,"166,79999999999998",5,1,1,7,Mid-Value,Potential Loyalists
35873,645,3,"42,25",4,1,1,6,Mid-Value,Potential Loyalists
35874,797,4,"83,05",3,1,1,5,Low-Value,At Risk Customers
35875,750,1,"31,3",3,1,1,5,Low-Value,At Risk Customers
35876,323,7,"285,7",5,2,1,8,High-Value,Potential Loyalists
35877,193,10,"450,6",5,2,1,8,High-Value,Potential Loyalists
35879,430,2,"76,05",4,1,1,6,Mid-Value,Potential Loyalists
35880,353,4,"482,0",5,1,1,7,Mid-Value,Potential Loyalists
35881,36,6,"323,75",5,1,1,7,Mid-Value,Potential Loyalists
35882,936,4,"244,5",3,1,1,5,Low-Value,At Risk Customers
35883,1314,2,"67,45",2,1,1,4,Low-Value,Can't Lose
35886,20,5,"299,6",5,1,1,7,Mid-Value,Potential Loyalists
35890,770,3,"394,35",3,1,1,5,Low-Value,At Risk Customers
35893,1798,1,"4,9",1,1,1,3,Low-Value,Lost
35894,1466,1,"14,8",1,1,1,3,Low-Value,Lost
35898,1308,1,"5,7",2,1,1,4,Low-Value,Can't Lose
35900,335,1,"71,6",5,1,1,7,Mid-Value,Potential Loyalists
35901,422,4,"285,8",4,1,1,6,Mid-Value,Potential Loyalists
35902,7,8,"201,45",5,2,1,8,High-Value,Potential Loyalists
35903,23,3,"262,45",5,1,1,7,Mid-Value,Potential Loyalists
35904,1256,1,"36,1",2,1,1,4,Low-Value,Can't Lose
35905,339,8,"527,2",5,2,1,8,High-Value,Potential Loyalists
35906,700,5,"173,45000000000002",4,1,1,6,Mid-Value,Potential Loyalists
35908,1401,1,"13,2",2,1,1,4,Low-Value,Can't Lose
35909,941,1,"22,6",3,1,1,5,Low-Value,At Risk Customers
35910,34,1,"86,1",5,1,1,7,Mid-Value,Potential Loyalists
35911,147,1,"322,4",5,1,1,7,Mid-Value,Potential Loyalists
35913,167,5,"278,35",5,1,1,7,Mid-Value,Potential Loyalists
35914,403,6,"250,89999999999998",4,1,1,6,Mid-Value,Potential Loyalists
35915,781,5,"163,45000000000002",3,1,1,5,Low-Value,At Risk Customers
35917,488,9,"401,4",4,2,1,7,Mid-Value,Potential Loyalists
35918,1744,1,"57,05",1,1,1,3,Low-Value,Lost
35921,374,6,"329,55",4,1,1,6,Mid-Value,Potential Loyalists
35922,571,2,"56,699999999999996",4,1,1,6,Mid-Value,Potential Loyalists
35923,855,2,"99,80000000000001",3,1,1,5,Low-Value,At Risk Customers
35924,1303,3,"575,5999999999999",2,1,1,4,Low-Value,Can't Lose
35925,673,1,"24,1",4,1,1,6,Mid-Value,Potential Loyalists
35926,1317,1,"38,1",2,1,1,4,Low-Value,Can't Lose
35927,79,10,"535,0",5,2,1,8,High-Value,Potential Loyalists
35928,707,1,"26,7",4,1,1,6,Mid-Value,Potential Loyalists
35930,40,4,"416,25",5,1,1,7,Mid-Value,Potential Loyalists
35932,1100,4,"265,25",2,1,1,4,Low-Value,Can't Lose
35935,85,3,"76,95",5,1,1,7,Mid-Value,Potential Loyalists
35939,1348,1,"19,35",2,1,1,4,Low-Value,Can't Lose
35940,392,7,"821,1",4,2,2,8,High-Value,Potential Loyalists
35942,222,1,"44,400000000000006",5,1,1,7,Mid-Value,Potential Loyalists
35943,7,9,"252,2",5,2,1,8,High-Value,Potential Loyalists
35944,10,9,"735,1999999999999",5,2,2,9,High-Value,Champions
35946,1222,1,"39,4",2,1,1,4,Low-Value,Can't Lose
35948,41,1,"45,6",5,1,1,7,Mid-Value,Potential Loyalists
35950,535,4,"591,45",4,1,1,6,Mid-Value,Potential Loyalists
35951,126,5,"104,45",5,1,1,7,Mid-Value,Potential Loyalists
35953,560,2,"145,3",4,1,1,6,Mid-Value,Potential Loyalists
35957,697,4,"466,55",4,1,1,6,Mid-Value,Potential Loyalists
35961,974,1,"19,35",3,1,1,5,Low-Value,At Risk Customers
35962,876,2,"57,0",3,1,1,5,Low-Value,At Risk Customers
35963,578,9,"766,75",4,2,2,8,High-Value,Potential Loyalists
35964,378,4,"230,15",4,1,1,6,Mid-Value,Potential Loyalists
35965,158,4,"199,25",5,1,1,7,Mid-Value,Potential Loyalists
35966,748,3,"301,15",3,1,1,5,Low-Value,At Risk Customers
35967,433,5,"329,9",4,1,1,6,Mid-Value,Potential Loyalists
35968,1084,1,"135,6",3,1,1,5,Low-Value,At Risk Customers
35969,235,4,"132,25",5,1,1,7,Mid-Value,Potential Loyalists
35970,534,2,"267,4",4,1,1,6,Mid-Value,Potential Loyalists
35971,82,1,"13,6",5,1,1,7,Mid-Value,Potential Loyalists
35974,437,5,"164,45",4,1,1,6,Mid-Value,Potential Loyalists
35976,945,2,"213,4",3,1,1,5,Low-Value,At Risk Customers
35979,848,1,"38,3",3,1,1,5,Low-Value,At Risk Customers
35980,1154,1,"11,8",2,1,1,4,Low-Value,Can't Lose
35981,384,6,"894,8",4,1,2,7,Mid-Value,Potential Loyalists
35983,90,4,"207,5",5,1,1,7,Mid-Value,Potential Loyalists
35986,622,3,"168,95",4,1,1,6,Mid-Value,Potential Loyalists
35988,894,1,"5,95",3,1,1,5,Low-Value,At Risk Customers
35989,81,3,"242,6",5,1,1,7,Mid-Value,Potential Loyalists
35990,458,7,"425,6",4,2,1,7,Mid-Value,Potential Loyalists
35991,140,1,"164,7",5,1,1,7,Mid-Value,Potential Loyalists
35993,83,6,"216,0",5,1,1,7,Mid-Value,Potential Loyalists
35994,1226,3,"259,5",2,1,1,4,Low-Value,Can't Lose
35995,295,8,"373,45",5,2,1,8,High-Value,Potential Loyalists
35999,6,5,"667,85",5,1,2,8,High-Value,Potential Loyalists
36000,87,3,"74,10000000000001",5,1,1,7,Mid-Value,Potential Loyalists
36002,1336,2,"207,8",2,1,1,4,Low-Value,Can't Lose
36003,57,8,"512,8",5,2,1,8,High-Value,Potential Loyalists
36004,1207,3,"106,35000000000001",2,1,1,4,Low-Value,Can't Lose
36006,383,2,"159,14999999999998",4,1,1,6,Mid-Value,Potential Loyalists
36011,629,2,"45,45",4,1,1,6,Mid-Value,Potential Loyalists
36013,474,6,"175,15",4,1,1,6,Mid-Value,Potential Loyalists
36014,641,3,"173,05",4,1,1,6,Mid-Value,Potential Loyalists
36015,220,2,"117,3",5,1,1,7,Mid-Value,Potential Loyalists
36017,113,5,"440,9",5,1,1,7,Mid-Value,Potential Loyalists
36018,3,4,"488,0",5,1,1,7,Mid-Value,Potential Loyalists
36019,1352,1,"513,2",2,1,1,4,Low-Value,Can't Lose
36021,400,7,"498,2",4,2,1,7,Mid-Value,Potential Loyalists
36022,485,2,"108,19999999999999",4,1,1,6,Mid-Value,Potential Loyalists
36024,1085,1,"36,8",3,1,1,5,Low-Value,At Risk Customers
36025,519,2,"215,75",4,1,1,6,Mid-Value,Potential Loyalists
36029,55,4,"189,1",5,1,1,7,Mid-Value,Potential Loyalists
36030,337,1,"26,6",5,1,1,7,Mid-Value,Potential Loyalists
36032,186,6,"155,6",5,1,1,7,Mid-Value,Potential Loyalists
36033,99,2,"105,55",5,1,1,7,Mid-Value,Potential Loyalists
36037,378,6,"1117,0",4,1,2,7,Mid-Value,Potential Loyalists
36038,1129,1,"53,7",2,1,1,4,Low-Value,Can't Lose
36039,108,5,"403,9",5,1,1,7,Mid-Value,Potential Loyalists
36041,503,3,"61,75000000000001",4,1,1,6,Mid-Value,Potential Loyalists
36042,67,5,"320,7",5,1,1,7,Mid-Value,Potential Loyalists
36044,122,5,"203,05",5,1,1,7,Mid-Value,Potential Loyalists
36045,240,5,"1060,15",5,1,2,8,High-Value,Potential Loyalists
36047,193,2,"140,85000000000002",5,1,1,7,Mid-Value,Potential Loyalists
36050,111,12,"624,0",5,3,1,9,High-Value,Champions
36052,778,2,"59,2",3,1,1,5,Low-Value,At Risk Customers
36053,1607,1,"41,8",1,1,1,3,Low-Value,Lost
36054,102,9,"714,25",5,2,2,9,High-Value,Champions
36057,528,1,"496,2",4,1,1,6,Mid-Value,Potential Loyalists
36059,61,8,"275,95",5,2,1,8,High-Value,Potential Loyalists
36060,206,3,"106,89999999999999",5,1,1,7,Mid-Value,Potential Loyalists
36061,38,10,"545,3",5,2,1,8,High-Value,Potential Loyalists
36063,1349,1,"28,55",2,1,1,4,Low-Value,Can't Lose
36068,328,5,"192,75",5,1,1,7,Mid-Value,Potential Loyalists
36072,14,5,"604,65",5,1,1,7,Mid-Value,Potential Loyalists
36073,910,2,"54,2",3,1,1,5,Low-Value,At Risk Customers
36074,224,1,"65,1",5,1,1,7,Mid-Value,Potential Loyalists
36076,117,2,"49,050000000000004",5,1,1,7,Mid-Value,Potential Loyalists
36077,1228,5,"274,04999999999995",2,1,1,4,Low-Value,Can't Lose
36078,379,8,"368,05",4,2,1,7,Mid-Value,Potential Loyalists
36079,416,3,"142,2",4,1,1,6,Mid-Value,Potential Loyalists
36081,1679,2,"62,8",1,1,1,3,Low-Value,Lost
36082,60,4,"97,95",5,1,1,7,Mid-Value,Potential Loyalists
36084,414,1,"39,0",4,1,1,6,Mid-Value,Potential Loyalists
36085,955,2,"145,45",3,1,1,5,Low-Value,At Risk Customers
36086,466,5,"294,8",4,1,1,6,Mid-Value,Potential Loyalists
36087,797,7,"284,6",3,2,1,6,Mid-Value,Potential Loyalists
36090,659,2,"41,510000000000005",4,1,1,6,Mid-Value,Potential Loyalists
36091,164,4,"289,40000000000003",5,1,1,7,Mid-Value,Potential Loyalists
36093,57,12,"938,1",5,3,2,10,High-Value,Champions
36094,559,1,"118,4",4,1,1,6,Mid-Value,Potential Loyalists
36096,195,7,"279,95",5,2,1,8,High-Value,Potential Loyalists
36097,1309,1,"47,25",2,1,1,4,Low-Value,Can't Lose
36098,45,4,"235,79999999999998",5,1,1,7,Mid-Value,Potential Loyalists
36102,1,3,"454,9",5,1,1,7,Mid-Value,Potential Loyalists
36103,1479,1,"57,5",1,1,1,3,Low-Value,Lost
36104,1495,6,"202,35",1,1,1,3,Low-Value,Lost
36105,522,6,"278,35",4,1,1,6,Mid-Value,Potential Loyalists
36108,1123,4,"338,95000000000005",2,1,1,4,Low-Value,Can't Lose
36110,183,1,"88,5",5,1,1,7,Mid-Value,Potential Loyalists
36111,13,1,"16,8",5,1,1,7,Mid-Value,Potential Loyalists
36112,888,3,"45,3",3,1,1,5,Low-Value,At Risk Customers
36113,453,2,"60,0",4,1,1,6,Mid-Value,Potential Loyalists
36114,618,3,"65,35",4,1,1,6,Mid-Value,Potential Loyalists
36115,1667,1,"75,6",1,1,1,3,Low-Value,Lost
36116,731,15,"898,7",3,3,2,8,High-Value,Potential Loyalists
36117,1149,1,"63,2",2,1,1,4,Low-Value,Can't Lose
36118,89,5,"200,6",5,1,1,7,Mid-Value,Potential Loyalists
36119,628,3,"26,3",4,1,1,6,Mid-Value,Potential Loyalists
36122,385,7,"778,3000000000001",4,2,2,8,High-Value,Potential Loyalists
36123,1672,2,"82,1",1,1,1,3,Low-Value,Lost
36124,306,4,"293,6",5,1,1,7,Mid-Value,Potential Loyalists
36126,28,5,"526,5",5,1,1,7,Mid-Value,Potential Loyalists
36127,95,1,"31,05",5,1,1,7,Mid-Value,Potential Loyalists
36128,895,1,"95,5",3,1,1,5,Low-Value,At Risk Customers
36129,126,3,"106,6",5,1,1,7,Mid-Value,Potential Loyalists
36131,410,3,"141,95",4,1,1,6,Mid-Value,Potential Loyalists
36132,542,5,"517,9",4,1,1,6,Mid-Value,Potential Loyalists
36133,113,6,"232,35",5,1,1,7,Mid-Value,Potential Loyalists
36135,165,2,"68,69999999999999",5,1,1,7,Mid-Value,Potential Loyalists
36138,64,2,"511,90000000000003",5,1,1,7,Mid-Value,Potential Loyalists
36139,1229,2,"118,3",2,1,1,4,Low-Value,Can't Lose
36140,203,2,"80,55000000000001",5,1,1,7,Mid-Value,Potential Loyalists
36141,381,2,"108,1",4,1,1,6,Mid-Value,Potential Loyalists
36143,496,2,"72,3",4,1,1,6,Mid-Value,Potential Loyalists
36144,62,7,"681,5",5,2,2,9,High-Value,Champions
36146,860,1,"302,25",3,1,1,5,Low-Value,At Risk Customers
36147,1390,1,"3,3",2,1,1,4,Low-Value,Can't Lose
36148,1665,1,"19,4",1,1,1,3,Low-Value,Lost
36149,886,2,"136,95",3,1,1,5,Low-Value,At Risk Customers
36151,368,5,"883,7",4,1,2,7,Mid-Value,Potential Loyalists
36152,1152,4,"182,60000000000002",2,1,1,4,Low-Value,Can't Lose
36153,337,1,"75,7",5,1,1,7,Mid-Value,Potential Loyalists
36154,1337,1,"108,0",2,1,1,4,Low-Value,Can't Lose
36155,1361,1,"6,1",2,1,1,4,Low-Value,Can't Lose
36156,668,2,"147,25",4,1,1,6,Mid-Value,Potential Loyalists
36157,822,2,"154,0",3,1,1,5,Low-Value,At Risk Customers
36158,39,3,"117,85",5,1,1,7,Mid-Value,Potential Loyalists
36160,708,1,"33,35",4,1,1,6,Mid-Value,Potential Loyalists
36162,533,3,"141,25",4,1,1,6,Mid-Value,Potential Loyalists
36163,504,2,"362,65",4,1,1,6,Mid-Value,Potential Loyalists
36165,517,2,"74,2",4,1,1,6,Mid-Value,Potential Loyalists
36167,136,6,"287,5",5,1,1,7,Mid-Value,Potential Loyalists
36168,562,4,"236,0",4,1,1,6,Mid-Value,Potential Loyalists
36169,1284,1,"215,85000000000002",2,1,1,4,Low-Value,Can't Lose
36171,472,7,"286,65",4,2,1,7,Mid-Value,Potential Loyalists
36172,14,5,"163,2",5,1,1,7,Mid-Value,Potential Loyalists
36173,481,5,"226,70000000000002",4,1,1,6,Mid-Value,Potential Loyalists
36174,1066,2,"243,60000000000002",3,1,1,5,Low-Value,At Risk Customers
36175,668,3,"269,55",4,1,1,6,Mid-Value,Potential Loyalists
36176,463,4,"97,6",4,1,1,6,Mid-Value,Potential Loyalists
36178,687,1,"69,8",4,1,1,6,Mid-Value,Potential Loyalists
36180,837,4,"81,1",3,1,1,5,Low-Value,At Risk Customers
36181,382,2,"110,65",4,1,1,6,Mid-Value,Potential Loyalists
36182,1507,2,"52,8",1,1,1,3,Low-Value,Lost
36183,488,9,"825,2",4,2,2,8,High-Value,Potential Loyalists
36184,635,1,"32,25",4,1,1,6,Mid-Value,Potential Loyalists
36185,1611,1,"44,5",1,1,1,3,Low-Value,Lost
36187,97,3,"90,55",5,1,1,7,Mid-Value,Potential Loyalists
36189,28,5,"166,6",5,1,1,7,Mid-Value,Potential Loyalists
36190,1747,2,"179,4",1,1,1,3,Low-Value,Lost
36191,91,5,"266,40000000000003",5,1,1,7,Mid-Value,Potential Loyalists
36192,691,1,"22,5",4,1,1,6,Mid-Value,Potential Loyalists
36193,105,4,"468,75",5,1,1,7,Mid-Value,Potential Loyalists
36194,887,2,"85,0",3,1,1,5,Low-Value,At Risk Customers
36196,796,1,"10,45",3,1,1,5,Low-Value,At Risk Customers
36199,1224,1,"37,349999999999994",2,1,1,4,Low-Value,Can't Lose
36200,1642,2,"204,6",1,1,1,3,Low-Value,Lost
36202,478,1,"118,1",4,1,1,6,Mid-Value,Potential Loyalists
36203,479,2,"192,45",4,1,1,6,Mid-Value,Potential Loyalists
36205,37,2,"110,55",5,1,1,7,Mid-Value,Potential Loyalists
36206,378,12,"891,8000000000001",4,3,2,9,High-Value,Champions
36208,173,5,"420,45000000000005",5,1,1,7,Mid-Value,Potential Loyalists
36211,430,2,"40,3",4,1,1,6,Mid-Value,Potential Loyalists
36213,29,3,"240,9",5,1,1,7,Mid-Value,Potential Loyalists
36214,151,1,"20,46",5,1,1,7,Mid-Value,Potential Loyalists
36215,5,4,"254,8",5,1,1,7,Mid-Value,Potential Loyalists
36220,327,3,"324,3",5,1,1,7,Mid-Value,Potential Loyalists
36225,211,5,"286,5",5,1,1,7,Mid-Value,Potential Loyalists
36229,897,1,"157,0",3,1,1,5,Low-Value,At Risk Customers
36230,732,1,"68,7",3,1,1,5,Low-Value,At Risk Customers
36232,1209,4,"245,10000000000002",2,1,1,4,Low-Value,Can't Lose
36234,1687,1,"37,349999999999994",1,1,1,3,Low-Value,Lost
36235,1170,2,"51,3",2,1,1,4,Low-Value,Can't Lose
36236,12,9,"1320,3",5,2,2,9,High-Value,Champions
36237,271,5,"631,8499999999999",5,1,1,7,Mid-Value,Potential Loyalists
36238,1684,1,"179,1",1,1,1,3,Low-Value,Lost
36239,391,3,"127,95",4,1,1,6,Mid-Value,Potential Loyalists
36241,633,1,"102,3",4,1,1,6,Mid-Value,Potential Loyalists
36243,1630,1,"16,25",1,1,1,3,Low-Value,Lost
36244,47,4,"173,10000000000002",5,1,1,7,Mid-Value,Potential Loyalists
36245,265,2,"42,5",5,1,1,7,Mid-Value,Potential Loyalists
36247,299,2,"160,3",5,1,1,7,Mid-Value,Potential Loyalists
36248,1471,8,"570,2500000000001",1,2,1,4,Low-Value,Can't Lose
36249,165,1,"181,6",5,1,1,7,Mid-Value,Potential Loyalists
36251,612,2,"94,75",4,1,1,6,Mid-Value,Potential Loyalists
36253,138,5,"120,25",5,1,1,7,Mid-Value,Potential Loyalists
36254,123,10,"1243,95",5,2,2,9,High-Value,Champions
36255,1192,3,"270,65",2,1,1,4,Low-Value,Can't Lose
36256,396,2,"21,1",4,1,1,6,Mid-Value,Potential Loyalists
36258,168,4,"144,1",5,1,1,7,Mid-Value,Potential Loyalists
36259,613,2,"20,299999999999997",4,1,1,6,Mid-Value,Potential Loyalists
36260,213,1,"116,0",5,1,1,7,Mid-Value,Potential Loyalists
36262,580,2,"115,8",4,1,1,6,Mid-Value,Potential Loyalists
36263,197,3,"519,2",5,1,1,7,Mid-Value,Potential Loyalists
36266,360,1,"17,8",5,1,1,7,Mid-Value,Potential Loyalists
36267,733,2,"57,7",3,1,1,5,Low-Value,At Risk Customers
36268,139,5,"195,55",5,1,1,7,Mid-Value,Potential Loyalists
36271,55,7,"1665,4499999999998",5,2,3,10,High-Value,Champions
36273,75,4,"95,0",5,1,1,7,Mid-Value,Potential Loyalists
36274,1769,1,"8,75",1,1,1,3,Low-Value,Lost
36280,843,2,"72,7",3,1,1,5,Low-Value,At Risk Customers
36281,201,1,"87,7",5,1,1,7,Mid-Value,Potential Loyalists
36283,332,5,"366,15000000000003",5,1,1,7,Mid-Value,Potential Loyalists
36285,545,4,"1054,7",4,1,2,7,Mid-Value,Potential Loyalists
36286,12,5,"487,25",5,1,1,7,Mid-Value,Potential Loyalists
36287,354,2,"185,1",5,1,1,7,Mid-Value,Potential Loyalists
36288,190,3,"231,8",5,1,1,7,Mid-Value,Potential Loyalists
36289,39,9,"869,1",5,2,2,9,High-Value,Champions
36293,168,4,"162,60000000000002",5,1,1,7,Mid-Value,Potential Loyalists
36294,965,1,"24,05",3,1,1,5,Low-Value,At Risk Customers
36295,418,2,"165,35000000000002",4,1,1,6,Mid-Value,Potential Loyalists
36298,145,4,"265,3",5,1,1,7,Mid-Value,Potential Loyalists
36299,1141,1,"18,05",2,1,1,4,Low-Value,Can't Lose
36301,388,6,"258,8",4,1,1,6,Mid-Value,Potential Loyalists
36302,1295,1,"381,0",2,1,1,4,Low-Value,Can't Lose
36303,825,2,"146,05",3,1,1,5,Low-Value,At Risk Customers
36304,1625,1,"11,65",1,1,1,3,Low-Value,Lost
36305,1594,1,"85,5",1,1,1,3,Low-Value,Lost
36307,525,1,"18,2",4,1,1,6,Mid-Value,Potential Loyalists
36308,109,3,"298,15",5,1,1,7,Mid-Value,Potential Loyalists
36310,309,3,"203,4",5,1,1,7,Mid-Value,Potential Loyalists
36311,561,2,"27,1",4,1,1,6,Mid-Value,Potential Loyalists
36312,206,2,"195,85",5,1,1,7,Mid-Value,Potential Loyalists
36313,399,4,"380,15",4,1,1,6,Mid-Value,Potential Loyalists
36315,475,9,"690,7",4,2,2,8,High-Value,Potential Loyalists
36316,97,4,"151,05",5,1,1,7,Mid-Value,Potential Loyalists
36317,386,5,"277,9",4,1,1,6,Mid-Value,Potential Loyalists
36319,466,3,"172,95",4,1,1,6,Mid-Value,Potential Loyalists
36320,918,5,"164,9",3,1,1,5,Low-Value,At Risk Customers
36321,1321,1,"100,8",2,1,1,4,Low-Value,Can't Lose
36324,432,10,"475,84999999999997",4,2,1,7,Mid-Value,Potential Loyalists
36326,715,9,"535,75",4,2,1,7,Mid-Value,Potential Loyalists
36331,1818,1,"26,4",1,1,1,3,Low-Value,Lost
36333,83,1,"17,25",5,1,1,7,Mid-Value,Potential Loyalists
36335,84,6,"341,65",5,1,1,7,Mid-Value,Potential Loyalists
36336,764,4,"89,5",3,1,1,5,Low-Value,At Risk Customers
36338,391,2,"106,0",4,1,1,6,Mid-Value,Potential Loyalists
36339,1061,1,"5,1",3,1,1,5,Low-Value,At Risk Customers
36341,437,1,"21,95",4,1,1,6,Mid-Value,Potential Loyalists
36342,148,4,"286,9",5,1,1,7,Mid-Value,Potential Loyalists
36343,420,1,"44,9",4,1,1,6,Mid-Value,Potential Loyalists
36344,10,2,"137,0",5,1,1,7,Mid-Value,Potential Loyalists
36345,225,2,"28,7",5,1,1,7,Mid-Value,Potential Loyalists
36346,21,7,"241,65",5,2,1,8,High-Value,Potential Loyalists
36347,406,1,"66,2",4,1,1,6,Mid-Value,Potential Loyalists
36352,43,3,"235,75",5,1,1,7,Mid-Value,Potential Loyalists
36354,60,6,"115,7",5,1,1,7,Mid-Value,Potential Loyalists
36355,387,1,"86,1",4,1,1,6,Mid-Value,Potential Loyalists
36359,1371,2,"88,45000000000002",2,1,1,4,Low-Value,Can't Lose
36361,1253,1,"67,8",2,1,1,4,Low-Value,Can't Lose
36365,566,1,"6,1",4,1,1,6,Mid-Value,Potential Loyalists
36367,5,3,"319,20000000000005",5,1,1,7,Mid-Value,Potential Loyalists
36368,336,3,"179,5",5,1,1,7,Mid-Value,Potential Loyalists
36369,626,11,"780,75",4,2,2,8,High-Value,Potential Loyalists
36370,208,3,"296,05",5,1,1,7,Mid-Value,Potential Loyalists
36371,20,8,"361,7",5,2,1,8,High-Value,Potential Loyalists
36374,732,2,"147,7",3,1,1,5,Low-Value,At Risk Customers
36377,155,2,"243,6",5,1,1,7,Mid-Value,Potential Loyalists
36379,40,4,"324,15",5,1,1,7,Mid-Value,Potential Loyalists
36380,225,4,"94,85",5,1,1,7,Mid-Value,Potential Loyalists
36382,62,2,"60,0",5,1,1,7,Mid-Value,Potential Loyalists
36383,31,10,"552,2",5,2,1,8,High-Value,Potential Loyalists
36384,176,5,"354,3",5,1,1,7,Mid-Value,Potential Loyalists
36385,610,3,"116,5",4,1,1,6,Mid-Value,Potential Loyalists
36386,404,4,"179,85",4,1,1,6,Mid-Value,Potential Loyalists
36387,68,11,"1121,85",5,2,2,9,High-Value,Champions
36388,565,4,"135,55",4,1,1,6,Mid-Value,Potential Loyalists
36389,1819,1,"116,35",1,1,1,3,Low-Value,Lost
36391,1124,2,"66,35000000000001",2,1,1,4,Low-Value,Can't Lose
36392,17,5,"264,15",5,1,1,7,Mid-Value,Potential Loyalists
36396,682,1,"3,75",4,1,1,6,Mid-Value,Potential Loyalists
36397,352,1,"34,1",5,1,1,7,Mid-Value,Potential Loyalists
36398,1543,2,"83,15",1,1,1,3,Low-Value,Lost
36399,83,3,"219,85",5,1,1,7,Mid-Value,Potential Loyalists
36401,155,2,"141,1",5,1,1,7,Mid-Value,Potential Loyalists
36402,158,12,"542,25",5,3,1,9,High-Value,Champions
36403,1231,1,"25,4",2,1,1,4,Low-Value,Can't Lose
36404,807,1,"28,25",3,1,1,5,Low-Value,At Risk Customers
36405,759,5,"229,0",3,1,1,5,Low-Value,At Risk Customers
36406,379,1,"158,0",4,1,1,6,Mid-Value,Potential Loyalists
36407,320,6,"232,35",5,1,1,7,Mid-Value,Potential Loyalists
36408,1076,2,"42,75",3,1,1,5,Low-Value,At Risk Customers
36409,271,3,"109,8",5,1,1,7,Mid-Value,Potential Loyalists
36410,645,1,"42,15",4,1,1,6,Mid-Value,Potential Loyalists
36411,1126,8,"402,8",2,2,1,5,Low-Value,At Risk Customers
36413,378,8,"309,8",4,2,1,7,Mid-Value,Potential Loyalists
36414,143,4,"222,65",5,1,1,7,Mid-Value,Potential Loyalists
36415,680,1,"22,4",4,1,1,6,Mid-Value,Potential Loyalists
36416,840,2,"52,0",3,1,1,5,Low-Value,At Risk Customers
36417,30,3,"168,65",5,1,1,7,Mid-Value,Potential Loyalists
36419,523,1,"34,5",4,1,1,6,Mid-Value,Potential Loyalists
36421,455,1,"1,1",4,1,1,6,Mid-Value,Potential Loyalists
36422,1404,2,"172,10000000000002",2,1,1,4,Low-Value,Can't Lose
36424,196,3,"115,39999999999999",5,1,1,7,Mid-Value,Potential Loyalists
36425,3,2,"520,5",5,1,1,7,Mid-Value,Potential Loyalists
36426,168,5,"351,65",5,1,1,7,Mid-Value,Potential Loyalists
36430,404,6,"330,35",4,1,1,6,Mid-Value,Potential Loyalists
36431,27,2,"69,6",5,1,1,7,Mid-Value,Potential Loyalists
36432,1800,1,"71,6",1,1,1,3,Low-Value,Lost
36433,1127,3,"511,1",2,1,1,4,Low-Value,Can't Lose
36435,374,4,"143,2",4,1,1,6,Mid-Value,Potential Loyalists
36437,414,12,"501,3",4,3,1,8,High-Value,Potential Loyalists
36439,605,3,"148,20000000000002",4,1,1,6,Mid-Value,Potential Loyalists
36442,1539,2,"370,9",1,1,1,3,Low-Value,Lost
36443,154,2,"97,95",5,1,1,7,Mid-Value,Potential Loyalists
36444,384,3,"177,15",4,1,1,6,Mid-Value,Potential Loyalists
36445,39,7,"473,85",5,2,1,8,High-Value,Potential Loyalists
36446,1318,1,"23,7",2,1,1,4,Low-Value,Can't Lose
36447,552,2,"16,85",4,1,1,6,Mid-Value,Potential Loyalists
36451,1471,2,"139,3",1,1,1,3,Low-Value,Lost
36452,948,3,"144,7",3,1,1,5,Low-Value,At Risk Customers
36454,1516,2,"15,1",1,1,1,3,Low-Value,Lost
36455,1359,1,"121,94999999999999",2,1,1,4,Low-Value,Can't Lose
36459,858,4,"201,65",3,1,1,5,Low-Value,At Risk Customers
36460,763,4,"182,3",3,1,1,5,Low-Value,At Risk Customers
36461,375,3,"77,55",4,1,1,6,Mid-Value,Potential Loyalists
36462,171,1,"5,35",5,1,1,7,Mid-Value,Potential Loyalists
36463,15,2,"48,55",5,1,1,7,Mid-Value,Potential Loyalists
36464,616,1,"20,0",4,1,1,6,Mid-Value,Potential Loyalists
36465,5,10,"799,65",5,2,2,9,High-Value,Champions
36467,540,1,"23,6",4,1,1,6,Mid-Value,Potential Loyalists
36468,919,3,"199,5",3,1,1,5,Low-Value,At Risk Customers
36469,1110,1,"74,1",2,1,1,4,Low-Value,Can't Lose
36471,396,2,"114,6",4,1,1,6,Mid-Value,Potential Loyalists
36472,861,5,"201,24999999999997",3,1,1,5,Low-Value,At Risk Customers
36474,9,1,"85,6",5,1,1,7,Mid-Value,Potential Loyalists
36476,377,5,"215,8",4,1,1,6,Mid-Value,Potential Loyalists
36477,199,6,"262,25",5,1,1,7,Mid-Value,Potential Loyalists
36478,1054,1,"23,45",3,1,1,5,Low-Value,At Risk Customers
36479,17,9,"736,35",5,2,2,9,High-Value,Champions
36480,232,1,"10,5",5,1,1,7,Mid-Value,Potential Loyalists
36483,829,3,"331,6",3,1,1,5,Low-Value,At Risk Customers
36484,861,2,"145,20000000000002",3,1,1,5,Low-Value,At Risk Customers
36487,619,5,"298,75",4,1,1,6,Mid-Value,Potential Loyalists
36489,242,3,"69,14999999999999",5,1,1,7,Mid-Value,Potential Loyalists
36490,141,10,"568,35",5,2,1,8,High-Value,Potential Loyalists
36491,1393,1,"43,95",2,1,1,4,Low-Value,Can't Lose
36492,115,1,"23,7",5,1,1,7,Mid-Value,Potential Loyalists
36493,910,2,"107,25",3,1,1,5,Low-Value,At Risk Customers
36494,418,5,"311,5",4,1,1,6,Mid-Value,Potential Loyalists
36498,215,1,"50,2",5,1,1,7,Mid-Value,Potential Loyalists
36502,764,4,"382,9",3,1,1,5,Low-Value,At Risk Customers
36503,694,2,"115,05000000000001",4,1,1,6,Mid-Value,Potential Loyalists
36504,259,1,"105,6",5,1,1,7,Mid-Value,Potential Loyalists
36505,797,1,"18,55",3,1,1,5,Low-Value,At Risk Customers
36506,948,1,"36,8",3,1,1,5,Low-Value,At Risk Customers
36507,243,2,"110,35",5,1,1,7,Mid-Value,Potential Loyalists
36508,66,2,"272,65",5,1,1,7,Mid-Value,Potential Loyalists
36509,1362,1,"22,9",2,1,1,4,Low-Value,Can't Lose
36510,1496,1,"18,75",1,1,1,3,Low-Value,Lost
36514,949,1,"40,75",3,1,1,5,Low-Value,At Risk Customers
36515,11,5,"115,9",5,1,1,7,Mid-Value,Potential Loyalists
36516,477,1,"49,8",4,1,1,6,Mid-Value,Potential Loyalists
36517,4,7,"336,1",5,2,1,8,High-Value,Potential Loyalists
36519,515,4,"434,0",4,1,1,6,Mid-Value,Potential Loyalists
36520,510,7,"795,95",4,2,2,8,High-Value,Potential Loyalists
36522,738,4,"377,2",3,1,1,5,Low-Value,At Risk Customers
36523,1385,5,"301,45",2,1,1,4,Low-Value,Can't Lose
36524,209,1,"2,0",5,1,1,7,Mid-Value,Potential Loyalists
36526,865,2,"138,0",3,1,1,5,Low-Value,At Risk Customers
36528,4,5,"132,95000000000002",5,1,1,7,Mid-Value,Potential Loyalists
36529,451,5,"173,7",4,1,1,6,Mid-Value,Potential Loyalists
36530,799,6,"392,3",3,1,1,5,Low-Value,At Risk Customers
36531,974,2,"32,45",3,1,1,5,Low-Value,At Risk Customers
36532,238,5,"239,40000000000003",5,1,1,7,Mid-Value,Potential Loyalists
36533,825,4,"71,35000000000001",3,1,1,5,Low-Value,At Risk Customers
36535,115,2,"38,75",5,1,1,7,Mid-Value,Potential Loyalists
36537,507,1,"8,6",4,1,1,6,Mid-Value,Potential Loyalists
36538,1604,2,"332,8",1,1,1,3,Low-Value,Lost
36539,183,7,"270,75",5,2,1,8,High-Value,Potential Loyalists
36545,225,7,"358,7",5,2,1,8,High-Value,Potential Loyalists
36547,172,6,"700,1999999999999",5,1,2,8,High-Value,Potential Loyalists
36548,1060,4,"110,35",3,1,1,5,Low-Value,At Risk Customers
36550,24,3,"258,55",5,1,1,7,Mid-Value,Potential Loyalists
36551,470,1,"12,85",4,1,1,6,Mid-Value,Potential Loyalists
36552,405,3,"132,0",4,1,1,6,Mid-Value,Potential Loyalists
36553,12,6,"209,9",5,1,1,7,Mid-Value,Potential Loyalists
36554,37,5,"403,45",5,1,1,7,Mid-Value,Potential Loyalists
36556,1116,1,"111,0",2,1,1,4,Low-Value,Can't Lose
36558,912,3,"142,35",3,1,1,5,Low-Value,At Risk Customers
36559,452,2,"30,2",4,1,1,6,Mid-Value,Potential Loyalists
36560,472,9,"1326,05",4,2,2,8,High-Value,Potential Loyalists
36561,190,2,"246,4",5,1,1,7,Mid-Value,Potential Loyalists
36562,421,5,"178,79999999999998",4,1,1,6,Mid-Value,Potential Loyalists
36563,654,4,"66,85",4,1,1,6,Mid-Value,Potential Loyalists
36564,1352,1,"129,55",2,1,1,4,Low-Value,Can't Lose
36565,374,7,"550,35",4,2,1,7,Mid-Value,Potential Loyalists
36566,454,2,"142,4",4,1,1,6,Mid-Value,Potential Loyalists
36568,1652,1,"13,5",1,1,1,3,Low-Value,Lost
36570,518,7,"417,8",4,2,1,7,Mid-Value,Potential Loyalists
36571,488,3,"377,1",4,1,1,6,Mid-Value,Potential Loyalists
36573,649,3,"514,0",4,1,1,6,Mid-Value,Potential Loyalists
36575,98,1,"192,35",5,1,1,7,Mid-Value,Potential Loyalists
36576,305,2,"63,05",5,1,1,7,Mid-Value,Potential Loyalists
36577,822,4,"119,1",3,1,1,5,Low-Value,At Risk Customers
36578,1236,2,"67,0",2,1,1,4,Low-Value,Can't Lose
36580,1481,2,"336,9",1,1,1,3,Low-Value,Lost
36581,559,1,"236,25",4,1,1,6,Mid-Value,Potential Loyalists
36582,1250,3,"61,65",2,1,1,4,Low-Value,Can't Lose
36583,1021,1,"12,3",3,1,1,5,Low-Value,At Risk Customers
36584,822,6,"427,95",3,1,1,5,Low-Value,At Risk Customers
36586,927,4,"201,65",3,1,1,5,Low-Value,At Risk Customers
36587,65,3,"386,7",5,1,1,7,Mid-Value,Potential Loyalists
36589,180,2,"136,55",5,1,1,7,Mid-Value,Potential Loyalists
36593,317,6,"288,45",5,1,1,7,Mid-Value,Potential Loyalists
36597,489,2,"266,1",4,1,1,6,Mid-Value,Potential Loyalists
36598,70,8,"868,4",5,2,2,9,High-Value,Champions
36600,1084,1,"37,75",3,1,1,5,Low-Value,At Risk Customers
36601,1032,4,"623,85",3,1,1,5,Low-Value,At Risk Customers
36603,1090,3,"168,7",3,1,1,5,Low-Value,At Risk Customers
36604,867,3,"343,0",3,1,1,5,Low-Value,At Risk Customers
36606,259,2,"72,05",5,1,1,7,Mid-Value,Potential Loyalists
36607,734,3,"102,6",3,1,1,5,Low-Value,At Risk Customers
36608,892,3,"180,45",3,1,1,5,Low-Value,At Risk Customers
36609,1717,1,"25,45",1,1,1,3,Low-Value,Lost
36612,1048,1,"8,1",3,1,1,5,Low-Value,At Risk Customers
36614,610,2,"33,2",4,1,1,6,Mid-Value,Potential Loyalists
36615,612,4,"251,3",4,1,1,6,Mid-Value,Potential Loyalists
36616,1242,1,"34,0",2,1,1,4,Low-Value,Can't Lose
36618,320,5,"333,04999999999995",5,1,1,7,Mid-Value,Potential Loyalists
36619,1065,1,"37,0",3,1,1,5,Low-Value,At Risk Customers
36620,467,5,"552,5999999999999",4,1,1,6,Mid-Value,Potential Loyalists
36621,142,2,"155,2",5,1,1,7,Mid-Value,Potential Loyalists
36622,25,2,"166,65",5,1,1,7,Mid-Value,Potential Loyalists
36623,1156,3,"126,35",2,1,1,4,Low-Value,Can't Lose
36624,315,3,"71,0",5,1,1,7,Mid-Value,Potential Loyalists
36625,62,1,"16,75",5,1,1,7,Mid-Value,Potential Loyalists
36626,1672,2,"68,9",1,1,1,3,Low-Value,Lost
36627,639,2,"43,6",4,1,1,6,Mid-Value,Potential Loyalists
36628,654,2,"96,65",4,1,1,6,Mid-Value,Potential Loyalists
36630,497,4,"192,0",4,1,1,6,Mid-Value,Potential Loyalists
36631,514,1,"172,5",4,1,1,6,Mid-Value,Potential Loyalists
36634,748,7,"602,65",3,2,1,6,Mid-Value,Potential Loyalists
36636,694,1,"13,2",4,1,1,6,Mid-Value,Potential Loyalists
36637,1618,1,"13,0",1,1,1,3,Low-Value,Lost
36638,176,5,"179,85",5,1,1,7,Mid-Value,Potential Loyalists
36639,463,2,"31,25",4,1,1,6,Mid-Value,Potential Loyalists
36641,150,2,"68,25",5,1,1,7,Mid-Value,Potential Loyalists
36643,348,4,"181,95",5,1,1,7,Mid-Value,Potential Loyalists
36646,12,6,"499,75",5,1,1,7,Mid-Value,Potential Loyalists
36648,333,2,"497,8",5,1,1,7,Mid-Value,Potential Loyalists
36651,78,5,"847,85",5,1,2,8,High-Value,Potential Loyalists
36655,10,1,"158,0",5,1,1,7,Mid-Value,Potential Loyalists
36656,1439,1,"61,8",2,1,1,4,Low-Value,Can't Lose
36657,951,5,"242,1",3,1,1,5,Low-Value,At Risk Customers
36659,8,8,"250,04999999999998",5,2,1,8,High-Value,Potential Loyalists
36660,20,10,"599,4",5,2,1,8,High-Value,Potential Loyalists
36661,710,4,"239,64999999999998",4,1,1,6,Mid-Value,Potential Loyalists
36662,417,2,"150,95",4,1,1,6,Mid-Value,Potential Loyalists
36664,101,3,"220,95",5,1,1,7,Mid-Value,Potential Loyalists
36665,186,8,"248,85",5,2,1,8,High-Value,Potential Loyalists
36666,379,4,"185,35",4,1,1,6,Mid-Value,Potential Loyalists
36667,11,5,"70,35",5,1,1,7,Mid-Value,Potential Loyalists
36668,1566,1,"12,45",1,1,1,3,Low-Value,Lost
36669,49,3,"37,05",5,1,1,7,Mid-Value,Potential Loyalists
36670,1527,1,"97,75",1,1,1,3,Low-Value,Lost
36671,1272,2,"128,6",2,1,1,4,Low-Value,Can't Lose
36672,750,3,"154,3",3,1,1,5,Low-Value,At Risk Customers
36673,396,1,"41,75",4,1,1,6,Mid-Value,Potential Loyalists
36674,722,3,"72,75",4,1,1,6,Mid-Value,Potential Loyalists
36676,17,13,"902,8499999999999",5,3,2,10,High-Value,Champions
36678,24,8,"916,4",5,2,2,9,High-Value,Champions
36681,115,4,"106,30000000000001",5,1,1,7,Mid-Value,Potential Loyalists
36682,514,1,"60,0",4,1,1,6,Mid-Value,Potential Loyalists
36684,537,3,"209,6",4,1,1,6,Mid-Value,Potential Loyalists
36685,1660,1,"31,4",1,1,1,3,Low-Value,Lost
36689,68,1,"5,45",5,1,1,7,Mid-Value,Potential Loyalists
36693,767,2,"15,75",3,1,1,5,Low-Value,At Risk Customers
36695,80,8,"170,0",5,2,1,8,High-Value,Potential Loyalists
36697,12,5,"369,65",5,1,1,7,Mid-Value,Potential Loyalists
36698,1167,2,"85,5",2,1,1,4,Low-Value,Can't Lose
36699,179,2,"161,55",5,1,1,7,Mid-Value,Potential Loyalists
36700,973,2,"183,0",3,1,1,5,Low-Value,At Risk Customers
36701,601,4,"130,2",4,1,1,6,Mid-Value,Potential Loyalists
36702,1332,1,"8,25",2,1,1,4,Low-Value,Can't Lose
36703,795,4,"87,25",3,1,1,5,Low-Value,At Risk Customers
36705,772,3,"549,1",3,1,1,5,Low-Value,At Risk Customers
36706,676,6,"248,79999999999998",4,1,1,6,Mid-Value,Potential Loyalists
36707,844,4,"312,2",3,1,1,5,Low-Value,At Risk Customers
36708,280,1,"24,75",5,1,1,7,Mid-Value,Potential Loyalists
36709,1652,1,"19,3",1,1,1,3,Low-Value,Lost
36710,418,1,"41,7",4,1,1,6,Mid-Value,Potential Loyalists
36713,136,4,"248,20000000000002",5,1,1,7,Mid-Value,Potential Loyalists
36714,1548,2,"49,599999999999994",1,1,1,3,Low-Value,Lost
36716,743,3,"304,6",3,1,1,5,Low-Value,At Risk Customers
36718,92,5,"153,15",5,1,1,7,Mid-Value,Potential Loyalists
36719,906,3,"113,25",3,1,1,5,Low-Value,At Risk Customers
36720,224,1,"16,4",5,1,1,7,Mid-Value,Potential Loyalists
36721,588,2,"30,400000000000002",4,1,1,6,Mid-Value,Potential Loyalists
36722,358,3,"67,8",5,1,1,7,Mid-Value,Potential Loyalists
36723,414,4,"181,7",4,1,1,6,Mid-Value,Potential Loyalists
36724,481,1,"63,6",4,1,1,6,Mid-Value,Potential Loyalists
36725,94,6,"467,04999999999995",5,1,1,7,Mid-Value,Potential Loyalists
36726,1225,2,"62,6",2,1,1,4,Low-Value,Can't Lose
36727,74,8,"544,4",5,2,1,8,High-Value,Potential Loyalists
36728,161,2,"52,9",5,1,1,7,Mid-Value,Potential Loyalists
36729,890,1,"165,75",3,1,1,5,Low-Value,At Risk Customers
36731,900,2,"261,6",3,1,1,5,Low-Value,At Risk Customers
36732,546,2,"274,34999999999997",4,1,1,6,Mid-Value,Potential Loyalists
36733,1123,1,"47,2",2,1,1,4,Low-Value,Can't Lose
36734,16,2,"95,44999999999999",5,1,1,7,Mid-Value,Potential Loyalists
36735,1158,5,"229,54999999999998",2,1,1,4,Low-Value,Can't Lose
36737,1219,1,"90,4",2,1,1,4,Low-Value,Can't Lose
36738,1357,1,"49,4",2,1,1,4,Low-Value,Can't Lose
36740,716,2,"218,0",4,1,1,6,Mid-Value,Potential Loyalists
36741,125,2,"110,7",5,1,1,7,Mid-Value,Potential Loyalists
36743,200,4,"139,35000000000002",5,1,1,7,Mid-Value,Potential Loyalists
36745,452,3,"82,5",4,1,1,6,Mid-Value,Potential Loyalists
36746,53,3,"392,8",5,1,1,7,Mid-Value,Potential Loyalists
36747,663,2,"84,3",4,1,1,6,Mid-Value,Potential Loyalists
36748,1191,2,"59,1",2,1,1,4,Low-Value,Can't Lose
36749,1664,1,"57,5",1,1,1,3,Low-Value,Lost
36752,53,1,"24,05",5,1,1,7,Mid-Value,Potential Loyalists
36753,728,1,"70,0",4,1,1,6,Mid-Value,Potential Loyalists
36754,1372,1,"47,85",2,1,1,4,Low-Value,Can't Lose
36755,997,2,"150,05",3,1,1,5,Low-Value,At Risk Customers
36756,797,2,"42,150000000000006",3,1,1,5,Low-Value,At Risk Customers
36757,36,5,"88,5",5,1,1,7,Mid-Value,Potential Loyalists
36758,1035,2,"67,1",3,1,1,5,Low-Value,At Risk Customers
36761,998,3,"276,35",3,1,1,5,Low-Value,At Risk Customers
36762,254,3,"42,599999999999994",5,1,1,7,Mid-Value,Potential Loyalists
36763,116,5,"246,14999999999998",5,1,1,7,Mid-Value,Potential Loyalists
36764,34,4,"56,8",5,1,1,7,Mid-Value,Potential Loyalists
36765,40,2,"124,64999999999999",5,1,1,7,Mid-Value,Potential Loyalists
36766,33,6,"353,3",5,1,1,7,Mid-Value,Potential Loyalists
36767,953,2,"50,050000000000004",3,1,1,5,Low-Value,At Risk Customers
36769,1344,1,"113,69999999999999",2,1,1,4,Low-Value,Can't Lose
36771,98,3,"105,9",5,1,1,7,Mid-Value,Potential Loyalists
36773,182,2,"87,6",5,1,1,7,Mid-Value,Potential Loyalists
36774,1335,2,"101,1",2,1,1,4,Low-Value,Can't Lose
36777,487,3,"200,4",4,1,1,6,Mid-Value,Potential Loyalists
36779,205,1,"19,65",5,1,1,7,Mid-Value,Potential Loyalists
36782,402,9,"574,2",4,2,1,7,Mid-Value,Potential Loyalists
36785,1603,1,"21,9",1,1,1,3,Low-Value,Lost
36788,97,3,"265,5",5,1,1,7,Mid-Value,Potential Loyalists
36791,1155,4,"297,1",2,1,1,4,Low-Value,Can't Lose
36792,221,3,"100,14999999999999",5,1,1,7,Mid-Value,Potential Loyalists
36793,18,2,"32,0",5,1,1,7,Mid-Value,Potential Loyalists
36794,52,2,"84,3",5,1,1,7,Mid-Value,Potential Loyalists
36798,518,6,"647,6",4,1,1,6,Mid-Value,Potential Loyalists
36801,1120,1,"40,92",2,1,1,4,Low-Value,Can't Lose
36802,74,5,"171,85",5,1,1,7,Mid-Value,Potential Loyalists
36803,262,1,"149,5",5,1,1,7,Mid-Value,Potential Loyalists
36806,804,9,"239,55",3,2,1,6,Mid-Value,Potential Loyalists
36807,512,8,"218,14999999999998",4,2,1,7,Mid-Value,Potential Loyalists
36810,153,1,"14,65",5,1,1,7,Mid-Value,Potential Loyalists
36812,178,2,"49,150000000000006",5,1,1,7,Mid-Value,Potential Loyalists
36814,993,1,"46,6",3,1,1,5,Low-Value,At Risk Customers
36815,1779,1,"55,85",1,1,1,3,Low-Value,Lost
36816,412,3,"156,95",4,1,1,6,Mid-Value,Potential Loyalists
36817,383,5,"734,0",4,1,2,7,Mid-Value,Potential Loyalists
36818,277,1,"80,9",5,1,1,7,Mid-Value,Potential Loyalists
36819,600,2,"16,35",4,1,1,6,Mid-Value,Potential Loyalists
36821,547,1,"46,1",4,1,1,6,Mid-Value,Potential Loyalists
36822,1352,1,"2,3",2,1,1,4,Low-Value,Can't Lose
36823,248,2,"42,25",5,1,1,7,Mid-Value,Potential Loyalists
36824,411,7,"299,85",4,2,1,7,Mid-Value,Potential Loyalists
36825,37,2,"84,25",5,1,1,7,Mid-Value,Potential Loyalists
36828,12,4,"251,85",5,1,1,7,Mid-Value,Potential Loyalists
36829,642,1,"32,3",4,1,1,6,Mid-Value,Potential Loyalists
36830,27,9,"743,0",5,2,2,9,High-Value,Champions
36832,1692,1,"15,7",1,1,1,3,Low-Value,Lost
36833,525,1,"109,4",4,1,1,6,Mid-Value,Potential Loyalists
36834,822,3,"151,25",3,1,1,5,Low-Value,At Risk Customers
36835,731,4,"211,2",3,1,1,5,Low-Value,At Risk Customers
36836,13,8,"314,1",5,2,1,8,High-Value,Potential Loyalists
36837,1545,2,"19,65",1,1,1,3,Low-Value,Lost
36838,0,6,"443,1",5,1,1,7,Mid-Value,Potential Loyalists
36841,217,2,"61,099999999999994",5,1,1,7,Mid-Value,Potential Loyalists
36844,136,3,"51,69",5,1,1,7,Mid-Value,Potential Loyalists
36845,1278,1,"117,2",2,1,1,4,Low-Value,Can't Lose
36846,382,5,"212,4",4,1,1,6,Mid-Value,Potential Loyalists
36847,1074,5,"233,55",3,1,1,5,Low-Value,At Risk Customers
36848,849,4,"475,34999999999997",3,1,1,5,Low-Value,At Risk Customers
36851,1247,3,"152,1",2,1,1,4,Low-Value,Can't Lose
36852,1245,2,"114,9",2,1,1,4,Low-Value,Can't Lose
36853,1113,3,"100,35",2,1,1,4,Low-Value,Can't Lose
36859,20,2,"78,9",5,1,1,7,Mid-Value,Potential Loyalists
36861,10,1,"304,2",5,1,1,7,Mid-Value,Potential Loyalists
36862,122,10,"622,75",5,2,1,8,High-Value,Potential Loyalists
36865,747,3,"452,5",3,1,1,5,Low-Value,At Risk Customers
36868,1440,1,"84,8",2,1,1,4,Low-Value,Can't Lose
36870,4,5,"237,8",5,1,1,7,Mid-Value,Potential Loyalists
36871,31,3,"82,6",5,1,1,7,Mid-Value,Potential Loyalists
36872,80,3,"167,6",5,1,1,7,Mid-Value,Potential Loyalists
36874,497,8,"603,05",4,2,1,7,Mid-Value,Potential Loyalists
36876,397,6,"187,3",4,1,1,6,Mid-Value,Potential Loyalists
36880,62,2,"60,75",5,1,1,7,Mid-Value,Potential Loyalists
36885,1262,1,"270,0",2,1,1,4,Low-Value,Can't Lose
36886,22,6,"325,5",5,1,1,7,Mid-Value,Potential Loyalists
36887,464,1,"48,3",4,1,1,6,Mid-Value,Potential Loyalists
36888,172,4,"165,45",5,1,1,7,Mid-Value,Potential Loyalists
36892,27,3,"120,4",5,1,1,7,Mid-Value,Potential Loyalists
36894,263,4,"247,4",5,1,1,7,Mid-Value,Potential Loyalists
36895,174,3,"244,10000000000002",5,1,1,7,Mid-Value,Potential Loyalists
36897,1298,1,"74,25",2,1,1,4,Low-Value,Can't Lose
36899,493,4,"158,85",4,1,1,6,Mid-Value,Potential Loyalists
36900,52,3,"371,55",5,1,1,7,Mid-Value,Potential Loyalists
36901,713,4,"138,5",4,1,1,6,Mid-Value,Potential Loyalists
36902,796,8,"237,45",3,2,1,6,Mid-Value,Potential Loyalists
36903,1282,1,"45,0",2,1,1,4,Low-Value,Can't Lose
36904,74,4,"221,75",5,1,1,7,Mid-Value,Potential Loyalists
36907,767,6,"273,2",3,1,1,5,Low-Value,At Risk Customers
36908,605,3,"387,35",4,1,1,6,Mid-Value,Potential Loyalists
36909,969,2,"118,19999999999999",3,1,1,5,Low-Value,At Risk Customers
36910,115,7,"322,55",5,2,1,8,High-Value,Potential Loyalists
36912,1326,1,"7,3500000000000005",2,1,1,4,Low-Value,Can't Lose
36914,355,3,"75,55000000000001",5,1,1,7,Mid-Value,Potential Loyalists
36915,829,1,"6,45",3,1,1,5,Low-Value,At Risk Customers
36916,902,1,"23,8",3,1,1,5,Low-Value,At Risk Customers
36917,1133,1,"1,35",2,1,1,4,Low-Value,Can't Lose
36918,810,6,"737,9499999999999",3,1,2,6,Mid-Value,Potential Loyalists
36919,176,5,"156,2",5,1,1,7,Mid-Value,Potential Loyalists
36920,8,2,"116,80000000000001",5,1,1,7,Mid-Value,Potential Loyalists
36921,143,11,"705,3",5,2,2,9,High-Value,Champions
36922,265,2,"111,0",5,1,1,7,Mid-Value,Potential Loyalists
36924,25,4,"269,65",5,1,1,7,Mid-Value,Potential Loyalists
36927,1244,3,"125,3",2,1,1,4,Low-Value,Can't Lose
36929,1446,1,"35,9",2,1,1,4,Low-Value,Can't Lose
36931,549,2,"130,3",4,1,1,6,Mid-Value,Potential Loyalists
36932,543,5,"73,0",4,1,1,6,Mid-Value,Potential Loyalists
36935,22,5,"124,05",5,1,1,7,Mid-Value,Potential Loyalists
36936,46,3,"161,25",5,1,1,7,Mid-Value,Potential Loyalists
36937,23,3,"134,2",5,1,1,7,Mid-Value,Potential Loyalists
36938,632,4,"109,25",4,1,1,6,Mid-Value,Potential Loyalists
36939,134,4,"632,85",5,1,1,7,Mid-Value,Potential Loyalists
36940,71,3,"194,6",5,1,1,7,Mid-Value,Potential Loyalists
36944,66,2,"72,35",5,1,1,7,Mid-Value,Potential Loyalists
36945,1080,1,"34,75",3,1,1,5,Low-Value,At Risk Customers
36946,10,6,"375,20000000000005",5,1,1,7,Mid-Value,Potential Loyalists
36947,256,9,"822,6",5,2,2,9,High-Value,Champions
36948,1113,5,"237,48",2,1,1,4,Low-Value,Can't Lose
36951,452,2,"10,950000000000001",4,1,1,6,Mid-Value,Potential Loyalists
36953,67,6,"778,8499999999999",5,1,2,8,High-Value,Potential Loyalists
36956,1402,1,"55,75",2,1,1,4,Low-Value,Can't Lose
36960,416,1,"26,2",4,1,1,6,Mid-Value,Potential Loyalists
36961,80,4,"149,85",5,1,1,7,Mid-Value,Potential Loyalists
36962,391,2,"287,8",4,1,1,6,Mid-Value,Potential Loyalists
36967,1303,2,"237,3",2,1,1,4,Low-Value,Can't Lose
36968,817,1,"34,1",3,1,1,5,Low-Value,At Risk Customers
36970,1084,1,"14,95",3,1,1,5,Low-Value,At Risk Customers
36971,355,1,"46,7",5,1,1,7,Mid-Value,Potential Loyalists
36972,577,5,"261,35",4,1,1,6,Mid-Value,Potential Loyalists
36973,0,7,"520,55",5,2,1,8,High-Value,Potential Loyalists
36974,694,2,"212,1",4,1,1,6,Mid-Value,Potential Loyalists
36975,1536,1,"34,35",1,1,1,3,Low-Value,Lost
36976,281,2,"30,6",5,1,1,7,Mid-Value,Potential Loyalists
36977,107,4,"444,4",5,1,1,7,Mid-Value,Potential Loyalists
36978,133,3,"322,20000000000005",5,1,1,7,Mid-Value,Potential Loyalists
36979,546,1,"171,89999999999998",4,1,1,6,Mid-Value,Potential Loyalists
36983,28,7,"1138,3",5,2,2,9,High-Value,Champions
36987,2,6,"452,3",5,1,1,7,Mid-Value,Potential Loyalists
36989,641,1,"7,4",4,1,1,6,Mid-Value,Potential Loyalists
36990,983,1,"16,45",3,1,1,5,Low-Value,At Risk Customers
36991,354,2,"493,6",5,1,1,7,Mid-Value,Potential Loyalists
36992,75,4,"159,75",5,1,1,7,Mid-Value,Potential Loyalists
36993,1017,2,"79,7",3,1,1,5,Low-Value,At Risk Customers
36995,319,1,"80,2",5,1,1,7,Mid-Value,Potential Loyalists
36999,819,2,"54,2",3,1,1,5,Low-Value,At Risk Customers
37002,558,3,"171,54999999999998",4,1,1,6,Mid-Value,Potential Loyalists
37003,34,2,"131,95",5,1,1,7,Mid-Value,Potential Loyalists
37006,771,2,"35,6",3,1,1,5,Low-Value,At Risk Customers
37007,1194,3,"76,85",2,1,1,4,Low-Value,Can't Lose
37010,92,1,"34,9",5,1,1,7,Mid-Value,Potential Loyalists
37011,768,1,"29,55",3,1,1,5,Low-Value,At Risk Customers
37013,980,3,"231,25",3,1,1,5,Low-Value,At Risk Customers
37015,20,2,"38,45",5,1,1,7,Mid-Value,Potential Loyalists
37016,31,4,"106,69999999999999",5,1,1,7,Mid-Value,Potential Loyalists
37018,442,3,"130,6",4,1,1,6,Mid-Value,Potential Loyalists
37019,407,3,"177,0",4,1,1,6,Mid-Value,Potential Loyalists
37021,95,4,"193,7",5,1,1,7,Mid-Value,Potential Loyalists
37022,41,2,"16,6",5,1,1,7,Mid-Value,Potential Loyalists
37025,9,1,"89,8",5,1,1,7,Mid-Value,Potential Loyalists
37026,619,1,"81,0",4,1,1,6,Mid-Value,Potential Loyalists
37028,1672,1,"35,1",1,1,1,3,Low-Value,Lost
37030,42,4,"202,95000000000002",5,1,1,7,Mid-Value,Potential Loyalists
37031,61,4,"172,6",5,1,1,7,Mid-Value,Potential Loyalists
37032,425,2,"37,0",4,1,1,6,Mid-Value,Potential Loyalists
37034,637,3,"292,05",4,1,1,6,Mid-Value,Potential Loyalists
37038,1686,1,"15,1",1,1,1,3,Low-Value,Lost
37039,643,5,"268,3",4,1,1,6,Mid-Value,Potential Loyalists
37040,998,1,"18,299999999999997",3,1,1,5,Low-Value,At Risk Customers
37041,340,2,"178,05",5,1,1,7,Mid-Value,Potential Loyalists
37042,191,1,"210,0",5,1,1,7,Mid-Value,Potential Loyalists
37043,190,4,"825,95",5,1,2,8,High-Value,Potential Loyalists
37047,959,2,"152,60000000000002",3,1,1,5,Low-Value,At Risk Customers
37048,162,4,"119,7",5,1,1,7,Mid-Value,Potential Loyalists
37051,243,9,"872,2",5,2,2,9,High-Value,Champions
37055,487,1,"114,25",4,1,1,6,Mid-Value,Potential Loyalists
37056,253,3,"197,25",5,1,1,7,Mid-Value,Potential Loyalists
37057,787,1,"11,75",3,1,1,5,Low-Value,At Risk Customers
37058,967,3,"116,50000000000001",3,1,1,5,Low-Value,At Risk Customers
37060,317,1,"11,4",5,1,1,7,Mid-Value,Potential Loyalists
37063,1101,2,"85,95",2,1,1,4,Low-Value,Can't Lose
37064,258,5,"93,6",5,1,1,7,Mid-Value,Potential Loyalists
37065,41,2,"83,5",5,1,1,7,Mid-Value,Potential Loyalists
37068,81,4,"669,3499999999999",5,1,2,8,High-Value,Potential Loyalists
37069,1496,2,"81,8",1,1,1,3,Low-Value,Lost
37073,67,3,"115,5",5,1,1,7,Mid-Value,Potential Loyalists
37074,675,5,"976,8",4,1,2,7,Mid-Value,Potential Loyalists
37075,1634,1,"31,9",1,1,1,3,Low-Value,Lost
37076,667,1,"78,15",4,1,1,6,Mid-Value,Potential Loyalists
37078,946,1,"71,9",3,1,1,5,Low-Value,At Risk Customers
37079,200,4,"228,7",5,1,1,7,Mid-Value,Potential Loyalists
37080,504,1,"376,95000000000005",4,1,1,6,Mid-Value,Potential Loyalists
37081,102,3,"213,85000000000002",5,1,1,7,Mid-Value,Potential Loyalists
37086,5,7,"334,59999999999997",5,2,1,8,High-Value,Potential Loyalists
37087,199,1,"41,5",5,1,1,7,Mid-Value,Potential Loyalists
37088,1468,2,"126,25",1,1,1,3,Low-Value,Lost
37090,29,2,"78,2",5,1,1,7,Mid-Value,Potential Loyalists
37091,15,4,"169,35000000000002",5,1,1,7,Mid-Value,Potential Loyalists
37092,699,1,"132,75",4,1,1,6,Mid-Value,Potential Loyalists
37094,12,3,"197,1",5,1,1,7,Mid-Value,Potential Loyalists
37095,795,7,"351,2",3,2,1,6,Mid-Value,Potential Loyalists
37096,788,4,"256,05",3,1,1,5,Low-Value,At Risk Customers
37097,566,5,"270,4",4,1,1,6,Mid-Value,Potential Loyalists
37098,258,1,"80,4",5,1,1,7,Mid-Value,Potential Loyalists
37099,1579,2,"47,35",1,1,1,3,Low-Value,Lost
37102,388,1,"11,9",4,1,1,6,Mid-Value,Potential Loyalists
37103,844,3,"74,55",3,1,1,5,Low-Value,At Risk Customers
37104,29,6,"400,95",5,1,1,7,Mid-Value,Potential Loyalists
37105,493,6,"739,6999999999999",4,1,2,7,Mid-Value,Potential Loyalists
37106,1060,1,"97,4",3,1,1,5,Low-Value,At Risk Customers
37107,59,4,"144,95",5,1,1,7,Mid-Value,Potential Loyalists
37108,794,2,"61,4",3,1,1,5,Low-Value,At Risk Customers
37109,1472,1,"82,8",1,1,1,3,Low-Value,Lost
37110,621,4,"392,35",4,1,1,6,Mid-Value,Potential Loyalists
37112,169,1,"103,05000000000001",5,1,1,7,Mid-Value,Potential Loyalists
37113,1238,1,"35,099999999999994",2,1,1,4,Low-Value,Can't Lose
37114,172,4,"144,15",5,1,1,7,Mid-Value,Potential Loyalists
37115,138,4,"78,2",5,1,1,7,Mid-Value,Potential Loyalists
37116,128,2,"60,0",5,1,1,7,Mid-Value,Potential Loyalists
37117,755,1,"154,5",3,1,1,5,Low-Value,At Risk Customers
37120,975,1,"113,45",3,1,1,5,Low-Value,At Risk Customers
37122,141,4,"162,6",5,1,1,7,Mid-Value,Potential Loyalists
37123,120,3,"307,25",5,1,1,7,Mid-Value,Potential Loyalists
37125,358,3,"170,5",5,1,1,7,Mid-Value,Potential Loyalists
37127,424,1,"135,0",4,1,1,6,Mid-Value,Potential Loyalists
37128,676,1,"116,0",4,1,1,6,Mid-Value,Potential Loyalists
37129,528,3,"159,55",4,1,1,6,Mid-Value,Potential Loyalists
37130,1074,3,"178,45",3,1,1,5,Low-Value,At Risk Customers
37133,1017,1,"16,8",3,1,1,5,Low-Value,At Risk Customers
37134,404,2,"179,35",4,1,1,6,Mid-Value,Potential Loyalists
37135,102,4,"381,7",5,1,1,7,Mid-Value,Potential Loyalists
37136,407,7,"460,09999999999997",4,2,1,7,Mid-Value,Potential Loyalists
37137,205,6,"427,8",5,1,1,7,Mid-Value,Potential Loyalists
37138,33,6,"349,5",5,1,1,7,Mid-Value,Potential Loyalists
37139,344,6,"278,35",5,1,1,7,Mid-Value,Potential Loyalists
37141,955,5,"215,0",3,1,1,5,Low-Value,At Risk Customers
37142,73,4,"321,5",5,1,1,7,Mid-Value,Potential Loyalists
37143,1530,1,"112,85",1,1,1,3,Low-Value,Lost
37144,947,2,"109,05000000000001",3,1,1,5,Low-Value,At Risk Customers
37145,391,6,"494,3",4,1,1,6,Mid-Value,Potential Loyalists
37146,933,3,"83,55",3,1,1,5,Low-Value,At Risk Customers
37149,710,3,"69,2",4,1,1,6,Mid-Value,Potential Loyalists
37150,112,5,"202,5",5,1,1,7,Mid-Value,Potential Loyalists
37153,1215,1,"31,2",2,1,1,4,Low-Value,Can't Lose
37155,635,2,"14,4",4,1,1,6,Mid-Value,Potential Loyalists
37156,0,2,"177,89999999999998",5,1,1,7,Mid-Value,Potential Loyalists
37158,97,3,"102,4",5,1,1,7,Mid-Value,Potential Loyalists
37159,235,6,"195,95",5,1,1,7,Mid-Value,Potential Loyalists
37161,58,5,"443,70000000000005",5,1,1,7,Mid-Value,Potential Loyalists
37163,1344,2,"6,45",2,1,1,4,Low-Value,Can't Lose
37164,1035,3,"79,95",3,1,1,5,Low-Value,At Risk Customers
37165,11,5,"1338,1499999999999",5,1,3,9,High-Value,Champions
37166,19,8,"706,2",5,2,2,9,High-Value,Champions
37168,31,3,"53,05",5,1,1,7,Mid-Value,Potential Loyalists
37169,778,3,"181,7",3,1,1,5,Low-Value,At Risk Customers
37171,382,2,"110,19999999999999",4,1,1,6,Mid-Value,Potential Loyalists
37172,977,1,"27,8",3,1,1,5,Low-Value,At Risk Customers
37174,671,9,"598,4",4,2,1,7,Mid-Value,Potential Loyalists
37175,1527,1,"9,3",1,1,1,3,Low-Value,Lost
37179,148,2,"556,9",5,1,1,7,Mid-Value,Potential Loyalists
37181,684,5,"187,65",4,1,1,6,Mid-Value,Potential Loyalists
37184,1211,1,"58,1",2,1,1,4,Low-Value,Can't Lose
37185,614,1,"79,0",4,1,1,6,Mid-Value,Potential Loyalists
37186,1602,1,"163,6",1,1,1,3,Low-Value,Lost
37188,21,7,"299,15000000000003",5,2,1,8,High-Value,Potential Loyalists
37190,0,10,"665,35",5,2,2,9,High-Value,Champions
37192,298,2,"124,15",5,1,1,7,Mid-Value,Potential Loyalists
37193,1111,1,"13,7",2,1,1,4,Low-Value,Can't Lose
37194,22,5,"368,65",5,1,1,7,Mid-Value,Potential Loyalists
37196,1473,1,"98,0",1,1,1,3,Low-Value,Lost
37199,539,7,"886,1500000000001",4,2,2,8,High-Value,Potential Loyalists
37200,740,6,"578,35",3,1,1,5,Low-Value,At Risk Customers
37204,760,4,"257,45",3,1,1,5,Low-Value,At Risk Customers
37205,1078,1,"12,7",3,1,1,5,Low-Value,At Risk Customers
37206,194,5,"319,55",5,1,1,7,Mid-Value,Potential Loyalists
37207,1154,8,"496,20000000000005",2,2,1,5,Low-Value,At Risk Customers
37208,442,2,"59,5",4,1,1,6,Mid-Value,Potential Loyalists
37210,116,2,"90,1",5,1,1,7,Mid-Value,Potential Loyalists
37211,441,3,"188,2",4,1,1,6,Mid-Value,Potential Loyalists
37212,57,7,"339,95",5,2,1,8,High-Value,Potential Loyalists
37213,25,4,"250,70000000000002",5,1,1,7,Mid-Value,Potential Loyalists
37215,1331,2,"49,7",2,1,1,4,Low-Value,Can't Lose
37218,224,3,"145,10000000000002",5,1,1,7,Mid-Value,Potential Loyalists
37219,1076,2,"48,0",3,1,1,5,Low-Value,At Risk Customers
37220,1256,1,"36,9",2,1,1,4,Low-Value,Can't Lose
37221,353,4,"224,2",5,1,1,7,Mid-Value,Potential Loyalists
37223,621,7,"325,4",4,2,1,7,Mid-Value,Potential Loyalists
37224,450,1,"15,55",4,1,1,6,Mid-Value,Potential Loyalists
37228,372,7,"120,45",4,2,1,7,Mid-Value,Potential Loyalists
37230,861,2,"115,05000000000001",3,1,1,5,Low-Value,At Risk Customers
37231,212,3,"89,76",5,1,1,7,Mid-Value,Potential Loyalists
37232,786,2,"101,60000000000001",3,1,1,5,Low-Value,At Risk Customers
37233,120,6,"435,6",5,1,1,7,Mid-Value,Potential Loyalists
37234,1105,2,"51,5",2,1,1,4,Low-Value,Can't Lose
37235,1534,3,"258,95",1,1,1,3,Low-Value,Lost
37236,771,5,"449,2",3,1,1,5,Low-Value,At Risk Customers
37237,126,2,"135,4",5,1,1,7,Mid-Value,Potential Loyalists
37238,634,2,"28,65",4,1,1,6,Mid-Value,Potential Loyalists
37239,538,7,"384,84999999999997",4,2,1,7,Mid-Value,Potential Loyalists
37240,511,4,"60,85000000000001",4,1,1,6,Mid-Value,Potential Loyalists
37241,732,2,"348,6",3,1,1,5,Low-Value,At Risk Customers
37242,398,4,"86,05",4,1,1,6,Mid-Value,Potential Loyalists
37243,381,1,"51,75",4,1,1,6,Mid-Value,Potential Loyalists
37244,158,6,"504,1",5,1,1,7,Mid-Value,Potential Loyalists
37245,656,3,"158,5",4,1,1,6,Mid-Value,Potential Loyalists
37246,160,5,"152,0",5,1,1,7,Mid-Value,Potential Loyalists
37252,68,2,"30,650000000000002",5,1,1,7,Mid-Value,Potential Loyalists
37253,1254,2,"36,900000000000006",2,1,1,4,Low-Value,Can't Lose
37254,132,4,"257,1",5,1,1,7,Mid-Value,Potential Loyalists
37255,642,1,"9,85",4,1,1,6,Mid-Value,Potential Loyalists
37256,591,1,"15,899999999999999",4,1,1,6,Mid-Value,Potential Loyalists
37257,1166,1,"38,3",2,1,1,4,Low-Value,Can't Lose
37258,1278,1,"46,5",2,1,1,4,Low-Value,Can't Lose
37259,528,5,"211,14999999999998",4,1,1,6,Mid-Value,Potential Loyalists
37261,1334,2,"110,45",2,1,1,4,Low-Value,Can't Lose
37263,844,5,"749,6500000000001",3,1,2,6,Mid-Value,Potential Loyalists
37265,824,1,"47,1",3,1,1,5,Low-Value,At Risk Customers
37268,216,1,"85,2",5,1,1,7,Mid-Value,Potential Loyalists
37269,251,5,"219,75",5,1,1,7,Mid-Value,Potential Loyalists
37270,24,6,"161,4",5,1,1,7,Mid-Value,Potential Loyalists
37271,328,2,"51,7",5,1,1,7,Mid-Value,Potential Loyalists
37272,121,3,"67,75",5,1,1,7,Mid-Value,Potential Loyalists
37273,38,1,"54,5",5,1,1,7,Mid-Value,Potential Loyalists
37274,78,2,"79,85",5,1,1,7,Mid-Value,Potential Loyalists
37275,514,2,"46,7",4,1,1,6,Mid-Value,Potential Loyalists
37276,354,3,"129,4",5,1,1,7,Mid-Value,Potential Loyalists
37277,1307,1,"111,9",2,1,1,4,Low-Value,Can't Lose
37278,784,7,"589,45",3,2,1,6,Mid-Value,Potential Loyalists
37280,443,1,"279,6",4,1,1,6,Mid-Value,Potential Loyalists
37281,375,1,"91,0",4,1,1,6,Mid-Value,Potential Loyalists
37283,876,6,"995,5",3,1,2,6,Mid-Value,Potential Loyalists
37285,17,7,"336,3",5,2,1,8,High-Value,Potential Loyalists
37286,40,2,"65,75",5,1,1,7,Mid-Value,Potential Loyalists
37287,226,4,"291,1",5,1,1,7,Mid-Value,Potential Loyalists
37289,243,2,"238,95",5,1,1,7,Mid-Value,Potential Loyalists
37290,691,2,"136,6",4,1,1,6,Mid-Value,Potential Loyalists
37293,1128,1,"40,75",2,1,1,4,Low-Value,Can't Lose
37294,15,5,"329,05",5,1,1,7,Mid-Value,Potential Loyalists
37295,913,4,"364,5",3,1,1,5,Low-Value,At Risk Customers
37296,227,5,"198,8",5,1,1,7,Mid-Value,Potential Loyalists
37299,732,3,"506,2",3,1,1,5,Low-Value,At Risk Customers
37300,655,1,"36,65",4,1,1,6,Mid-Value,Potential Loyalists
37301,268,2,"26,35",5,1,1,7,Mid-Value,Potential Loyalists
37303,1510,3,"22,05",1,1,1,3,Low-Value,Lost
37305,25,7,"562,9",5,2,1,8,High-Value,Potential Loyalists
37306,620,3,"218,79999999999998",4,1,1,6,Mid-Value,Potential Loyalists
37307,378,1,"19,1",4,1,1,6,Mid-Value,Potential Loyalists
37308,1597,1,"126,4",1,1,1,3,Low-Value,Lost
37309,1758,1,"175,2",1,1,1,3,Low-Value,Lost
37310,113,9,"914,1",5,2,2,9,High-Value,Champions
37312,222,4,"480,5",5,1,1,7,Mid-Value,Potential Loyalists
37315,579,4,"125,8",4,1,1,6,Mid-Value,Potential Loyalists
37316,55,7,"187,45000000000002",5,2,1,8,High-Value,Potential Loyalists
37318,246,1,"204,4",5,1,1,7,Mid-Value,Potential Loyalists
37319,622,1,"125,85",4,1,1,6,Mid-Value,Potential Loyalists
37320,1620,1,"168,45",1,1,1,3,Low-Value,Lost
37321,199,6,"457,35",5,1,1,7,Mid-Value,Potential Loyalists
37323,47,5,"358,3",5,1,1,7,Mid-Value,Potential Loyalists
37325,1349,3,"92,25",2,1,1,4,Low-Value,Can't Lose
37326,306,3,"148,45000000000002",5,1,1,7,Mid-Value,Potential Loyalists
37327,133,2,"114,45000000000002",5,1,1,7,Mid-Value,Potential Loyalists
37330,14,8,"439,35",5,2,1,8,High-Value,Potential Loyalists
37331,225,4,"434,3",5,1,1,7,Mid-Value,Potential Loyalists
37332,28,7,"559,2",5,2,1,8,High-Value,Potential Loyalists
37333,1597,1,"10,15",1,1,1,3,Low-Value,Lost
37334,189,5,"441,4",5,1,1,7,Mid-Value,Potential Loyalists
37335,67,3,"140,15",5,1,1,7,Mid-Value,Potential Loyalists
37336,1605,1,"57,6",1,1,1,3,Low-Value,Lost
37337,540,2,"120,60000000000001",4,1,1,6,Mid-Value,Potential Loyalists
37338,669,1,"29,05",4,1,1,6,Mid-Value,Potential Loyalists
37339,406,3,"36,900000000000006",4,1,1,6,Mid-Value,Potential Loyalists
37340,165,7,"332,59999999999997",5,2,1,8,High-Value,Potential Loyalists
37344,613,1,"14,4",4,1,1,6,Mid-Value,Potential Loyalists
37345,226,4,"160,25",5,1,1,7,Mid-Value,Potential Loyalists
37346,388,4,"402,7",4,1,1,6,Mid-Value,Potential Loyalists
37347,744,1,"114,1",3,1,1,5,Low-Value,At Risk Customers
37348,1145,4,"110,95",2,1,1,4,Low-Value,Can't Lose
37352,1475,3,"175,0",1,1,1,3,Low-Value,Lost
37353,343,12,"512,3",5,3,1,9,High-Value,Champions
37354,1436,1,"10,23",2,1,1,4,Low-Value,Can't Lose
37357,22,1,"23,9",5,1,1,7,Mid-Value,Potential Loyalists
37358,1604,2,"139,05",1,1,1,3,Low-Value,Lost
37360,418,6,"318,55",4,1,1,6,Mid-Value,Potential Loyalists
37361,84,4,"106,60000000000001",5,1,1,7,Mid-Value,Potential Loyalists
37363,1746,1,"15,55",1,1,1,3,Low-Value,Lost
37364,810,3,"246,95",3,1,1,5,Low-Value,At Risk Customers
37365,812,3,"66,4",3,1,1,5,Low-Value,At Risk Customers
37367,353,5,"303,5",5,1,1,7,Mid-Value,Potential Loyalists
37368,232,3,"82,2",5,1,1,7,Mid-Value,Potential Loyalists
37369,199,5,"200,65",5,1,1,7,Mid-Value,Potential Loyalists
37372,361,4,"352,00000000000006",5,1,1,7,Mid-Value,Potential Loyalists
37373,9,8,"195,9",5,2,1,8,High-Value,Potential Loyalists
37374,40,8,"694,9",5,2,2,9,High-Value,Champions
37376,43,5,"178,4",5,1,1,7,Mid-Value,Potential Loyalists
37379,56,2,"161,60000000000002",5,1,1,7,Mid-Value,Potential Loyalists
37380,862,2,"80,35000000000001",3,1,1,5,Low-Value,At Risk Customers
37381,392,4,"531,45",4,1,1,6,Mid-Value,Potential Loyalists
37382,893,2,"93,6",3,1,1,5,Low-Value,At Risk Customers
37386,747,10,"332,7",3,2,1,6,Mid-Value,Potential Loyalists
37387,755,4,"294,3",3,1,1,5,Low-Value,At Risk Customers
37388,262,2,"68,55",5,1,1,7,Mid-Value,Potential Loyalists
37389,1461,2,"73,5",1,1,1,3,Low-Value,Lost
37390,1228,2,"29,099999999999998",2,1,1,4,Low-Value,Can't Lose
37391,262,2,"101,19999999999999",5,1,1,7,Mid-Value,Potential Loyalists
37392,745,1,"18,3",3,1,1,5,Low-Value,At Risk Customers
37395,374,5,"258,7",4,1,1,6,Mid-Value,Potential Loyalists
37396,1410,1,"9,2",2,1,1,4,Low-Value,Can't Lose
37397,184,1,"172,1",5,1,1,7,Mid-Value,Potential Loyalists
37400,852,2,"134,45",3,1,1,5,Low-Value,At Risk Customers
37401,174,6,"953,95",5,1,2,8,High-Value,Potential Loyalists
37403,242,5,"166,35",5,1,1,7,Mid-Value,Potential Loyalists
37404,1392,1,"38,8",2,1,1,4,Low-Value,Can't Lose
37405,1602,1,"153,1",1,1,1,3,Low-Value,Lost
37406,77,1,"21,25",5,1,1,7,Mid-Value,Potential Loyalists
37407,1603,3,"177,85",1,1,1,3,Low-Value,Lost
37408,210,4,"596,9",5,1,1,7,Mid-Value,Potential Loyalists
37409,857,4,"195,0",3,1,1,5,Low-Value,At Risk Customers
37410,111,4,"227,75",5,1,1,7,Mid-Value,Potential Loyalists
37411,200,8,"516,85",5,2,1,8,High-Value,Potential Loyalists
37413,1031,2,"100,85",3,1,1,5,Low-Value,At Risk Customers
37415,308,6,"262,65000000000003",5,1,1,7,Mid-Value,Potential Loyalists
37417,198,6,"337,40000000000003",5,1,1,7,Mid-Value,Potential Loyalists
37418,106,2,"147,8",5,1,1,7,Mid-Value,Potential Loyalists
37419,853,2,"164,6",3,1,1,5,Low-Value,At Risk Customers
37420,41,5,"515,95",5,1,1,7,Mid-Value,Potential Loyalists
37421,18,5,"403,7",5,1,1,7,Mid-Value,Potential Loyalists
37422,812,1,"22,55",3,1,1,5,Low-Value,At Risk Customers
37423,535,2,"100,25",4,1,1,6,Mid-Value,Potential Loyalists
37424,398,2,"13,4",4,1,1,6,Mid-Value,Potential Loyalists
37426,208,1,"124,3",5,1,1,7,Mid-Value,Potential Loyalists
37427,1088,1,"1854,0",3,1,3,7,Mid-Value,Potential Loyalists
37431,225,3,"71,45",5,1,1,7,Mid-Value,Potential Loyalists
37432,1247,1,"160,2",2,1,1,4,Low-Value,Can't Lose
37434,25,4,"181,25",5,1,1,7,Mid-Value,Potential Loyalists
37438,1243,2,"70,15",2,1,1,4,Low-Value,Can't Lose
37439,1718,1,"35,25",1,1,1,3,Low-Value,Lost
37442,403,2,"190,65",4,1,1,6,Mid-Value,Potential Loyalists
37443,94,5,"506,34999999999997",5,1,1,7,Mid-Value,Potential Loyalists
37445,7,6,"185,55",5,1,1,7,Mid-Value,Potential Loyalists
37446,853,4,"158,84",3,1,1,5,Low-Value,At Risk Customers
37447,545,5,"477,6",4,1,1,6,Mid-Value,Potential Loyalists
37448,137,6,"557,85",5,1,1,7,Mid-Value,Potential Loyalists
37451,1079,1,"67,8",3,1,1,5,Low-Value,At Risk Customers
37452,139,4,"115,1",5,1,1,7,Mid-Value,Potential Loyalists
37453,624,2,"120,94999999999999",4,1,1,6,Mid-Value,Potential Loyalists
37457,194,3,"112,85",5,1,1,7,Mid-Value,Potential Loyalists
37458,215,1,"2,4000000000000004",5,1,1,7,Mid-Value,Potential Loyalists
37459,84,4,"373,1",5,1,1,7,Mid-Value,Potential Loyalists
37462,484,5,"378,25",4,1,1,6,Mid-Value,Potential Loyalists
37463,54,2,"41,949999999999996",5,1,1,7,Mid-Value,Potential Loyalists
37464,1319,1,"19,25",2,1,1,4,Low-Value,Can't Lose
37465,3,5,"1492,45",5,1,3,9,High-Value,Champions
37466,577,3,"130,95",4,1,1,6,Mid-Value,Potential Loyalists
37467,392,2,"117,4",4,1,1,6,Mid-Value,Potential Loyalists
37468,283,2,"86,5",5,1,1,7,Mid-Value,Potential Loyalists
37469,763,3,"58,45",3,1,1,5,Low-Value,At Risk Customers
37475,183,4,"211,4",5,1,1,7,Mid-Value,Potential Loyalists
37476,349,3,"87,4",5,1,1,7,Mid-Value,Potential Loyalists
37477,704,3,"162,35",4,1,1,6,Mid-Value,Potential Loyalists
37478,243,2,"65,65",5,1,1,7,Mid-Value,Potential Loyalists
37480,267,3,"280,75",5,1,1,7,Mid-Value,Potential Loyalists
37482,206,2,"97,5",5,1,1,7,Mid-Value,Potential Loyalists
37483,456,2,"173,0",4,1,1,6,Mid-Value,Potential Loyalists
37484,368,5,"554,8",4,1,1,6,Mid-Value,Potential Loyalists
37488,934,1,"46,2",3,1,1,5,Low-Value,At Risk Customers
37489,882,1,"15,7",3,1,1,5,Low-Value,At Risk Customers
37490,20,2,"153,79999999999998",5,1,1,7,Mid-Value,Potential Loyalists
37491,1089,1,"19,65",3,1,1,5,Low-Value,At Risk Customers
37492,465,2,"45,900000000000006",4,1,1,6,Mid-Value,Potential Loyalists
37493,924,3,"342,65",3,1,1,5,Low-Value,At Risk Customers
37494,10,4,"132,6",5,1,1,7,Mid-Value,Potential Loyalists
37495,416,3,"74,2",4,1,1,6,Mid-Value,Potential Loyalists
37497,740,6,"754,6",3,1,2,6,Mid-Value,Potential Loyalists
37498,1579,1,"11,45",1,1,1,3,Low-Value,Lost
37499,264,1,"39,05",5,1,1,7,Mid-Value,Potential Loyalists
37500,1536,1,"40,65",1,1,1,3,Low-Value,Lost
37501,368,6,"227,6",4,1,1,6,Mid-Value,Potential Loyalists
37502,1289,2,"132,8",2,1,1,4,Low-Value,Can't Lose
37503,1079,1,"82,95",3,1,1,5,Low-Value,At Risk Customers
37505,221,3,"291,9",5,1,1,7,Mid-Value,Potential Loyalists
37506,1407,2,"92,1",2,1,1,4,Low-Value,Can't Lose
37508,1486,3,"135,35",1,1,1,3,Low-Value,Lost
37509,881,1,"40,1",3,1,1,5,Low-Value,At Risk Customers
37510,8,5,"309,25",5,1,1,7,Mid-Value,Potential Loyalists
37512,540,8,"853,75",4,2,2,8,High-Value,Potential Loyalists
37515,754,3,"108,1",3,1,1,5,Low-Value,At Risk Customers
37516,8,1,"31,0",5,1,1,7,Mid-Value,Potential Loyalists
37517,456,1,"23,45",4,1,1,6,Mid-Value,Potential Loyalists
37518,402,4,"302,15",4,1,1,6,Mid-Value,Potential Loyalists
37519,45,6,"217,05",5,1,1,7,Mid-Value,Potential Loyalists
37521,87,1,"14,35",5,1,1,7,Mid-Value,Potential Loyalists
37522,232,2,"52,1",5,1,1,7,Mid-Value,Potential Loyalists
37524,33,5,"241,65",5,1,1,7,Mid-Value,Potential Loyalists
37525,1250,1,"60,5",2,1,1,4,Low-Value,Can't Lose
37526,1349,1,"40,45",2,1,1,4,Low-Value,Can't Lose
37527,263,3,"271,05",5,1,1,7,Mid-Value,Potential Loyalists
37530,19,1,"17,1",5,1,1,7,Mid-Value,Potential Loyalists
37531,1790,1,"28,75",1,1,1,3,Low-Value,Lost
37532,20,3,"120,2",5,1,1,7,Mid-Value,Potential Loyalists
37533,481,2,"96,8",4,1,1,6,Mid-Value,Potential Loyalists
37535,516,3,"119,10000000000001",4,1,1,6,Mid-Value,Potential Loyalists
37536,298,11,"412,3",5,2,1,8,High-Value,Potential Loyalists
37537,683,6,"359,34999999999997",4,1,1,6,Mid-Value,Potential Loyalists
37538,126,3,"287,5",5,1,1,7,Mid-Value,Potential Loyalists
37539,77,6,"899,05",5,1,2,8,High-Value,Potential Loyalists
37541,726,1,"170,7",4,1,1,6,Mid-Value,Potential Loyalists
37542,934,3,"269,05",3,1,1,5,Low-Value,At Risk Customers
37543,1165,1,"4,7",2,1,1,4,Low-Value,Can't Lose
37545,24,2,"266,7",5,1,1,7,Mid-Value,Potential Loyalists
37547,283,3,"411,55",5,1,1,7,Mid-Value,Potential Loyalists
37555,942,1,"20,7",3,1,1,5,Low-Value,At Risk Customers
37558,881,1,"104,0",3,1,1,5,Low-Value,At Risk Customers
37560,8,1,"16,1",5,1,1,7,Mid-Value,Potential Loyalists
37563,873,5,"244,0",3,1,1,5,Low-Value,At Risk Customers
37565,472,1,"25,0",4,1,1,6,Mid-Value,Potential Loyalists
37566,1660,1,"85,2",1,1,1,3,Low-Value,Lost
37567,631,2,"194,5",4,1,1,6,Mid-Value,Potential Loyalists
37568,1488,2,"57,8",1,1,1,3,Low-Value,Lost
37571,81,3,"79,45",5,1,1,7,Mid-Value,Potential Loyalists
37572,1028,1,"139,35",3,1,1,5,Low-Value,At Risk Customers
37573,1107,2,"56,3",2,1,1,4,Low-Value,Can't Lose
37574,374,5,"228,35",4,1,1,6,Mid-Value,Potential Loyalists
37576,62,8,"553,95",5,2,1,8,High-Value,Potential Loyalists
37577,217,4,"217,1",5,1,1,7,Mid-Value,Potential Loyalists
37578,742,2,"66,1",3,1,1,5,Low-Value,At Risk Customers
37579,495,6,"118,05",4,1,1,6,Mid-Value,Potential Loyalists
37580,10,6,"522,35",5,1,1,7,Mid-Value,Potential Loyalists
37582,130,4,"243,3",5,1,1,7,Mid-Value,Potential Loyalists
37583,147,1,"88,8",5,1,1,7,Mid-Value,Potential Loyalists
37584,361,5,"157,2",5,1,1,7,Mid-Value,Potential Loyalists
37586,9,6,"309,9",5,1,1,7,Mid-Value,Potential Loyalists
37587,268,6,"199,25",5,1,1,7,Mid-Value,Potential Loyalists
37589,1694,2,"80,15",1,1,1,3,Low-Value,Lost
37590,384,6,"325,7",4,1,1,6,Mid-Value,Potential Loyalists
37591,3,6,"312,45",5,1,1,7,Mid-Value,Potential Loyalists
37594,720,2,"264,75",4,1,1,6,Mid-Value,Potential Loyalists
37595,988,1,"8,25",3,1,1,5,Low-Value,At Risk Customers
37597,524,1,"14,8",4,1,1,6,Mid-Value,Potential Loyalists
37598,588,1,"11,15",4,1,1,6,Mid-Value,Potential Loyalists
37600,816,5,"182,05",3,1,1,5,Low-Value,At Risk Customers
37601,925,4,"516,3000000000001",3,1,1,5,Low-Value,At Risk Customers
37602,1241,1,"48,6",2,1,1,4,Low-Value,Can't Lose
37604,35,4,"212,65",5,1,1,7,Mid-Value,Potential Loyalists
37605,335,4,"191,05",5,1,1,7,Mid-Value,Potential Loyalists
37606,816,3,"252,7",3,1,1,5,Low-Value,At Risk Customers
37607,125,1,"43,7",5,1,1,7,Mid-Value,Potential Loyalists
37610,389,4,"858,5",4,1,2,7,Mid-Value,Potential Loyalists
37611,666,4,"150,75",4,1,1,6,Mid-Value,Potential Loyalists
37612,1235,2,"102,5",2,1,1,4,Low-Value,Can't Lose
37616,450,2,"32,4",4,1,1,6,Mid-Value,Potential Loyalists
37618,270,4,"216,65",5,1,1,7,Mid-Value,Potential Loyalists
37619,517,10,"357,09999999999997",4,2,1,7,Mid-Value,Potential Loyalists
37620,465,2,"93,15",4,1,1,6,Mid-Value,Potential Loyalists
37621,213,8,"452,5",5,2,1,8,High-Value,Potential Loyalists
37622,153,3,"86,05",5,1,1,7,Mid-Value,Potential Loyalists
37623,103,2,"128,1",5,1,1,7,Mid-Value,Potential Loyalists
37624,162,5,"258,54999999999995",5,1,1,7,Mid-Value,Potential Loyalists
37625,444,3,"907,5999999999999",4,1,2,7,Mid-Value,Potential Loyalists
37626,1063,1,"42,15",3,1,1,5,Low-Value,At Risk Customers
37630,1768,2,"91,0",1,1,1,3,Low-Value,Lost
37636,206,6,"177,0",5,1,1,7,Mid-Value,Potential Loyalists
37638,363,7,"251,25",5,2,1,8,High-Value,Potential Loyalists
37639,768,2,"58,5",3,1,1,5,Low-Value,At Risk Customers
37640,149,7,"338,25",5,2,1,8,High-Value,Potential Loyalists
37641,1291,2,"84,6",2,1,1,4,Low-Value,Can't Lose
37644,16,6,"310,2",5,1,1,7,Mid-Value,Potential Loyalists
37645,893,1,"125,55000000000001",3,1,1,5,Low-Value,At Risk Customers
37648,15,3,"149,65",5,1,1,7,Mid-Value,Potential Loyalists
37650,591,1,"675,0",4,1,2,7,Mid-Value,Potential Loyalists
37651,1178,1,"37,8",2,1,1,4,Low-Value,Can't Lose
37654,482,3,"303,7",4,1,1,6,Mid-Value,Potential Loyalists
37655,40,2,"31,5",5,1,1,7,Mid-Value,Potential Loyalists
37657,144,7,"215,95",5,2,1,8,High-Value,Potential Loyalists
37658,187,9,"1108,9",5,2,2,9,High-Value,Champions
37659,1731,2,"324,5",1,1,1,3,Low-Value,Lost
37660,798,8,"545,6",3,2,1,6,Mid-Value,Potential Loyalists
37661,948,2,"317,79999999999995",3,1,1,5,Low-Value,At Risk Customers
37663,686,1,"114,1",4,1,1,6,Mid-Value,Potential Loyalists
37664,225,2,"233,85",5,1,1,7,Mid-Value,Potential Loyalists
37666,1808,1,"20,85",1,1,1,3,Low-Value,Lost
37667,724,5,"137,45",4,1,1,6,Mid-Value,Potential Loyalists
37668,1604,1,"18,4",1,1,1,3,Low-Value,Lost
37670,309,6,"269,65",5,1,1,7,Mid-Value,Potential Loyalists
37672,534,1,"3,0",4,1,1,6,Mid-Value,Potential Loyalists
37673,73,7,"718,0",5,2,2,9,High-Value,Champions
37675,87,8,"406,4",5,2,1,8,High-Value,Potential Loyalists
37676,224,5,"293,15",5,1,1,7,Mid-Value,Potential Loyalists
37677,752,5,"222,55",3,1,1,5,Low-Value,At Risk Customers
37678,811,1,"24,0",3,1,1,5,Low-Value,At Risk Customers
37679,915,3,"119,4",3,1,1,5,Low-Value,At Risk Customers
37682,963,2,"171,8",3,1,1,5,Low-Value,At Risk Customers
37683,418,8,"353,0",4,2,1,7,Mid-Value,Potential Loyalists
37684,412,3,"106,8",4,1,1,6,Mid-Value,Potential Loyalists
37687,1600,3,"63,650000000000006",1,1,1,3,Low-Value,Lost
37688,809,5,"176,04999999999998",3,1,1,5,Low-Value,At Risk Customers
37689,428,10,"937,5",4,2,2,8,High-Value,Potential Loyalists
37691,69,8,"683,95",5,2,2,9,High-Value,Champions
37693,1208,2,"60,2",2,1,1,4,Low-Value,Can't Lose
37694,19,4,"135,4",5,1,1,7,Mid-Value,Potential Loyalists
37695,1302,1,"144,0",2,1,1,4,Low-Value,Can't Lose
37696,605,4,"291,9",4,1,1,6,Mid-Value,Potential Loyalists
37698,483,2,"54,55",4,1,1,6,Mid-Value,Potential Loyalists
37699,16,3,"248,34999999999997",5,1,1,7,Mid-Value,Potential Loyalists
37700,722,1,"93,1",4,1,1,6,Mid-Value,Potential Loyalists
37702,132,5,"292,70000000000005",5,1,1,7,Mid-Value,Potential Loyalists
37706,168,6,"187,55",5,1,1,7,Mid-Value,Potential Loyalists
37708,803,3,"128,55",3,1,1,5,Low-Value,At Risk Customers
37709,866,4,"1563,8",3,1,3,7,Mid-Value,Potential Loyalists
37710,1503,2,"21,0",1,1,1,3,Low-Value,Lost
37711,21,6,"289,0",5,1,1,7,Mid-Value,Potential Loyalists
37712,161,7,"330,25",5,2,1,8,High-Value,Potential Loyalists
37713,1689,1,"116,25",1,1,1,3,Low-Value,Lost
37714,1138,2,"144,25",2,1,1,4,Low-Value,Can't Lose
37716,1196,2,"49,1",2,1,1,4,Low-Value,Can't Lose
37719,766,1,"10,2",3,1,1,5,Low-Value,At Risk Customers
37721,425,1,"8,1",4,1,1,6,Mid-Value,Potential Loyalists
37722,284,4,"281,1",5,1,1,7,Mid-Value,Potential Loyalists
37723,150,3,"369,84999999999997",5,1,1,7,Mid-Value,Potential Loyalists
37724,54,4,"120,5",5,1,1,7,Mid-Value,Potential Loyalists
37725,1706,2,"81,05000000000001",1,1,1,3,Low-Value,Lost
37727,1219,3,"86,85",2,1,1,4,Low-Value,Can't Lose
37728,435,3,"23,5",4,1,1,6,Mid-Value,Potential Loyalists
37729,169,4,"74,0",5,1,1,7,Mid-Value,Potential Loyalists
37731,249,2,"59,8",5,1,1,7,Mid-Value,Potential Loyalists
37732,663,1,"10,6",4,1,1,6,Mid-Value,Potential Loyalists
37733,809,5,"216,89999999999998",3,1,1,5,Low-Value,At Risk Customers
37734,19,9,"648,35",5,2,1,8,High-Value,Potential Loyalists
37735,54,4,"133,70000000000002",5,1,1,7,Mid-Value,Potential Loyalists
37737,276,3,"40,7",5,1,1,7,Mid-Value,Potential Loyalists
37738,627,4,"249,2",4,1,1,6,Mid-Value,Potential Loyalists
37740,361,3,"83,35",5,1,1,7,Mid-Value,Potential Loyalists
37743,188,3,"134,2",5,1,1,7,Mid-Value,Potential Loyalists
37745,393,1,"59,6",4,1,1,6,Mid-Value,Potential Loyalists
37746,943,1,"14,3",3,1,1,5,Low-Value,At Risk Customers
37747,626,2,"10,4",4,1,1,6,Mid-Value,Potential Loyalists
37750,11,1,"18,6",5,1,1,7,Mid-Value,Potential Loyalists
37751,1035,2,"89,60000000000001",3,1,1,5,Low-Value,At Risk Customers
37752,899,1,"270,0",3,1,1,5,Low-Value,At Risk Customers
37755,1677,1,"162,8",1,1,1,3,Low-Value,Lost
37756,353,4,"77,8",5,1,1,7,Mid-Value,Potential Loyalists
37757,131,1,"55,0",5,1,1,7,Mid-Value,Potential Loyalists
37758,232,2,"16,25",5,1,1,7,Mid-Value,Potential Loyalists
37759,762,2,"87,6",3,1,1,5,Low-Value,At Risk Customers
37761,1355,1,"30,75",2,1,1,4,Low-Value,Can't Lose
37763,541,4,"344,5",4,1,1,6,Mid-Value,Potential Loyalists
37764,405,8,"467,25",4,2,1,7,Mid-Value,Potential Loyalists
37765,103,4,"328,25",5,1,1,7,Mid-Value,Potential Loyalists
37769,87,1,"9,15",5,1,1,7,Mid-Value,Potential Loyalists
37770,329,3,"407,2",5,1,1,7,Mid-Value,Potential Loyalists
37771,1479,3,"195,9",1,1,1,3,Low-Value,Lost
37772,210,4,"150,1",5,1,1,7,Mid-Value,Potential Loyalists
37773,499,3,"284,6",4,1,1,6,Mid-Value,Potential Loyalists
37774,1010,1,"41,6",3,1,1,5,Low-Value,At Risk Customers
37777,747,1,"12,5",3,1,1,5,Low-Value,At Risk Customers
37778,931,5,"230,1",3,1,1,5,Low-Value,At Risk Customers
37781,844,4,"166,4",3,1,1,5,Low-Value,At Risk Customers
37782,1062,1,"20,8",3,1,1,5,Low-Value,At Risk Customers
37786,1306,3,"227,5",2,1,1,4,Low-Value,Can't Lose
37788,1651,1,"51,9",1,1,1,3,Low-Value,Lost
37789,38,5,"163,45",5,1,1,7,Mid-Value,Potential Loyalists
37790,339,3,"463,3",5,1,1,7,Mid-Value,Potential Loyalists
37791,1008,1,"188,5",3,1,1,5,Low-Value,At Risk Customers
37792,35,2,"53,3",5,1,1,7,Mid-Value,Potential Loyalists
37793,344,1,"29,35",5,1,1,7,Mid-Value,Potential Loyalists
37794,10,5,"174,15",5,1,1,7,Mid-Value,Potential Loyalists
37795,33,2,"87,15",5,1,1,7,Mid-Value,Potential Loyalists
37796,1028,2,"54,650000000000006",3,1,1,5,Low-Value,At Risk Customers
37797,1611,1,"6,05",1,1,1,3,Low-Value,Lost
37798,211,3,"108,60000000000001",5,1,1,7,Mid-Value,Potential Loyalists
37799,1184,2,"161,2",2,1,1,4,Low-Value,Can't Lose
37800,94,3,"127,4",5,1,1,7,Mid-Value,Potential Loyalists
37801,1791,1,"64,25",1,1,1,3,Low-Value,Lost
37803,1039,2,"277,40000000000003",3,1,1,5,Low-Value,At Risk Customers
37804,991,3,"92,1",3,1,1,5,Low-Value,At Risk Customers
37805,158,2,"67,65",5,1,1,7,Mid-Value,Potential Loyalists
37808,292,4,"98,4",5,1,1,7,Mid-Value,Potential Loyalists
37809,585,2,"130,3",4,1,1,6,Mid-Value,Potential Loyalists
37810,24,10,"565,45",5,2,1,8,High-Value,Potential Loyalists
37813,568,2,"162,3",4,1,1,6,Mid-Value,Potential Loyalists
37814,517,4,"206,85",4,1,1,6,Mid-Value,Potential Loyalists
37815,452,7,"561,9",4,2,1,7,Mid-Value,Potential Loyalists
37816,901,4,"240,15",3,1,1,5,Low-Value,At Risk Customers
37817,56,3,"85,15",5,1,1,7,Mid-Value,Potential Loyalists
37819,814,3,"222,05",3,1,1,5,Low-Value,At Risk Customers
37820,988,1,"33,6",3,1,1,5,Low-Value,At Risk Customers
37824,141,9,"636,55",5,2,1,8,High-Value,Potential Loyalists
37825,740,2,"156,9",3,1,1,5,Low-Value,At Risk Customers
37829,299,2,"286,55",5,1,1,7,Mid-Value,Potential Loyalists
37830,978,3,"175,25",3,1,1,5,Low-Value,At Risk Customers
37831,460,3,"129,7",4,1,1,6,Mid-Value,Potential Loyalists
37832,1424,2,"515,15",2,1,1,4,Low-Value,Can't Lose
37833,112,1,"16,15",5,1,1,7,Mid-Value,Potential Loyalists
37834,192,5,"348,8",5,1,1,7,Mid-Value,Potential Loyalists
37835,435,2,"81,94999999999999",4,1,1,6,Mid-Value,Potential Loyalists
37836,590,2,"74,7",4,1,1,6,Mid-Value,Potential Loyalists
37837,1107,3,"282,25",2,1,1,4,Low-Value,Can't Lose
37838,23,15,"1675,8999999999999",5,3,3,11,High-Value,Champions
37839,1465,1,"43,7",1,1,1,3,Low-Value,Lost
37841,1074,2,"45,8",3,1,1,5,Low-Value,At Risk Customers
37843,685,2,"332,3",4,1,1,6,Mid-Value,Potential Loyalists
37844,377,5,"134,15",4,1,1,6,Mid-Value,Potential Loyalists
37847,1617,1,"29,849999999999998",1,1,1,3,Low-Value,Lost
37849,276,2,"26,75",5,1,1,7,Mid-Value,Potential Loyalists
37850,519,2,"59,400000000000006",4,1,1,6,Mid-Value,Potential Loyalists
37851,725,2,"205,39999999999998",4,1,1,6,Mid-Value,Potential Loyalists
37852,1337,2,"105,39999999999999",2,1,1,4,Low-Value,Can't Lose
37854,49,16,"983,15",5,3,2,10,High-Value,Champions
37855,617,1,"20,4",4,1,1,6,Mid-Value,Potential Loyalists
37856,18,12,"676,6999999999999",5,3,2,10,High-Value,Champions
37859,103,2,"59,0",5,1,1,7,Mid-Value,Potential Loyalists
37860,42,5,"208,4",5,1,1,7,Mid-Value,Potential Loyalists
37861,148,6,"710,3",5,1,2,8,High-Value,Potential Loyalists
37862,315,3,"172,2",5,1,1,7,Mid-Value,Potential Loyalists
37863,38,6,"384,4",5,1,1,7,Mid-Value,Potential Loyalists
37864,232,3,"96,1",5,1,1,7,Mid-Value,Potential Loyalists
37865,531,2,"291,5",4,1,1,6,Mid-Value,Potential Loyalists
37867,361,6,"410,3",5,1,1,7,Mid-Value,Potential Loyalists
37868,531,3,"309,9",4,1,1,6,Mid-Value,Potential Loyalists
37870,292,6,"356,3",5,1,1,7,Mid-Value,Potential Loyalists
37871,1514,2,"166,2",1,1,1,3,Low-Value,Lost
37873,113,2,"97,1",5,1,1,7,Mid-Value,Potential Loyalists
37878,553,2,"163,15",4,1,1,6,Mid-Value,Potential Loyalists
37880,698,4,"224,35",4,1,1,6,Mid-Value,Potential Loyalists
37881,201,5,"231,75",5,1,1,7,Mid-Value,Potential Loyalists
37883,652,2,"22,7",4,1,1,6,Mid-Value,Potential Loyalists
37887,826,1,"15,0",3,1,1,5,Low-Value,At Risk Customers
37888,944,4,"333,1",3,1,1,5,Low-Value,At Risk Customers
37889,971,4,"380,44999999999993",3,1,1,5,Low-Value,At Risk Customers
37890,1489,2,"65,80000000000001",1,1,1,3,Low-Value,Lost
37894,1265,3,"92,64999999999999",2,1,1,4,Low-Value,Can't Lose
37896,833,1,"25,5",3,1,1,5,Low-Value,At Risk Customers
37897,512,2,"448,70000000000005",4,1,1,6,Mid-Value,Potential Loyalists
37898,293,5,"160,05",5,1,1,7,Mid-Value,Potential Loyalists
37900,602,3,"42,599999999999994",4,1,1,6,Mid-Value,Potential Loyalists
37901,53,3,"372,55",5,1,1,7,Mid-Value,Potential Loyalists
37903,557,2,"139,7",4,1,1,6,Mid-Value,Potential Loyalists
37904,1497,2,"58,7",1,1,1,3,Low-Value,Lost
37905,1310,1,"17,5",2,1,1,4,Low-Value,Can't Lose
37907,900,1,"80,3",3,1,1,5,Low-Value,At Risk Customers
37908,399,3,"50,9",4,1,1,6,Mid-Value,Potential Loyalists
37909,1237,2,"722,3",2,1,2,5,Low-Value,At Risk Customers
37910,1016,1,"46,65",3,1,1,5,Low-Value,At Risk Customers
37911,946,4,"335,6",3,1,1,5,Low-Value,At Risk Customers
37913,1259,5,"285,1",2,1,1,4,Low-Value,Can't Lose
37914,57,2,"97,6",5,1,1,7,Mid-Value,Potential Loyalists
37915,678,4,"125,6",4,1,1,6,Mid-Value,Potential Loyalists
37916,1277,3,"145,0",2,1,1,4,Low-Value,Can't Lose
37917,14,5,"332,5",5,1,1,7,Mid-Value,Potential Loyalists
37918,9,2,"35,55",5,1,1,7,Mid-Value,Potential Loyalists
37919,203,3,"68,5",5,1,1,7,Mid-Value,Potential Loyalists
37921,82,2,"113,5",5,1,1,7,Mid-Value,Potential Loyalists
37922,242,1,"269,70000000000005",5,1,1,7,Mid-Value,Potential Loyalists
37923,726,1,"52,8",4,1,1,6,Mid-Value,Potential Loyalists
37924,254,1,"17,85",5,1,1,7,Mid-Value,Potential Loyalists
37925,1023,5,"196,6",3,1,1,5,Low-Value,At Risk Customers
37926,20,5,"347,79999999999995",5,1,1,7,Mid-Value,Potential Loyalists
37928,1360,1,"300,4",2,1,1,4,Low-Value,Can't Lose
37929,192,1,"100,4",5,1,1,7,Mid-Value,Potential Loyalists
37930,127,1,"97,5",5,1,1,7,Mid-Value,Potential Loyalists
37940,620,3,"529,7",4,1,1,6,Mid-Value,Potential Loyalists
37941,385,8,"427,8",4,2,1,7,Mid-Value,Potential Loyalists
37942,207,2,"187,0",5,1,1,7,Mid-Value,Potential Loyalists
37943,599,3,"41,6",4,1,1,6,Mid-Value,Potential Loyalists
37944,100,5,"272,0",5,1,1,7,Mid-Value,Potential Loyalists
37945,71,6,"192,64999999999998",5,1,1,7,Mid-Value,Potential Loyalists
37946,420,3,"97,85000000000001",4,1,1,6,Mid-Value,Potential Loyalists
37952,111,7,"696,5",5,2,2,9,High-Value,Champions
37955,1123,2,"97,0",2,1,1,4,Low-Value,Can't Lose
37956,756,3,"438,90000000000003",3,1,1,5,Low-Value,At Risk Customers
37957,941,3,"416,54999999999995",3,1,1,5,Low-Value,At Risk Customers
37958,195,2,"36,75",5,1,1,7,Mid-Value,Potential Loyalists
37961,612,3,"252,00000000000003",4,1,1,6,Mid-Value,Potential Loyalists
37965,1483,1,"39,95",1,1,1,3,Low-Value,Lost
37966,327,2,"16,1",5,1,1,7,Mid-Value,Potential Loyalists
37967,41,3,"278,8",5,1,1,7,Mid-Value,Potential Loyalists
37970,743,6,"428,4",3,1,1,5,Low-Value,At Risk Customers
37971,593,1,"40,8",4,1,1,6,Mid-Value,Potential Loyalists
37972,505,3,"135,65",4,1,1,6,Mid-Value,Potential Loyalists
37977,425,3,"218,3",4,1,1,6,Mid-Value,Potential Loyalists
37978,771,5,"421,4",3,1,1,5,Low-Value,At Risk Customers
37980,189,3,"137,25",5,1,1,7,Mid-Value,Potential Loyalists
37982,801,1,"19,5",3,1,1,5,Low-Value,At Risk Customers
37988,991,3,"72,6",3,1,1,5,Low-Value,At Risk Customers
37989,117,4,"147,45",5,1,1,7,Mid-Value,Potential Loyalists
37990,1670,1,"24,4",1,1,1,3,Low-Value,Lost
37993,760,3,"222,85000000000002",3,1,1,5,Low-Value,At Risk Customers
37994,118,3,"142,4",5,1,1,7,Mid-Value,Potential Loyalists
37998,1136,1,"63,2",2,1,1,4,Low-Value,Can't Lose
37999,68,3,"132,05",5,1,1,7,Mid-Value,Potential Loyalists
38000,745,2,"69,15",3,1,1,5,Low-Value,At Risk Customers
38002,904,2,"62,6",3,1,1,5,Low-Value,At Risk Customers
38003,1294,2,"74,05",2,1,1,4,Low-Value,Can't Lose
38005,1322,2,"101,6",2,1,1,4,Low-Value,Can't Lose
38008,822,1,"64,6",3,1,1,5,Low-Value,At Risk Customers
38009,365,4,"108,5",5,1,1,7,Mid-Value,Potential Loyalists
38011,24,4,"1237,35",5,1,2,8,High-Value,Potential Loyalists
38012,1445,1,"5,95",2,1,1,4,Low-Value,Can't Lose
38013,531,3,"103,0",4,1,1,6,Mid-Value,Potential Loyalists
38014,194,3,"58,25",5,1,1,7,Mid-Value,Potential Loyalists
38016,153,1,"40,1",5,1,1,7,Mid-Value,Potential Loyalists
38017,774,6,"497,95",3,1,1,5,Low-Value,At Risk Customers
38018,1552,1,"209,45",1,1,1,3,Low-Value,Lost
38019,838,2,"149,7",3,1,1,5,Low-Value,At Risk Customers
38022,218,8,"445,9",5,2,1,8,High-Value,Potential Loyalists
38024,143,5,"600,6500000000001",5,1,1,7,Mid-Value,Potential Loyalists
38025,751,2,"134,3",3,1,1,5,Low-Value,At Risk Customers
38027,948,2,"96,75",3,1,1,5,Low-Value,At Risk Customers
38028,103,6,"208,35",5,1,1,7,Mid-Value,Potential Loyalists
38030,1685,1,"4,0",1,1,1,3,Low-Value,Lost
38031,175,5,"635,4499999999999",5,1,1,7,Mid-Value,Potential Loyalists
38032,1152,1,"18,9",2,1,1,4,Low-Value,Can't Lose
38033,5,5,"284,55",5,1,1,7,Mid-Value,Potential Loyalists
38034,224,2,"141,9",5,1,1,7,Mid-Value,Potential Loyalists
38035,1454,1,"25,6",2,1,1,4,Low-Value,Can't Lose
38036,1468,4,"151,1",1,1,1,3,Low-Value,Lost
38037,88,7,"743,5",5,2,2,9,High-Value,Champions
38038,596,3,"92,8",4,1,1,6,Mid-Value,Potential Loyalists
38040,24,1,"23,9",5,1,1,7,Mid-Value,Potential Loyalists
38043,300,5,"441,95000000000005",5,1,1,7,Mid-Value,Potential Loyalists
38044,52,9,"694,9499999999999",5,2,2,9,High-Value,Champions
38045,1305,1,"125,0",2,1,1,4,Low-Value,Can't Lose
38047,12,6,"560,0999999999999",5,1,1,7,Mid-Value,Potential Loyalists
38049,768,2,"53,25",3,1,1,5,Low-Value,At Risk Customers
38051,1052,1,"76,9",3,1,1,5,Low-Value,At Risk Customers
38052,921,2,"253,25",3,1,1,5,Low-Value,At Risk Customers
38054,516,3,"76,1",4,1,1,6,Mid-Value,Potential Loyalists
38056,964,2,"206,70000000000002",3,1,1,5,Low-Value,At Risk Customers
38058,1765,1,"9,3",1,1,1,3,Low-Value,Lost
38060,236,4,"219,45",5,1,1,7,Mid-Value,Potential Loyalists
38061,1046,1,"12,2",3,1,1,5,Low-Value,At Risk Customers
38062,594,2,"496,7",4,1,1,6,Mid-Value,Potential Loyalists
38063,249,3,"90,4",5,1,1,7,Mid-Value,Potential Loyalists
38064,110,3,"137,55",5,1,1,7,Mid-Value,Potential Loyalists
38065,1090,1,"27,5",3,1,1,5,Low-Value,At Risk Customers
38067,712,5,"658,25",4,1,1,6,Mid-Value,Potential Loyalists
38068,342,2,"31,85",5,1,1,7,Mid-Value,Potential Loyalists
38069,1312,3,"111,1",2,1,1,4,Low-Value,Can't Lose
38070,20,4,"291,8",5,1,1,7,Mid-Value,Potential Loyalists
38072,621,2,"94,75",4,1,1,6,Mid-Value,Potential Loyalists
38073,884,3,"217,55",3,1,1,5,Low-Value,At Risk Customers
38074,1032,1,"40,7",3,1,1,5,Low-Value,At Risk Customers
38076,1421,1,"45,2",2,1,1,4,Low-Value,Can't Lose
38077,1251,1,"151,0",2,1,1,4,Low-Value,Can't Lose
38078,300,1,"37,7",5,1,1,7,Mid-Value,Potential Loyalists
38081,1714,2,"25,1",1,1,1,3,Low-Value,Lost
38082,385,1,"237,0",4,1,1,6,Mid-Value,Potential Loyalists
38083,500,1,"148,3",4,1,1,6,Mid-Value,Potential Loyalists
38084,983,2,"111,69999999999999",3,1,1,5,Low-Value,At Risk Customers
38088,1765,1,"16,7",1,1,1,3,Low-Value,Lost
38092,1538,2,"36,75",1,1,1,3,Low-Value,Lost
38094,28,4,"531,4",5,1,1,7,Mid-Value,Potential Loyalists
38095,928,1,"68,5",3,1,1,5,Low-Value,At Risk Customers
38096,213,2,"126,75",5,1,1,7,Mid-Value,Potential Loyalists
38097,759,1,"26,8",3,1,1,5,Low-Value,At Risk Customers
38100,23,3,"293,55",5,1,1,7,Mid-Value,Potential Loyalists
38101,797,4,"158,55",3,1,1,5,Low-Value,At Risk Customers
38103,26,5,"151,55",5,1,1,7,Mid-Value,Potential Loyalists
38104,507,6,"521,5500000000001",4,1,1,6,Mid-Value,Potential Loyalists
38105,894,1,"20,46",3,1,1,5,Low-Value,At Risk Customers
38107,48,7,"598,0",5,2,1,8,High-Value,Potential Loyalists
38108,547,2,"27,8",4,1,1,6,Mid-Value,Potential Loyalists
38109,377,4,"293,6",4,1,1,6,Mid-Value,Potential Loyalists
38110,300,2,"68,45",5,1,1,7,Mid-Value,Potential Loyalists
38111,187,2,"75,9",5,1,1,7,Mid-Value,Potential Loyalists
38115,889,2,"84,55",3,1,1,5,Low-Value,At Risk Customers
38116,782,4,"89,25",3,1,1,5,Low-Value,At Risk Customers
38117,881,1,"90,8",3,1,1,5,Low-Value,At Risk Customers
38118,1252,3,"221,0",2,1,1,4,Low-Value,Can't Lose
38119,231,5,"161,65",5,1,1,7,Mid-Value,Potential Loyalists
38120,740,4,"164,5",3,1,1,5,Low-Value,At Risk Customers
38121,1210,1,"174,3",2,1,1,4,Low-Value,Can't Lose
38124,447,2,"52,35",4,1,1,6,Mid-Value,Potential Loyalists
38125,31,6,"119,55000000000001",5,1,1,7,Mid-Value,Potential Loyalists
38127,1705,1,"25,45",1,1,1,3,Low-Value,Lost
38128,962,2,"94,6",3,1,1,5,Low-Value,At Risk Customers
38129,1623,1,"73,65",1,1,1,3,Low-Value,Lost
38131,678,1,"43,55",4,1,1,6,Mid-Value,Potential Loyalists
38132,1065,1,"160,6",3,1,1,5,Low-Value,At Risk Customers
38133,88,11,"652,65",5,2,1,8,High-Value,Potential Loyalists
38134,1421,1,"11,2",2,1,1,4,Low-Value,Can't Lose
38137,30,4,"164,95",5,1,1,7,Mid-Value,Potential Loyalists
38138,528,3,"128,3",4,1,1,6,Mid-Value,Potential Loyalists
38139,59,6,"850,4000000000001",5,1,2,8,High-Value,Potential Loyalists
38142,125,1,"51,599999999999994",5,1,1,7,Mid-Value,Potential Loyalists
38145,867,3,"66,15",3,1,1,5,Low-Value,At Risk Customers
38147,1602,1,"53,9",1,1,1,3,Low-Value,Lost
38148,1059,1,"412,3",3,1,1,5,Low-Value,At Risk Customers
38150,1614,2,"574,35",1,1,1,3,Low-Value,Lost
38151,1572,1,"9,45",1,1,1,3,Low-Value,Lost
38154,118,3,"194,6",5,1,1,7,Mid-Value,Potential Loyalists
38158,1274,4,"267,3",2,1,1,4,Low-Value,Can't Lose
38159,208,3,"298,3",5,1,1,7,Mid-Value,Potential Loyalists
38160,186,2,"38,400000000000006",5,1,1,7,Mid-Value,Potential Loyalists
38161,18,4,"231,05",5,1,1,7,Mid-Value,Potential Loyalists
38162,934,1,"152,6",3,1,1,5,Low-Value,At Risk Customers
38170,1030,1,"5,8",3,1,1,5,Low-Value,At Risk Customers
38172,54,5,"160,85",5,1,1,7,Mid-Value,Potential Loyalists
38174,23,2,"27,9",5,1,1,7,Mid-Value,Potential Loyalists
38175,715,1,"17,95",4,1,1,6,Mid-Value,Potential Loyalists
38177,1622,1,"89,7",1,1,1,3,Low-Value,Lost
38181,87,6,"300,5",5,1,1,7,Mid-Value,Potential Loyalists
38182,1240,2,"116,89999999999999",2,1,1,4,Low-Value,Can't Lose
38185,76,3,"194,7",5,1,1,7,Mid-Value,Potential Loyalists
38187,1329,1,"21,35",2,1,1,4,Low-Value,Can't Lose
38188,1222,3,"302,2",2,1,1,4,Low-Value,Can't Lose
38194,763,3,"98,95",3,1,1,5,Low-Value,At Risk Customers
38195,430,6,"628,4499999999999",4,1,1,6,Mid-Value,Potential Loyalists
38197,1818,1,"72,4",1,1,1,3,Low-Value,Lost
38198,236,3,"166,45",5,1,1,7,Mid-Value,Potential Loyalists
38200,283,2,"165,35",5,1,1,7,Mid-Value,Potential Loyalists
38201,740,14,"867,45",3,3,2,8,High-Value,Potential Loyalists
38202,630,4,"222,2",4,1,1,6,Mid-Value,Potential Loyalists
38204,74,2,"74,60000000000001",5,1,1,7,Mid-Value,Potential Loyalists
38205,1810,1,"23,75",1,1,1,3,Low-Value,Lost
38206,19,3,"337,4",5,1,1,7,Mid-Value,Potential Loyalists
38207,334,6,"156,85",5,1,1,7,Mid-Value,Potential Loyalists
38210,930,2,"248,9",3,1,1,5,Low-Value,At Risk Customers
38211,7,6,"196,25",5,1,1,7,Mid-Value,Potential Loyalists
38213,457,3,"172,05",4,1,1,6,Mid-Value,Potential Loyalists
38215,1005,1,"287,1",3,1,1,5,Low-Value,At Risk Customers
38216,613,2,"503,9",4,1,1,6,Mid-Value,Potential Loyalists
38218,81,1,"11,4",5,1,1,7,Mid-Value,Potential Loyalists
38220,824,1,"14,8",3,1,1,5,Low-Value,At Risk Customers
38222,1815,1,"149,9",1,1,1,3,Low-Value,Lost
38225,85,3,"31,550000000000004",5,1,1,7,Mid-Value,Potential Loyalists
38226,461,1,"31,95",4,1,1,6,Mid-Value,Potential Loyalists
38229,672,5,"261,95",4,1,1,6,Mid-Value,Potential Loyalists
38231,1499,2,"106,95",1,1,1,3,Low-Value,Lost
38233,748,1,"523,25",3,1,1,5,Low-Value,At Risk Customers
38235,1136,3,"63,300000000000004",2,1,1,4,Low-Value,Can't Lose
38237,1030,7,"655,95",3,2,1,6,Mid-Value,Potential Loyalists
38240,638,3,"64,9",4,1,1,6,Mid-Value,Potential Loyalists
38241,327,2,"79,2",5,1,1,7,Mid-Value,Potential Loyalists
38244,823,2,"16,6",3,1,1,5,Low-Value,At Risk Customers
38247,236,2,"30,35",5,1,1,7,Mid-Value,Potential Loyalists
38248,1668,7,"346,0",1,2,1,4,Low-Value,Can't Lose
38249,87,1,"398,3",5,1,1,7,Mid-Value,Potential Loyalists
38250,132,1,"20,7",5,1,1,7,Mid-Value,Potential Loyalists
38252,1317,4,"222,89999999999998",2,1,1,4,Low-Value,Can't Lose
38254,510,1,"120,1",4,1,1,6,Mid-Value,Potential Loyalists
38255,115,5,"195,0",5,1,1,7,Mid-Value,Potential Loyalists
38256,1232,1,"24,6",2,1,1,4,Low-Value,Can't Lose
38258,953,1,"58,8",3,1,1,5,Low-Value,At Risk Customers
38259,208,2,"187,2",5,1,1,7,Mid-Value,Potential Loyalists
38260,596,2,"136,7",4,1,1,6,Mid-Value,Potential Loyalists
38261,123,7,"413,0",5,2,1,8,High-Value,Potential Loyalists
38263,193,5,"251,35",5,1,1,7,Mid-Value,Potential Loyalists
38264,355,2,"109,35000000000001",5,1,1,7,Mid-Value,Potential Loyalists
38268,458,6,"333,45",4,1,1,6,Mid-Value,Potential Loyalists
38270,17,10,"681,35",5,2,2,9,High-Value,Champions
38274,101,3,"50,05",5,1,1,7,Mid-Value,Potential Loyalists
38275,463,2,"27,5",4,1,1,6,Mid-Value,Potential Loyalists
38278,12,10,"612,45",5,2,1,8,High-Value,Potential Loyalists
38281,776,1,"51,55",3,1,1,5,Low-Value,At Risk Customers
38282,964,1,"117,2",3,1,1,5,Low-Value,At Risk Customers
38283,382,1,"8,1",4,1,1,6,Mid-Value,Potential Loyalists
38284,635,2,"59,1",4,1,1,6,Mid-Value,Potential Loyalists
38285,272,1,"15,45",5,1,1,7,Mid-Value,Potential Loyalists
38286,714,2,"81,75",4,1,1,6,Mid-Value,Potential Loyalists
38288,26,7,"436,2",5,2,1,8,High-Value,Potential Loyalists
38289,1119,4,"255,45000000000002",2,1,1,4,Low-Value,Can't Lose
38290,1459,1,"30,0",2,1,1,4,Low-Value,Can't Lose
38291,400,8,"501,25",4,2,1,7,Mid-Value,Potential Loyalists
38292,482,2,"74,75",4,1,1,6,Mid-Value,Potential Loyalists
38293,512,1,"41,4",4,1,1,6,Mid-Value,Potential Loyalists
38294,490,6,"231,35",4,1,1,6,Mid-Value,Potential Loyalists
38296,172,1,"66,75",5,1,1,7,Mid-Value,Potential Loyalists
38297,24,6,"481,0",5,1,1,7,Mid-Value,Potential Loyalists
38299,1062,1,"27,15",3,1,1,5,Low-Value,At Risk Customers
38300,1677,2,"220,55",1,1,1,3,Low-Value,Lost
38301,782,2,"356,45",3,1,1,5,Low-Value,At Risk Customers
38305,900,2,"56,3",3,1,1,5,Low-Value,At Risk Customers
38306,482,1,"57,05",4,1,1,6,Mid-Value,Potential Loyalists
38307,83,4,"663,15",5,1,1,7,Mid-Value,Potential Loyalists
38308,375,10,"1243,3",4,2,2,8,High-Value,Potential Loyalists
38312,766,4,"266,25",3,1,1,5,Low-Value,At Risk Customers
38314,682,3,"83,1",4,1,1,6,Mid-Value,Potential Loyalists
38315,46,2,"46,650000000000006",5,1,1,7,Mid-Value,Potential Loyalists
38318,1488,1,"16,8",1,1,1,3,Low-Value,Lost
38320,227,5,"363,6",5,1,1,7,Mid-Value,Potential Loyalists
38323,168,3,"118,95",5,1,1,7,Mid-Value,Potential Loyalists
38324,283,5,"127,95",5,1,1,7,Mid-Value,Potential Loyalists
38326,916,3,"524,3000000000001",3,1,1,5,Low-Value,At Risk Customers
38327,505,1,"90,7",4,1,1,6,Mid-Value,Potential Loyalists
38328,68,2,"53,05",5,1,1,7,Mid-Value,Potential Loyalists
38330,122,4,"200,45",5,1,1,7,Mid-Value,Potential Loyalists
38331,0,4,"93,95",5,1,1,7,Mid-Value,Potential Loyalists
38333,703,13,"514,95",4,3,1,8,High-Value,Potential Loyalists
38335,149,11,"843,9",5,2,2,9,High-Value,Champions
38336,1517,3,"60,7",1,1,1,3,Low-Value,Lost
38338,193,3,"171,6",5,1,1,7,Mid-Value,Potential Loyalists
38339,1037,1,"10,85",3,1,1,5,Low-Value,At Risk Customers
38340,1090,2,"50,6",3,1,1,5,Low-Value,At Risk Customers
38341,221,3,"122,8",5,1,1,7,Mid-Value,Potential Loyalists
38342,1399,2,"46,25",2,1,1,4,Low-Value,Can't Lose
38343,1539,4,"140,9",1,1,1,3,Low-Value,Lost
38344,1114,1,"58,6",2,1,1,4,Low-Value,Can't Lose
38345,66,3,"194,4",5,1,1,7,Mid-Value,Potential Loyalists
38347,1050,2,"38,75",3,1,1,5,Low-Value,At Risk Customers
38349,1162,1,"30,95",2,1,1,4,Low-Value,Can't Lose
38351,49,2,"30,9",5,1,1,7,Mid-Value,Potential Loyalists
38352,577,1,"52,2",4,1,1,6,Mid-Value,Potential Loyalists
38353,204,9,"806,5",5,2,2,9,High-Value,Champions
38355,458,1,"43,2",4,1,1,6,Mid-Value,Potential Loyalists
38356,3,2,"71,06",5,1,1,7,Mid-Value,Potential Loyalists
38358,536,1,"20,0",4,1,1,6,Mid-Value,Potential Loyalists
38359,909,1,"14,65",3,1,1,5,Low-Value,At Risk Customers
38362,639,3,"217,29999999999998",4,1,1,6,Mid-Value,Potential Loyalists
38365,775,3,"367,90000000000003",3,1,1,5,Low-Value,At Risk Customers
38367,997,4,"434,4",3,1,1,5,Low-Value,At Risk Customers
38369,666,1,"32,5",4,1,1,6,Mid-Value,Potential Loyalists
38370,719,1,"45,35",4,1,1,6,Mid-Value,Potential Loyalists
38371,763,2,"23,55",3,1,1,5,Low-Value,At Risk Customers
38372,3,2,"404,8",5,1,1,7,Mid-Value,Potential Loyalists
38374,885,3,"103,6",3,1,1,5,Low-Value,At Risk Customers
38375,215,11,"428,8",5,2,1,8,High-Value,Potential Loyalists
38376,738,1,"291,15",3,1,1,5,Low-Value,At Risk Customers
38379,832,2,"83,39999999999999",3,1,1,5,Low-Value,At Risk Customers
38380,385,2,"94,9",4,1,1,6,Mid-Value,Potential Loyalists
38381,1336,1,"28,3",2,1,1,4,Low-Value,Can't Lose
38383,102,3,"154,5",5,1,1,7,Mid-Value,Potential Loyalists
38386,1643,1,"7,9",1,1,1,3,Low-Value,Lost
38387,487,4,"206,15",4,1,1,6,Mid-Value,Potential Loyalists
38388,353,4,"173,0",5,1,1,7,Mid-Value,Potential Loyalists
38389,105,1,"42,45",5,1,1,7,Mid-Value,Potential Loyalists
38390,941,4,"223,35",3,1,1,5,Low-Value,At Risk Customers
38391,1177,1,"97,85",2,1,1,4,Low-Value,Can't Lose
38392,268,2,"51,55",5,1,1,7,Mid-Value,Potential Loyalists
38393,557,1,"102,9",4,1,1,6,Mid-Value,Potential Loyalists
38394,1590,1,"75,9",1,1,1,3,Low-Value,Lost
38395,833,2,"24,0",3,1,1,5,Low-Value,At Risk Customers
38400,1411,1,"120,1",2,1,1,4,Low-Value,Can't Lose
38401,911,6,"323,35",3,1,1,5,Low-Value,At Risk Customers
38402,1455,1,"43,4",2,1,1,4,Low-Value,Can't Lose
38403,892,3,"100,5",3,1,1,5,Low-Value,At Risk Customers
38405,350,4,"98,9",5,1,1,7,Mid-Value,Potential Loyalists
38406,260,3,"501,95",5,1,1,7,Mid-Value,Potential Loyalists
38407,66,1,"6,35",5,1,1,7,Mid-Value,Potential Loyalists
38414,917,1,"74,5",3,1,1,5,Low-Value,At Risk Customers
38415,7,7,"532,85",5,2,1,8,High-Value,Potential Loyalists
38416,199,1,"215,2",5,1,1,7,Mid-Value,Potential Loyalists
38417,81,3,"131,7",5,1,1,7,Mid-Value,Potential Loyalists
38419,777,4,"108,9",3,1,1,5,Low-Value,At Risk Customers
38420,1799,1,"18,05",1,1,1,3,Low-Value,Lost
38424,1091,2,"50,2",3,1,1,5,Low-Value,At Risk Customers
38425,1227,1,"82,94999999999999",2,1,1,4,Low-Value,Can't Lose
38427,672,2,"121,55000000000001",4,1,1,6,Mid-Value,Potential Loyalists
38428,471,2,"34,15",4,1,1,6,Mid-Value,Potential Loyalists
38429,17,6,"115,9",5,1,1,7,Mid-Value,Potential Loyalists
38430,273,2,"771,3",5,1,2,8,High-Value,Potential Loyalists
38431,172,3,"207,7",5,1,1,7,Mid-Value,Potential Loyalists
38432,224,6,"239,35",5,1,1,7,Mid-Value,Potential Loyalists
38433,629,1,"79,9",4,1,1,6,Mid-Value,Potential Loyalists
38436,653,3,"271,35",4,1,1,6,Mid-Value,Potential Loyalists
38437,207,4,"116,05",5,1,1,7,Mid-Value,Potential Loyalists
38438,131,3,"109,6",5,1,1,7,Mid-Value,Potential Loyalists
38441,1029,1,"40,65",3,1,1,5,Low-Value,At Risk Customers
38443,750,2,"72,6",3,1,1,5,Low-Value,At Risk Customers
38444,134,11,"362,9",5,2,1,8,High-Value,Potential Loyalists
38445,173,4,"73,3",5,1,1,7,Mid-Value,Potential Loyalists
38446,655,6,"623,35",4,1,1,6,Mid-Value,Potential Loyalists
38448,188,1,"136,05",5,1,1,7,Mid-Value,Potential Loyalists
38449,340,3,"559,75",5,1,1,7,Mid-Value,Potential Loyalists
38452,1438,1,"36,4",2,1,1,4,Low-Value,Can't Lose
38453,704,9,"438,55",4,2,1,7,Mid-Value,Potential Loyalists
38454,40,11,"998,55",5,2,2,9,High-Value,Champions
38455,1487,5,"254,15",1,1,1,3,Low-Value,Lost
38460,756,2,"93,80000000000001",3,1,1,5,Low-Value,At Risk Customers
38461,564,1,"178,05",4,1,1,6,Mid-Value,Potential Loyalists
38462,339,7,"314,1",5,2,1,8,High-Value,Potential Loyalists
38463,589,1,"17,85",4,1,1,6,Mid-Value,Potential Loyalists
38464,236,3,"300,9",5,1,1,7,Mid-Value,Potential Loyalists
38466,110,2,"43,8",5,1,1,7,Mid-Value,Potential Loyalists
38467,525,3,"87,7",4,1,1,6,Mid-Value,Potential Loyalists
38469,1105,3,"126,1",2,1,1,4,Low-Value,Can't Lose
38470,545,18,"909,35",4,4,2,10,High-Value,Champions
38471,1016,2,"40,75",3,1,1,5,Low-Value,At Risk Customers
38472,760,2,"126,0",3,1,1,5,Low-Value,At Risk Customers
38473,966,2,"209,14999999999998",3,1,1,5,Low-Value,At Risk Customers
38474,710,10,"619,8",4,2,1,7,Mid-Value,Potential Loyalists
38475,297,6,"371,1",5,1,1,7,Mid-Value,Potential Loyalists
38477,271,7,"399,25",5,2,1,8,High-Value,Potential Loyalists
38479,21,4,"147,1",5,1,1,7,Mid-Value,Potential Loyalists
38480,123,6,"290,65",5,1,1,7,Mid-Value,Potential Loyalists
38483,902,1,"124,5",3,1,1,5,Low-Value,At Risk Customers
38484,1270,2,"122,05",2,1,1,4,Low-Value,Can't Lose
38485,1114,1,"44,9",2,1,1,4,Low-Value,Can't Lose
38486,820,3,"346,15",3,1,1,5,Low-Value,At Risk Customers
38489,68,5,"164,25",5,1,1,7,Mid-Value,Potential Loyalists
38490,372,2,"76,4",4,1,1,6,Mid-Value,Potential Loyalists
38492,370,2,"45,35",4,1,1,6,Mid-Value,Potential Loyalists
38493,438,2,"423,75",4,1,1,6,Mid-Value,Potential Loyalists
38495,1557,3,"826,05",1,1,2,4,Low-Value,Can't Lose
38501,538,4,"148,20000000000002",4,1,1,6,Mid-Value,Potential Loyalists
38503,73,4,"149,45000000000002",5,1,1,7,Mid-Value,Potential Loyalists
38504,40,3,"82,15",5,1,1,7,Mid-Value,Potential Loyalists
38508,152,6,"601,3",5,1,1,7,Mid-Value,Potential Loyalists
38510,178,3,"130,1",5,1,1,7,Mid-Value,Potential Loyalists
38511,152,7,"363,5",5,2,1,8,High-Value,Potential Loyalists
38512,1577,1,"199,0",1,1,1,3,Low-Value,Lost
38513,13,12,"693,25",5,3,2,10,High-Value,Champions
38514,447,1,"15,55",4,1,1,6,Mid-Value,Potential Loyalists
38515,767,2,"26,25",3,1,1,5,Low-Value,At Risk Customers
38516,1106,3,"93,4",2,1,1,4,Low-Value,Can't Lose
38517,526,1,"19,25",4,1,1,6,Mid-Value,Potential Loyalists
38519,25,2,"87,35",5,1,1,7,Mid-Value,Potential Loyalists
38520,83,6,"235,3",5,1,1,7,Mid-Value,Potential Loyalists
38521,42,5,"776,15",5,1,2,8,High-Value,Potential Loyalists
38522,4,4,"281,25",5,1,1,7,Mid-Value,Potential Loyalists
38524,1122,1,"19,5",2,1,1,4,Low-Value,Can't Lose
38525,1159,1,"24,5",2,1,1,4,Low-Value,Can't Lose
38526,889,1,"55,5",3,1,1,5,Low-Value,At Risk Customers
38527,33,7,"351,55",5,2,1,8,High-Value,Potential Loyalists
38529,242,2,"180,1",5,1,1,7,Mid-Value,Potential Loyalists
38531,1683,2,"38,1",1,1,1,3,Low-Value,Lost
38533,754,4,"286,55",3,1,1,5,Low-Value,At Risk Customers
38534,27,6,"372,9",5,1,1,7,Mid-Value,Potential Loyalists
38535,114,4,"150,35",5,1,1,7,Mid-Value,Potential Loyalists
38536,468,5,"133,7",4,1,1,6,Mid-Value,Potential Loyalists
38537,1284,2,"45,45",2,1,1,4,Low-Value,Can't Lose
38539,40,5,"279,2",5,1,1,7,Mid-Value,Potential Loyalists
38542,395,3,"132,8",4,1,1,6,Mid-Value,Potential Loyalists
38543,17,1,"8,0",5,1,1,7,Mid-Value,Potential Loyalists
38544,1521,4,"439,7",1,1,1,3,Low-Value,Lost
38545,149,1,"103,1",5,1,1,7,Mid-Value,Potential Loyalists
38547,17,5,"250,5",5,1,1,7,Mid-Value,Potential Loyalists
38548,782,2,"61,05",3,1,1,5,Low-Value,At Risk Customers
38550,710,5,"207,4",4,1,1,6,Mid-Value,Potential Loyalists
38551,168,7,"535,0500000000001",5,2,1,8,High-Value,Potential Loyalists
38552,731,2,"174,25",3,1,1,5,Low-Value,At Risk Customers
38554,34,3,"160,6",5,1,1,7,Mid-Value,Potential Loyalists
38555,262,6,"449,5",5,1,1,7,Mid-Value,Potential Loyalists
38556,292,8,"293,15",5,2,1,8,High-Value,Potential Loyalists
38557,402,6,"264,25",4,1,1,6,Mid-Value,Potential Loyalists
38559,474,6,"326,9",4,1,1,6,Mid-Value,Potential Loyalists
38562,532,1,"68,55000000000001",4,1,1,6,Mid-Value,Potential Loyalists
38564,396,2,"27,900000000000002",4,1,1,6,Mid-Value,Potential Loyalists
38565,435,2,"91,4",4,1,1,6,Mid-Value,Potential Loyalists
38566,45,4,"169,79999999999998",5,1,1,7,Mid-Value,Potential Loyalists
38568,41,3,"130,29999999999998",5,1,1,7,Mid-Value,Potential Loyalists
38572,775,3,"53,45",3,1,1,5,Low-Value,At Risk Customers
38574,279,3,"54,0",5,1,1,7,Mid-Value,Potential Loyalists
38577,556,1,"57,05",4,1,1,6,Mid-Value,Potential Loyalists
38578,34,3,"84,89999999999999",5,1,1,7,Mid-Value,Potential Loyalists
38579,35,6,"672,8",5,1,2,8,High-Value,Potential Loyalists
38581,347,2,"64,0",5,1,1,7,Mid-Value,Potential Loyalists
38582,1016,1,"42,6",3,1,1,5,Low-Value,At Risk Customers
38583,757,2,"81,3",3,1,1,5,Low-Value,At Risk Customers
38584,1470,1,"7,6",1,1,1,3,Low-Value,Lost
38586,27,3,"96,9",5,1,1,7,Mid-Value,Potential Loyalists
38588,773,7,"486,8",3,2,1,6,Mid-Value,Potential Loyalists
38590,1088,8,"633,6",3,2,1,6,Mid-Value,Potential Loyalists
38591,724,1,"38,6",4,1,1,6,Mid-Value,Potential Loyalists
38592,64,2,"55,3",5,1,1,7,Mid-Value,Potential Loyalists
38594,423,1,"59,4",4,1,1,6,Mid-Value,Potential Loyalists
38595,11,8,"298,7",5,2,1,8,High-Value,Potential Loyalists
38596,236,2,"227,65",5,1,1,7,Mid-Value,Potential Loyalists
38598,1176,1,"15,45",2,1,1,4,Low-Value,Can't Lose
38599,251,1,"22,8",5,1,1,7,Mid-Value,Potential Loyalists
38600,690,2,"78,5",4,1,1,6,Mid-Value,Potential Loyalists
38603,1413,6,"182,6",2,1,1,4,Low-Value,Can't Lose
38605,337,3,"143,2",5,1,1,7,Mid-Value,Potential Loyalists
38606,682,1,"8,55",4,1,1,6,Mid-Value,Potential Loyalists
38608,1274,1,"62,8",2,1,1,4,Low-Value,Can't Lose
38609,19,6,"142,63",5,1,1,7,Mid-Value,Potential Loyalists
38611,240,2,"52,400000000000006",5,1,1,7,Mid-Value,Potential Loyalists
38612,923,1,"52,3",3,1,1,5,Low-Value,At Risk Customers
38613,1794,1,"2,2",1,1,1,3,Low-Value,Lost
38614,5,1,"58,6",5,1,1,7,Mid-Value,Potential Loyalists
38615,57,11,"438,75",5,2,1,8,High-Value,Potential Loyalists
38617,758,2,"285,2",3,1,1,5,Low-Value,At Risk Customers
38619,1278,10,"412,5",2,2,1,5,Low-Value,At Risk Customers
38621,1020,3,"217,85",3,1,1,5,Low-Value,At Risk Customers
38622,658,1,"14,5",4,1,1,6,Mid-Value,Potential Loyalists
38625,143,2,"142,2",5,1,1,7,Mid-Value,Potential Loyalists
38626,881,2,"60,150000000000006",3,1,1,5,Low-Value,At Risk Customers
38627,61,2,"43,9",5,1,1,7,Mid-Value,Potential Loyalists
38628,1522,2,"36,2",1,1,1,3,Low-Value,Lost
38629,200,6,"191,35000000000002",5,1,1,7,Mid-Value,Potential Loyalists
38631,1137,2,"33,1",2,1,1,4,Low-Value,Can't Lose
38632,618,3,"242,60000000000002",4,1,1,6,Mid-Value,Potential Loyalists
38633,666,1,"135,0",4,1,1,6,Mid-Value,Potential Loyalists
38634,632,2,"63,8",4,1,1,6,Mid-Value,Potential Loyalists
38636,39,4,"170,6",5,1,1,7,Mid-Value,Potential Loyalists
38637,1545,1,"9,1",1,1,1,3,Low-Value,Lost
38640,439,2,"45,65",4,1,1,6,Mid-Value,Potential Loyalists
38641,1317,4,"113,75",2,1,1,4,Low-Value,Can't Lose
38644,18,1,"45,6",5,1,1,7,Mid-Value,Potential Loyalists
38645,24,1,"204,60000000000002",5,1,1,7,Mid-Value,Potential Loyalists
38648,19,7,"525,45",5,2,1,8,High-Value,Potential Loyalists
38650,474,3,"195,05",4,1,1,6,Mid-Value,Potential Loyalists
38653,26,2,"76,05",5,1,1,7,Mid-Value,Potential Loyalists
38654,377,4,"330,15",4,1,1,6,Mid-Value,Potential Loyalists
38655,519,10,"618,85",4,2,1,7,Mid-Value,Potential Loyalists
38656,1558,1,"135,0",1,1,1,3,Low-Value,Lost
38657,1530,3,"83,15",1,1,1,3,Low-Value,Lost
38659,903,2,"142,35",3,1,1,5,Low-Value,At Risk Customers
38660,14,5,"80,2",5,1,1,7,Mid-Value,Potential Loyalists
38661,1529,2,"41,9",1,1,1,3,Low-Value,Lost
38662,304,2,"30,450000000000003",5,1,1,7,Mid-Value,Potential Loyalists
38663,85,3,"202,10000000000002",5,1,1,7,Mid-Value,Potential Loyalists
38666,207,15,"842,5",5,3,2,10,High-Value,Champions
38667,276,1,"32,25",5,1,1,7,Mid-Value,Potential Loyalists
38669,42,4,"915,8",5,1,2,8,High-Value,Potential Loyalists
38671,670,3,"247,35000000000002",4,1,1,6,Mid-Value,Potential Loyalists
38672,178,4,"251,25",5,1,1,7,Mid-Value,Potential Loyalists
38675,1331,1,"39,5",2,1,1,4,Low-Value,Can't Lose
38677,516,4,"637,4",4,1,1,6,Mid-Value,Potential Loyalists
38682,666,1,"528,1500000000001",4,1,1,6,Mid-Value,Potential Loyalists
38683,808,3,"89,55",3,1,1,5,Low-Value,At Risk Customers
38687,468,3,"128,0",4,1,1,6,Mid-Value,Potential Loyalists
38688,1043,1,"14,8",3,1,1,5,Low-Value,At Risk Customers
38689,40,4,"118,8",5,1,1,7,Mid-Value,Potential Loyalists
38691,157,1,"327,2",5,1,1,7,Mid-Value,Potential Loyalists
38692,120,2,"158,0",5,1,1,7,Mid-Value,Potential Loyalists
38699,1499,2,"108,4",1,1,1,3,Low-Value,Lost
38700,472,2,"90,85",4,1,1,6,Mid-Value,Potential Loyalists
38701,839,4,"435,05",3,1,1,5,Low-Value,At Risk Customers
38702,10,5,"368,6",5,1,1,7,Mid-Value,Potential Loyalists
38704,165,2,"47,9",5,1,1,7,Mid-Value,Potential Loyalists
38705,402,3,"65,7",4,1,1,6,Mid-Value,Potential Loyalists
38706,1595,1,"51,9",1,1,1,3,Low-Value,Lost
38708,970,1,"17,25",3,1,1,5,Low-Value,At Risk Customers
38709,683,6,"320,85",4,1,1,6,Mid-Value,Potential Loyalists
38710,1109,4,"201,6",2,1,1,4,Low-Value,Can't Lose
38711,1301,1,"117,8",2,1,1,4,Low-Value,Can't Lose
38712,880,1,"71,69999999999999",3,1,1,5,Low-Value,At Risk Customers
38713,959,3,"93,0",3,1,1,5,Low-Value,At Risk Customers
38714,1154,2,"67,35",2,1,1,4,Low-Value,Can't Lose
38718,112,3,"122,35",5,1,1,7,Mid-Value,Potential Loyalists
38719,1257,1,"114,75",2,1,1,4,Low-Value,Can't Lose
38721,622,6,"585,45",4,1,1,6,Mid-Value,Potential Loyalists
38722,1109,3,"149,1",2,1,1,4,Low-Value,Can't Lose
38723,597,2,"40,85",4,1,1,6,Mid-Value,Potential Loyalists
38724,144,6,"489,5",5,1,1,7,Mid-Value,Potential Loyalists
38725,144,6,"416,5",5,1,1,7,Mid-Value,Potential Loyalists
38726,308,4,"426,54999999999995",5,1,1,7,Mid-Value,Potential Loyalists
38728,32,4,"184,7",5,1,1,7,Mid-Value,Potential Loyalists
38729,238,2,"222,29999999999998",5,1,1,7,Mid-Value,Potential Loyalists
38730,301,2,"161,35",5,1,1,7,Mid-Value,Potential Loyalists
38731,128,2,"84,45",5,1,1,7,Mid-Value,Potential Loyalists
38733,225,4,"161,45",5,1,1,7,Mid-Value,Potential Loyalists
38734,133,9,"646,05",5,2,1,8,High-Value,Potential Loyalists
38736,609,4,"302,85",4,1,1,6,Mid-Value,Potential Loyalists
38737,147,7,"517,25",5,2,1,8,High-Value,Potential Loyalists
38739,339,4,"167,95",5,1,1,7,Mid-Value,Potential Loyalists
38740,1484,2,"110,60000000000001",1,1,1,3,Low-Value,Lost
38741,756,10,"1685,1999999999998",3,2,3,8,High-Value,Potential Loyalists
38742,186,2,"102,2",5,1,1,7,Mid-Value,Potential Loyalists
38743,1596,1,"34,05",1,1,1,3,Low-Value,Lost
38745,928,1,"46,2",3,1,1,5,Low-Value,At Risk Customers
38748,191,7,"873,9499999999999",5,2,2,9,High-Value,Champions
38751,596,2,"78,45",4,1,1,6,Mid-Value,Potential Loyalists
38752,347,1,"544,6",5,1,1,7,Mid-Value,Potential Loyalists
38753,372,4,"213,8",4,1,1,6,Mid-Value,Potential Loyalists
38754,226,1,"23,75",5,1,1,7,Mid-Value,Potential Loyalists
38755,69,3,"227,75000000000003",5,1,1,7,Mid-Value,Potential Loyalists
38757,571,1,"40,9",4,1,1,6,Mid-Value,Potential Loyalists
38759,771,5,"204,65",3,1,1,5,Low-Value,At Risk Customers
38767,224,1,"44,25",5,1,1,7,Mid-Value,Potential Loyalists
38769,996,1,"11,05",3,1,1,5,Low-Value,At Risk Customers
38770,638,2,"54,65",4,1,1,6,Mid-Value,Potential Loyalists
38771,728,2,"67,3",4,1,1,6,Mid-Value,Potential Loyalists
38775,668,4,"171,6",4,1,1,6,Mid-Value,Potential Loyalists
38776,1821,1,"38,6",1,1,1,3,Low-Value,Lost
38779,678,2,"138,4",4,1,1,6,Mid-Value,Potential Loyalists
38780,32,1,"58,0",5,1,1,7,Mid-Value,Potential Loyalists
38782,745,10,"336,3",3,2,1,6,Mid-Value,Potential Loyalists
38783,1351,2,"20,1",2,1,1,4,Low-Value,Can't Lose
38785,1301,3,"321,29999999999995",2,1,1,4,Low-Value,Can't Lose
38786,533,2,"38,7",4,1,1,6,Mid-Value,Potential Loyalists
38787,1461,1,"116,69999999999999",1,1,1,3,Low-Value,Lost
38788,6,3,"185,85",5,1,1,7,Mid-Value,Potential Loyalists
38789,769,2,"86,25",3,1,1,5,Low-Value,At Risk Customers
38790,1419,1,"29,65",2,1,1,4,Low-Value,Can't Lose
38791,14,8,"360,75",5,2,1,8,High-Value,Potential Loyalists
38794,1222,3,"508,7",2,1,1,4,Low-Value,Can't Lose
38795,1657,1,"22,1",1,1,1,3,Low-Value,Lost
38796,15,6,"348,83000000000004",5,1,1,7,Mid-Value,Potential Loyalists
38797,801,3,"59,150000000000006",3,1,1,5,Low-Value,At Risk Customers
38802,1056,1,"12,0",3,1,1,5,Low-Value,At Risk Customers
38803,947,6,"238,9",3,1,1,5,Low-Value,At Risk Customers
38806,1571,1,"111,0",1,1,1,3,Low-Value,Lost
38807,629,1,"474,2",4,1,1,6,Mid-Value,Potential Loyalists
38808,85,1,"29,2",5,1,1,7,Mid-Value,Potential Loyalists
38809,1311,1,"130,64999999999998",2,1,1,4,Low-Value,Can't Lose
38811,92,1,"16,95",5,1,1,7,Mid-Value,Potential Loyalists
38812,53,4,"130,8",5,1,1,7,Mid-Value,Potential Loyalists
38813,1809,1,"25,8",1,1,1,3,Low-Value,Lost
38814,430,6,"539,9",4,1,1,6,Mid-Value,Potential Loyalists
38815,1551,2,"267,6",1,1,1,3,Low-Value,Lost
38816,195,2,"31,4",5,1,1,7,Mid-Value,Potential Loyalists
38817,52,7,"315,7",5,2,1,8,High-Value,Potential Loyalists
38818,103,6,"282,15000000000003",5,1,1,7,Mid-Value,Potential Loyalists
38820,732,2,"95,89999999999999",3,1,1,5,Low-Value,At Risk Customers
38821,1110,6,"737,7",2,1,2,5,Low-Value,At Risk Customers
38822,521,4,"216,45",4,1,1,6,Mid-Value,Potential Loyalists
38823,51,3,"168,95000000000002",5,1,1,7,Mid-Value,Potential Loyalists
38824,598,2,"78,8",4,1,1,6,Mid-Value,Potential Loyalists
38826,367,4,"355,9",4,1,1,6,Mid-Value,Potential Loyalists
38828,142,3,"278,65",5,1,1,7,Mid-Value,Potential Loyalists
38831,346,3,"89,75",5,1,1,7,Mid-Value,Potential Loyalists
38832,27,9,"644,3",5,2,1,8,High-Value,Potential Loyalists
38833,984,1,"254,0",3,1,1,5,Low-Value,At Risk Customers
38834,315,1,"7,5",5,1,1,7,Mid-Value,Potential Loyalists
38835,914,3,"170,1",3,1,1,5,Low-Value,At Risk Customers
38836,329,1,"70,0",5,1,1,7,Mid-Value,Potential Loyalists
38837,120,3,"287,5",5,1,1,7,Mid-Value,Potential Loyalists
38838,776,1,"40,75",3,1,1,5,Low-Value,At Risk Customers
38839,91,2,"53,25",5,1,1,7,Mid-Value,Potential Loyalists
38840,766,1,"40,65",3,1,1,5,Low-Value,At Risk Customers
38842,394,1,"24,6",4,1,1,6,Mid-Value,Potential Loyalists
38844,531,4,"227,85",4,1,1,6,Mid-Value,Potential Loyalists
38846,346,6,"373,0",5,1,1,7,Mid-Value,Potential Loyalists
38847,323,3,"177,25",5,1,1,7,Mid-Value,Potential Loyalists
38850,478,1,"199,0",4,1,1,6,Mid-Value,Potential Loyalists
38851,3,3,"246,0",5,1,1,7,Mid-Value,Potential Loyalists
38853,124,11,"453,09999999999997",5,2,1,8,High-Value,Potential Loyalists
38854,28,3,"221,14999999999998",5,1,1,7,Mid-Value,Potential Loyalists
38856,928,1,"348,15",3,1,1,5,Low-Value,At Risk Customers
38857,96,6,"526,7",5,1,1,7,Mid-Value,Potential Loyalists
38859,552,3,"274,0",4,1,1,6,Mid-Value,Potential Loyalists
38861,512,5,"332,95",4,1,1,6,Mid-Value,Potential Loyalists
38862,1327,2,"38,85",2,1,1,4,Low-Value,Can't Lose
38863,355,4,"129,95",5,1,1,7,Mid-Value,Potential Loyalists
38865,113,4,"181,4",5,1,1,7,Mid-Value,Potential Loyalists
38866,1762,1,"23,7",1,1,1,3,Low-Value,Lost
38868,270,11,"518,15",5,2,1,8,High-Value,Potential Loyalists
38870,1795,1,"56,0",1,1,1,3,Low-Value,Lost
38871,770,2,"106,44999999999999",3,1,1,5,Low-Value,At Risk Customers
38873,113,3,"197,29999999999998",5,1,1,7,Mid-Value,Potential Loyalists
38875,765,3,"85,25",3,1,1,5,Low-Value,At Risk Customers
38876,571,4,"302,3",4,1,1,6,Mid-Value,Potential Loyalists
38878,1053,3,"336,55",3,1,1,5,Low-Value,At Risk Customers
38879,1466,3,"437,90000000000003",1,1,1,3,Low-Value,Lost
38880,572,2,"220,0",4,1,1,6,Mid-Value,Potential Loyalists
38881,596,3,"208,34999999999997",4,1,1,6,Mid-Value,Potential Loyalists
38882,517,9,"346,5",4,2,1,7,Mid-Value,Potential Loyalists
38883,716,1,"145,8",4,1,1,6,Mid-Value,Potential Loyalists
38884,827,3,"121,7",3,1,1,5,Low-Value,At Risk Customers
38886,931,4,"109,45",3,1,1,5,Low-Value,At Risk Customers
38887,1088,1,"56,6",3,1,1,5,Low-Value,At Risk Customers
38888,465,6,"472,50000000000006",4,1,1,6,Mid-Value,Potential Loyalists
38889,790,2,"37,45",3,1,1,5,Low-Value,At Risk Customers
38891,57,7,"242,95",5,2,1,8,High-Value,Potential Loyalists
38892,9,10,"668,4499999999999",5,2,2,9,High-Value,Champions
38896,1470,1,"71,2",1,1,1,3,Low-Value,Lost
38897,10,3,"190,10000000000002",5,1,1,7,Mid-Value,Potential Loyalists
38898,7,6,"173,9",5,1,1,7,Mid-Value,Potential Loyalists
38899,1286,2,"206,8",2,1,1,4,Low-Value,Can't Lose
38902,1492,1,"8,5",1,1,1,3,Low-Value,Lost
38903,218,4,"126,95",5,1,1,7,Mid-Value,Potential Loyalists
38904,139,6,"420,85",5,1,1,7,Mid-Value,Potential Loyalists
38905,193,3,"1058,3",5,1,2,8,High-Value,Potential Loyalists
38906,18,11,"707,1",5,2,2,9,High-Value,Champions
38912,97,2,"229,8",5,1,1,7,Mid-Value,Potential Loyalists
38914,410,7,"255,65",4,2,1,7,Mid-Value,Potential Loyalists
38915,1775,1,"33,35",1,1,1,3,Low-Value,Lost
38917,592,2,"318,0",4,1,1,6,Mid-Value,Potential Loyalists
38918,158,1,"61,4",5,1,1,7,Mid-Value,Potential Loyalists
38919,266,4,"373,2",5,1,1,7,Mid-Value,Potential Loyalists
38920,799,2,"356,4",3,1,1,5,Low-Value,At Risk Customers
38922,1581,2,"56,7",1,1,1,3,Low-Value,Lost
38923,276,2,"258,59999999999997",5,1,1,7,Mid-Value,Potential Loyalists
38924,989,4,"280,15",3,1,1,5,Low-Value,At Risk Customers
38926,148,11,"780,3",5,2,2,9,High-Value,Champions
38932,749,2,"24,150000000000002",3,1,1,5,Low-Value,At Risk Customers
38934,1062,1,"15,75",3,1,1,5,Low-Value,At Risk Customers
38935,582,2,"160,95",4,1,1,6,Mid-Value,Potential Loyalists
38936,724,2,"121,69999999999999",4,1,1,6,Mid-Value,Potential Loyalists
38937,312,3,"84,8",5,1,1,7,Mid-Value,Potential Loyalists
38938,255,5,"1259,25",5,1,2,8,High-Value,Potential Loyalists
38939,413,3,"79,5",4,1,1,6,Mid-Value,Potential Loyalists
38943,861,4,"134,20000000000002",3,1,1,5,Low-Value,At Risk Customers
38944,398,1,"35,4",4,1,1,6,Mid-Value,Potential Loyalists
38947,701,1,"29,05",4,1,1,6,Mid-Value,Potential Loyalists
38948,1100,5,"134,55",2,1,1,4,Low-Value,Can't Lose
38949,1097,2,"65,9",2,1,1,4,Low-Value,Can't Lose
38950,28,3,"134,4",5,1,1,7,Mid-Value,Potential Loyalists
38951,308,6,"534,1",5,1,1,7,Mid-Value,Potential Loyalists
38952,1154,3,"95,35",2,1,1,4,Low-Value,Can't Lose
38953,1222,1,"104,2",2,1,1,4,Low-Value,Can't Lose
38955,55,2,"43,85",5,1,1,7,Mid-Value,Potential Loyalists
38956,1040,1,"11,8",3,1,1,5,Low-Value,At Risk Customers
38959,402,4,"125,95000000000002",4,1,1,6,Mid-Value,Potential Loyalists
38967,661,1,"67,8",4,1,1,6,Mid-Value,Potential Loyalists
38968,7,6,"587,0",5,1,1,7,Mid-Value,Potential Loyalists
38970,660,2,"135,55",4,1,1,6,Mid-Value,Potential Loyalists
38971,456,1,"4,15",4,1,1,6,Mid-Value,Potential Loyalists
38972,1107,2,"216,39999999999998",2,1,1,4,Low-Value,Can't Lose
38973,342,1,"36,9",5,1,1,7,Mid-Value,Potential Loyalists
38974,1669,1,"27,1",1,1,1,3,Low-Value,Lost
38975,313,2,"178,14999999999998",5,1,1,7,Mid-Value,Potential Loyalists
38976,1,1,"143,6",5,1,1,7,Mid-Value,Potential Loyalists
38977,1236,1,"143,2",2,1,1,4,Low-Value,Can't Lose
38978,92,2,"136,1",5,1,1,7,Mid-Value,Potential Loyalists
38982,97,5,"294,3",5,1,1,7,Mid-Value,Potential Loyalists
38985,383,4,"249,2",4,1,1,6,Mid-Value,Potential Loyalists
38987,341,7,"220,4",5,2,1,8,High-Value,Potential Loyalists
38988,217,2,"280,45",5,1,1,7,Mid-Value,Potential Loyalists
38989,34,8,"540,9",5,2,1,8,High-Value,Potential Loyalists
38990,596,11,"634,55",4,2,1,7,Mid-Value,Potential Loyalists
38991,1007,1,"18,65",3,1,1,5,Low-Value,At Risk Customers
38992,610,3,"74,60000000000001",4,1,1,6,Mid-Value,Potential Loyalists
38993,1051,1,"28,7",3,1,1,5,Low-Value,At Risk Customers
38994,3,4,"281,45",5,1,1,7,Mid-Value,Potential Loyalists
38995,91,4,"142,89999999999998",5,1,1,7,Mid-Value,Potential Loyalists
38998,136,6,"328,90000000000003",5,1,1,7,Mid-Value,Potential Loyalists
39000,774,5,"615,25",3,1,1,5,Low-Value,At Risk Customers
39001,633,1,"16,75",4,1,1,6,Mid-Value,Potential Loyalists
39003,68,5,"238,70000000000002",5,1,1,7,Mid-Value,Potential Loyalists
39004,774,4,"115,14999999999999",3,1,1,5,Low-Value,At Risk Customers
39007,348,2,"75,95",5,1,1,7,Mid-Value,Potential Loyalists
39008,311,3,"236,29999999999998",5,1,1,7,Mid-Value,Potential Loyalists
39009,1286,1,"34,95",2,1,1,4,Low-Value,Can't Lose
39011,728,2,"370,9",4,1,1,6,Mid-Value,Potential Loyalists
39014,10,10,"904,45",5,2,2,9,High-Value,Champions
39016,256,7,"570,6",5,2,1,8,High-Value,Potential Loyalists
39017,424,4,"71,95",4,1,1,6,Mid-Value,Potential Loyalists
39018,122,3,"60,5",5,1,1,7,Mid-Value,Potential Loyalists
39020,63,2,"46,800000000000004",5,1,1,7,Mid-Value,Potential Loyalists
39021,1027,4,"104,4",3,1,1,5,Low-Value,At Risk Customers
39022,769,5,"348,75",3,1,1,5,Low-Value,At Risk Customers
39023,267,1,"15,65",5,1,1,7,Mid-Value,Potential Loyalists
39024,1142,2,"36,0",2,1,1,4,Low-Value,Can't Lose
39025,1523,3,"79,69999999999999",1,1,1,3,Low-Value,Lost
39027,762,4,"195,55",3,1,1,5,Low-Value,At Risk Customers
39028,1469,2,"47,3",1,1,1,3,Low-Value,Lost
39029,20,6,"267,3",5,1,1,7,Mid-Value,Potential Loyalists
39030,90,5,"159,45",5,1,1,7,Mid-Value,Potential Loyalists
39031,871,1,"20,6",3,1,1,5,Low-Value,At Risk Customers
39032,539,7,"590,9",4,2,1,7,Mid-Value,Potential Loyalists
39033,253,2,"182,54999999999998",5,1,1,7,Mid-Value,Potential Loyalists
39034,34,1,"21,6",5,1,1,7,Mid-Value,Potential Loyalists
39035,384,2,"71,3",4,1,1,6,Mid-Value,Potential Loyalists
39036,17,2,"31,099999999999998",5,1,1,7,Mid-Value,Potential Loyalists
39037,245,5,"308,55",5,1,1,7,Mid-Value,Potential Loyalists
39039,902,1,"71,9",3,1,1,5,Low-Value,At Risk Customers
39041,1055,1,"10,9",3,1,1,5,Low-Value,At Risk Customers
39042,4,4,"304,34999999999997",5,1,1,7,Mid-Value,Potential Loyalists
39043,1715,1,"20,15",1,1,1,3,Low-Value,Lost
39046,1265,4,"128,1",2,1,1,4,Low-Value,Can't Lose
39048,136,2,"361,7",5,1,1,7,Mid-Value,Potential Loyalists
39053,125,4,"124,25",5,1,1,7,Mid-Value,Potential Loyalists
39054,52,6,"431,95",5,1,1,7,Mid-Value,Potential Loyalists
39055,43,2,"56,95",5,1,1,7,Mid-Value,Potential Loyalists
39056,159,4,"93,5",5,1,1,7,Mid-Value,Potential Loyalists
39057,1635,1,"29,1",1,1,1,3,Low-Value,Lost
39058,1438,1,"71,6",2,1,1,4,Low-Value,Can't Lose
39059,1204,1,"251,3",2,1,1,4,Low-Value,Can't Lose
39060,1080,1,"2,9",3,1,1,5,Low-Value,At Risk Customers
39061,668,1,"14,35",4,1,1,6,Mid-Value,Potential Loyalists
39062,82,2,"199,7",5,1,1,7,Mid-Value,Potential Loyalists
39063,284,2,"74,10000000000001",5,1,1,7,Mid-Value,Potential Loyalists
39064,31,8,"640,6500000000001",5,2,1,8,High-Value,Potential Loyalists
39066,154,4,"724,8",5,1,2,8,High-Value,Potential Loyalists
39067,980,1,"69,8",3,1,1,5,Low-Value,At Risk Customers
39070,314,5,"482,93",5,1,1,7,Mid-Value,Potential Loyalists
39071,266,4,"187,55",5,1,1,7,Mid-Value,Potential Loyalists
39074,73,7,"442,59999999999997",5,2,1,8,High-Value,Potential Loyalists
39076,703,1,"191,3",4,1,1,6,Mid-Value,Potential Loyalists
39079,788,4,"55,4",3,1,1,5,Low-Value,At Risk Customers
39083,376,5,"445,79999999999995",4,1,1,6,Mid-Value,Potential Loyalists
39084,1819,1,"41,1",1,1,1,3,Low-Value,Lost
39085,963,4,"63,599999999999994",3,1,1,5,Low-Value,At Risk Customers
39086,1029,1,"9,75",3,1,1,5,Low-Value,At Risk Customers
39088,452,3,"91,3",4,1,1,6,Mid-Value,Potential Loyalists
39089,986,4,"655,55",3,1,1,5,Low-Value,At Risk Customers
39091,906,1,"20,4",3,1,1,5,Low-Value,At Risk Customers
39092,591,1,"43,0",4,1,1,6,Mid-Value,Potential Loyalists
39093,134,5,"127,25",5,1,1,7,Mid-Value,Potential Loyalists
39094,9,2,"209,25",5,1,1,7,Mid-Value,Potential Loyalists
39096,766,3,"52,55",3,1,1,5,Low-Value,At Risk Customers
39097,964,2,"27,25",3,1,1,5,Low-Value,At Risk Customers
39098,1261,1,"46,349999999999994",2,1,1,4,Low-Value,Can't Lose
39099,42,16,"653,9",5,3,1,9,High-Value,Champions
39100,148,4,"454,0",5,1,1,7,Mid-Value,Potential Loyalists
39102,259,2,"114,55",5,1,1,7,Mid-Value,Potential Loyalists
39103,109,2,"14,649999999999999",5,1,1,7,Mid-Value,Potential Loyalists
39105,1002,4,"163,25",3,1,1,5,Low-Value,At Risk Customers
39106,1324,1,"22,5",2,1,1,4,Low-Value,Can't Lose
39107,392,3,"93,1",4,1,1,6,Mid-Value,Potential Loyalists
39108,15,4,"136,35",5,1,1,7,Mid-Value,Potential Loyalists
39111,1314,3,"128,9",2,1,1,4,Low-Value,Can't Lose
39114,298,6,"672,3499999999999",5,1,2,8,High-Value,Potential Loyalists
39115,1148,8,"346,05",2,2,1,5,Low-Value,At Risk Customers
39117,69,8,"460,5",5,2,1,8,High-Value,Potential Loyalists
39118,1149,3,"108,1",2,1,1,4,Low-Value,Can't Lose
39121,162,3,"66,0",5,1,1,7,Mid-Value,Potential Loyalists
39122,132,4,"80,2",5,1,1,7,Mid-Value,Potential Loyalists
39123,25,9,"410,8",5,2,1,8,High-Value,Potential Loyalists
39125,462,9,"403,95",4,2,1,7,Mid-Value,Potential Loyalists
39127,833,5,"84,85",3,1,1,5,Low-Value,At Risk Customers
39129,858,4,"240,45",3,1,1,5,Low-Value,At Risk Customers
39130,433,4,"228,75",4,1,1,6,Mid-Value,Potential Loyalists
39131,1646,1,"19,5",1,1,1,3,Low-Value,Lost
39132,50,4,"496,99999999999994",5,1,1,7,Mid-Value,Potential Loyalists
39135,980,1,"80,9",3,1,1,5,Low-Value,At Risk Customers
39136,256,9,"1370,75",5,2,3,10,High-Value,Champions
39137,105,7,"289,7",5,2,1,8,High-Value,Potential Loyalists
39138,159,5,"345,3",5,1,1,7,Mid-Value,Potential Loyalists
39141,51,1,"28,25",5,1,1,7,Mid-Value,Potential Loyalists
39142,253,1,"24,55",5,1,1,7,Mid-Value,Potential Loyalists
39143,1473,2,"44,15",1,1,1,3,Low-Value,Lost
39144,515,9,"629,15",4,2,1,7,Mid-Value,Potential Loyalists
39145,75,4,"162,25",5,1,1,7,Mid-Value,Potential Loyalists
39147,9,6,"262,4",5,1,1,7,Mid-Value,Potential Loyalists
39148,539,1,"168,14999999999998",4,1,1,6,Mid-Value,Potential Loyalists
39150,1111,3,"451,40000000000003",2,1,1,4,Low-Value,Can't Lose
39152,709,2,"32,1",4,1,1,6,Mid-Value,Potential Loyalists
39153,58,9,"594,3",5,2,1,8,High-Value,Potential Loyalists
39155,138,3,"120,4",5,1,1,7,Mid-Value,Potential Loyalists
39158,734,6,"267,09999999999997",3,1,1,5,Low-Value,At Risk Customers
39160,23,6,"692,5",5,1,2,8,High-Value,Potential Loyalists
39161,598,3,"223,4",4,1,1,6,Mid-Value,Potential Loyalists
39164,1371,2,"67,3",2,1,1,4,Low-Value,Can't Lose
39166,1442,1,"42,25",2,1,1,4,Low-Value,Can't Lose
39167,614,7,"300,15",4,2,1,7,Mid-Value,Potential Loyalists
39170,1645,2,"30,75",1,1,1,3,Low-Value,Lost
39171,225,3,"97,55000000000001",5,1,1,7,Mid-Value,Potential Loyalists
39172,862,4,"85,3",3,1,1,5,Low-Value,At Risk Customers
39173,531,7,"314,05",4,2,1,7,Mid-Value,Potential Loyalists
39174,1143,2,"68,05",2,1,1,4,Low-Value,Can't Lose
39176,21,2,"97,5",5,1,1,7,Mid-Value,Potential Loyalists
39178,850,2,"79,75",3,1,1,5,Low-Value,At Risk Customers
39180,749,6,"774,55",3,1,2,6,Mid-Value,Potential Loyalists
39181,716,6,"461,3",4,1,1,6,Mid-Value,Potential Loyalists
39182,753,2,"43,400000000000006",3,1,1,5,Low-Value,At Risk Customers
39183,1165,1,"16,45",2,1,1,4,Low-Value,Can't Lose
39185,57,1,"108,6",5,1,1,7,Mid-Value,Potential Loyalists
39186,496,1,"51,5",4,1,1,6,Mid-Value,Potential Loyalists
39187,262,5,"539,95",5,1,1,7,Mid-Value,Potential Loyalists
39189,56,11,"624,25",5,2,1,8,High-Value,Potential Loyalists
39190,492,3,"359,0",4,1,1,6,Mid-Value,Potential Loyalists
39191,102,3,"266,6",5,1,1,7,Mid-Value,Potential Loyalists
39194,1727,1,"50,75",1,1,1,3,Low-Value,Lost
39197,1414,3,"128,4",2,1,1,4,Low-Value,Can't Lose
39198,238,1,"48,599999999999994",5,1,1,7,Mid-Value,Potential Loyalists
39199,966,7,"353,05",3,2,1,6,Mid-Value,Potential Loyalists
39203,438,1,"15,9",4,1,1,6,Mid-Value,Potential Loyalists
39204,405,3,"179,05",4,1,1,6,Mid-Value,Potential Loyalists
39205,1221,1,"53,7",2,1,1,4,Low-Value,Can't Lose
39211,40,5,"465,85",5,1,1,7,Mid-Value,Potential Loyalists
39212,1018,2,"201,95",3,1,1,5,Low-Value,At Risk Customers
39213,305,5,"253,5",5,1,1,7,Mid-Value,Potential Loyalists
39214,596,2,"51,849999999999994",4,1,1,6,Mid-Value,Potential Loyalists
39215,795,1,"34,5",3,1,1,5,Low-Value,At Risk Customers
39217,12,8,"350,7",5,2,1,8,High-Value,Potential Loyalists
39219,3,11,"752,9",5,2,2,9,High-Value,Champions
39220,822,3,"71,7",3,1,1,5,Low-Value,At Risk Customers
39221,1549,2,"17,45",1,1,1,3,Low-Value,Lost
39222,64,9,"910,45",5,2,2,9,High-Value,Champions
39223,879,3,"969,65",3,1,2,6,Mid-Value,Potential Loyalists
39224,60,2,"46,25",5,1,1,7,Mid-Value,Potential Loyalists
39226,852,1,"97,8",3,1,1,5,Low-Value,At Risk Customers
39228,15,3,"253,65",5,1,1,7,Mid-Value,Potential Loyalists
39232,673,2,"49,25",4,1,1,6,Mid-Value,Potential Loyalists
39233,189,2,"200,6",5,1,1,7,Mid-Value,Potential Loyalists
39234,125,3,"92,71000000000001",5,1,1,7,Mid-Value,Potential Loyalists
39235,945,1,"19,9",3,1,1,5,Low-Value,At Risk Customers
39238,174,2,"22,76",5,1,1,7,Mid-Value,Potential Loyalists
39239,1137,3,"69,5",2,1,1,4,Low-Value,Can't Lose
39240,521,5,"188,85",4,1,1,6,Mid-Value,Potential Loyalists
39241,475,6,"512,0",4,1,1,6,Mid-Value,Potential Loyalists
39244,513,1,"17,4",4,1,1,6,Mid-Value,Potential Loyalists
39247,939,4,"1070,1",3,1,2,6,Mid-Value,Potential Loyalists
39248,1473,2,"89,5",1,1,1,3,Low-Value,Lost
39249,936,1,"68,6",3,1,1,5,Low-Value,At Risk Customers
39250,39,4,"595,4",5,1,1,7,Mid-Value,Potential Loyalists
39252,825,1,"135,0",3,1,1,5,Low-Value,At Risk Customers
39256,303,4,"131,5",5,1,1,7,Mid-Value,Potential Loyalists
39257,761,13,"976,6",3,3,2,8,High-Value,Potential Loyalists
39258,1786,1,"533,75",1,1,1,3,Low-Value,Lost
39261,22,4,"130,65",5,1,1,7,Mid-Value,Potential Loyalists
39262,535,1,"64,6",4,1,1,6,Mid-Value,Potential Loyalists
39265,384,3,"120,75",4,1,1,6,Mid-Value,Potential Loyalists
39266,13,2,"50,4",5,1,1,7,Mid-Value,Potential Loyalists
39267,584,2,"210,5",4,1,1,6,Mid-Value,Potential Loyalists
39268,1073,1,"14,1",3,1,1,5,Low-Value,At Risk Customers
39269,2,4,"498,15",5,1,1,7,Mid-Value,Potential Loyalists
39270,446,5,"126,5",4,1,1,6,Mid-Value,Potential Loyalists
39271,363,8,"701,75",5,2,2,9,High-Value,Champions
39272,153,3,"282,8",5,1,1,7,Mid-Value,Potential Loyalists
39273,499,1,"111,7",4,1,1,6,Mid-Value,Potential Loyalists
39274,29,1,"27,5",5,1,1,7,Mid-Value,Potential Loyalists
39276,493,6,"166,1",4,1,1,6,Mid-Value,Potential Loyalists
39279,794,5,"275,59999999999997",3,1,1,5,Low-Value,At Risk Customers
39281,439,3,"194,95000000000002",4,1,1,6,Mid-Value,Potential Loyalists
39282,208,13,"460,55",5,3,1,9,High-Value,Champions
39283,490,2,"104,55",4,1,1,6,Mid-Value,Potential Loyalists
39284,652,2,"205,05",4,1,1,6,Mid-Value,Potential Loyalists
39285,1219,4,"180,5",2,1,1,4,Low-Value,Can't Lose
39287,898,2,"152,5",3,1,1,5,Low-Value,At Risk Customers
39288,561,2,"141,39999999999998",4,1,1,6,Mid-Value,Potential Loyalists
39291,123,4,"320,2",5,1,1,7,Mid-Value,Potential Loyalists
39296,61,3,"75,39999999999999",5,1,1,7,Mid-Value,Potential Loyalists
39297,938,4,"622,6",3,1,1,5,Low-Value,At Risk Customers
39298,44,4,"167,79999999999998",5,1,1,7,Mid-Value,Potential Loyalists
39299,69,5,"241,05",5,1,1,7,Mid-Value,Potential Loyalists
39301,1219,1,"19,1",2,1,1,4,Low-Value,Can't Lose
39303,137,2,"753,3",5,1,2,8,High-Value,Potential Loyalists
39304,2,4,"386,2",5,1,1,7,Mid-Value,Potential Loyalists
39307,20,5,"238,7",5,1,1,7,Mid-Value,Potential Loyalists
39308,1498,2,"89,7",1,1,1,3,Low-Value,Lost
39309,1539,1,"7,45",1,1,1,3,Low-Value,Lost
39313,290,4,"117,44999999999999",5,1,1,7,Mid-Value,Potential Loyalists
39316,812,3,"120,4",3,1,1,5,Low-Value,At Risk Customers
39318,1088,3,"427,1",3,1,1,5,Low-Value,At Risk Customers
39320,1123,3,"392,59999999999997",2,1,1,4,Low-Value,Can't Lose
39321,40,2,"46,400000000000006",5,1,1,7,Mid-Value,Potential Loyalists
39322,154,1,"60,7",5,1,1,7,Mid-Value,Potential Loyalists
39323,28,2,"240,0",5,1,1,7,Mid-Value,Potential Loyalists
39324,641,6,"173,75",4,1,1,6,Mid-Value,Potential Loyalists
39325,1664,1,"140,8",1,1,1,3,Low-Value,Lost
39326,1081,1,"20,95",3,1,1,5,Low-Value,At Risk Customers
39327,1401,1,"9,85",2,1,1,4,Low-Value,Can't Lose
39328,21,8,"440,1",5,2,1,8,High-Value,Potential Loyalists
39330,989,1,"127,75",3,1,1,5,Low-Value,At Risk Customers
39331,1060,2,"246,29999999999998",3,1,1,5,Low-Value,At Risk Customers
39333,31,7,"430,8",5,2,1,8,High-Value,Potential Loyalists
39335,575,3,"299,35",4,1,1,6,Mid-Value,Potential Loyalists
39337,293,4,"151,2",5,1,1,7,Mid-Value,Potential Loyalists
39338,1074,2,"154,4",3,1,1,5,Low-Value,At Risk Customers
39339,5,2,"149,2",5,1,1,7,Mid-Value,Potential Loyalists
39341,412,2,"54,45",4,1,1,6,Mid-Value,Potential Loyalists
39344,518,1,"61,0",4,1,1,6,Mid-Value,Potential Loyalists
39345,1413,2,"155,35",2,1,1,4,Low-Value,Can't Lose
39346,1009,5,"260,4",3,1,1,5,Low-Value,At Risk Customers
39347,563,2,"99,75",4,1,1,6,Mid-Value,Potential Loyalists
39348,621,3,"148,39999999999998",4,1,1,6,Mid-Value,Potential Loyalists
39349,517,2,"76,65",4,1,1,6,Mid-Value,Potential Loyalists
39350,1016,1,"155,3",3,1,1,5,Low-Value,At Risk Customers
39351,46,4,"206,20000000000002",5,1,1,7,Mid-Value,Potential Loyalists
39352,10,3,"198,1",5,1,1,7,Mid-Value,Potential Loyalists
39353,1487,2,"261,5",1,1,1,3,Low-Value,Lost
39355,276,3,"627,4",5,1,1,7,Mid-Value,Potential Loyalists
39356,236,1,"14,0",5,1,1,7,Mid-Value,Potential Loyalists
39357,42,6,"690,5",5,1,2,8,High-Value,Potential Loyalists
39358,158,3,"177,25",5,1,1,7,Mid-Value,Potential Loyalists
39359,46,1,"16,75",5,1,1,7,Mid-Value,Potential Loyalists
39361,822,2,"46,2",3,1,1,5,Low-Value,At Risk Customers
39362,396,11,"472,95",4,2,1,7,Mid-Value,Potential Loyalists
39363,493,2,"132,9",4,1,1,6,Mid-Value,Potential Loyalists
39364,944,1,"42,15",3,1,1,5,Low-Value,At Risk Customers
39366,119,4,"428,65000000000003",5,1,1,7,Mid-Value,Potential Loyalists
39367,316,1,"2,85",5,1,1,7,Mid-Value,Potential Loyalists
39369,1598,2,"41,65",1,1,1,3,Low-Value,Lost
39371,32,4,"66,1",5,1,1,7,Mid-Value,Potential Loyalists
39377,859,2,"249,70000000000002",3,1,1,5,Low-Value,At Risk Customers
39379,743,4,"416,59999999999997",3,1,1,5,Low-Value,At Risk Customers
39383,798,1,"66,5",3,1,1,5,Low-Value,At Risk Customers
39385,1190,1,"254,0",2,1,1,4,Low-Value,Can't Lose
39388,11,7,"296,5",5,2,1,8,High-Value,Potential Loyalists
39389,47,4,"197,05",5,1,1,7,Mid-Value,Potential Loyalists
39390,169,4,"121,95",5,1,1,7,Mid-Value,Potential Loyalists
39391,323,1,"9,85",5,1,1,7,Mid-Value,Potential Loyalists
39393,767,3,"280,15000000000003",3,1,1,5,Low-Value,At Risk Customers
39398,9,5,"331,04999999999995",5,1,1,7,Mid-Value,Potential Loyalists
39399,176,5,"908,15",5,1,2,8,High-Value,Potential Loyalists
39400,424,2,"134,14999999999998",4,1,1,6,Mid-Value,Potential Loyalists
39401,1248,1,"11,2",2,1,1,4,Low-Value,Can't Lose
39403,124,2,"148,8",5,1,1,7,Mid-Value,Potential Loyalists
39405,342,3,"242,0",5,1,1,7,Mid-Value,Potential Loyalists
39406,875,2,"91,85",3,1,1,5,Low-Value,At Risk Customers
39409,706,5,"95,0",4,1,1,6,Mid-Value,Potential Loyalists
39411,1580,1,"52,2",1,1,1,3,Low-Value,Lost
39413,431,3,"286,2",4,1,1,6,Mid-Value,Potential Loyalists
39414,129,5,"350,15",5,1,1,7,Mid-Value,Potential Loyalists
39415,165,5,"225,65",5,1,1,7,Mid-Value,Potential Loyalists
39416,597,3,"74,65",4,1,1,6,Mid-Value,Potential Loyalists
39417,19,5,"417,85",5,1,1,7,Mid-Value,Potential Loyalists
39419,383,1,"135,0",4,1,1,6,Mid-Value,Potential Loyalists
39421,259,2,"47,6",5,1,1,7,Mid-Value,Potential Loyalists
39422,60,7,"340,25",5,2,1,8,High-Value,Potential Loyalists
39424,35,2,"89,85",5,1,1,7,Mid-Value,Potential Loyalists
39425,604,1,"17,25",4,1,1,6,Mid-Value,Potential Loyalists
39428,433,1,"106,75",4,1,1,6,Mid-Value,Potential Loyalists
39433,1515,1,"19,75",1,1,1,3,Low-Value,Lost
39434,33,8,"655,8000000000001",5,2,1,8,High-Value,Potential Loyalists
39435,586,5,"414,1",4,1,1,6,Mid-Value,Potential Loyalists
39436,519,1,"5,9",4,1,1,6,Mid-Value,Potential Loyalists
39437,383,2,"111,4",4,1,1,6,Mid-Value,Potential Loyalists
39439,1558,2,"109,80000000000001",1,1,1,3,Low-Value,Lost
39441,271,2,"61,2",5,1,1,7,Mid-Value,Potential Loyalists
39442,1067,4,"125,15",3,1,1,5,Low-Value,At Risk Customers
39443,57,7,"207,29999999999998",5,2,1,8,High-Value,Potential Loyalists
39445,480,5,"431,3",4,1,1,6,Mid-Value,Potential Loyalists
39446,777,5,"431,0",3,1,1,5,Low-Value,At Risk Customers
39447,18,9,"392,95",5,2,1,8,High-Value,Potential Loyalists
39448,1,3,"161,0",5,1,1,7,Mid-Value,Potential Loyalists
39450,173,5,"136,85",5,1,1,7,Mid-Value,Potential Loyalists
39452,181,2,"234,4",5,1,1,7,Mid-Value,Potential Loyalists
39453,324,1,"7,5",5,1,1,7,Mid-Value,Potential Loyalists
39454,906,2,"48,15",3,1,1,5,Low-Value,At Risk Customers
39456,141,9,"789,15",5,2,2,9,High-Value,Champions
39458,922,1,"234,4",3,1,1,5,Low-Value,At Risk Customers
39463,4,12,"613,75",5,3,1,9,High-Value,Champions
39464,888,1,"157,0",3,1,1,5,Low-Value,At Risk Customers
39465,32,5,"213,0",5,1,1,7,Mid-Value,Potential Loyalists
39466,201,6,"293,20000000000005",5,1,1,7,Mid-Value,Potential Loyalists
39467,1472,4,"135,35",1,1,1,3,Low-Value,Lost
39468,863,1,"110,0",3,1,1,5,Low-Value,At Risk Customers
39469,474,1,"42,2",4,1,1,6,Mid-Value,Potential Loyalists
39473,248,5,"269,2",5,1,1,7,Mid-Value,Potential Loyalists
39474,155,5,"453,65",5,1,1,7,Mid-Value,Potential Loyalists
39476,960,1,"159,4",3,1,1,5,Low-Value,At Risk Customers
39477,539,3,"85,1",4,1,1,6,Mid-Value,Potential Loyalists
39478,748,1,"251,3",3,1,1,5,Low-Value,At Risk Customers
39479,551,3,"154,7",4,1,1,6,Mid-Value,Potential Loyalists
39480,115,1,"63,7",5,1,1,7,Mid-Value,Potential Loyalists
39481,325,2,"77,6",5,1,1,7,Mid-Value,Potential Loyalists
39483,655,1,"112,2",4,1,1,6,Mid-Value,Potential Loyalists
39484,374,2,"115,8",4,1,1,6,Mid-Value,Potential Loyalists
39485,857,2,"285,9",3,1,1,5,Low-Value,At Risk Customers
39486,916,1,"74,5",3,1,1,5,Low-Value,At Risk Customers
39489,224,14,"765,0",5,3,2,10,High-Value,Champions
39493,220,4,"716,55",5,1,2,8,High-Value,Potential Loyalists
39494,1012,1,"12,3",3,1,1,5,Low-Value,At Risk Customers
39495,630,1,"12,85",4,1,1,6,Mid-Value,Potential Loyalists
39496,545,1,"150,89999999999998",4,1,1,6,Mid-Value,Potential Loyalists
39498,1815,1,"199,0",1,1,1,3,Low-Value,Lost
39500,796,2,"456,34999999999997",3,1,1,5,Low-Value,At Risk Customers
39502,231,4,"352,1",5,1,1,7,Mid-Value,Potential Loyalists
39503,866,2,"90,25",3,1,1,5,Low-Value,At Risk Customers
39504,84,4,"416,9",5,1,1,7,Mid-Value,Potential Loyalists
39506,159,4,"195,2",5,1,1,7,Mid-Value,Potential Loyalists
39507,57,7,"298,2",5,2,1,8,High-Value,Potential Loyalists
39508,3,6,"203,15",5,1,1,7,Mid-Value,Potential Loyalists
39509,1235,2,"87,35",2,1,1,4,Low-Value,Can't Lose
39510,186,6,"679,75",5,1,2,8,High-Value,Potential Loyalists
39511,718,1,"10,75",4,1,1,6,Mid-Value,Potential Loyalists
39512,888,3,"246,2",3,1,1,5,Low-Value,At Risk Customers
39513,749,2,"79,35",3,1,1,5,Low-Value,At Risk Customers
39514,54,7,"290,75",5,2,1,8,High-Value,Potential Loyalists
39515,308,1,"22,35",5,1,1,7,Mid-Value,Potential Loyalists
39516,557,1,"55,9",4,1,1,6,Mid-Value,Potential Loyalists
39518,808,3,"727,6999999999999",3,1,2,6,Mid-Value,Potential Loyalists
39519,402,3,"861,55",4,1,2,7,Mid-Value,Potential Loyalists
39521,1573,1,"28,75",1,1,1,3,Low-Value,Lost
39522,1698,2,"17,299999999999997",1,1,1,3,Low-Value,Lost
39523,1522,1,"11,5",1,1,1,3,Low-Value,Lost
39526,385,3,"246,1",4,1,1,6,Mid-Value,Potential Loyalists
39527,878,2,"100,9",3,1,1,5,Low-Value,At Risk Customers
39528,1159,2,"66,05",2,1,1,4,Low-Value,Can't Lose
39529,518,2,"59,85",4,1,1,6,Mid-Value,Potential Loyalists
39530,175,1,"42,1",5,1,1,7,Mid-Value,Potential Loyalists
39533,761,3,"175,89999999999998",3,1,1,5,Low-Value,At Risk Customers
39534,136,3,"92,3",5,1,1,7,Mid-Value,Potential Loyalists
39535,561,1,"37,6",4,1,1,6,Mid-Value,Potential Loyalists
39536,130,3,"749,65",5,1,2,8,High-Value,Potential Loyalists
39538,1126,1,"161,2",2,1,1,4,Low-Value,Can't Lose
39540,25,2,"75,2",5,1,1,7,Mid-Value,Potential Loyalists
39541,1737,1,"74,3",1,1,1,3,Low-Value,Lost
39542,85,5,"570,4499999999999",5,1,1,7,Mid-Value,Potential Loyalists
39543,1186,2,"33,0",2,1,1,4,Low-Value,Can't Lose
39544,126,3,"223,3",5,1,1,7,Mid-Value,Potential Loyalists
39549,287,1,"55,2",5,1,1,7,Mid-Value,Potential Loyalists
39550,51,6,"767,5500000000001",5,1,2,8,High-Value,Potential Loyalists
39551,29,10,"642,1999999999999",5,2,1,8,High-Value,Potential Loyalists
39552,589,3,"125,65",4,1,1,6,Mid-Value,Potential Loyalists
39553,490,3,"1491,9499999999998",4,1,3,8,High-Value,Potential Loyalists
39554,1724,2,"90,4",1,1,1,3,Low-Value,Lost
39555,196,5,"47,55",5,1,1,7,Mid-Value,Potential Loyalists
39556,1287,2,"110,55000000000001",2,1,1,4,Low-Value,Can't Lose
39557,464,4,"220,5",4,1,1,6,Mid-Value,Potential Loyalists
39559,1104,1,"6,75",2,1,1,4,Low-Value,Can't Lose
39560,949,2,"606,5",3,1,1,5,Low-Value,At Risk Customers
39561,699,1,"59,6",4,1,1,6,Mid-Value,Potential Loyalists
39562,880,1,"6,3",3,1,1,5,Low-Value,At Risk Customers
39563,536,2,"41,25",4,1,1,6,Mid-Value,Potential Loyalists
39564,187,6,"270,75",5,1,1,7,Mid-Value,Potential Loyalists
39566,484,4,"106,19999999999999",4,1,1,6,Mid-Value,Potential Loyalists
39567,1071,2,"46,2",3,1,1,5,Low-Value,At Risk Customers
39570,13,5,"184,5",5,1,1,7,Mid-Value,Potential Loyalists
39572,158,2,"137,55",5,1,1,7,Mid-Value,Potential Loyalists
39573,362,1,"17,5",5,1,1,7,Mid-Value,Potential Loyalists
39575,152,3,"148,15",5,1,1,7,Mid-Value,Potential Loyalists
39576,395,1,"135,0",4,1,1,6,Mid-Value,Potential Loyalists
39577,4,5,"228,85",5,1,1,7,Mid-Value,Potential Loyalists
39578,304,3,"128,8",5,1,1,7,Mid-Value,Potential Loyalists
39580,32,3,"100,4",5,1,1,7,Mid-Value,Potential Loyalists
39583,369,4,"139,2",4,1,1,6,Mid-Value,Potential Loyalists
39584,685,1,"10,25",4,1,1,6,Mid-Value,Potential Loyalists
39585,1292,2,"63,5",2,1,1,4,Low-Value,Can't Lose
39587,1,1,"65,9",5,1,1,7,Mid-Value,Potential Loyalists
39589,525,3,"298,45000000000005",4,1,1,6,Mid-Value,Potential Loyalists
39590,612,1,"256,45",4,1,1,6,Mid-Value,Potential Loyalists
39591,1005,3,"219,89999999999998",3,1,1,5,Low-Value,At Risk Customers
39595,196,2,"251,4",5,1,1,7,Mid-Value,Potential Loyalists
39596,35,7,"640,0999999999999",5,2,1,8,High-Value,Potential Loyalists
39599,1243,3,"87,1",2,1,1,4,Low-Value,Can't Lose
39600,219,2,"200,3",5,1,1,7,Mid-Value,Potential Loyalists
39601,1485,2,"360,2",1,1,1,3,Low-Value,Lost
39607,1184,1,"46,95",2,1,1,4,Low-Value,Can't Lose
39611,262,2,"97,6",5,1,1,7,Mid-Value,Potential Loyalists
39612,1427,4,"257,95",2,1,1,4,Low-Value,Can't Lose
39613,841,2,"286,8",3,1,1,5,Low-Value,At Risk Customers
39614,1064,1,"16,05",3,1,1,5,Low-Value,At Risk Customers
39619,523,3,"175,7",4,1,1,6,Mid-Value,Potential Loyalists
39623,743,3,"384,95",3,1,1,5,Low-Value,At Risk Customers
39626,28,6,"178,7",5,1,1,7,Mid-Value,Potential Loyalists
39630,1183,1,"19,55",2,1,1,4,Low-Value,Can't Lose
39632,1273,1,"24,7",2,1,1,4,Low-Value,Can't Lose
39633,157,4,"257,35",5,1,1,7,Mid-Value,Potential Loyalists
39635,689,5,"249,7",4,1,1,6,Mid-Value,Potential Loyalists
39636,709,2,"22,25",4,1,1,6,Mid-Value,Potential Loyalists
39637,701,3,"20,4",4,1,1,6,Mid-Value,Potential Loyalists
39638,94,6,"238,3",5,1,1,7,Mid-Value,Potential Loyalists
39639,753,3,"112,7",3,1,1,5,Low-Value,At Risk Customers
39640,12,1,"53,3",5,1,1,7,Mid-Value,Potential Loyalists
39642,118,6,"339,15",5,1,1,7,Mid-Value,Potential Loyalists
39644,1504,2,"19,2",1,1,1,3,Low-Value,Lost
39645,1716,1,"51,6",1,1,1,3,Low-Value,Lost
39648,880,3,"111,55",3,1,1,5,Low-Value,At Risk Customers
39650,3,3,"322,79999999999995",5,1,1,7,Mid-Value,Potential Loyalists
39652,577,2,"111,60000000000001",4,1,1,6,Mid-Value,Potential Loyalists
39654,1323,2,"19,35",2,1,1,4,Low-Value,Can't Lose
39657,781,4,"372,25",3,1,1,5,Low-Value,At Risk Customers
39658,1053,1,"30,5",3,1,1,5,Low-Value,At Risk Customers
39660,1220,2,"158,85",2,1,1,4,Low-Value,Can't Lose
39661,351,2,"38,3",5,1,1,7,Mid-Value,Potential Loyalists
39662,1381,2,"88,05",2,1,1,4,Low-Value,Can't Lose
39666,227,2,"52,85",5,1,1,7,Mid-Value,Potential Loyalists
39667,1,7,"288,1",5,2,1,8,High-Value,Potential Loyalists
39668,1351,3,"446,15",2,1,1,4,Low-Value,Can't Lose
39670,1557,1,"12,2",1,1,1,3,Low-Value,Lost
39671,1124,3,"694,45",2,1,2,5,Low-Value,At Risk Customers
39675,939,2,"129,6",3,1,1,5,Low-Value,At Risk Customers
39676,146,1,"169,4",5,1,1,7,Mid-Value,Potential Loyalists
39677,1511,2,"88,5",1,1,1,3,Low-Value,Lost
39679,944,3,"408,7",3,1,1,5,Low-Value,At Risk Customers
39680,969,4,"236,25",3,1,1,5,Low-Value,At Risk Customers
39681,496,3,"164,14999999999998",4,1,1,6,Mid-Value,Potential Loyalists
39682,394,8,"447,0",4,2,1,7,Mid-Value,Potential Loyalists
39683,836,2,"73,3",3,1,1,5,Low-Value,At Risk Customers
39686,981,1,"97,9",3,1,1,5,Low-Value,At Risk Customers
39687,157,3,"74,80000000000001",5,1,1,7,Mid-Value,Potential Loyalists
39688,74,6,"214,35",5,1,1,7,Mid-Value,Potential Loyalists
39689,585,2,"105,95",4,1,1,6,Mid-Value,Potential Loyalists
39690,1464,2,"212,89999999999998",1,1,1,3,Low-Value,Lost
39692,1691,1,"16,95",1,1,1,3,Low-Value,Lost
39693,966,1,"43,3",3,1,1,5,Low-Value,At Risk Customers
39694,963,2,"37,35",3,1,1,5,Low-Value,At Risk Customers
39696,337,1,"18,45",5,1,1,7,Mid-Value,Potential Loyalists
39697,112,2,"78,15",5,1,1,7,Mid-Value,Potential Loyalists
39698,27,2,"21,549999999999997",5,1,1,7,Mid-Value,Potential Loyalists
39700,1122,3,"202,8",2,1,1,4,Low-Value,Can't Lose
39703,48,4,"100,75",5,1,1,7,Mid-Value,Potential Loyalists
39704,1646,2,"101,1",1,1,1,3,Low-Value,Lost
39705,267,3,"166,79999999999998",5,1,1,7,Mid-Value,Potential Loyalists
39706,27,3,"61,5",5,1,1,7,Mid-Value,Potential Loyalists
39708,1469,2,"164,5",1,1,1,3,Low-Value,Lost
39712,158,4,"196,79999999999998",5,1,1,7,Mid-Value,Potential Loyalists
39713,157,7,"377,95",5,2,1,8,High-Value,Potential Loyalists
39715,899,1,"40,75",3,1,1,5,Low-Value,At Risk Customers
39716,739,2,"63,95",3,1,1,5,Low-Value,At Risk Customers
39717,7,3,"118,85000000000001",5,1,1,7,Mid-Value,Potential Loyalists
39719,28,14,"537,45",5,3,1,9,High-Value,Champions
39720,1416,1,"14,55",2,1,1,4,Low-Value,Can't Lose
39726,312,2,"160,2",5,1,1,7,Mid-Value,Potential Loyalists
39727,1270,2,"28,65",2,1,1,4,Low-Value,Can't Lose
39728,224,2,"87,9",5,1,1,7,Mid-Value,Potential Loyalists
39729,1525,1,"20,0",1,1,1,3,Low-Value,Lost
39730,935,2,"42,65",3,1,1,5,Low-Value,At Risk Customers
39731,417,5,"82,05",4,1,1,6,Mid-Value,Potential Loyalists
39733,32,3,"91,30000000000001",5,1,1,7,Mid-Value,Potential Loyalists
39734,1275,4,"201,45",2,1,1,4,Low-Value,Can't Lose
39735,935,6,"209,2",3,1,1,5,Low-Value,At Risk Customers
39736,737,11,"1097,3500000000001",3,2,2,7,Mid-Value,Potential Loyalists
39737,192,4,"334,1",5,1,1,7,Mid-Value,Potential Loyalists
39738,400,2,"106,15",4,1,1,6,Mid-Value,Potential Loyalists
39741,633,2,"21,65",4,1,1,6,Mid-Value,Potential Loyalists
39742,1124,2,"178,95",2,1,1,4,Low-Value,Can't Lose
39743,38,6,"283,35",5,1,1,7,Mid-Value,Potential Loyalists
39745,813,4,"166,10000000000002",3,1,1,5,Low-Value,At Risk Customers
39746,106,2,"157,64999999999998",5,1,1,7,Mid-Value,Potential Loyalists
39750,1035,1,"76,3",3,1,1,5,Low-Value,At Risk Customers
39752,298,5,"123,44999999999999",5,1,1,7,Mid-Value,Potential Loyalists
39753,387,3,"113,9",4,1,1,6,Mid-Value,Potential Loyalists
39756,52,4,"171,45",5,1,1,7,Mid-Value,Potential Loyalists
39759,1141,3,"131,6",2,1,1,4,Low-Value,Can't Lose
39760,18,9,"511,15",5,2,1,8,High-Value,Potential Loyalists
39762,1729,1,"26,35",1,1,1,3,Low-Value,Lost
39763,1186,1,"89,05",2,1,1,4,Low-Value,Can't Lose
39764,414,1,"42,45",4,1,1,6,Mid-Value,Potential Loyalists
39765,759,1,"363,0",3,1,1,5,Low-Value,At Risk Customers
39767,808,2,"121,05",3,1,1,5,Low-Value,At Risk Customers
39768,337,3,"210,75",5,1,1,7,Mid-Value,Potential Loyalists
39769,34,11,"944,05",5,2,2,9,High-Value,Champions
39771,515,3,"184,65",4,1,1,6,Mid-Value,Potential Loyalists
39774,152,6,"285,75",5,1,1,7,Mid-Value,Potential Loyalists
39776,614,1,"40,75",4,1,1,6,Mid-Value,Potential Loyalists
39778,899,3,"152,0",3,1,1,5,Low-Value,At Risk Customers
39779,668,1,"25,45",4,1,1,6,Mid-Value,Potential Loyalists
39780,19,1,"357,75",5,1,1,7,Mid-Value,Potential Loyalists
39781,252,9,"581,2",5,2,1,8,High-Value,Potential Loyalists
39782,252,2,"159,1",5,1,1,7,Mid-Value,Potential Loyalists
39783,13,6,"540,0999999999999",5,1,1,7,Mid-Value,Potential Loyalists
39784,363,3,"79,89999999999999",5,1,1,7,Mid-Value,Potential Loyalists
39785,265,6,"181,3",5,1,1,7,Mid-Value,Potential Loyalists
39786,97,6,"717,05",5,1,2,8,High-Value,Potential Loyalists
39787,816,2,"331,65000000000003",3,1,1,5,Low-Value,At Risk Customers
39788,73,19,"791,5",5,4,2,11,High-Value,Champions
39790,943,1,"214,79999999999998",3,1,1,5,Low-Value,At Risk Customers
39791,867,1,"36,7",3,1,1,5,Low-Value,At Risk Customers
39792,313,4,"171,45",5,1,1,7,Mid-Value,Potential Loyalists
39793,183,4,"191,39999999999998",5,1,1,7,Mid-Value,Potential Loyalists
39795,553,1,"61,1",4,1,1,6,Mid-Value,Potential Loyalists
39797,594,6,"223,95",4,1,1,6,Mid-Value,Potential Loyalists
39798,35,7,"253,15",5,2,1,8,High-Value,Potential Loyalists
39799,21,4,"255,5",5,1,1,7,Mid-Value,Potential Loyalists
39800,804,4,"231,95",3,1,1,5,Low-Value,At Risk Customers
39801,1078,1,"348,6",3,1,1,5,Low-Value,At Risk Customers
39803,204,2,"107,8",5,1,1,7,Mid-Value,Potential Loyalists
39804,651,1,"172,2",4,1,1,6,Mid-Value,Potential Loyalists
39805,1595,1,"35,8",1,1,1,3,Low-Value,Lost
39806,15,2,"131,85000000000002",5,1,1,7,Mid-Value,Potential Loyalists
39808,787,2,"92,4",3,1,1,5,Low-Value,At Risk Customers
39811,416,5,"307,65000000000003",4,1,1,6,Mid-Value,Potential Loyalists
39813,35,4,"77,7",5,1,1,7,Mid-Value,Potential Loyalists
39814,86,9,"181,6",5,2,1,8,High-Value,Potential Loyalists
39815,662,2,"131,95",4,1,1,6,Mid-Value,Potential Loyalists
39816,43,3,"335,25",5,1,1,7,Mid-Value,Potential Loyalists
39817,188,2,"134,6",5,1,1,7,Mid-Value,Potential Loyalists
39818,382,2,"279,95",4,1,1,6,Mid-Value,Potential Loyalists
39819,1056,1,"19,45",3,1,1,5,Low-Value,At Risk Customers
39820,634,1,"30,5",4,1,1,6,Mid-Value,Potential Loyalists
39824,1189,2,"168,54999999999998",2,1,1,4,Low-Value,Can't Lose
39827,1132,5,"758,25",2,1,2,5,Low-Value,At Risk Customers
39828,200,3,"276,8",5,1,1,7,Mid-Value,Potential Loyalists
39829,54,9,"349,1",5,2,1,8,High-Value,Potential Loyalists
39839,10,4,"218,2",5,1,1,7,Mid-Value,Potential Loyalists
39840,111,1,"15,0",5,1,1,7,Mid-Value,Potential Loyalists
39841,122,3,"73,8",5,1,1,7,Mid-Value,Potential Loyalists
39842,710,1,"24,85",4,1,1,6,Mid-Value,Potential Loyalists
39843,79,2,"46,2",5,1,1,7,Mid-Value,Potential Loyalists
39847,409,3,"92,75",4,1,1,6,Mid-Value,Potential Loyalists
39850,181,8,"493,75",5,2,1,8,High-Value,Potential Loyalists
39854,802,3,"280,5",3,1,1,5,Low-Value,At Risk Customers
39855,164,4,"315,45",5,1,1,7,Mid-Value,Potential Loyalists
39857,308,2,"115,45",5,1,1,7,Mid-Value,Potential Loyalists
39858,1119,1,"155,7",2,1,1,4,Low-Value,Can't Lose
39859,1495,4,"276,55",1,1,1,3,Low-Value,Lost
39862,604,2,"222,70000000000002",4,1,1,6,Mid-Value,Potential Loyalists
39867,1722,1,"80,4",1,1,1,3,Low-Value,Lost
39868,1540,1,"23,35",1,1,1,3,Low-Value,Lost
39870,398,2,"63,25",4,1,1,6,Mid-Value,Potential Loyalists
39872,88,5,"103,25",5,1,1,7,Mid-Value,Potential Loyalists
39873,991,3,"47,9",3,1,1,5,Low-Value,At Risk Customers
39875,977,1,"72,75",3,1,1,5,Low-Value,At Risk Customers
39876,3,1,"17,5",5,1,1,7,Mid-Value,Potential Loyalists
39878,41,6,"532,05",5,1,1,7,Mid-Value,Potential Loyalists
39882,24,4,"477,9",5,1,1,7,Mid-Value,Potential Loyalists
39883,1451,1,"17,25",2,1,1,4,Low-Value,Can't Lose
39884,85,2,"18,9",5,1,1,7,Mid-Value,Potential Loyalists
39886,10,4,"342,0",5,1,1,7,Mid-Value,Potential Loyalists
39887,198,4,"333,0",5,1,1,7,Mid-Value,Potential Loyalists
39888,559,1,"90,1",4,1,1,6,Mid-Value,Potential Loyalists
39889,357,4,"415,95",5,1,1,7,Mid-Value,Potential Loyalists
39890,230,2,"219,3",5,1,1,7,Mid-Value,Potential Loyalists
39891,42,2,"205,2",5,1,1,7,Mid-Value,Potential Loyalists
39892,845,3,"128,6",3,1,1,5,Low-Value,At Risk Customers
39894,863,2,"343,6",3,1,1,5,Low-Value,At Risk Customers
39895,1635,2,"75,2",1,1,1,3,Low-Value,Lost
39898,879,3,"322,90000000000003",3,1,1,5,Low-Value,At Risk Customers
39901,87,4,"294,25",5,1,1,7,Mid-Value,Potential Loyalists
39902,468,1,"55,0",4,1,1,6,Mid-Value,Potential Loyalists
39903,465,2,"52,25",4,1,1,6,Mid-Value,Potential Loyalists
39905,333,5,"298,3",5,1,1,7,Mid-Value,Potential Loyalists
39907,1659,1,"25,200000000000003",1,1,1,3,Low-Value,Lost
39908,1725,1,"21,5",1,1,1,3,Low-Value,Lost
39911,1060,1,"17,25",3,1,1,5,Low-Value,At Risk Customers
39912,72,8,"566,6",5,2,1,8,High-Value,Potential Loyalists
39914,443,2,"59,650000000000006",4,1,1,6,Mid-Value,Potential Loyalists
39918,734,2,"95,25",3,1,1,5,Low-Value,At Risk Customers
39919,160,2,"85,5",5,1,1,7,Mid-Value,Potential Loyalists
39924,106,4,"144,95",5,1,1,7,Mid-Value,Potential Loyalists
39925,719,1,"97,95",4,1,1,6,Mid-Value,Potential Loyalists
39926,403,2,"132,20000000000002",4,1,1,6,Mid-Value,Potential Loyalists
39927,543,4,"346,5",4,1,1,6,Mid-Value,Potential Loyalists
39929,1706,1,"15,4",1,1,1,3,Low-Value,Lost
39930,833,1,"17,5",3,1,1,5,Low-Value,At Risk Customers
39931,139,4,"213,15",5,1,1,7,Mid-Value,Potential Loyalists
39932,259,1,"200,10000000000002",5,1,1,7,Mid-Value,Potential Loyalists
39933,1520,1,"10,23",1,1,1,3,Low-Value,Lost
39935,107,1,"14,5",5,1,1,7,Mid-Value,Potential Loyalists
39936,1505,2,"113,05000000000001",1,1,1,3,Low-Value,Lost
39937,59,5,"136,35",5,1,1,7,Mid-Value,Potential Loyalists
39938,68,3,"70,65",5,1,1,7,Mid-Value,Potential Loyalists
39939,584,1,"7,25",4,1,1,6,Mid-Value,Potential Loyalists
39942,111,2,"336,84999999999997",5,1,1,7,Mid-Value,Potential Loyalists
39945,759,1,"113,10000000000001",3,1,1,5,Low-Value,At Risk Customers
39946,544,4,"302,05",4,1,1,6,Mid-Value,Potential Loyalists
39947,374,9,"447,5",4,2,1,7,Mid-Value,Potential Loyalists
39948,27,2,"297,29999999999995",5,1,1,7,Mid-Value,Potential Loyalists
39950,894,2,"277,25",3,1,1,5,Low-Value,At Risk Customers
39951,1023,1,"10,75",3,1,1,5,Low-Value,At Risk Customers
39953,332,3,"648,1",5,1,1,7,Mid-Value,Potential Loyalists
39954,115,7,"299,1",5,2,1,8,High-Value,Potential Loyalists
39955,1358,2,"56,9",2,1,1,4,Low-Value,Can't Lose
39956,158,6,"398,65000000000003",5,1,1,7,Mid-Value,Potential Loyalists
39959,463,1,"54,75",4,1,1,6,Mid-Value,Potential Loyalists
39960,1359,2,"340,8",2,1,1,4,Low-Value,Can't Lose
39961,743,8,"567,5",3,2,1,6,Mid-Value,Potential Loyalists
39962,55,8,"458,0",5,2,1,8,High-Value,Potential Loyalists
39963,9,3,"299,85",5,1,1,7,Mid-Value,Potential Loyalists
39964,375,3,"191,0",4,1,1,6,Mid-Value,Potential Loyalists
39967,526,2,"568,0",4,1,1,6,Mid-Value,Potential Loyalists
39968,742,3,"161,0",3,1,1,5,Low-Value,At Risk Customers
39969,11,7,"851,9",5,2,2,9,High-Value,Champions
39974,323,2,"139,5",5,1,1,7,Mid-Value,Potential Loyalists
39976,829,2,"126,5",3,1,1,5,Low-Value,At Risk Customers
39979,638,1,"15,8",4,1,1,6,Mid-Value,Potential Loyalists
39981,1332,1,"7,0",2,1,1,4,Low-Value,Can't Lose
39983,338,1,"33,5",5,1,1,7,Mid-Value,Potential Loyalists
39984,27,7,"844,1",5,2,2,9,High-Value,Champions
39985,3,2,"354,4",5,1,1,7,Mid-Value,Potential Loyalists
39986,301,5,"137,5",5,1,1,7,Mid-Value,Potential Loyalists
39987,466,4,"251,55",4,1,1,6,Mid-Value,Potential Loyalists
39988,169,4,"277,9",5,1,1,7,Mid-Value,Potential Loyalists
39990,986,1,"23,75",3,1,1,5,Low-Value,At Risk Customers
39991,796,1,"18,9",3,1,1,5,Low-Value,At Risk Customers
39992,543,6,"730,2",4,1,2,7,Mid-Value,Potential Loyalists
39994,28,9,"1108,5",5,2,2,9,High-Value,Champions
39997,10,4,"283,95",5,1,1,7,Mid-Value,Potential Loyalists
40000,32,7,"384,75",5,2,1,8,High-Value,Potential Loyalists
40001,62,8,"242,54",5,2,1,8,High-Value,Potential Loyalists
40003,139,5,"331,6",5,1,1,7,Mid-Value,Potential Loyalists
40004,1125,5,"556,15",2,1,1,4,Low-Value,Can't Lose
40005,16,1,"148,3",5,1,1,7,Mid-Value,Potential Loyalists
40006,22,6,"302,45",5,1,1,7,Mid-Value,Potential Loyalists
40008,804,5,"349,05",3,1,1,5,Low-Value,At Risk Customers
40009,63,3,"47,5",5,1,1,7,Mid-Value,Potential Loyalists
40010,35,4,"221,85",5,1,1,7,Mid-Value,Potential Loyalists
40013,311,4,"227,55",5,1,1,7,Mid-Value,Potential Loyalists
40015,7,3,"178,1",5,1,1,7,Mid-Value,Potential Loyalists
40016,1114,1,"36,25",2,1,1,4,Low-Value,Can't Lose
40017,392,2,"88,0",4,1,1,6,Mid-Value,Potential Loyalists
40019,657,3,"347,95",4,1,1,6,Mid-Value,Potential Loyalists
40020,122,9,"447,35",5,2,1,8,High-Value,Potential Loyalists
40022,608,6,"368,9",4,1,1,6,Mid-Value,Potential Loyalists
40023,95,10,"966,4",5,2,2,9,High-Value,Champions
40024,806,4,"88,45",3,1,1,5,Low-Value,At Risk Customers
40025,1001,2,"183,05",3,1,1,5,Low-Value,At Risk Customers
40028,136,7,"510,3",5,2,1,8,High-Value,Potential Loyalists
40029,70,5,"212,29999999999998",5,1,1,7,Mid-Value,Potential Loyalists
40030,1664,1,"44,55",1,1,1,3,Low-Value,Lost
40032,130,12,"702,75",5,3,2,10,High-Value,Champions
40034,1314,1,"18,75",2,1,1,4,Low-Value,Can't Lose
40035,615,3,"144,15",4,1,1,6,Mid-Value,Potential Loyalists
40036,1234,2,"494,65",2,1,1,4,Low-Value,Can't Lose
40038,884,7,"379,85",3,2,1,6,Mid-Value,Potential Loyalists
40040,215,1,"48,7",5,1,1,7,Mid-Value,Potential Loyalists
40041,904,3,"119,2",3,1,1,5,Low-Value,At Risk Customers
40042,1092,1,"54,0",3,1,1,5,Low-Value,At Risk Customers
40044,227,8,"460,1",5,2,1,8,High-Value,Potential Loyalists
40045,584,2,"66,7",4,1,1,6,Mid-Value,Potential Loyalists
40046,1328,1,"177,60000000000002",2,1,1,4,Low-Value,Can't Lose
40047,575,3,"73,25",4,1,1,6,Mid-Value,Potential Loyalists
40052,1770,1,"21,2",1,1,1,3,Low-Value,Lost
40056,183,2,"54,3",5,1,1,7,Mid-Value,Potential Loyalists
40057,223,1,"14,4",5,1,1,7,Mid-Value,Potential Loyalists
40059,1037,5,"397,54999999999995",3,1,1,5,Low-Value,At Risk Customers
40060,1217,6,"374,7",2,1,1,4,Low-Value,Can't Lose
40062,155,5,"288,85",5,1,1,7,Mid-Value,Potential Loyalists
40063,245,4,"137,75",5,1,1,7,Mid-Value,Potential Loyalists
40064,751,1,"55,85",3,1,1,5,Low-Value,At Risk Customers
40066,525,3,"275,0",4,1,1,6,Mid-Value,Potential Loyalists
40067,891,1,"2,7",3,1,1,5,Low-Value,At Risk Customers
40068,1465,3,"200,14999999999998",1,1,1,3,Low-Value,Lost
40069,964,1,"84,3",3,1,1,5,Low-Value,At Risk Customers
40070,865,4,"166,0",3,1,1,5,Low-Value,At Risk Customers
40073,512,6,"289,0",4,1,1,6,Mid-Value,Potential Loyalists
40075,1315,2,"190,95000000000002",2,1,1,4,Low-Value,Can't Lose
40076,88,2,"45,15",5,1,1,7,Mid-Value,Potential Loyalists
40077,1417,1,"4,65",2,1,1,4,Low-Value,Can't Lose
40078,377,6,"695,55",4,1,2,7,Mid-Value,Potential Loyalists
40079,735,4,"293,15",3,1,1,5,Low-Value,At Risk Customers
40081,385,1,"61,0",4,1,1,6,Mid-Value,Potential Loyalists
40082,754,2,"120,65",3,1,1,5,Low-Value,At Risk Customers
40084,1206,1,"26,6",2,1,1,4,Low-Value,Can't Lose
40086,98,2,"72,8",5,1,1,7,Mid-Value,Potential Loyalists
40087,990,4,"222,07",3,1,1,5,Low-Value,At Risk Customers
40088,20,2,"45,55",5,1,1,7,Mid-Value,Potential Loyalists
40089,808,3,"232,35",3,1,1,5,Low-Value,At Risk Customers
40090,83,9,"752,6",5,2,2,9,High-Value,Champions
40091,1237,4,"636,45",2,1,1,4,Low-Value,Can't Lose
40094,570,7,"537,0",4,2,1,7,Mid-Value,Potential Loyalists
40095,1342,1,"51,65",2,1,1,4,Low-Value,Can't Lose
40099,65,2,"137,20000000000002",5,1,1,7,Mid-Value,Potential Loyalists
40101,98,1,"16,5",5,1,1,7,Mid-Value,Potential Loyalists
40102,915,2,"117,4",3,1,1,5,Low-Value,At Risk Customers
40103,1356,4,"504,95",2,1,1,4,Low-Value,Can't Lose
40106,113,4,"221,8",5,1,1,7,Mid-Value,Potential Loyalists
40107,906,2,"41,0",3,1,1,5,Low-Value,At Risk Customers
40109,533,1,"75,7",4,1,1,6,Mid-Value,Potential Loyalists
40110,411,1,"44,9",4,1,1,6,Mid-Value,Potential Loyalists
40111,55,2,"143,05",5,1,1,7,Mid-Value,Potential Loyalists
40113,304,2,"59,75",5,1,1,7,Mid-Value,Potential Loyalists
40115,701,5,"397,35",4,1,1,6,Mid-Value,Potential Loyalists
40116,1741,1,"48,0",1,1,1,3,Low-Value,Lost
40118,1240,3,"731,6500000000001",2,1,2,5,Low-Value,At Risk Customers
40119,1596,1,"77,2",1,1,1,3,Low-Value,Lost
40120,212,1,"398,0",5,1,1,7,Mid-Value,Potential Loyalists
40124,335,1,"8,75",5,1,1,7,Mid-Value,Potential Loyalists
40125,470,2,"48,849999999999994",4,1,1,6,Mid-Value,Potential Loyalists
40127,242,2,"58,95",5,1,1,7,Mid-Value,Potential Loyalists
40128,318,3,"384,20000000000005",5,1,1,7,Mid-Value,Potential Loyalists
40129,167,3,"173,8",5,1,1,7,Mid-Value,Potential Loyalists
40131,1780,1,"26,35",1,1,1,3,Low-Value,Lost
40132,53,3,"73,25",5,1,1,7,Mid-Value,Potential Loyalists
40134,593,1,"67,55",4,1,1,6,Mid-Value,Potential Loyalists
40136,13,2,"42,55",5,1,1,7,Mid-Value,Potential Loyalists
40137,514,2,"28,55",4,1,1,6,Mid-Value,Potential Loyalists
40140,942,2,"164,15",3,1,1,5,Low-Value,At Risk Customers
40142,803,4,"204,5",3,1,1,5,Low-Value,At Risk Customers
40143,102,2,"57,849999999999994",5,1,1,7,Mid-Value,Potential Loyalists
40146,161,2,"90,95",5,1,1,7,Mid-Value,Potential Loyalists
40148,320,1,"4,4",5,1,1,7,Mid-Value,Potential Loyalists
40149,257,3,"89,44999999999999",5,1,1,7,Mid-Value,Potential Loyalists
40150,735,8,"1224,2",3,2,2,7,Mid-Value,Potential Loyalists
40151,289,11,"1163,5",5,2,2,9,High-Value,Champions
40153,1378,1,"117,8",2,1,1,4,Low-Value,Can't Lose
40155,774,1,"33,6",3,1,1,5,Low-Value,At Risk Customers
40157,200,5,"238,75",5,1,1,7,Mid-Value,Potential Loyalists
40158,68,6,"788,3",5,1,2,8,High-Value,Potential Loyalists
40160,82,4,"227,05",5,1,1,7,Mid-Value,Potential Loyalists
40162,255,10,"274,09999999999997",5,2,1,8,High-Value,Potential Loyalists
40164,72,2,"24,049999999999997",5,1,1,7,Mid-Value,Potential Loyalists
40165,973,2,"78,1",3,1,1,5,Low-Value,At Risk Customers
40166,560,2,"63,0",4,1,1,6,Mid-Value,Potential Loyalists
40168,316,3,"120,9",5,1,1,7,Mid-Value,Potential Loyalists
40169,14,9,"768,9",5,2,2,9,High-Value,Champions
40170,374,4,"186,25",4,1,1,6,Mid-Value,Potential Loyalists
40171,853,2,"192,65",3,1,1,5,Low-Value,At Risk Customers
40174,262,4,"206,3",5,1,1,7,Mid-Value,Potential Loyalists
40177,132,8,"334,4",5,2,1,8,High-Value,Potential Loyalists
40178,202,5,"180,05",5,1,1,7,Mid-Value,Potential Loyalists
40182,262,4,"106,44999999999999",5,1,1,7,Mid-Value,Potential Loyalists
40183,145,7,"229,85000000000002",5,2,1,8,High-Value,Potential Loyalists
40184,98,1,"22,7",5,1,1,7,Mid-Value,Potential Loyalists
40185,538,1,"86,9",4,1,1,6,Mid-Value,Potential Loyalists
40186,12,14,"472,25",5,3,1,9,High-Value,Champions
40187,444,2,"1509,7",4,1,3,8,High-Value,Potential Loyalists
40189,864,1,"17,3",3,1,1,5,Low-Value,At Risk Customers
40191,47,6,"505,29999999999995",5,1,1,7,Mid-Value,Potential Loyalists
40193,568,2,"452,0",4,1,1,6,Mid-Value,Potential Loyalists
40194,1692,1,"28,15",1,1,1,3,Low-Value,Lost
40195,439,1,"12,3",4,1,1,6,Mid-Value,Potential Loyalists
40198,755,8,"339,35",3,2,1,6,Mid-Value,Potential Loyalists
40199,4,5,"304,7",5,1,1,7,Mid-Value,Potential Loyalists
40202,249,3,"161,45000000000002",5,1,1,7,Mid-Value,Potential Loyalists
40203,766,1,"155,3",3,1,1,5,Low-Value,At Risk Customers
40205,1251,1,"61,6",2,1,1,4,Low-Value,Can't Lose
40206,1660,1,"38,5",1,1,1,3,Low-Value,Lost
40207,162,4,"655,55",5,1,1,7,Mid-Value,Potential Loyalists
40210,837,1,"35,7",3,1,1,5,Low-Value,At Risk Customers
40211,10,4,"476,34999999999997",5,1,1,7,Mid-Value,Potential Loyalists
40212,1478,1,"45,2",1,1,1,3,Low-Value,Lost
40214,418,4,"194,95",4,1,1,6,Mid-Value,Potential Loyalists
40217,773,5,"453,3",3,1,1,5,Low-Value,At Risk Customers
40218,150,1,"270,0",5,1,1,7,Mid-Value,Potential Loyalists
40219,723,2,"582,7",4,1,1,6,Mid-Value,Potential Loyalists
40220,971,2,"94,55",3,1,1,5,Low-Value,At Risk Customers
40222,956,2,"29,75",3,1,1,5,Low-Value,At Risk Customers
40223,544,1,"224,0",4,1,1,6,Mid-Value,Potential Loyalists
40224,1378,1,"10,2",2,1,1,4,Low-Value,Can't Lose
40225,703,3,"118,35",4,1,1,6,Mid-Value,Potential Loyalists
40230,85,3,"53,25",5,1,1,7,Mid-Value,Potential Loyalists
40231,45,10,"695,5",5,2,2,9,High-Value,Champions
40232,7,2,"70,95",5,1,1,7,Mid-Value,Potential Loyalists
40233,203,3,"213,35",5,1,1,7,Mid-Value,Potential Loyalists
40234,1011,1,"87,4",3,1,1,5,Low-Value,At Risk Customers
40235,228,8,"610,5",5,2,1,8,High-Value,Potential Loyalists
40236,1599,1,"82,19999999999999",1,1,1,3,Low-Value,Lost
40238,819,2,"127,85",3,1,1,5,Low-Value,At Risk Customers
40239,1047,6,"451,54",3,1,1,5,Low-Value,At Risk Customers
40240,837,1,"25,25",3,1,1,5,Low-Value,At Risk Customers
40242,778,2,"55,95",3,1,1,5,Low-Value,At Risk Customers
40243,780,5,"343,85",3,1,1,5,Low-Value,At Risk Customers
40244,852,2,"113,6",3,1,1,5,Low-Value,At Risk Customers
40245,1610,3,"287,4",1,1,1,3,Low-Value,Lost
40247,16,6,"391,2",5,1,1,7,Mid-Value,Potential Loyalists
40248,752,7,"373,04999999999995",3,2,1,6,Mid-Value,Potential Loyalists
40249,235,3,"115,35000000000002",5,1,1,7,Mid-Value,Potential Loyalists
40252,406,3,"174,35000000000002",4,1,1,6,Mid-Value,Potential Loyalists
40253,780,2,"34,5",3,1,1,5,Low-Value,At Risk Customers
40254,354,2,"29,150000000000002",5,1,1,7,Mid-Value,Potential Loyalists
40257,701,1,"44,25",4,1,1,6,Mid-Value,Potential Loyalists
40258,54,7,"776,55",5,2,2,9,High-Value,Champions
40259,151,5,"371,75",5,1,1,7,Mid-Value,Potential Loyalists
40260,1553,2,"78,69999999999999",1,1,1,3,Low-Value,Lost
40261,376,13,"520,0",4,3,1,8,High-Value,Potential Loyalists
40262,860,1,"100,3",3,1,1,5,Low-Value,At Risk Customers
40263,192,3,"69,3",5,1,1,7,Mid-Value,Potential Loyalists
40264,675,1,"115,80000000000001",4,1,1,6,Mid-Value,Potential Loyalists
40265,174,7,"360,09999999999997",5,2,1,8,High-Value,Potential Loyalists
40266,857,1,"26,15",3,1,1,5,Low-Value,At Risk Customers
40267,946,2,"81,25",3,1,1,5,Low-Value,At Risk Customers
40268,277,5,"475,70000000000005",5,1,1,7,Mid-Value,Potential Loyalists
40270,1614,1,"72,6",1,1,1,3,Low-Value,Lost
40271,271,4,"186,05",5,1,1,7,Mid-Value,Potential Loyalists
40272,1078,1,"79,0",3,1,1,5,Low-Value,At Risk Customers
40273,125,2,"71,95",5,1,1,7,Mid-Value,Potential Loyalists
40275,429,5,"229,25",4,1,1,6,Mid-Value,Potential Loyalists
40276,150,13,"512,6",5,3,1,9,High-Value,Champions
40277,1541,1,"27,15",1,1,1,3,Low-Value,Lost
40278,589,3,"260,75",4,1,1,6,Mid-Value,Potential Loyalists
40279,325,4,"357,95000000000005",5,1,1,7,Mid-Value,Potential Loyalists
40280,385,1,"116,35",4,1,1,6,Mid-Value,Potential Loyalists
40281,445,6,"365,15",4,1,1,6,Mid-Value,Potential Loyalists
40282,206,4,"263,8",5,1,1,7,Mid-Value,Potential Loyalists
40283,286,4,"153,9",5,1,1,7,Mid-Value,Potential Loyalists
40285,1123,4,"243,8",2,1,1,4,Low-Value,Can't Lose
40287,761,3,"72,6",3,1,1,5,Low-Value,At Risk Customers
40288,95,6,"270,5",5,1,1,7,Mid-Value,Potential Loyalists
40289,14,8,"416,9",5,2,1,8,High-Value,Potential Loyalists
40290,859,1,"182,3",3,1,1,5,Low-Value,At Risk Customers
40292,131,2,"260,35",5,1,1,7,Mid-Value,Potential Loyalists
40294,1295,2,"43,3",2,1,1,4,Low-Value,Can't Lose
40297,262,5,"241,95",5,1,1,7,Mid-Value,Potential Loyalists
40299,126,13,"903,7",5,3,2,10,High-Value,Champions
40300,561,1,"35,6",4,1,1,6,Mid-Value,Potential Loyalists
40301,1707,1,"3,5",1,1,1,3,Low-Value,Lost
40302,1645,1,"66,0",1,1,1,3,Low-Value,Lost
40305,382,4,"172,2",4,1,1,6,Mid-Value,Potential Loyalists
40306,4,3,"54,900000000000006",5,1,1,7,Mid-Value,Potential Loyalists
40308,7,5,"401,9",5,1,1,7,Mid-Value,Potential Loyalists
40309,280,1,"51,75",5,1,1,7,Mid-Value,Potential Loyalists
40312,1589,2,"227,8",1,1,1,3,Low-Value,Lost
40313,58,6,"134,8",5,1,1,7,Mid-Value,Potential Loyalists
40318,1517,2,"170,4",1,1,1,3,Low-Value,Lost
40319,1564,1,"34,1",1,1,1,3,Low-Value,Lost
40320,210,3,"272,45000000000005",5,1,1,7,Mid-Value,Potential Loyalists
40321,1343,1,"174,0",2,1,1,4,Low-Value,Can't Lose
40322,399,1,"28,5",4,1,1,6,Mid-Value,Potential Loyalists
40323,107,2,"270,3",5,1,1,7,Mid-Value,Potential Loyalists
40324,187,3,"635,75",5,1,1,7,Mid-Value,Potential Loyalists
40325,64,5,"340,0",5,1,1,7,Mid-Value,Potential Loyalists
40326,1482,2,"103,3",1,1,1,3,Low-Value,Lost
40328,434,2,"116,55",4,1,1,6,Mid-Value,Potential Loyalists
40329,1655,1,"197,70000000000002",1,1,1,3,Low-Value,Lost
40330,549,5,"363,3",4,1,1,6,Mid-Value,Potential Loyalists
40332,215,2,"25,2",5,1,1,7,Mid-Value,Potential Loyalists
40333,1148,2,"69,75",2,1,1,4,Low-Value,Can't Lose
40334,12,10,"515,2",5,2,1,8,High-Value,Potential Loyalists
40335,1456,4,"250,2",2,1,1,4,Low-Value,Can't Lose
40336,251,3,"176,4",5,1,1,7,Mid-Value,Potential Loyalists
40337,171,3,"287,75",5,1,1,7,Mid-Value,Potential Loyalists
40339,281,3,"368,15",5,1,1,7,Mid-Value,Potential Loyalists
40340,682,1,"15,9",4,1,1,6,Mid-Value,Potential Loyalists
40342,40,1,"9,1",5,1,1,7,Mid-Value,Potential Loyalists
40343,620,2,"160,14999999999998",4,1,1,6,Mid-Value,Potential Loyalists
40344,15,8,"448,35",5,2,1,8,High-Value,Potential Loyalists
40345,732,7,"764,55",3,2,2,7,Mid-Value,Potential Loyalists
40346,929,2,"61,35",3,1,1,5,Low-Value,At Risk Customers
40347,511,6,"133,95",4,1,1,6,Mid-Value,Potential Loyalists
40348,1627,1,"91,35",1,1,1,3,Low-Value,Lost
40351,1404,2,"38,15",2,1,1,4,Low-Value,Can't Lose
40352,342,6,"774,3499999999999",5,1,2,8,High-Value,Potential Loyalists
40353,712,4,"314,05000000000007",4,1,1,6,Mid-Value,Potential Loyalists
40358,1797,1,"93,75",1,1,1,3,Low-Value,Lost
40359,424,3,"355,35",4,1,1,6,Mid-Value,Potential Loyalists
40360,515,1,"13,75",4,1,1,6,Mid-Value,Potential Loyalists
40364,7,3,"56,099999999999994",5,1,1,7,Mid-Value,Potential Loyalists
40365,1087,1,"34,55",3,1,1,5,Low-Value,At Risk Customers
40368,1476,1,"90,4",1,1,1,3,Low-Value,Lost
40370,965,1,"20,2",3,1,1,5,Low-Value,At Risk Customers
40372,38,5,"413,15000000000003",5,1,1,7,Mid-Value,Potential Loyalists
40373,37,6,"423,9",5,1,1,7,Mid-Value,Potential Loyalists
40375,535,1,"156,8",4,1,1,6,Mid-Value,Potential Loyalists
40377,1066,5,"265,9",3,1,1,5,Low-Value,At Risk Customers
40379,1015,1,"163,64999999999998",3,1,1,5,Low-Value,At Risk Customers
40382,241,1,"49,95",5,1,1,7,Mid-Value,Potential Loyalists
40386,888,2,"38,95",3,1,1,5,Low-Value,At Risk Customers
40387,602,3,"308,25",4,1,1,6,Mid-Value,Potential Loyalists
40389,909,2,"89,7",3,1,1,5,Low-Value,At Risk Customers
40390,194,3,"124,1",5,1,1,7,Mid-Value,Potential Loyalists
40392,655,1,"219,1",4,1,1,6,Mid-Value,Potential Loyalists
40393,783,1,"18,5",3,1,1,5,Low-Value,At Risk Customers
40394,1128,1,"13,95",2,1,1,4,Low-Value,Can't Lose
40395,311,4,"362,65",5,1,1,7,Mid-Value,Potential Loyalists
40396,22,9,"891,0500000000001",5,2,2,9,High-Value,Champions
40397,606,5,"328,7",4,1,1,6,Mid-Value,Potential Loyalists
40399,294,4,"650,35",5,1,1,7,Mid-Value,Potential Loyalists
40400,1188,1,"81,8",2,1,1,4,Low-Value,Can't Lose
40401,391,2,"277,5",4,1,1,6,Mid-Value,Potential Loyalists
40402,925,2,"108,75",3,1,1,5,Low-Value,At Risk Customers
40403,138,8,"472,8",5,2,1,8,High-Value,Potential Loyalists
40404,745,2,"352,8",3,1,1,5,Low-Value,At Risk Customers
40407,4,7,"253,35",5,2,1,8,High-Value,Potential Loyalists
40408,885,2,"23,65",3,1,1,5,Low-Value,At Risk Customers
40411,251,3,"197,45",5,1,1,7,Mid-Value,Potential Loyalists
40412,34,1,"28,25",5,1,1,7,Mid-Value,Potential Loyalists
40413,1279,2,"78,15",2,1,1,4,Low-Value,Can't Lose
40414,775,3,"405,45000000000005",3,1,1,5,Low-Value,At Risk Customers
40415,162,3,"32,7",5,1,1,7,Mid-Value,Potential Loyalists
40417,389,4,"229,70000000000002",4,1,1,6,Mid-Value,Potential Loyalists
40421,46,1,"42,15",5,1,1,7,Mid-Value,Potential Loyalists
40423,542,2,"475,55",4,1,1,6,Mid-Value,Potential Loyalists
40424,1218,1,"41,6",2,1,1,4,Low-Value,Can't Lose
40425,1449,1,"11,4",2,1,1,4,Low-Value,Can't Lose
40427,668,1,"41,4",4,1,1,6,Mid-Value,Potential Loyalists
40428,114,2,"103,0",5,1,1,7,Mid-Value,Potential Loyalists
40429,1520,1,"34,35",1,1,1,3,Low-Value,Lost
40430,872,2,"120,5",3,1,1,5,Low-Value,At Risk Customers
40431,613,4,"254,0",4,1,1,6,Mid-Value,Potential Loyalists
40432,964,5,"374,65000000000003",3,1,1,5,Low-Value,At Risk Customers
40435,202,4,"246,35000000000002",5,1,1,7,Mid-Value,Potential Loyalists
40437,456,3,"131,15",4,1,1,6,Mid-Value,Potential Loyalists
40438,301,3,"71,35",5,1,1,7,Mid-Value,Potential Loyalists
40439,75,4,"505,54999999999995",5,1,1,7,Mid-Value,Potential Loyalists
40440,269,5,"360,04999999999995",5,1,1,7,Mid-Value,Potential Loyalists
40441,350,4,"416,15",5,1,1,7,Mid-Value,Potential Loyalists
40442,319,3,"284,45",5,1,1,7,Mid-Value,Potential Loyalists
40443,943,1,"501,4",3,1,1,5,Low-Value,At Risk Customers
40444,50,6,"117,05",5,1,1,7,Mid-Value,Potential Loyalists
40445,14,2,"123,8",5,1,1,7,Mid-Value,Potential Loyalists
40446,152,3,"235,3",5,1,1,7,Mid-Value,Potential Loyalists
40447,174,4,"192,85",5,1,1,7,Mid-Value,Potential Loyalists
40448,573,1,"75,95",4,1,1,6,Mid-Value,Potential Loyalists
40449,668,2,"49,349999999999994",4,1,1,6,Mid-Value,Potential Loyalists
40450,272,2,"31,6",5,1,1,7,Mid-Value,Potential Loyalists
40451,52,5,"264,35",5,1,1,7,Mid-Value,Potential Loyalists
40452,601,1,"112,05000000000001",4,1,1,6,Mid-Value,Potential Loyalists
40455,20,4,"65,7",5,1,1,7,Mid-Value,Potential Loyalists
40457,182,2,"72,5",5,1,1,7,Mid-Value,Potential Loyalists
40458,1612,2,"128,8",1,1,1,3,Low-Value,Lost
40459,784,2,"46,5",3,1,1,5,Low-Value,At Risk Customers
40460,313,5,"210,24999999999997",5,1,1,7,Mid-Value,Potential Loyalists
40462,447,1,"3,6",4,1,1,6,Mid-Value,Potential Loyalists
40463,4,4,"94,0",5,1,1,7,Mid-Value,Potential Loyalists
40465,9,9,"627,2",5,2,1,8,High-Value,Potential Loyalists
40466,391,3,"101,8",4,1,1,6,Mid-Value,Potential Loyalists
40467,1541,2,"72,45",1,1,1,3,Low-Value,Lost
40468,596,5,"183,0",4,1,1,6,Mid-Value,Potential Loyalists
40469,857,2,"457,1",3,1,1,5,Low-Value,At Risk Customers
40470,667,3,"842,5",4,1,2,7,Mid-Value,Potential Loyalists
40471,776,5,"158,65",3,1,1,5,Low-Value,At Risk Customers
40472,878,1,"45,75",3,1,1,5,Low-Value,At Risk Customers
40473,811,3,"434,5",3,1,1,5,Low-Value,At Risk Customers
40474,65,4,"522,95",5,1,1,7,Mid-Value,Potential Loyalists
40475,227,2,"90,94999999999999",5,1,1,7,Mid-Value,Potential Loyalists
40476,171,12,"640,7",5,3,1,9,High-Value,Champions
40477,138,4,"210,64999999999998",5,1,1,7,Mid-Value,Potential Loyalists
40480,20,5,"309,45",5,1,1,7,Mid-Value,Potential Loyalists
40481,371,3,"860,0",4,1,2,7,Mid-Value,Potential Loyalists
40484,1097,4,"425,49999999999994",2,1,1,4,Low-Value,Can't Lose
40486,113,5,"587,9",5,1,1,7,Mid-Value,Potential Loyalists
40487,391,7,"772,65",4,2,2,8,High-Value,Potential Loyalists
40488,642,1,"28,95",4,1,1,6,Mid-Value,Potential Loyalists
40490,596,3,"98,95",4,1,1,6,Mid-Value,Potential Loyalists
40491,615,5,"278,3",4,1,1,6,Mid-Value,Potential Loyalists
40492,692,1,"43,55",4,1,1,6,Mid-Value,Potential Loyalists
40493,422,5,"161,7",4,1,1,6,Mid-Value,Potential Loyalists
40495,64,6,"617,9",5,1,1,7,Mid-Value,Potential Loyalists
40496,179,4,"300,29999999999995",5,1,1,7,Mid-Value,Potential Loyalists
40499,754,2,"265,9",3,1,1,5,Low-Value,At Risk Customers
40500,866,1,"33,0",3,1,1,5,Low-Value,At Risk Customers
40502,217,3,"107,45",5,1,1,7,Mid-Value,Potential Loyalists
40503,168,5,"477,0",5,1,1,7,Mid-Value,Potential Loyalists
40505,335,6,"213,8",5,1,1,7,Mid-Value,Potential Loyalists
40506,852,1,"12,3",3,1,1,5,Low-Value,At Risk Customers
40507,492,2,"146,2",4,1,1,6,Mid-Value,Potential Loyalists
40510,340,6,"369,29999999999995",5,1,1,7,Mid-Value,Potential Loyalists
40511,822,2,"150,8",3,1,1,5,Low-Value,At Risk Customers
40512,1084,1,"163,0",3,1,1,5,Low-Value,At Risk Customers
40513,746,7,"470,0",3,2,1,6,Mid-Value,Potential Loyalists
40515,467,3,"154,85",4,1,1,6,Mid-Value,Potential Loyalists
40517,1774,1,"5,8",1,1,1,3,Low-Value,Lost
40518,594,2,"46,400000000000006",4,1,1,6,Mid-Value,Potential Loyalists
40520,179,4,"293,6",5,1,1,7,Mid-Value,Potential Loyalists
40521,17,3,"355,25",5,1,1,7,Mid-Value,Potential Loyalists
40523,671,3,"130,25",4,1,1,6,Mid-Value,Potential Loyalists
40524,617,7,"465,25",4,2,1,7,Mid-Value,Potential Loyalists
40525,195,6,"251,2",5,1,1,7,Mid-Value,Potential Loyalists
40526,865,4,"140,4",3,1,1,5,Low-Value,At Risk Customers
40527,1505,2,"33,900000000000006",1,1,1,3,Low-Value,Lost
40528,442,1,"38,6",4,1,1,6,Mid-Value,Potential Loyalists
40529,826,5,"214,6",3,1,1,5,Low-Value,At Risk Customers
40531,220,3,"78,3",5,1,1,7,Mid-Value,Potential Loyalists
40532,304,2,"144,64999999999998",5,1,1,7,Mid-Value,Potential Loyalists
40533,776,4,"282,6",3,1,1,5,Low-Value,At Risk Customers
40535,513,1,"66,8",4,1,1,6,Mid-Value,Potential Loyalists
40537,342,2,"151,25",5,1,1,7,Mid-Value,Potential Loyalists
40538,369,1,"50,7",4,1,1,6,Mid-Value,Potential Loyalists
40539,89,7,"333,55",5,2,1,8,High-Value,Potential Loyalists
40540,453,4,"105,65",4,1,1,6,Mid-Value,Potential Loyalists
40541,399,4,"237,0",4,1,1,6,Mid-Value,Potential Loyalists
40542,48,3,"127,35",5,1,1,7,Mid-Value,Potential Loyalists
40545,263,3,"82,05",5,1,1,7,Mid-Value,Potential Loyalists
40546,1142,6,"169,95",2,1,1,4,Low-Value,Can't Lose
40547,799,4,"587,05",3,1,1,5,Low-Value,At Risk Customers
40548,661,4,"161,64999999999998",4,1,1,6,Mid-Value,Potential Loyalists
40549,776,3,"233,8",3,1,1,5,Low-Value,At Risk Customers
40551,263,2,"186,6",5,1,1,7,Mid-Value,Potential Loyalists
40552,1064,6,"352,4",3,1,1,5,Low-Value,At Risk Customers
40553,1383,1,"48,7",2,1,1,4,Low-Value,Can't Lose
40554,366,3,"348,5",4,1,1,6,Mid-Value,Potential Loyalists
40557,1463,4,"161,7",1,1,1,3,Low-Value,Lost
40560,108,1,"38,05",5,1,1,7,Mid-Value,Potential Loyalists
40562,97,6,"372,95",5,1,1,7,Mid-Value,Potential Loyalists
40563,1004,1,"50,75",3,1,1,5,Low-Value,At Risk Customers
40564,582,1,"57,45",4,1,1,6,Mid-Value,Potential Loyalists
40565,867,2,"52,800000000000004",3,1,1,5,Low-Value,At Risk Customers
40566,46,2,"26,549999999999997",5,1,1,7,Mid-Value,Potential Loyalists
40567,425,3,"134,89999999999998",4,1,1,6,Mid-Value,Potential Loyalists
40568,528,1,"227,2",4,1,1,6,Mid-Value,Potential Loyalists
40570,756,3,"111,55",3,1,1,5,Low-Value,At Risk Customers
40571,911,4,"241,55",3,1,1,5,Low-Value,At Risk Customers
40575,494,4,"273,95",4,1,1,6,Mid-Value,Potential Loyalists
40576,128,2,"215,3",5,1,1,7,Mid-Value,Potential Loyalists
40577,617,2,"60,900000000000006",4,1,1,6,Mid-Value,Potential Loyalists
40578,2,3,"76,4",5,1,1,7,Mid-Value,Potential Loyalists
40579,890,1,"1002,8",3,1,2,6,Mid-Value,Potential Loyalists
40580,568,2,"347,70000000000005",4,1,1,6,Mid-Value,Potential Loyalists
40581,73,1,"26,45",5,1,1,7,Mid-Value,Potential Loyalists
40582,165,4,"214,45",5,1,1,7,Mid-Value,Potential Loyalists
40583,166,3,"216,8",5,1,1,7,Mid-Value,Potential Loyalists
40586,1112,1,"45,75",2,1,1,4,Low-Value,Can't Lose
40588,509,4,"351,9",4,1,1,6,Mid-Value,Potential Loyalists
40591,1099,1,"401,5",2,1,1,4,Low-Value,Can't Lose
40592,995,3,"168,25",3,1,1,5,Low-Value,At Risk Customers
40594,255,3,"354,15",5,1,1,7,Mid-Value,Potential Loyalists
40595,216,3,"76,5",5,1,1,7,Mid-Value,Potential Loyalists
40596,517,3,"217,4",4,1,1,6,Mid-Value,Potential Loyalists
40597,1254,1,"663,8",2,1,2,5,Low-Value,At Risk Customers
40599,1064,1,"49,25",3,1,1,5,Low-Value,At Risk Customers
40600,109,3,"94,7",5,1,1,7,Mid-Value,Potential Loyalists
40603,320,3,"26,1",5,1,1,7,Mid-Value,Potential Loyalists
40606,1631,1,"160,4",1,1,1,3,Low-Value,Lost
40607,30,5,"161,85",5,1,1,7,Mid-Value,Potential Loyalists
40608,714,3,"817,5999999999999",4,1,2,7,Mid-Value,Potential Loyalists
40609,849,5,"334,45",3,1,1,5,Low-Value,At Risk Customers
40610,1011,2,"26,150000000000002",3,1,1,5,Low-Value,At Risk Customers
40612,1083,2,"32,449999999999996",3,1,1,5,Low-Value,At Risk Customers
40613,34,3,"75,19999999999999",5,1,1,7,Mid-Value,Potential Loyalists
40614,1505,2,"60,65",1,1,1,3,Low-Value,Lost
40615,126,3,"161,35",5,1,1,7,Mid-Value,Potential Loyalists
40616,309,3,"440,65",5,1,1,7,Mid-Value,Potential Loyalists
40617,203,2,"38,25",5,1,1,7,Mid-Value,Potential Loyalists
40618,512,1,"24,4",4,1,1,6,Mid-Value,Potential Loyalists
40619,1146,2,"64,1",2,1,1,4,Low-Value,Can't Lose
40622,161,2,"95,9",5,1,1,7,Mid-Value,Potential Loyalists
40623,817,2,"80,69999999999999",3,1,1,5,Low-Value,At Risk Customers
40624,1482,1,"149,8",1,1,1,3,Low-Value,Lost
40625,872,2,"93,15",3,1,1,5,Low-Value,At Risk Customers
40629,1273,4,"209,39999999999998",2,1,1,4,Low-Value,Can't Lose
40631,56,4,"106,7",5,1,1,7,Mid-Value,Potential Loyalists
40633,1573,1,"17,6",1,1,1,3,Low-Value,Lost
40634,522,1,"7,8",4,1,1,6,Mid-Value,Potential Loyalists
40635,33,5,"322,2",5,1,1,7,Mid-Value,Potential Loyalists
40636,882,1,"23,2",3,1,1,5,Low-Value,At Risk Customers
40637,446,3,"274,25",4,1,1,6,Mid-Value,Potential Loyalists
40638,466,1,"147,3",4,1,1,6,Mid-Value,Potential Loyalists
40639,257,3,"83,55",5,1,1,7,Mid-Value,Potential Loyalists
40642,1273,1,"99,14999999999999",2,1,1,4,Low-Value,Can't Lose
40643,379,6,"595,25",4,1,1,6,Mid-Value,Potential Loyalists
40644,769,4,"280,95",3,1,1,5,Low-Value,At Risk Customers
40645,923,2,"86,1",3,1,1,5,Low-Value,At Risk Customers
40646,347,3,"117,35000000000001",5,1,1,7,Mid-Value,Potential Loyalists
40648,1535,1,"38,25",1,1,1,3,Low-Value,Lost
40649,3,6,"212,8",5,1,1,7,Mid-Value,Potential Loyalists
40650,201,2,"92,0",5,1,1,7,Mid-Value,Potential Loyalists
40651,968,2,"254,4",3,1,1,5,Low-Value,At Risk Customers
40652,191,2,"378,4",5,1,1,7,Mid-Value,Potential Loyalists
40654,717,1,"14,5",4,1,1,6,Mid-Value,Potential Loyalists
40657,1397,1,"1,7",2,1,1,4,Low-Value,Can't Lose
40658,130,6,"347,35",5,1,1,7,Mid-Value,Potential Loyalists
40659,511,2,"75,35000000000001",4,1,1,6,Mid-Value,Potential Loyalists
40660,438,2,"141,9",4,1,1,6,Mid-Value,Potential Loyalists
40661,1362,3,"111,85",2,1,1,4,Low-Value,Can't Lose
40662,148,8,"229,5",5,2,1,8,High-Value,Potential Loyalists
40663,808,2,"31,6",3,1,1,5,Low-Value,At Risk Customers
40666,48,4,"980,7499999999999",5,1,2,8,High-Value,Potential Loyalists
40667,421,1,"26,25",4,1,1,6,Mid-Value,Potential Loyalists
40668,544,2,"339,6",4,1,1,6,Mid-Value,Potential Loyalists
40670,875,1,"45,8",3,1,1,5,Low-Value,At Risk Customers
40672,261,5,"235,35",5,1,1,7,Mid-Value,Potential Loyalists
40673,58,2,"15,75",5,1,1,7,Mid-Value,Potential Loyalists
40674,771,4,"405,65",3,1,1,5,Low-Value,At Risk Customers
40675,826,1,"28,35",3,1,1,5,Low-Value,At Risk Customers
40676,718,2,"57,95",4,1,1,6,Mid-Value,Potential Loyalists
40677,81,4,"156,65",5,1,1,7,Mid-Value,Potential Loyalists
40678,1589,2,"59,8",1,1,1,3,Low-Value,Lost
40679,97,3,"107,05",5,1,1,7,Mid-Value,Potential Loyalists
40680,237,3,"62,449999999999996",5,1,1,7,Mid-Value,Potential Loyalists
40681,11,4,"515,9000000000001",5,1,1,7,Mid-Value,Potential Loyalists
40682,400,3,"276,4",4,1,1,6,Mid-Value,Potential Loyalists
40686,10,6,"477,84999999999997",5,1,1,7,Mid-Value,Potential Loyalists
40688,178,3,"388,65",5,1,1,7,Mid-Value,Potential Loyalists
40689,59,2,"59,2",5,1,1,7,Mid-Value,Potential Loyalists
40690,1462,3,"277,7",1,1,1,3,Low-Value,Lost
40691,59,13,"750,05",5,3,2,10,High-Value,Champions
40692,1113,1,"4,4",2,1,1,4,Low-Value,Can't Lose
40693,1789,1,"6,25",1,1,1,3,Low-Value,Lost
40695,127,2,"176,1",5,1,1,7,Mid-Value,Potential Loyalists
40696,742,2,"123,89999999999999",3,1,1,5,Low-Value,At Risk Customers
40697,1348,1,"4,75",2,1,1,4,Low-Value,Can't Lose
40699,1019,1,"27,95",3,1,1,5,Low-Value,At Risk Customers
40700,266,2,"175,55",5,1,1,7,Mid-Value,Potential Loyalists
40701,105,8,"593,9499999999999",5,2,1,8,High-Value,Potential Loyalists
40702,957,3,"81,05000000000001",3,1,1,5,Low-Value,At Risk Customers
40703,139,7,"706,2",5,2,2,9,High-Value,Champions
40705,956,4,"154,4",3,1,1,5,Low-Value,At Risk Customers
40707,546,1,"23,5",4,1,1,6,Mid-Value,Potential Loyalists
40708,909,1,"184,05",3,1,1,5,Low-Value,At Risk Customers
40709,469,5,"219,1",4,1,1,6,Mid-Value,Potential Loyalists
40710,1037,1,"32,15",3,1,1,5,Low-Value,At Risk Customers
40711,120,3,"167,5",5,1,1,7,Mid-Value,Potential Loyalists
40713,1103,11,"674,3000000000001",2,2,2,6,Mid-Value,Potential Loyalists
40715,190,5,"357,85",5,1,1,7,Mid-Value,Potential Loyalists
40716,405,4,"296,95000000000005",4,1,1,6,Mid-Value,Potential Loyalists
40717,276,1,"73,6",5,1,1,7,Mid-Value,Potential Loyalists
40719,510,6,"224,45000000000002",4,1,1,6,Mid-Value,Potential Loyalists
40720,1204,1,"150,8",2,1,1,4,Low-Value,Can't Lose
40722,1665,1,"46,7",1,1,1,3,Low-Value,Lost
40723,95,2,"187,95",5,1,1,7,Mid-Value,Potential Loyalists
40726,572,2,"99,45",4,1,1,6,Mid-Value,Potential Loyalists
40729,137,5,"196,7",5,1,1,7,Mid-Value,Potential Loyalists
40730,40,6,"341,65",5,1,1,7,Mid-Value,Potential Loyalists
40732,857,2,"118,1",3,1,1,5,Low-Value,At Risk Customers
40734,74,4,"187,45000000000002",5,1,1,7,Mid-Value,Potential Loyalists
40739,84,4,"310,6",5,1,1,7,Mid-Value,Potential Loyalists
40740,1762,2,"39,0",1,1,1,3,Low-Value,Lost
40741,182,4,"188,6",5,1,1,7,Mid-Value,Potential Loyalists
40742,246,2,"25,4",5,1,1,7,Mid-Value,Potential Loyalists
40743,1654,1,"20,4",1,1,1,3,Low-Value,Lost
40747,266,3,"363,59999999999997",5,1,1,7,Mid-Value,Potential Loyalists
40748,13,3,"102,55",5,1,1,7,Mid-Value,Potential Loyalists
40750,195,5,"221,85",5,1,1,7,Mid-Value,Potential Loyalists
40752,73,4,"97,05",5,1,1,7,Mid-Value,Potential Loyalists
40753,925,1,"1,1",3,1,1,5,Low-Value,At Risk Customers
40754,5,2,"106,7",5,1,1,7,Mid-Value,Potential Loyalists
40755,19,11,"646,4",5,2,1,8,High-Value,Potential Loyalists
40756,89,2,"101,55",5,1,1,7,Mid-Value,Potential Loyalists
40758,618,1,"23,35",4,1,1,6,Mid-Value,Potential Loyalists
40759,56,5,"223,8",5,1,1,7,Mid-Value,Potential Loyalists
40763,48,5,"184,35",5,1,1,7,Mid-Value,Potential Loyalists
40765,296,2,"337,4",5,1,1,7,Mid-Value,Potential Loyalists
40768,728,4,"195,70000000000002",4,1,1,6,Mid-Value,Potential Loyalists
40769,739,3,"69,95",3,1,1,5,Low-Value,At Risk Customers
40771,9,7,"375,04999999999995",5,2,1,8,High-Value,Potential Loyalists
40773,141,2,"119,65",5,1,1,7,Mid-Value,Potential Loyalists
40774,587,6,"285,7",4,1,1,6,Mid-Value,Potential Loyalists
40775,414,5,"221,4",4,1,1,6,Mid-Value,Potential Loyalists
40776,637,3,"191,95",4,1,1,6,Mid-Value,Potential Loyalists
40777,141,4,"683,25",5,1,2,8,High-Value,Potential Loyalists
40778,447,1,"1,35",4,1,1,6,Mid-Value,Potential Loyalists
40779,1126,4,"350,90000000000003",2,1,1,4,Low-Value,Can't Lose
40780,269,6,"172,25",5,1,1,7,Mid-Value,Potential Loyalists
40781,1179,1,"82,8",2,1,1,4,Low-Value,Can't Lose
40784,331,5,"257,95",5,1,1,7,Mid-Value,Potential Loyalists
40785,19,3,"146,15",5,1,1,7,Mid-Value,Potential Loyalists
40791,1159,1,"7,2",2,1,1,4,Low-Value,Can't Lose
40792,665,1,"124,9",4,1,1,6,Mid-Value,Potential Loyalists
40794,737,2,"83,85000000000001",3,1,1,5,Low-Value,At Risk Customers
40795,163,3,"107,95",5,1,1,7,Mid-Value,Potential Loyalists
40796,134,2,"45,1",5,1,1,7,Mid-Value,Potential Loyalists
40797,1681,1,"4,4",1,1,1,3,Low-Value,Lost
40798,426,1,"19,75",4,1,1,6,Mid-Value,Potential Loyalists
40801,68,3,"903,65",5,1,2,8,High-Value,Potential Loyalists
40802,543,1,"69,3",4,1,1,6,Mid-Value,Potential Loyalists
40803,58,2,"227,55",5,1,1,7,Mid-Value,Potential Loyalists
40804,1262,1,"98,4",2,1,1,4,Low-Value,Can't Lose
40807,425,3,"150,7",4,1,1,6,Mid-Value,Potential Loyalists
40808,2,2,"152,4",5,1,1,7,Mid-Value,Potential Loyalists
40809,1313,3,"72,65",2,1,1,4,Low-Value,Can't Lose
40810,901,4,"102,75",3,1,1,5,Low-Value,At Risk Customers
40811,235,4,"113,75",5,1,1,7,Mid-Value,Potential Loyalists
40813,424,5,"300,7",4,1,1,6,Mid-Value,Potential Loyalists
40814,1094,1,"9,95",3,1,1,5,Low-Value,At Risk Customers
40816,1757,1,"14,05",1,1,1,3,Low-Value,Lost
40817,245,4,"147,39999999999998",5,1,1,7,Mid-Value,Potential Loyalists
40820,1497,3,"148,04999999999998",1,1,1,3,Low-Value,Lost
40821,1397,2,"44,1",2,1,1,4,Low-Value,Can't Lose
40823,542,1,"19,05",4,1,1,6,Mid-Value,Potential Loyalists
40824,730,2,"114,4",4,1,1,6,Mid-Value,Potential Loyalists
40825,488,1,"105,0",4,1,1,6,Mid-Value,Potential Loyalists
40827,8,6,"367,85",5,1,1,7,Mid-Value,Potential Loyalists
40829,773,11,"768,2",3,2,2,7,Mid-Value,Potential Loyalists
40831,861,3,"175,3",3,1,1,5,Low-Value,At Risk Customers
40833,683,4,"250,14999999999998",4,1,1,6,Mid-Value,Potential Loyalists
40834,463,2,"37,65",4,1,1,6,Mid-Value,Potential Loyalists
40837,186,1,"102,7",5,1,1,7,Mid-Value,Potential Loyalists
40838,199,3,"232,45000000000002",5,1,1,7,Mid-Value,Potential Loyalists
40839,980,3,"85,75",3,1,1,5,Low-Value,At Risk Customers
40841,194,7,"510,8",5,2,1,8,High-Value,Potential Loyalists
40842,814,2,"24,15",3,1,1,5,Low-Value,At Risk Customers
40845,1062,2,"263,65000000000003",3,1,1,5,Low-Value,At Risk Customers
40846,200,4,"187,5",5,1,1,7,Mid-Value,Potential Loyalists
40848,45,3,"152,75",5,1,1,7,Mid-Value,Potential Loyalists
40849,473,2,"131,6",4,1,1,6,Mid-Value,Potential Loyalists
40850,752,4,"134,55",3,1,1,5,Low-Value,At Risk Customers
40851,1191,2,"102,8",2,1,1,4,Low-Value,Can't Lose
40852,954,1,"45,75",3,1,1,5,Low-Value,At Risk Customers
40854,1079,1,"28,6",3,1,1,5,Low-Value,At Risk Customers
40855,401,4,"125,45000000000002",4,1,1,6,Mid-Value,Potential Loyalists
40856,928,2,"89,95",3,1,1,5,Low-Value,At Risk Customers
40857,1027,3,"179,85",3,1,1,5,Low-Value,At Risk Customers
40859,372,2,"145,60000000000002",4,1,1,6,Mid-Value,Potential Loyalists
40861,1568,1,"208,4",1,1,1,3,Low-Value,Lost
40862,4,1,"63,8",5,1,1,7,Mid-Value,Potential Loyalists
40863,1056,1,"71,1",3,1,1,5,Low-Value,At Risk Customers
40864,349,1,"7,25",5,1,1,7,Mid-Value,Potential Loyalists
40865,1686,2,"27,35",1,1,1,3,Low-Value,Lost
40869,1548,2,"40,8",1,1,1,3,Low-Value,Lost
40872,735,1,"39,0",3,1,1,5,Low-Value,At Risk Customers
40873,531,4,"261,55",4,1,1,6,Mid-Value,Potential Loyalists
40874,85,1,"131,95",5,1,1,7,Mid-Value,Potential Loyalists
40875,787,2,"96,8",3,1,1,5,Low-Value,At Risk Customers
40876,397,1,"28,0",4,1,1,6,Mid-Value,Potential Loyalists
40877,867,2,"113,55",3,1,1,5,Low-Value,At Risk Customers
40878,45,17,"601,2",5,4,1,10,High-Value,Champions
40879,238,3,"84,15",5,1,1,7,Mid-Value,Potential Loyalists
40881,1187,4,"486,54999999999995",2,1,1,4,Low-Value,Can't Lose
40883,1392,1,"9,5",2,1,1,4,Low-Value,Can't Lose
40884,21,2,"279,40000000000003",5,1,1,7,Mid-Value,Potential Loyalists
40885,1581,2,"58,75",1,1,1,3,Low-Value,Lost
40887,1209,2,"67,95",2,1,1,4,Low-Value,Can't Lose
40889,1306,1,"66,75",2,1,1,4,Low-Value,Can't Lose
40890,22,4,"252,45",5,1,1,7,Mid-Value,Potential Loyalists
40891,922,5,"131,6",3,1,1,5,Low-Value,At Risk Customers
40893,472,2,"282,75",4,1,1,6,Mid-Value,Potential Loyalists
40894,591,1,"7,85",4,1,1,6,Mid-Value,Potential Loyalists
40895,145,4,"354,94999999999993",5,1,1,7,Mid-Value,Potential Loyalists
40897,929,1,"84,75",3,1,1,5,Low-Value,At Risk Customers
40898,804,1,"50,75",3,1,1,5,Low-Value,At Risk Customers
40899,1494,2,"69,69999999999999",1,1,1,3,Low-Value,Lost
40900,369,1,"204,60000000000002",4,1,1,6,Mid-Value,Potential Loyalists
40901,70,3,"169,75",5,1,1,7,Mid-Value,Potential Loyalists
40903,476,1,"86,1",4,1,1,6,Mid-Value,Potential Loyalists
40904,463,8,"348,21000000000004",4,2,1,7,Mid-Value,Potential Loyalists
40905,54,4,"114,6",5,1,1,7,Mid-Value,Potential Loyalists
40906,131,3,"105,5",5,1,1,7,Mid-Value,Potential Loyalists
40911,209,4,"219,35",5,1,1,7,Mid-Value,Potential Loyalists
40912,1344,1,"56,3",2,1,1,4,Low-Value,Can't Lose
40914,1165,3,"253,79999999999998",2,1,1,4,Low-Value,Can't Lose
40915,434,2,"60,55",4,1,1,6,Mid-Value,Potential Loyalists
40916,1179,2,"37,1",2,1,1,4,Low-Value,Can't Lose
40917,22,3,"404,4",5,1,1,7,Mid-Value,Potential Loyalists
40918,808,6,"513,5",3,1,1,5,Low-Value,At Risk Customers
40919,194,5,"580,45",5,1,1,7,Mid-Value,Potential Loyalists
40922,322,6,"939,55",5,1,2,8,High-Value,Potential Loyalists
40923,25,2,"83,05",5,1,1,7,Mid-Value,Potential Loyalists
40926,864,2,"37,3",3,1,1,5,Low-Value,At Risk Customers
40927,204,1,"59,6",5,1,1,7,Mid-Value,Potential Loyalists
40929,1499,1,"52,25",1,1,1,3,Low-Value,Lost
40932,853,1,"87,15",3,1,1,5,Low-Value,At Risk Customers
40934,1667,1,"117,2",1,1,1,3,Low-Value,Lost
40935,1482,1,"147,0",1,1,1,3,Low-Value,Lost
40938,8,2,"257,55",5,1,1,7,Mid-Value,Potential Loyalists
40939,487,7,"365,45",4,2,1,7,Mid-Value,Potential Loyalists
40940,718,2,"239,8",4,1,1,6,Mid-Value,Potential Loyalists
40941,71,4,"248,10000000000002",5,1,1,7,Mid-Value,Potential Loyalists
40942,94,4,"117,15",5,1,1,7,Mid-Value,Potential Loyalists
40943,160,6,"306,35",5,1,1,7,Mid-Value,Potential Loyalists
40944,498,3,"164,5",4,1,1,6,Mid-Value,Potential Loyalists
40945,402,6,"411,95",4,1,1,6,Mid-Value,Potential Loyalists
40946,237,5,"734,25",5,1,2,8,High-Value,Potential Loyalists
40947,145,3,"54,75",5,1,1,7,Mid-Value,Potential Loyalists
40948,1300,1,"20,46",2,1,1,4,Low-Value,Can't Lose
40950,542,5,"194,25",4,1,1,6,Mid-Value,Potential Loyalists
40951,1308,2,"138,65",2,1,1,4,Low-Value,Can't Lose
40952,792,2,"17,2",3,1,1,5,Low-Value,At Risk Customers
40953,594,1,"37,35",4,1,1,6,Mid-Value,Potential Loyalists
40956,63,9,"218,2",5,2,1,8,High-Value,Potential Loyalists
40959,3,7,"164,35",5,2,1,8,High-Value,Potential Loyalists
40961,1187,1,"42,95",2,1,1,4,Low-Value,Can't Lose
40962,262,3,"189,3",5,1,1,7,Mid-Value,Potential Loyalists
40963,126,1,"100,4",5,1,1,7,Mid-Value,Potential Loyalists
40964,1369,1,"87,2",2,1,1,4,Low-Value,Can't Lose
40965,814,2,"45,75",3,1,1,5,Low-Value,At Risk Customers
40966,1229,4,"224,75",2,1,1,4,Low-Value,Can't Lose
40969,917,3,"160,9",3,1,1,5,Low-Value,At Risk Customers
40970,1229,1,"72,9",2,1,1,4,Low-Value,Can't Lose
40972,370,4,"240,15",4,1,1,6,Mid-Value,Potential Loyalists
40973,686,3,"76,15",4,1,1,6,Mid-Value,Potential Loyalists
40976,1441,1,"12,8",2,1,1,4,Low-Value,Can't Lose
40977,18,4,"242,45",5,1,1,7,Mid-Value,Potential Loyalists
40978,103,5,"171,7",5,1,1,7,Mid-Value,Potential Loyalists
40979,51,8,"969,8",5,2,2,9,High-Value,Champions
40980,932,4,"117,25",3,1,1,5,Low-Value,At Risk Customers
40982,955,5,"302,5",3,1,1,5,Low-Value,At Risk Customers
40984,937,3,"187,3",3,1,1,5,Low-Value,At Risk Customers
40985,760,3,"222,8",3,1,1,5,Low-Value,At Risk Customers
40987,102,4,"226,2",5,1,1,7,Mid-Value,Potential Loyalists
40988,740,1,"4,75",3,1,1,5,Low-Value,At Risk Customers
40990,130,9,"487,85",5,2,1,8,High-Value,Potential Loyalists
40992,261,1,"10,75",5,1,1,7,Mid-Value,Potential Loyalists
40993,56,2,"156,0",5,1,1,7,Mid-Value,Potential Loyalists
40996,767,4,"254,75",3,1,1,5,Low-Value,At Risk Customers
40998,48,5,"187,9",5,1,1,7,Mid-Value,Potential Loyalists
41000,1133,2,"66,15",2,1,1,4,Low-Value,Can't Lose
41001,964,2,"50,75",3,1,1,5,Low-Value,At Risk Customers
41002,403,2,"71,7",4,1,1,6,Mid-Value,Potential Loyalists
41006,262,6,"173,7",5,1,1,7,Mid-Value,Potential Loyalists
41007,781,3,"154,3",3,1,1,5,Low-Value,At Risk Customers
41010,480,3,"64,25",4,1,1,6,Mid-Value,Potential Loyalists
41011,147,2,"250,45",5,1,1,7,Mid-Value,Potential Loyalists
41015,138,2,"195,0",5,1,1,7,Mid-Value,Potential Loyalists
41016,544,7,"660,3",4,2,1,7,Mid-Value,Potential Loyalists
41017,889,2,"51,55",3,1,1,5,Low-Value,At Risk Customers
41018,27,5,"791,75",5,1,2,8,High-Value,Potential Loyalists
41022,221,1,"26,6",5,1,1,7,Mid-Value,Potential Loyalists
41023,397,1,"10,75",4,1,1,6,Mid-Value,Potential Loyalists
41024,124,1,"88,5",5,1,1,7,Mid-Value,Potential Loyalists
41027,1065,7,"985,05",3,2,2,7,Mid-Value,Potential Loyalists
41030,107,4,"63,349999999999994",5,1,1,7,Mid-Value,Potential Loyalists
41032,170,14,"1082,6100000000001",5,3,2,10,High-Value,Champions
41034,416,3,"139,15",4,1,1,6,Mid-Value,Potential Loyalists
41035,668,1,"15,95",4,1,1,6,Mid-Value,Potential Loyalists
41036,1155,1,"43,6",2,1,1,4,Low-Value,Can't Lose
41038,18,2,"58,05",5,1,1,7,Mid-Value,Potential Loyalists
41040,456,1,"7,9",4,1,1,6,Mid-Value,Potential Loyalists
41042,943,3,"126,80000000000001",3,1,1,5,Low-Value,At Risk Customers
41045,20,5,"300,8",5,1,1,7,Mid-Value,Potential Loyalists
41048,1101,2,"127,9",2,1,1,4,Low-Value,Can't Lose
41051,816,1,"10,3",3,1,1,5,Low-Value,At Risk Customers
41052,46,10,"594,25",5,2,1,8,High-Value,Potential Loyalists
41054,1126,2,"253,09999999999997",2,1,1,4,Low-Value,Can't Lose
41056,11,9,"511,34999999999997",5,2,1,8,High-Value,Potential Loyalists
41059,147,10,"566,75",5,2,1,8,High-Value,Potential Loyalists
41060,410,5,"289,70000000000005",4,1,1,6,Mid-Value,Potential Loyalists
41061,219,3,"260,45",5,1,1,7,Mid-Value,Potential Loyalists
41064,387,10,"354,7",4,2,1,7,Mid-Value,Potential Loyalists
41065,204,4,"82,7",5,1,1,7,Mid-Value,Potential Loyalists
41066,39,4,"95,35",5,1,1,7,Mid-Value,Potential Loyalists
41069,825,2,"65,1",3,1,1,5,Low-Value,At Risk Customers
41070,738,5,"250,55",3,1,1,5,Low-Value,At Risk Customers
41071,1466,3,"306,15",1,1,1,3,Low-Value,Lost
41072,0,5,"92,5",5,1,1,7,Mid-Value,Potential Loyalists
41073,250,3,"197,3",5,1,1,7,Mid-Value,Potential Loyalists
41074,270,4,"384,4",5,1,1,7,Mid-Value,Potential Loyalists
41075,467,1,"86,3",4,1,1,6,Mid-Value,Potential Loyalists
41077,132,5,"362,20000000000005",5,1,1,7,Mid-Value,Potential Loyalists
41078,643,2,"64,4",4,1,1,6,Mid-Value,Potential Loyalists
41079,997,2,"23,3",3,1,1,5,Low-Value,At Risk Customers
41080,77,4,"84,2",5,1,1,7,Mid-Value,Potential Loyalists
41081,33,2,"47,1",5,1,1,7,Mid-Value,Potential Loyalists
41085,243,5,"208,25",5,1,1,7,Mid-Value,Potential Loyalists
41086,172,11,"422,35",5,2,1,8,High-Value,Potential Loyalists
41087,415,1,"6,65",4,1,1,6,Mid-Value,Potential Loyalists
41088,1005,1,"105,55",3,1,1,5,Low-Value,At Risk Customers
41089,88,5,"453,75",5,1,1,7,Mid-Value,Potential Loyalists
41090,463,3,"114,0",4,1,1,6,Mid-Value,Potential Loyalists
41091,843,1,"9,95",3,1,1,5,Low-Value,At Risk Customers
41092,209,9,"750,85",5,2,2,9,High-Value,Champions
41093,351,1,"36,25",5,1,1,7,Mid-Value,Potential Loyalists
41094,127,2,"551,6",5,1,1,7,Mid-Value,Potential Loyalists
41095,823,2,"205,70000000000002",3,1,1,5,Low-Value,At Risk Customers
41097,978,1,"72,3",3,1,1,5,Low-Value,At Risk Customers
41098,585,4,"488,6",4,1,1,6,Mid-Value,Potential Loyalists
41100,123,4,"207,75",5,1,1,7,Mid-Value,Potential Loyalists
41101,1103,7,"300,4",2,2,1,5,Low-Value,At Risk Customers
41103,174,2,"104,30000000000001",5,1,1,7,Mid-Value,Potential Loyalists
41104,618,1,"126,44999999999999",4,1,1,6,Mid-Value,Potential Loyalists
41106,1678,1,"3,5",1,1,1,3,Low-Value,Lost
41108,682,5,"342,79999999999995",4,1,1,6,Mid-Value,Potential Loyalists
41111,1051,1,"19,9",3,1,1,5,Low-Value,At Risk Customers
41112,374,1,"177,6",4,1,1,6,Mid-Value,Potential Loyalists
41113,932,2,"314,45",3,1,1,5,Low-Value,At Risk Customers
41115,806,8,"315,65000000000003",3,2,1,6,Mid-Value,Potential Loyalists
41116,1117,1,"42,15",2,1,1,4,Low-Value,Can't Lose
41117,636,4,"321,25",4,1,1,6,Mid-Value,Potential Loyalists
41118,148,3,"262,6",5,1,1,7,Mid-Value,Potential Loyalists
41122,1018,1,"116,05",3,1,1,5,Low-Value,At Risk Customers
41123,28,4,"414,55",5,1,1,7,Mid-Value,Potential Loyalists
41124,388,1,"132,8",4,1,1,6,Mid-Value,Potential Loyalists
41125,83,3,"98,0",5,1,1,7,Mid-Value,Potential Loyalists
41126,479,5,"444,75",4,1,1,6,Mid-Value,Potential Loyalists
41131,463,8,"643,0",4,2,1,7,Mid-Value,Potential Loyalists
41132,1135,2,"34,4",2,1,1,4,Low-Value,Can't Lose
41134,159,6,"285,45",5,1,1,7,Mid-Value,Potential Loyalists
41136,494,1,"143,2",4,1,1,6,Mid-Value,Potential Loyalists
41138,798,9,"538,95",3,2,1,6,Mid-Value,Potential Loyalists
41139,519,3,"171,64999999999998",4,1,1,6,Mid-Value,Potential Loyalists
41140,223,1,"18,9",5,1,1,7,Mid-Value,Potential Loyalists
41141,1445,1,"1036,4",2,1,2,5,Low-Value,At Risk Customers
41143,570,6,"409,7",4,1,1,6,Mid-Value,Potential Loyalists
41144,506,1,"95,85",4,1,1,6,Mid-Value,Potential Loyalists
41146,1587,1,"124,35000000000001",1,1,1,3,Low-Value,Lost
41147,73,2,"117,19999999999999",5,1,1,7,Mid-Value,Potential Loyalists
41148,385,4,"125,95",4,1,1,6,Mid-Value,Potential Loyalists
41149,1337,1,"30,450000000000003",2,1,1,4,Low-Value,Can't Lose
41151,385,1,"112,7",4,1,1,6,Mid-Value,Potential Loyalists
41152,792,2,"154,0",3,1,1,5,Low-Value,At Risk Customers
41154,12,5,"774,25",5,1,2,8,High-Value,Potential Loyalists
41155,925,2,"287,9",3,1,1,5,Low-Value,At Risk Customers
41158,358,3,"150,05",5,1,1,7,Mid-Value,Potential Loyalists
41159,509,1,"251,35",4,1,1,6,Mid-Value,Potential Loyalists
41161,21,2,"746,25",5,1,2,8,High-Value,Potential Loyalists
41163,76,2,"50,75",5,1,1,7,Mid-Value,Potential Loyalists
41166,38,3,"37,800000000000004",5,1,1,7,Mid-Value,Potential Loyalists
41167,1537,2,"107,7",1,1,1,3,Low-Value,Lost
41169,1337,1,"21,55",2,1,1,4,Low-Value,Can't Lose
41170,140,1,"94,9",5,1,1,7,Mid-Value,Potential Loyalists
41172,89,7,"1430,95",5,2,3,10,High-Value,Champions
41173,80,8,"336,3",5,2,1,8,High-Value,Potential Loyalists
41174,1158,1,"33,8",2,1,1,4,Low-Value,Can't Lose
41175,57,6,"232,6",5,1,1,7,Mid-Value,Potential Loyalists
41176,689,2,"28,650000000000002",4,1,1,6,Mid-Value,Potential Loyalists
41178,703,1,"11,8",4,1,1,6,Mid-Value,Potential Loyalists
41179,513,2,"349,95",4,1,1,6,Mid-Value,Potential Loyalists
41180,193,1,"41,849999999999994",5,1,1,7,Mid-Value,Potential Loyalists
41181,717,6,"493,65",4,1,1,6,Mid-Value,Potential Loyalists
41182,14,3,"291,75",5,1,1,7,Mid-Value,Potential Loyalists
41183,777,3,"481,1",3,1,1,5,Low-Value,At Risk Customers
41184,1070,1,"16,8",3,1,1,5,Low-Value,At Risk Customers
41185,467,1,"12,2",4,1,1,6,Mid-Value,Potential Loyalists
41191,4,2,"262,40000000000003",5,1,1,7,Mid-Value,Potential Loyalists
41192,278,7,"349,6",5,2,1,8,High-Value,Potential Loyalists
41193,172,5,"490,15",5,1,1,7,Mid-Value,Potential Loyalists
41196,525,6,"316,3",4,1,1,6,Mid-Value,Potential Loyalists
41197,1272,1,"77,25",2,1,1,4,Low-Value,Can't Lose
41198,212,2,"245,75",5,1,1,7,Mid-Value,Potential Loyalists
41199,129,6,"223,9",5,1,1,7,Mid-Value,Potential Loyalists
41201,368,7,"664,4",4,2,2,8,High-Value,Potential Loyalists
41203,1217,2,"8,35",2,1,1,4,Low-Value,Can't Lose
41204,750,3,"58,199999999999996",3,1,1,5,Low-Value,At Risk Customers
41207,248,3,"136,75",5,1,1,7,Mid-Value,Potential Loyalists
41210,36,6,"529,3",5,1,1,7,Mid-Value,Potential Loyalists
41213,480,4,"773,35",4,1,2,7,Mid-Value,Potential Loyalists
41215,185,11,"635,2",5,2,1,8,High-Value,Potential Loyalists
41217,395,6,"265,1",4,1,1,6,Mid-Value,Potential Loyalists
41218,366,5,"305,75",4,1,1,6,Mid-Value,Potential Loyalists
41219,113,5,"155,25",5,1,1,7,Mid-Value,Potential Loyalists
41224,278,8,"523,9",5,2,1,8,High-Value,Potential Loyalists
41228,880,3,"79,45",3,1,1,5,Low-Value,At Risk Customers
41229,158,1,"35,4",5,1,1,7,Mid-Value,Potential Loyalists
41230,223,4,"197,55",5,1,1,7,Mid-Value,Potential Loyalists
41231,210,1,"59,9",5,1,1,7,Mid-Value,Potential Loyalists
41233,1056,1,"199,0",3,1,1,5,Low-Value,At Risk Customers
41235,75,9,"1188,4",5,2,2,9,High-Value,Champions
41236,187,4,"342,0",5,1,1,7,Mid-Value,Potential Loyalists
41237,234,5,"502,83000000000004",5,1,1,7,Mid-Value,Potential Loyalists
41238,38,2,"155,64999999999998",5,1,1,7,Mid-Value,Potential Loyalists
41239,697,1,"16,05",4,1,1,6,Mid-Value,Potential Loyalists
41240,318,2,"53,2",5,1,1,7,Mid-Value,Potential Loyalists
41241,475,4,"374,2",4,1,1,6,Mid-Value,Potential Loyalists
41243,1018,1,"105,6",3,1,1,5,Low-Value,At Risk Customers
41244,68,5,"116,55000000000001",5,1,1,7,Mid-Value,Potential Loyalists
41246,369,3,"112,15",4,1,1,6,Mid-Value,Potential Loyalists
41247,524,4,"539,9499999999999",4,1,1,6,Mid-Value,Potential Loyalists
41250,8,4,"184,75",5,1,1,7,Mid-Value,Potential Loyalists
41251,357,8,"407,5",5,2,1,8,High-Value,Potential Loyalists
41252,633,5,"291,65000000000003",4,1,1,6,Mid-Value,Potential Loyalists
41253,1140,1,"5,15",2,1,1,4,Low-Value,Can't Lose
41256,196,4,"72,2",5,1,1,7,Mid-Value,Potential Loyalists
41257,10,4,"151,39999999999998",5,1,1,7,Mid-Value,Potential Loyalists
41258,732,3,"291,95",3,1,1,5,Low-Value,At Risk Customers
41259,1425,1,"28,7",2,1,1,4,Low-Value,Can't Lose
41262,27,5,"269,4",5,1,1,7,Mid-Value,Potential Loyalists
41264,645,3,"57,7",4,1,1,6,Mid-Value,Potential Loyalists
41265,238,1,"32,2",5,1,1,7,Mid-Value,Potential Loyalists
41266,1745,1,"41,1",1,1,1,3,Low-Value,Lost
41268,835,2,"149,6",3,1,1,5,Low-Value,At Risk Customers
41269,54,7,"436,1",5,2,1,8,High-Value,Potential Loyalists
41271,409,1,"10,0",4,1,1,6,Mid-Value,Potential Loyalists
41272,64,1,"57,6",5,1,1,7,Mid-Value,Potential Loyalists
41274,619,1,"22,35",4,1,1,6,Mid-Value,Potential Loyalists
41275,145,3,"159,7",5,1,1,7,Mid-Value,Potential Loyalists
41276,1371,1,"28,35",2,1,1,4,Low-Value,Can't Lose
41279,948,1,"31,2",3,1,1,5,Low-Value,At Risk Customers
41280,219,2,"222,6",5,1,1,7,Mid-Value,Potential Loyalists
41281,1190,2,"76,95",2,1,1,4,Low-Value,Can't Lose
41282,4,9,"532,65",5,2,1,8,High-Value,Potential Loyalists
41283,1098,6,"773,35",2,1,2,5,Low-Value,At Risk Customers
41284,56,4,"378,15000000000003",5,1,1,7,Mid-Value,Potential Loyalists
41285,73,12,"523,5",5,3,1,9,High-Value,Champions
41286,682,2,"152,5",4,1,1,6,Mid-Value,Potential Loyalists
41287,1218,3,"262,4",2,1,1,4,Low-Value,Can't Lose
41288,1595,1,"26,6",1,1,1,3,Low-Value,Lost
41289,141,2,"246,79999999999998",5,1,1,7,Mid-Value,Potential Loyalists
41290,49,9,"662,9",5,2,1,8,High-Value,Potential Loyalists
41291,134,5,"245,95",5,1,1,7,Mid-Value,Potential Loyalists
41292,136,4,"245,9",5,1,1,7,Mid-Value,Potential Loyalists
41293,1613,2,"181,2",1,1,1,3,Low-Value,Lost
41294,213,1,"193,8",5,1,1,7,Mid-Value,Potential Loyalists
41295,1111,2,"110,30000000000001",2,1,1,4,Low-Value,Can't Lose
41296,297,2,"24,85",5,1,1,7,Mid-Value,Potential Loyalists
41299,859,1,"154,64999999999998",3,1,1,5,Low-Value,At Risk Customers
41300,115,3,"353,15",5,1,1,7,Mid-Value,Potential Loyalists
41302,44,10,"489,09999999999997",5,2,1,8,High-Value,Potential Loyalists
41303,705,1,"36,1",4,1,1,6,Mid-Value,Potential Loyalists
41304,14,14,"1242,0",5,3,2,10,High-Value,Champions
41306,217,3,"134,85",5,1,1,7,Mid-Value,Potential Loyalists
41307,1704,1,"84,3",1,1,1,3,Low-Value,Lost
41310,720,2,"41,300000000000004",4,1,1,6,Mid-Value,Potential Loyalists
41311,536,3,"147,05",4,1,1,6,Mid-Value,Potential Loyalists
41312,178,4,"98,15",5,1,1,7,Mid-Value,Potential Loyalists
41313,22,5,"291,40000000000003",5,1,1,7,Mid-Value,Potential Loyalists
41314,201,5,"184,05",5,1,1,7,Mid-Value,Potential Loyalists
41315,1641,1,"219,5",1,1,1,3,Low-Value,Lost
41316,668,4,"398,7",4,1,1,6,Mid-Value,Potential Loyalists
41320,894,1,"218,7",3,1,1,5,Low-Value,At Risk Customers
41322,837,3,"96,0",3,1,1,5,Low-Value,At Risk Customers
41323,25,11,"452,75",5,2,1,8,High-Value,Potential Loyalists
41324,731,3,"234,9",3,1,1,5,Low-Value,At Risk Customers
41326,182,1,"206,15",5,1,1,7,Mid-Value,Potential Loyalists
41329,740,1,"38,099999999999994",3,1,1,5,Low-Value,At Risk Customers
41330,921,1,"9,65",3,1,1,5,Low-Value,At Risk Customers
41331,959,1,"51,75",3,1,1,5,Low-Value,At Risk Customers
41332,1058,5,"492,85",3,1,1,5,Low-Value,At Risk Customers
41333,348,5,"154,45",5,1,1,7,Mid-Value,Potential Loyalists
41335,1133,1,"38,6",2,1,1,4,Low-Value,Can't Lose
41336,108,2,"21,099999999999998",5,1,1,7,Mid-Value,Potential Loyalists
41337,362,2,"110,85000000000001",5,1,1,7,Mid-Value,Potential Loyalists
41338,973,2,"467,05",3,1,1,5,Low-Value,At Risk Customers
41339,260,3,"66,75",5,1,1,7,Mid-Value,Potential Loyalists
41341,1026,1,"2,2",3,1,1,5,Low-Value,At Risk Customers
41342,618,3,"107,0",4,1,1,6,Mid-Value,Potential Loyalists
41343,15,5,"653,0",5,1,1,7,Mid-Value,Potential Loyalists
41344,756,5,"322,0",3,1,1,5,Low-Value,At Risk Customers
41346,974,3,"221,15",3,1,1,5,Low-Value,At Risk Customers
41347,7,4,"113,10000000000001",5,1,1,7,Mid-Value,Potential Loyalists
41349,141,7,"633,95",5,2,1,8,High-Value,Potential Loyalists
41351,337,5,"484,75",5,1,1,7,Mid-Value,Potential Loyalists
41353,1462,1,"57,6",1,1,1,3,Low-Value,Lost
41356,95,5,"319,45",5,1,1,7,Mid-Value,Potential Loyalists
41357,258,3,"372,95",5,1,1,7,Mid-Value,Potential Loyalists
41358,30,5,"218,2",5,1,1,7,Mid-Value,Potential Loyalists
41359,791,2,"34,0",3,1,1,5,Low-Value,At Risk Customers
41360,1085,4,"123,45",3,1,1,5,Low-Value,At Risk Customers
41361,431,6,"411,79999999999995",4,1,1,6,Mid-Value,Potential Loyalists
41362,1362,1,"63,1",2,1,1,4,Low-Value,Can't Lose
41363,689,6,"300,7",4,1,1,6,Mid-Value,Potential Loyalists
41367,293,1,"54,7",5,1,1,7,Mid-Value,Potential Loyalists
41368,407,1,"33,4",4,1,1,6,Mid-Value,Potential Loyalists
41369,500,2,"87,30000000000001",4,1,1,6,Mid-Value,Potential Loyalists
41370,252,3,"228,3",5,1,1,7,Mid-Value,Potential Loyalists
41372,54,6,"383,5",5,1,1,7,Mid-Value,Potential Loyalists
41375,579,4,"157,7",4,1,1,6,Mid-Value,Potential Loyalists
41376,1417,1,"21,65",2,1,1,4,Low-Value,Can't Lose
41377,1285,1,"27,8",2,1,1,4,Low-Value,Can't Lose
41378,402,2,"159,1",4,1,1,6,Mid-Value,Potential Loyalists
41379,1606,2,"535,5",1,1,1,3,Low-Value,Lost
41380,19,6,"385,8",5,1,1,7,Mid-Value,Potential Loyalists
41386,471,2,"44,4",4,1,1,6,Mid-Value,Potential Loyalists
41387,1377,1,"21,85",2,1,1,4,Low-Value,Can't Lose
41388,814,2,"184,95",3,1,1,5,Low-Value,At Risk Customers
41389,1300,1,"110,85000000000001",2,1,1,4,Low-Value,Can't Lose
41393,193,2,"58,5",5,1,1,7,Mid-Value,Potential Loyalists
41394,113,3,"75,39999999999999",5,1,1,7,Mid-Value,Potential Loyalists
41397,362,1,"10,0",5,1,1,7,Mid-Value,Potential Loyalists
41400,916,2,"369,55",3,1,1,5,Low-Value,At Risk Customers
41401,1125,1,"545,0",2,1,1,4,Low-Value,Can't Lose
41403,1490,1,"27,8",1,1,1,3,Low-Value,Lost
41405,89,5,"115,55",5,1,1,7,Mid-Value,Potential Loyalists
41406,819,3,"167,55",3,1,1,5,Low-Value,At Risk Customers
41407,242,1,"14,0",5,1,1,7,Mid-Value,Potential Loyalists
41408,1245,2,"242,2",2,1,1,4,Low-Value,Can't Lose
41412,1503,1,"6,7",1,1,1,3,Low-Value,Lost
41416,378,2,"86,8",4,1,1,6,Mid-Value,Potential Loyalists
41417,40,2,"44,7",5,1,1,7,Mid-Value,Potential Loyalists
41418,394,2,"395,65",4,1,1,6,Mid-Value,Potential Loyalists
41420,248,1,"152,1",5,1,1,7,Mid-Value,Potential Loyalists
41421,529,2,"182,7",4,1,1,6,Mid-Value,Potential Loyalists
41422,28,3,"551,9",5,1,1,7,Mid-Value,Potential Loyalists
41426,1715,1,"59,9",1,1,1,3,Low-Value,Lost
41427,196,1,"1,2",5,1,1,7,Mid-Value,Potential Loyalists
41428,190,6,"288,84999999999997",5,1,1,7,Mid-Value,Potential Loyalists
41429,883,11,"286,5",3,2,1,6,Mid-Value,Potential Loyalists
41430,390,3,"380,7",4,1,1,6,Mid-Value,Potential Loyalists
41431,225,2,"105,5",5,1,1,7,Mid-Value,Potential Loyalists
41432,361,5,"417,84999999999997",5,1,1,7,Mid-Value,Potential Loyalists
41433,73,2,"16,65",5,1,1,7,Mid-Value,Potential Loyalists
41434,78,3,"124,95",5,1,1,7,Mid-Value,Potential Loyalists
41435,1488,1,"31,4",1,1,1,3,Low-Value,Lost
41437,91,2,"52,65",5,1,1,7,Mid-Value,Potential Loyalists
41439,135,5,"402,1",5,1,1,7,Mid-Value,Potential Loyalists
41442,904,4,"217,2",3,1,1,5,Low-Value,At Risk Customers
41444,182,3,"343,65",5,1,1,7,Mid-Value,Potential Loyalists
41445,763,4,"504,95",3,1,1,5,Low-Value,At Risk Customers
41446,14,2,"58,6",5,1,1,7,Mid-Value,Potential Loyalists
41447,446,2,"268,05",4,1,1,6,Mid-Value,Potential Loyalists
41448,802,9,"248,3",3,2,1,6,Mid-Value,Potential Loyalists
41451,613,4,"239,5",4,1,1,6,Mid-Value,Potential Loyalists
41452,1363,1,"25,4",2,1,1,4,Low-Value,Can't Lose
41454,17,9,"546,1",5,2,1,8,High-Value,Potential Loyalists
41455,172,3,"361,05",5,1,1,7,Mid-Value,Potential Loyalists
41456,38,3,"216,8",5,1,1,7,Mid-Value,Potential Loyalists
41457,936,2,"105,0",3,1,1,5,Low-Value,At Risk Customers
41459,950,4,"265,84999999999997",3,1,1,5,Low-Value,At Risk Customers
41464,944,1,"18,45",3,1,1,5,Low-Value,At Risk Customers
41467,276,1,"37,8",5,1,1,7,Mid-Value,Potential Loyalists
41469,383,5,"66,55",4,1,1,6,Mid-Value,Potential Loyalists
41470,850,3,"386,35",3,1,1,5,Low-Value,At Risk Customers
41471,1648,2,"31,700000000000003",1,1,1,3,Low-Value,Lost
41473,1488,1,"78,6",1,1,1,3,Low-Value,Lost
41474,186,1,"68,2",5,1,1,7,Mid-Value,Potential Loyalists
41475,592,3,"127,25",4,1,1,6,Mid-Value,Potential Loyalists
41476,717,1,"16,75",4,1,1,6,Mid-Value,Potential Loyalists
41477,78,1,"110,5",5,1,1,7,Mid-Value,Potential Loyalists
41478,173,3,"104,45",5,1,1,7,Mid-Value,Potential Loyalists
41479,617,2,"356,75",4,1,1,6,Mid-Value,Potential Loyalists
41480,437,1,"178,6",4,1,1,6,Mid-Value,Potential Loyalists
41483,182,2,"195,2",5,1,1,7,Mid-Value,Potential Loyalists
41484,109,13,"1769,0",5,3,3,11,High-Value,Champions
41485,1655,1,"50,7",1,1,1,3,Low-Value,Lost
41486,69,5,"115,35000000000001",5,1,1,7,Mid-Value,Potential Loyalists
41488,1486,1,"199,0",1,1,1,3,Low-Value,Lost
41489,1,3,"217,3",5,1,1,7,Mid-Value,Potential Loyalists
41490,770,1,"11,75",3,1,1,5,Low-Value,At Risk Customers
41492,986,1,"12,7",3,1,1,5,Low-Value,At Risk Customers
41494,471,3,"139,25",4,1,1,6,Mid-Value,Potential Loyalists
41495,933,1,"42,5",3,1,1,5,Low-Value,At Risk Customers
41497,1263,2,"138,8",2,1,1,4,Low-Value,Can't Lose
41501,925,1,"49,6",3,1,1,5,Low-Value,At Risk Customers
41502,3,7,"575,15",5,2,1,8,High-Value,Potential Loyalists
41503,767,5,"243,25",3,1,1,5,Low-Value,At Risk Customers
41506,1396,3,"160,60000000000002",2,1,1,4,Low-Value,Can't Lose
41507,33,2,"69,15",5,1,1,7,Mid-Value,Potential Loyalists
41508,216,1,"14,0",5,1,1,7,Mid-Value,Potential Loyalists
41509,615,2,"64,23",4,1,1,6,Mid-Value,Potential Loyalists
41511,202,6,"243,0",5,1,1,7,Mid-Value,Potential Loyalists
41513,381,7,"398,09999999999997",4,2,1,7,Mid-Value,Potential Loyalists
41516,97,5,"333,3",5,1,1,7,Mid-Value,Potential Loyalists
41521,1022,4,"210,24999999999997",3,1,1,5,Low-Value,At Risk Customers
41523,256,1,"159,75",5,1,1,7,Mid-Value,Potential Loyalists
41524,794,3,"94,7",3,1,1,5,Low-Value,At Risk Customers
41525,181,6,"787,95",5,1,2,8,High-Value,Potential Loyalists
41528,204,2,"104,55",5,1,1,7,Mid-Value,Potential Loyalists
41530,14,1,"38,0",5,1,1,7,Mid-Value,Potential Loyalists
41532,606,7,"210,0",4,2,1,7,Mid-Value,Potential Loyalists
41533,383,2,"403,90000000000003",4,1,1,6,Mid-Value,Potential Loyalists
41535,1241,1,"41,9",2,1,1,4,Low-Value,Can't Lose
41536,340,4,"98,3",5,1,1,7,Mid-Value,Potential Loyalists
41537,362,2,"114,9",5,1,1,7,Mid-Value,Potential Loyalists
41538,1477,3,"16,25",1,1,1,3,Low-Value,Lost
41539,603,6,"684,6",4,1,2,7,Mid-Value,Potential Loyalists
41540,1684,1,"56,0",1,1,1,3,Low-Value,Lost
41542,30,9,"849,75",5,2,2,9,High-Value,Champions
41543,194,5,"262,45",5,1,1,7,Mid-Value,Potential Loyalists
41546,526,2,"159,54999999999998",4,1,1,6,Mid-Value,Potential Loyalists
41547,234,9,"586,6",5,2,1,8,High-Value,Potential Loyalists
41548,382,1,"23,45",4,1,1,6,Mid-Value,Potential Loyalists
41550,412,4,"420,5",4,1,1,6,Mid-Value,Potential Loyalists
41552,1823,1,"31,1",1,1,1,3,Low-Value,Lost
41553,258,2,"103,2",5,1,1,7,Mid-Value,Potential Loyalists
41554,288,1,"31,5",5,1,1,7,Mid-Value,Potential Loyalists
41555,18,9,"948,4499999999999",5,2,2,9,High-Value,Champions
41556,171,9,"565,5",5,2,1,8,High-Value,Potential Loyalists
41558,759,3,"308,70000000000005",3,1,1,5,Low-Value,At Risk Customers
41560,560,2,"110,39999999999999",4,1,1,6,Mid-Value,Potential Loyalists
41562,177,8,"586,6",5,2,1,8,High-Value,Potential Loyalists
41563,224,8,"288,1",5,2,1,8,High-Value,Potential Loyalists
41564,1353,1,"40,92",2,1,1,4,Low-Value,Can't Lose
41565,636,1,"65,2",4,1,1,6,Mid-Value,Potential Loyalists
41567,87,5,"275,85",5,1,1,7,Mid-Value,Potential Loyalists
41568,28,1,"278,9",5,1,1,7,Mid-Value,Potential Loyalists
41569,643,5,"154,8",4,1,1,6,Mid-Value,Potential Loyalists
41570,414,4,"291,15",4,1,1,6,Mid-Value,Potential Loyalists
41572,116,1,"11,05",5,1,1,7,Mid-Value,Potential Loyalists
41573,461,1,"89,55",4,1,1,6,Mid-Value,Potential Loyalists
41574,920,1,"27,9",3,1,1,5,Low-Value,At Risk Customers
41575,393,3,"63,849999999999994",4,1,1,6,Mid-Value,Potential Loyalists
41576,1009,1,"34,55",3,1,1,5,Low-Value,At Risk Customers
41577,48,8,"154,55",5,2,1,8,High-Value,Potential Loyalists
41578,7,3,"340,6",5,1,1,7,Mid-Value,Potential Loyalists
41579,785,3,"185,55",3,1,1,5,Low-Value,At Risk Customers
41580,621,4,"278,4",4,1,1,6,Mid-Value,Potential Loyalists
41581,985,3,"65,4",3,1,1,5,Low-Value,At Risk Customers
41582,1144,2,"106,7",2,1,1,4,Low-Value,Can't Lose
41586,162,1,"81,1",5,1,1,7,Mid-Value,Potential Loyalists
41588,133,4,"375,25",5,1,1,7,Mid-Value,Potential Loyalists
41590,522,4,"304,5",4,1,1,6,Mid-Value,Potential Loyalists
41591,445,3,"262,0",4,1,1,6,Mid-Value,Potential Loyalists
41597,6,7,"207,65",5,2,1,8,High-Value,Potential Loyalists
41600,939,3,"74,55",3,1,1,5,Low-Value,At Risk Customers
41601,1225,2,"70,69999999999999",2,1,1,4,Low-Value,Can't Lose
41602,190,5,"371,65",5,1,1,7,Mid-Value,Potential Loyalists
41603,660,3,"129,55",4,1,1,6,Mid-Value,Potential Loyalists
41605,199,1,"170,7",5,1,1,7,Mid-Value,Potential Loyalists
41606,1263,3,"120,8",2,1,1,4,Low-Value,Can't Lose
41608,1494,1,"13,55",1,1,1,3,Low-Value,Lost
41611,1131,2,"21,75",2,1,1,4,Low-Value,Can't Lose
41612,19,1,"32,3",5,1,1,7,Mid-Value,Potential Loyalists
41613,1558,1,"6,3",1,1,1,3,Low-Value,Lost
41614,28,4,"153,20000000000002",5,1,1,7,Mid-Value,Potential Loyalists
41615,1817,1,"199,0",1,1,1,3,Low-Value,Lost
41617,1,3,"818,45",5,1,2,8,High-Value,Potential Loyalists
41619,173,1,"103,8",5,1,1,7,Mid-Value,Potential Loyalists
41620,60,14,"897,6",5,3,2,10,High-Value,Champions
41623,54,1,"195,7",5,1,1,7,Mid-Value,Potential Loyalists
41624,1333,1,"42,2",2,1,1,4,Low-Value,Can't Lose
41625,1394,2,"89,64999999999999",2,1,1,4,Low-Value,Can't Lose
41626,73,14,"782,7",5,3,2,10,High-Value,Champions
41628,570,5,"374,2",4,1,1,6,Mid-Value,Potential Loyalists
41629,544,1,"193,8",4,1,1,6,Mid-Value,Potential Loyalists
41632,1594,2,"62,75",1,1,1,3,Low-Value,Lost
41633,246,10,"789,1",5,2,2,9,High-Value,Champions
41634,1793,1,"7,65",1,1,1,3,Low-Value,Lost
41636,628,1,"34,35",4,1,1,6,Mid-Value,Potential Loyalists
41640,217,3,"100,7",5,1,1,7,Mid-Value,Potential Loyalists
41641,21,10,"704,8499999999999",5,2,2,9,High-Value,Champions
41642,207,1,"32,4",5,1,1,7,Mid-Value,Potential Loyalists
41643,1247,3,"109,8",2,1,1,4,Low-Value,Can't Lose
41645,231,3,"48,85",5,1,1,7,Mid-Value,Potential Loyalists
41646,102,4,"191,5",5,1,1,7,Mid-Value,Potential Loyalists
41648,310,5,"95,6",5,1,1,7,Mid-Value,Potential Loyalists
41649,1392,1,"117,4",2,1,1,4,Low-Value,Can't Lose
41652,380,4,"139,29999999999998",4,1,1,6,Mid-Value,Potential Loyalists
41653,368,1,"31,2",4,1,1,6,Mid-Value,Potential Loyalists
41654,389,3,"203,3",4,1,1,6,Mid-Value,Potential Loyalists
41655,347,1,"0,8",5,1,1,7,Mid-Value,Potential Loyalists
41657,67,7,"407,45",5,2,1,8,High-Value,Potential Loyalists
41660,434,4,"279,25",4,1,1,6,Mid-Value,Potential Loyalists
41661,51,3,"81,4",5,1,1,7,Mid-Value,Potential Loyalists
41662,412,2,"104,0",4,1,1,6,Mid-Value,Potential Loyalists
41663,1670,4,"198,55",1,1,1,3,Low-Value,Lost
41664,841,3,"173,29999999999998",3,1,1,5,Low-Value,At Risk Customers
41665,828,7,"471,3",3,2,1,6,Mid-Value,Potential Loyalists
41666,900,1,"27,9",3,1,1,5,Low-Value,At Risk Customers
41667,440,2,"52,449999999999996",4,1,1,6,Mid-Value,Potential Loyalists
41669,195,1,"97,94999999999999",5,1,1,7,Mid-Value,Potential Loyalists
41670,425,1,"8,35",4,1,1,6,Mid-Value,Potential Loyalists
41671,163,2,"59,05",5,1,1,7,Mid-Value,Potential Loyalists
41672,1377,4,"234,14999999999998",2,1,1,4,Low-Value,Can't Lose
41674,18,3,"176,6",5,1,1,7,Mid-Value,Potential Loyalists
41675,727,2,"62,45",4,1,1,6,Mid-Value,Potential Loyalists
41676,31,2,"26,15",5,1,1,7,Mid-Value,Potential Loyalists
41677,24,6,"350,15",5,1,1,7,Mid-Value,Potential Loyalists
41678,227,9,"422,25",5,2,1,8,High-Value,Potential Loyalists
41679,146,4,"369,35",5,1,1,7,Mid-Value,Potential Loyalists
41680,621,1,"232,1",4,1,1,6,Mid-Value,Potential Loyalists
41681,1095,1,"51,2",3,1,1,5,Low-Value,At Risk Customers
41683,1000,2,"34,8",3,1,1,5,Low-Value,At Risk Customers
41685,383,2,"78,86",4,1,1,6,Mid-Value,Potential Loyalists
41686,234,2,"31,650000000000002",5,1,1,7,Mid-Value,Potential Loyalists
41687,785,2,"52,6",3,1,1,5,Low-Value,At Risk Customers
41689,125,2,"118,80000000000001",5,1,1,7,Mid-Value,Potential Loyalists
41690,741,7,"381,1",3,2,1,6,Mid-Value,Potential Loyalists
41691,784,2,"36,0",3,1,1,5,Low-Value,At Risk Customers
41692,76,3,"224,79999999999998",5,1,1,7,Mid-Value,Potential Loyalists
41693,292,8,"863,75",5,2,2,9,High-Value,Champions
41694,155,3,"193,55",5,1,1,7,Mid-Value,Potential Loyalists
41695,694,1,"20,45",4,1,1,6,Mid-Value,Potential Loyalists
41697,900,1,"67,2",3,1,1,5,Low-Value,At Risk Customers
41698,477,14,"668,9",4,3,2,9,High-Value,Champions
41703,1600,2,"77,95",1,1,1,3,Low-Value,Lost
41704,146,3,"130,15",5,1,1,7,Mid-Value,Potential Loyalists
41705,514,1,"201,3",4,1,1,6,Mid-Value,Potential Loyalists
41706,271,3,"173,7",5,1,1,7,Mid-Value,Potential Loyalists
41709,46,3,"160,05",5,1,1,7,Mid-Value,Potential Loyalists
41710,860,3,"105,8",3,1,1,5,Low-Value,At Risk Customers
41711,416,6,"148,35",4,1,1,6,Mid-Value,Potential Loyalists
41713,23,4,"327,59999999999997",5,1,1,7,Mid-Value,Potential Loyalists
41715,232,2,"393,79999999999995",5,1,1,7,Mid-Value,Potential Loyalists
41716,423,4,"71,9",4,1,1,6,Mid-Value,Potential Loyalists
41717,757,1,"155,4",3,1,1,5,Low-Value,At Risk Customers
41719,615,3,"221,3",4,1,1,6,Mid-Value,Potential Loyalists
41720,164,8,"227,7",5,2,1,8,High-Value,Potential Loyalists
41721,493,2,"66,9",4,1,1,6,Mid-Value,Potential Loyalists
41722,30,1,"289,95",5,1,1,7,Mid-Value,Potential Loyalists
41723,147,2,"102,5",5,1,1,7,Mid-Value,Potential Loyalists
41725,934,2,"50,6",3,1,1,5,Low-Value,At Risk Customers
41726,175,4,"153,15",5,1,1,7,Mid-Value,Potential Loyalists
41728,753,5,"197,6",3,1,1,5,Low-Value,At Risk Customers
41730,350,2,"12,4",5,1,1,7,Mid-Value,Potential Loyalists
41733,558,4,"215,1",4,1,1,6,Mid-Value,Potential Loyalists
41734,1135,2,"52,5",2,1,1,4,Low-Value,Can't Lose
41737,466,4,"109,9",4,1,1,6,Mid-Value,Potential Loyalists
41738,28,2,"175,4",5,1,1,7,Mid-Value,Potential Loyalists
41739,876,1,"61,3",3,1,1,5,Low-Value,At Risk Customers
41740,737,3,"99,65",3,1,1,5,Low-Value,At Risk Customers
41741,46,4,"305,7",5,1,1,7,Mid-Value,Potential Loyalists
41742,1548,1,"16,7",1,1,1,3,Low-Value,Lost
41743,958,2,"276,15000000000003",3,1,1,5,Low-Value,At Risk Customers
41744,274,4,"98,0",5,1,1,7,Mid-Value,Potential Loyalists
41746,634,1,"19,75",4,1,1,6,Mid-Value,Potential Loyalists
41747,370,3,"466,20000000000005",4,1,1,6,Mid-Value,Potential Loyalists
41748,834,1,"90,3",3,1,1,5,Low-Value,At Risk Customers
41749,1116,1,"188,7",2,1,1,4,Low-Value,Can't Lose
41751,517,2,"129,7",4,1,1,6,Mid-Value,Potential Loyalists
41752,1430,2,"86,75",2,1,1,4,Low-Value,Can't Lose
41754,345,2,"16,45",5,1,1,7,Mid-Value,Potential Loyalists
41755,153,4,"886,7",5,1,2,8,High-Value,Potential Loyalists
41756,103,7,"696,7",5,2,2,9,High-Value,Champions
41757,1743,1,"12,45",1,1,1,3,Low-Value,Lost
41758,49,4,"152,0",5,1,1,7,Mid-Value,Potential Loyalists
41759,264,3,"159,04999999999998",5,1,1,7,Mid-Value,Potential Loyalists
41760,895,2,"58,650000000000006",3,1,1,5,Low-Value,At Risk Customers
41761,1137,1,"28,85",2,1,1,4,Low-Value,Can't Lose
41762,196,2,"130,3",5,1,1,7,Mid-Value,Potential Loyalists
41763,20,4,"142,79999999999998",5,1,1,7,Mid-Value,Potential Loyalists
41764,782,6,"364,4",3,1,1,5,Low-Value,At Risk Customers
41766,476,3,"193,0",4,1,1,6,Mid-Value,Potential Loyalists
41768,186,3,"256,1",5,1,1,7,Mid-Value,Potential Loyalists
41769,557,10,"717,9",4,2,2,8,High-Value,Potential Loyalists
41770,565,1,"45,9",4,1,1,6,Mid-Value,Potential Loyalists
41771,621,4,"204,85",4,1,1,6,Mid-Value,Potential Loyalists
41772,59,4,"247,65",5,1,1,7,Mid-Value,Potential Loyalists
41773,186,3,"119,7",5,1,1,7,Mid-Value,Potential Loyalists
41777,225,3,"56,45",5,1,1,7,Mid-Value,Potential Loyalists
41779,165,8,"419,75",5,2,1,8,High-Value,Potential Loyalists
41780,193,6,"676,6",5,1,2,8,High-Value,Potential Loyalists
41781,375,4,"124,3",4,1,1,6,Mid-Value,Potential Loyalists
41782,61,5,"180,9",5,1,1,7,Mid-Value,Potential Loyalists
41785,1606,1,"117,2",1,1,1,3,Low-Value,Lost
41786,814,1,"57,6",3,1,1,5,Low-Value,At Risk Customers
41787,293,1,"87,15",5,1,1,7,Mid-Value,Potential Loyalists
41790,722,1,"76,3",4,1,1,6,Mid-Value,Potential Loyalists
41793,94,4,"226,55",5,1,1,7,Mid-Value,Potential Loyalists
41795,304,8,"563,05",5,2,1,8,High-Value,Potential Loyalists
41799,220,2,"596,0",5,1,1,7,Mid-Value,Potential Loyalists
41800,1755,1,"34,8",1,1,1,3,Low-Value,Lost
41801,234,4,"318,35",5,1,1,7,Mid-Value,Potential Loyalists
41802,830,4,"243,39999999999998",3,1,1,5,Low-Value,At Risk Customers
41803,620,4,"336,15",4,1,1,6,Mid-Value,Potential Loyalists
41804,911,2,"426,04999999999995",3,1,1,5,Low-Value,At Risk Customers
41805,358,1,"23,75",5,1,1,7,Mid-Value,Potential Loyalists
41807,593,1,"2,4000000000000004",4,1,1,6,Mid-Value,Potential Loyalists
41808,251,3,"216,2",5,1,1,7,Mid-Value,Potential Loyalists
41809,1099,1,"39,9",2,1,1,4,Low-Value,Can't Lose
41811,754,4,"210,75",3,1,1,5,Low-Value,At Risk Customers
41812,409,2,"94,45",4,1,1,6,Mid-Value,Potential Loyalists
41813,853,2,"54,55",3,1,1,5,Low-Value,At Risk Customers
41814,252,3,"119,6",5,1,1,7,Mid-Value,Potential Loyalists
41816,182,1,"32,4",5,1,1,7,Mid-Value,Potential Loyalists
41817,231,6,"115,4",5,1,1,7,Mid-Value,Potential Loyalists
41819,118,1,"32,9",5,1,1,7,Mid-Value,Potential Loyalists
41820,135,5,"639,2",5,1,1,7,Mid-Value,Potential Loyalists
41821,425,1,"46,7",4,1,1,6,Mid-Value,Potential Loyalists
41822,913,3,"226,5",3,1,1,5,Low-Value,At Risk Customers
41823,7,4,"139,4",5,1,1,7,Mid-Value,Potential Loyalists
41824,50,9,"525,5",5,2,1,8,High-Value,Potential Loyalists
41826,733,1,"60,6",3,1,1,5,Low-Value,At Risk Customers
41827,377,5,"746,5500000000001",4,1,2,7,Mid-Value,Potential Loyalists
41828,475,3,"85,15",4,1,1,6,Mid-Value,Potential Loyalists
41829,80,3,"220,20000000000002",5,1,1,7,Mid-Value,Potential Loyalists
41830,24,1,"80,45",5,1,1,7,Mid-Value,Potential Loyalists
41831,1653,1,"19,3",1,1,1,3,Low-Value,Lost
41835,866,5,"152,3",3,1,1,5,Low-Value,At Risk Customers
41836,202,5,"269,95",5,1,1,7,Mid-Value,Potential Loyalists
41837,1329,1,"40,05",2,1,1,4,Low-Value,Can't Lose
41838,1144,1,"21,6",2,1,1,4,Low-Value,Can't Lose
41839,754,1,"168,0",3,1,1,5,Low-Value,At Risk Customers
41841,482,4,"177,0",4,1,1,6,Mid-Value,Potential Loyalists
41842,96,5,"259,3",5,1,1,7,Mid-Value,Potential Loyalists
41845,96,1,"9,1",5,1,1,7,Mid-Value,Potential Loyalists
41846,1417,1,"9,55",2,1,1,4,Low-Value,Can't Lose
41847,384,4,"167,95",4,1,1,6,Mid-Value,Potential Loyalists
41848,1105,1,"24,2",2,1,1,4,Low-Value,Can't Lose
41849,43,3,"52,55",5,1,1,7,Mid-Value,Potential Loyalists
41850,68,9,"264,75",5,2,1,8,High-Value,Potential Loyalists
41851,1123,4,"203,95",2,1,1,4,Low-Value,Can't Lose
41852,1750,1,"10,6",1,1,1,3,Low-Value,Lost
41855,399,5,"216,75",4,1,1,6,Mid-Value,Potential Loyalists
41856,143,1,"251,3",5,1,1,7,Mid-Value,Potential Loyalists
41857,649,7,"313,4",4,2,1,7,Mid-Value,Potential Loyalists
41858,1161,1,"21,35",2,1,1,4,Low-Value,Can't Lose
41865,645,2,"79,75",4,1,1,6,Mid-Value,Potential Loyalists
41866,59,1,"85,15",5,1,1,7,Mid-Value,Potential Loyalists
41867,613,1,"89,4",4,1,1,6,Mid-Value,Potential Loyalists
41868,11,2,"96,0",5,1,1,7,Mid-Value,Potential Loyalists
41870,26,11,"806,5",5,2,2,9,High-Value,Champions
41871,552,2,"63,1",4,1,1,6,Mid-Value,Potential Loyalists
41873,410,7,"937,0",4,2,2,8,High-Value,Potential Loyalists
41874,209,2,"28,55",5,1,1,7,Mid-Value,Potential Loyalists
41877,576,1,"84,44999999999999",4,1,1,6,Mid-Value,Potential Loyalists
41878,136,2,"212,29999999999998",5,1,1,7,Mid-Value,Potential Loyalists
41879,1722,1,"95,3",1,1,1,3,Low-Value,Lost
41884,1489,1,"203,39999999999998",1,1,1,3,Low-Value,Lost
41885,1,2,"94,89999999999999",5,1,1,7,Mid-Value,Potential Loyalists
41886,136,4,"147,8",5,1,1,7,Mid-Value,Potential Loyalists
41887,144,1,"100,3",5,1,1,7,Mid-Value,Potential Loyalists
41889,191,3,"380,84999999999997",5,1,1,7,Mid-Value,Potential Loyalists
41890,24,7,"762,05",5,2,2,9,High-Value,Champions
41891,1298,2,"84,25",2,1,1,4,Low-Value,Can't Lose
41892,259,5,"312,09999999999997",5,1,1,7,Mid-Value,Potential Loyalists
41893,451,2,"56,65",4,1,1,6,Mid-Value,Potential Loyalists
41896,1291,2,"210,79999999999998",2,1,1,4,Low-Value,Can't Lose
41898,643,2,"57,35",4,1,1,6,Mid-Value,Potential Loyalists
41899,1439,1,"60,65",2,1,1,4,Low-Value,Can't Lose
41900,1541,1,"66,1",1,1,1,3,Low-Value,Lost
41901,460,3,"400,25",4,1,1,6,Mid-Value,Potential Loyalists
41902,55,7,"252,64999999999998",5,2,1,8,High-Value,Potential Loyalists
41903,1459,2,"109,05",2,1,1,4,Low-Value,Can't Lose
41904,45,6,"205,70000000000002",5,1,1,7,Mid-Value,Potential Loyalists
41905,885,3,"55,9",3,1,1,5,Low-Value,At Risk Customers
41906,215,4,"314,25",5,1,1,7,Mid-Value,Potential Loyalists
41908,995,3,"193,25",3,1,1,5,Low-Value,At Risk Customers
41909,396,2,"42,099999999999994",4,1,1,6,Mid-Value,Potential Loyalists
41910,1049,1,"88,35",3,1,1,5,Low-Value,At Risk Customers
41912,833,4,"275,95",3,1,1,5,Low-Value,At Risk Customers
41913,328,4,"207,3",5,1,1,7,Mid-Value,Potential Loyalists
41914,165,9,"360,55",5,2,1,8,High-Value,Potential Loyalists
41915,253,5,"727,0",5,1,2,8,High-Value,Potential Loyalists
41917,703,1,"6,75",4,1,1,6,Mid-Value,Potential Loyalists
41918,73,2,"256,45",5,1,1,7,Mid-Value,Potential Loyalists
41919,809,4,"158,95",3,1,1,5,Low-Value,At Risk Customers
41922,105,3,"139,3",5,1,1,7,Mid-Value,Potential Loyalists
41924,4,16,"767,0",5,3,2,10,High-Value,Champions
41925,893,1,"17,7",3,1,1,5,Low-Value,At Risk Customers
41928,858,3,"104,75",3,1,1,5,Low-Value,At Risk Customers
41931,479,3,"80,35000000000001",4,1,1,6,Mid-Value,Potential Loyalists
41933,616,3,"314,2",4,1,1,6,Mid-Value,Potential Loyalists
41934,131,3,"282,55",5,1,1,7,Mid-Value,Potential Loyalists
41935,674,1,"4,65",4,1,1,6,Mid-Value,Potential Loyalists
41936,403,3,"47,25",4,1,1,6,Mid-Value,Potential Loyalists
41937,70,4,"61,45",5,1,1,7,Mid-Value,Potential Loyalists
41938,279,3,"189,89999999999998",5,1,1,7,Mid-Value,Potential Loyalists
41940,1108,3,"92,85",2,1,1,4,Low-Value,Can't Lose
41942,1404,1,"32,3",2,1,1,4,Low-Value,Can't Lose
41944,99,9,"390,45000000000005",5,2,1,8,High-Value,Potential Loyalists
41945,51,4,"520,25",5,1,1,7,Mid-Value,Potential Loyalists
41946,537,4,"149,75",4,1,1,6,Mid-Value,Potential Loyalists
41947,1412,1,"9,8",2,1,1,4,Low-Value,Can't Lose
41950,143,5,"254,29999999999998",5,1,1,7,Mid-Value,Potential Loyalists
41951,389,5,"144,85",4,1,1,6,Mid-Value,Potential Loyalists
41952,326,4,"416,95000000000005",5,1,1,7,Mid-Value,Potential Loyalists
41953,63,3,"183,05",5,1,1,7,Mid-Value,Potential Loyalists
41955,67,3,"64,6",5,1,1,7,Mid-Value,Potential Loyalists
41956,235,2,"141,55",5,1,1,7,Mid-Value,Potential Loyalists
41957,17,4,"236,8",5,1,1,7,Mid-Value,Potential Loyalists
41958,1187,1,"26,65",2,1,1,4,Low-Value,Can't Lose
41960,533,4,"210,0",4,1,1,6,Mid-Value,Potential Loyalists
41961,1058,4,"143,79999999999998",3,1,1,5,Low-Value,At Risk Customers
41962,1256,1,"39,3",2,1,1,4,Low-Value,Can't Lose
41963,1198,2,"78,7",2,1,1,4,Low-Value,Can't Lose
41964,1788,1,"59,4",1,1,1,3,Low-Value,Lost
41966,748,5,"339,45000000000005",3,1,1,5,Low-Value,At Risk Customers
41968,158,5,"232,15",5,1,1,7,Mid-Value,Potential Loyalists
41971,237,3,"16,25",5,1,1,7,Mid-Value,Potential Loyalists
41972,402,3,"147,3",4,1,1,6,Mid-Value,Potential Loyalists
41973,1071,2,"37,0",3,1,1,5,Low-Value,At Risk Customers
41974,264,1,"25,85",5,1,1,7,Mid-Value,Potential Loyalists
41975,145,7,"479,95",5,2,1,8,High-Value,Potential Loyalists
41976,532,4,"288,15000000000003",4,1,1,6,Mid-Value,Potential Loyalists
41977,681,1,"7,65",4,1,1,6,Mid-Value,Potential Loyalists
41978,245,2,"109,15",5,1,1,7,Mid-Value,Potential Loyalists
41979,554,2,"209,2",4,1,1,6,Mid-Value,Potential Loyalists
41980,227,2,"168,9",5,1,1,7,Mid-Value,Potential Loyalists
41982,685,3,"194,7",4,1,1,6,Mid-Value,Potential Loyalists
41987,232,3,"262,15",5,1,1,7,Mid-Value,Potential Loyalists
41988,882,3,"395,5",3,1,1,5,Low-Value,At Risk Customers
41990,15,5,"311,4",5,1,1,7,Mid-Value,Potential Loyalists
41991,206,2,"48,900000000000006",5,1,1,7,Mid-Value,Potential Loyalists
41992,525,2,"263,45",4,1,1,6,Mid-Value,Potential Loyalists
41993,472,5,"251,79999999999998",4,1,1,6,Mid-Value,Potential Loyalists
41994,211,4,"552,2",5,1,1,7,Mid-Value,Potential Loyalists
41995,113,6,"746,35",5,1,2,8,High-Value,Potential Loyalists
41996,518,6,"332,70000000000005",4,1,1,6,Mid-Value,Potential Loyalists
41997,650,6,"628,85",4,1,1,6,Mid-Value,Potential Loyalists
42000,505,1,"280,0",4,1,1,6,Mid-Value,Potential Loyalists
42001,960,5,"220,15",3,1,1,5,Low-Value,At Risk Customers
42002,1233,1,"270,0",2,1,1,4,Low-Value,Can't Lose
42003,315,2,"35,85",5,1,1,7,Mid-Value,Potential Loyalists
42004,683,1,"170,6",4,1,1,6,Mid-Value,Potential Loyalists
42006,629,1,"33,9",4,1,1,6,Mid-Value,Potential Loyalists
42009,1315,2,"121,19999999999999",2,1,1,4,Low-Value,Can't Lose
42011,1006,2,"37,849999999999994",3,1,1,5,Low-Value,At Risk Customers
42013,732,2,"120,45",3,1,1,5,Low-Value,At Risk Customers
42016,890,2,"231,6",3,1,1,5,Low-Value,At Risk Customers
42017,873,2,"101,0",3,1,1,5,Low-Value,At Risk Customers
42018,282,1,"35,0",5,1,1,7,Mid-Value,Potential Loyalists
42021,360,2,"97,75",5,1,1,7,Mid-Value,Potential Loyalists
42022,267,2,"106,15",5,1,1,7,Mid-Value,Potential Loyalists
42025,26,9,"766,1",5,2,2,9,High-Value,Champions
42027,1305,1,"149,9",2,1,1,4,Low-Value,Can't Lose
42030,1333,1,"59,849999999999994",2,1,1,4,Low-Value,Can't Lose
42031,592,2,"89,3",4,1,1,6,Mid-Value,Potential Loyalists
42033,1598,2,"159,85000000000002",1,1,1,3,Low-Value,Lost
42036,805,2,"261,8",3,1,1,5,Low-Value,At Risk Customers
42037,438,4,"200,3",4,1,1,6,Mid-Value,Potential Loyalists
42039,1034,3,"389,04999999999995",3,1,1,5,Low-Value,At Risk Customers
42040,434,5,"147,2",4,1,1,6,Mid-Value,Potential Loyalists
42044,1705,1,"23,85",1,1,1,3,Low-Value,Lost
42045,1503,2,"134,9",1,1,1,3,Low-Value,Lost
42047,52,6,"299,55",5,1,1,7,Mid-Value,Potential Loyalists
42048,375,1,"92,8",4,1,1,6,Mid-Value,Potential Loyalists
42049,558,9,"1216,4",4,2,2,8,High-Value,Potential Loyalists
42050,341,2,"102,75",5,1,1,7,Mid-Value,Potential Loyalists
42052,759,5,"219,1",3,1,1,5,Low-Value,At Risk Customers
42053,16,4,"498,8",5,1,1,7,Mid-Value,Potential Loyalists
42054,775,2,"141,6",3,1,1,5,Low-Value,At Risk Customers
42055,1410,1,"10,2",2,1,1,4,Low-Value,Can't Lose
42057,386,6,"576,65",4,1,1,6,Mid-Value,Potential Loyalists
42058,28,5,"303,15000000000003",5,1,1,7,Mid-Value,Potential Loyalists
42059,199,4,"292,05",5,1,1,7,Mid-Value,Potential Loyalists
42060,868,2,"129,6",3,1,1,5,Low-Value,At Risk Customers
42061,1201,3,"268,4",2,1,1,4,Low-Value,Can't Lose
42062,1799,1,"27,7",1,1,1,3,Low-Value,Lost
42063,428,4,"249,05",4,1,1,6,Mid-Value,Potential Loyalists
42064,338,1,"19,15",5,1,1,7,Mid-Value,Potential Loyalists
42065,1103,3,"243,75",2,1,1,4,Low-Value,Can't Lose
42067,1020,3,"73,95",3,1,1,5,Low-Value,At Risk Customers
42068,1149,1,"46,05",2,1,1,4,Low-Value,Can't Lose
42069,94,3,"252,0",5,1,1,7,Mid-Value,Potential Loyalists
42070,81,5,"340,45",5,1,1,7,Mid-Value,Potential Loyalists
42071,1055,1,"87,8",3,1,1,5,Low-Value,At Risk Customers
42072,1621,1,"69,0",1,1,1,3,Low-Value,Lost
42073,495,5,"404,40000000000003",4,1,1,6,Mid-Value,Potential Loyalists
42075,5,2,"118,25",5,1,1,7,Mid-Value,Potential Loyalists
42076,591,3,"47,25",4,1,1,6,Mid-Value,Potential Loyalists
42077,112,1,"44,2",5,1,1,7,Mid-Value,Potential Loyalists
42081,1596,1,"165,6",1,1,1,3,Low-Value,Lost
42085,1053,1,"8,1",3,1,1,5,Low-Value,At Risk Customers
42086,247,1,"17,1",5,1,1,7,Mid-Value,Potential Loyalists
42087,77,3,"106,30000000000001",5,1,1,7,Mid-Value,Potential Loyalists
42090,118,9,"1667,8",5,2,3,10,High-Value,Champions
42091,1263,1,"418,9",2,1,1,4,Low-Value,Can't Lose
42092,802,5,"271,75",3,1,1,5,Low-Value,At Risk Customers
42093,216,2,"60,95",5,1,1,7,Mid-Value,Potential Loyalists
42095,1489,2,"64,9",1,1,1,3,Low-Value,Lost
42096,1155,1,"54,95",2,1,1,4,Low-Value,Can't Lose
42097,7,5,"174,4",5,1,1,7,Mid-Value,Potential Loyalists
42098,32,1,"177,3",5,1,1,7,Mid-Value,Potential Loyalists
42099,1197,2,"22,349999999999998",2,1,1,4,Low-Value,Can't Lose
42100,929,2,"48,05",3,1,1,5,Low-Value,At Risk Customers
42101,535,7,"608,9000000000001",4,2,1,7,Mid-Value,Potential Loyalists
42103,799,3,"87,3",3,1,1,5,Low-Value,At Risk Customers
42104,459,5,"161,95",4,1,1,6,Mid-Value,Potential Loyalists
42106,474,2,"16,85",4,1,1,6,Mid-Value,Potential Loyalists
42107,116,4,"313,45000000000005",5,1,1,7,Mid-Value,Potential Loyalists
42108,194,3,"73,6",5,1,1,7,Mid-Value,Potential Loyalists
42109,1482,2,"75,75",1,1,1,3,Low-Value,Lost
42111,703,6,"293,65",4,1,1,6,Mid-Value,Potential Loyalists
42112,137,8,"342,35",5,2,1,8,High-Value,Potential Loyalists
42114,997,1,"15,05",3,1,1,5,Low-Value,At Risk Customers
42115,82,5,"251,1",5,1,1,7,Mid-Value,Potential Loyalists
42116,386,9,"598,0500000000001",4,2,1,7,Mid-Value,Potential Loyalists
42117,73,5,"267,29999999999995",5,1,1,7,Mid-Value,Potential Loyalists
42118,804,3,"377,40000000000003",3,1,1,5,Low-Value,At Risk Customers
42119,621,1,"16,25",4,1,1,6,Mid-Value,Potential Loyalists
42120,512,4,"292,7",4,1,1,6,Mid-Value,Potential Loyalists
42121,192,1,"48,0",5,1,1,7,Mid-Value,Potential Loyalists
42122,549,3,"195,95",4,1,1,6,Mid-Value,Potential Loyalists
42123,894,1,"31,2",3,1,1,5,Low-Value,At Risk Customers
42124,179,2,"304,3",5,1,1,7,Mid-Value,Potential Loyalists
42125,922,1,"44,849999999999994",3,1,1,5,Low-Value,At Risk Customers
42127,370,7,"526,2",4,2,1,7,Mid-Value,Potential Loyalists
42130,1049,2,"57,2",3,1,1,5,Low-Value,At Risk Customers
42131,28,3,"92,15",5,1,1,7,Mid-Value,Potential Loyalists
42132,1125,1,"72,0",2,1,1,4,Low-Value,Can't Lose
42133,259,5,"170,05",5,1,1,7,Mid-Value,Potential Loyalists
42134,759,5,"313,4",3,1,1,5,Low-Value,At Risk Customers
42135,129,1,"27,5",5,1,1,7,Mid-Value,Potential Loyalists
42136,89,7,"311,5",5,2,1,8,High-Value,Potential Loyalists
42138,123,4,"717,0000000000001",5,1,2,8,High-Value,Potential Loyalists
42140,984,5,"329,45",3,1,1,5,Low-Value,At Risk Customers
42142,1505,1,"48,45",1,1,1,3,Low-Value,Lost
42143,260,6,"353,3",5,1,1,7,Mid-Value,Potential Loyalists
42144,606,3,"100,35",4,1,1,6,Mid-Value,Potential Loyalists
42145,918,1,"83,2",3,1,1,5,Low-Value,At Risk Customers
42146,540,5,"283,84999999999997",4,1,1,6,Mid-Value,Potential Loyalists
42150,1064,1,"31,5",3,1,1,5,Low-Value,At Risk Customers
42153,142,9,"658,7",5,2,1,8,High-Value,Potential Loyalists
42155,33,3,"92,05",5,1,1,7,Mid-Value,Potential Loyalists
42156,133,9,"2116,6",5,2,4,11,High-Value,Champions
42158,208,2,"392,3",5,1,1,7,Mid-Value,Potential Loyalists
42159,44,3,"321,4",5,1,1,7,Mid-Value,Potential Loyalists
42160,208,6,"277,8",5,1,1,7,Mid-Value,Potential Loyalists
42162,1601,1,"38,8",1,1,1,3,Low-Value,Lost
42164,1032,1,"113,65",3,1,1,5,Low-Value,At Risk Customers
42166,1219,1,"70,15",2,1,1,4,Low-Value,Can't Lose
42167,412,1,"14,8",4,1,1,6,Mid-Value,Potential Loyalists
42169,36,9,"467,15",5,2,1,8,High-Value,Potential Loyalists
42170,362,5,"185,75",5,1,1,7,Mid-Value,Potential Loyalists
42172,639,1,"85,5",4,1,1,6,Mid-Value,Potential Loyalists
42173,1735,1,"7,25",1,1,1,3,Low-Value,Lost
42174,182,1,"99,2",5,1,1,7,Mid-Value,Potential Loyalists
42175,1459,1,"53,7",2,1,1,4,Low-Value,Can't Lose
42176,136,3,"177,59",5,1,1,7,Mid-Value,Potential Loyalists
42177,19,4,"105,44999999999999",5,1,1,7,Mid-Value,Potential Loyalists
42179,388,1,"22,8",4,1,1,6,Mid-Value,Potential Loyalists
42180,738,3,"210,5",3,1,1,5,Low-Value,At Risk Customers
42182,51,3,"81,15",5,1,1,7,Mid-Value,Potential Loyalists
42183,66,3,"577,65",5,1,1,7,Mid-Value,Potential Loyalists
42185,1641,1,"18,6",1,1,1,3,Low-Value,Lost
42186,200,8,"634,8",5,2,1,8,High-Value,Potential Loyalists
42189,123,7,"265,05",5,2,1,8,High-Value,Potential Loyalists
42190,683,6,"235,9",4,1,1,6,Mid-Value,Potential Loyalists
42191,67,6,"148,31",5,1,1,7,Mid-Value,Potential Loyalists
42192,269,4,"283,59999999999997",5,1,1,7,Mid-Value,Potential Loyalists
42193,1623,2,"105,80000000000001",1,1,1,3,Low-Value,Lost
42194,475,2,"115,45",4,1,1,6,Mid-Value,Potential Loyalists
42196,339,5,"96,10000000000001",5,1,1,7,Mid-Value,Potential Loyalists
42199,99,7,"408,15000000000003",5,2,1,8,High-Value,Potential Loyalists
42200,745,1,"54,7",3,1,1,5,Low-Value,At Risk Customers
42201,239,6,"238,35",5,1,1,7,Mid-Value,Potential Loyalists
42202,1094,1,"22,15",3,1,1,5,Low-Value,At Risk Customers
42204,802,4,"227,25",3,1,1,5,Low-Value,At Risk Customers
42206,368,2,"136,0",4,1,1,6,Mid-Value,Potential Loyalists
42207,283,6,"267,7",5,1,1,7,Mid-Value,Potential Loyalists
42208,1684,1,"493,1",1,1,1,3,Low-Value,Lost
42209,262,1,"86,1",5,1,1,7,Mid-Value,Potential Loyalists
42211,392,4,"575,7",4,1,1,6,Mid-Value,Potential Loyalists
42212,425,3,"244,00000000000003",4,1,1,6,Mid-Value,Potential Loyalists
42213,27,3,"173,2",5,1,1,7,Mid-Value,Potential Loyalists
42214,510,1,"191,5",4,1,1,6,Mid-Value,Potential Loyalists
42215,18,5,"505,5",5,1,1,7,Mid-Value,Potential Loyalists
42217,282,3,"115,19999999999999",5,1,1,7,Mid-Value,Potential Loyalists
42218,152,3,"65,75",5,1,1,7,Mid-Value,Potential Loyalists
42219,1135,2,"297,5",2,1,1,4,Low-Value,Can't Lose
42220,333,1,"192,7",5,1,1,7,Mid-Value,Potential Loyalists
42221,916,4,"359,75",3,1,1,5,Low-Value,At Risk Customers
42224,1315,1,"14,05",2,1,1,4,Low-Value,Can't Lose
42225,129,6,"347,70000000000005",5,1,1,7,Mid-Value,Potential Loyalists
42228,482,1,"41,0",4,1,1,6,Mid-Value,Potential Loyalists
42229,1194,1,"16,35",2,1,1,4,Low-Value,Can't Lose
42230,7,6,"344,3",5,1,1,7,Mid-Value,Potential Loyalists
42231,1338,2,"33,35",2,1,1,4,Low-Value,Can't Lose
42232,805,3,"158,5",3,1,1,5,Low-Value,At Risk Customers
42233,389,2,"78,85",4,1,1,6,Mid-Value,Potential Loyalists
42234,396,6,"373,0",4,1,1,6,Mid-Value,Potential Loyalists
42236,390,3,"49,15",4,1,1,6,Mid-Value,Potential Loyalists
42237,80,3,"125,75",5,1,1,7,Mid-Value,Potential Loyalists
42238,347,2,"102,3",5,1,1,7,Mid-Value,Potential Loyalists
42239,1184,1,"121,75",2,1,1,4,Low-Value,Can't Lose
42240,43,7,"246,45",5,2,1,8,High-Value,Potential Loyalists
42241,1632,5,"599,1999999999999",1,1,1,3,Low-Value,Lost
42242,1442,1,"61,8",2,1,1,4,Low-Value,Can't Lose
42243,1634,2,"378,7",1,1,1,3,Low-Value,Lost
42244,516,1,"22,2",4,1,1,6,Mid-Value,Potential Loyalists
42246,1386,2,"253,35000000000002",2,1,1,4,Low-Value,Can't Lose
42247,589,3,"103,4",4,1,1,6,Mid-Value,Potential Loyalists
42248,580,1,"25,4",4,1,1,6,Mid-Value,Potential Loyalists
42249,420,1,"43,85",4,1,1,6,Mid-Value,Potential Loyalists
42250,1366,1,"245,8",2,1,1,4,Low-Value,Can't Lose
42251,1067,1,"12,25",3,1,1,5,Low-Value,At Risk Customers
42254,372,2,"639,8",4,1,1,6,Mid-Value,Potential Loyalists
42255,1,1,"41,2",5,1,1,7,Mid-Value,Potential Loyalists
42259,256,2,"252,85",5,1,1,7,Mid-Value,Potential Loyalists
42262,653,2,"141,1",4,1,1,6,Mid-Value,Potential Loyalists
42263,39,4,"101,39999999999999",5,1,1,7,Mid-Value,Potential Loyalists
42266,162,4,"138,55",5,1,1,7,Mid-Value,Potential Loyalists
42269,34,3,"288,13",5,1,1,7,Mid-Value,Potential Loyalists
42273,19,13,"435,15",5,3,1,9,High-Value,Champions
42274,1212,1,"13,45",2,1,1,4,Low-Value,Can't Lose
42277,737,3,"81,55",3,1,1,5,Low-Value,At Risk Customers
42279,1019,2,"26,45",3,1,1,5,Low-Value,At Risk Customers
42280,75,4,"157,9",5,1,1,7,Mid-Value,Potential Loyalists
42282,1104,2,"69,1",2,1,1,4,Low-Value,Can't Lose
42283,189,5,"497,95",5,1,1,7,Mid-Value,Potential Loyalists
42284,1165,2,"88,45",2,1,1,4,Low-Value,Can't Lose
42285,216,1,"15,4",5,1,1,7,Mid-Value,Potential Loyalists
42286,889,3,"231,60000000000002",3,1,1,5,Low-Value,At Risk Customers
42290,283,1,"11,8",5,1,1,7,Mid-Value,Potential Loyalists
42291,763,3,"130,35000000000002",3,1,1,5,Low-Value,At Risk Customers
42293,209,4,"123,9",5,1,1,7,Mid-Value,Potential Loyalists
42294,493,3,"261,8",4,1,1,6,Mid-Value,Potential Loyalists
42295,959,1,"15,0",3,1,1,5,Low-Value,At Risk Customers
42296,789,3,"201,7",3,1,1,5,Low-Value,At Risk Customers
42297,713,1,"43,75",4,1,1,6,Mid-Value,Potential Loyalists
42298,104,5,"231,05",5,1,1,7,Mid-Value,Potential Loyalists
42299,26,3,"126,25",5,1,1,7,Mid-Value,Potential Loyalists
42301,494,3,"257,95",4,1,1,6,Mid-Value,Potential Loyalists
42302,33,3,"106,94999999999999",5,1,1,7,Mid-Value,Potential Loyalists
42303,1012,1,"9,3",3,1,1,5,Low-Value,At Risk Customers
42306,1222,1,"11,2",2,1,1,4,Low-Value,Can't Lose
42307,503,2,"57,55",4,1,1,6,Mid-Value,Potential Loyalists
42310,452,1,"32,3",4,1,1,6,Mid-Value,Potential Loyalists
42313,516,4,"425,9",4,1,1,6,Mid-Value,Potential Loyalists
42314,788,2,"47,1",3,1,1,5,Low-Value,At Risk Customers
42316,817,2,"85,0",3,1,1,5,Low-Value,At Risk Customers
42317,377,2,"165,35",4,1,1,6,Mid-Value,Potential Loyalists
42318,17,6,"386,25",5,1,1,7,Mid-Value,Potential Loyalists
42321,454,2,"91,2",4,1,1,6,Mid-Value,Potential Loyalists
42322,654,1,"18,25",4,1,1,6,Mid-Value,Potential Loyalists
42325,52,2,"46,949999999999996",5,1,1,7,Mid-Value,Potential Loyalists
42328,461,2,"20,65",4,1,1,6,Mid-Value,Potential Loyalists
42329,708,3,"188,65",4,1,1,6,Mid-Value,Potential Loyalists
42330,1440,1,"28,7",2,1,1,4,Low-Value,Can't Lose
42331,623,1,"66,65",4,1,1,6,Mid-Value,Potential Loyalists
42332,224,1,"238,3",5,1,1,7,Mid-Value,Potential Loyalists
42334,284,2,"81,60000000000001",5,1,1,7,Mid-Value,Potential Loyalists
42335,1301,2,"39,9",2,1,1,4,Low-Value,Can't Lose
42338,717,3,"83,05",4,1,1,6,Mid-Value,Potential Loyalists
42339,129,4,"955,3499999999999",5,1,2,8,High-Value,Potential Loyalists
42341,1802,1,"3,35",1,1,1,3,Low-Value,Lost
42343,131,4,"118,25",5,1,1,7,Mid-Value,Potential Loyalists
42344,377,2,"414,5",4,1,1,6,Mid-Value,Potential Loyalists
42346,1698,1,"79,0",1,1,1,3,Low-Value,Lost
42348,815,1,"30,35",3,1,1,5,Low-Value,At Risk Customers
42349,553,3,"149,35",4,1,1,6,Mid-Value,Potential Loyalists
42350,1031,1,"182,2",3,1,1,5,Low-Value,At Risk Customers
42353,1212,4,"190,75",2,1,1,4,Low-Value,Can't Lose
42354,467,1,"270,0",4,1,1,6,Mid-Value,Potential Loyalists
42355,41,5,"123,69999999999999",5,1,1,7,Mid-Value,Potential Loyalists
42358,508,3,"90,75",4,1,1,6,Mid-Value,Potential Loyalists
42359,733,2,"208,7",3,1,1,5,Low-Value,At Risk Customers
42361,216,1,"15,35",5,1,1,7,Mid-Value,Potential Loyalists
42362,1222,2,"95,14999999999999",2,1,1,4,Low-Value,Can't Lose
42363,310,6,"218,25",5,1,1,7,Mid-Value,Potential Loyalists
42364,180,4,"386,55",5,1,1,7,Mid-Value,Potential Loyalists
42366,505,1,"250,5",4,1,1,6,Mid-Value,Potential Loyalists
42367,515,2,"347,79999999999995",4,1,1,6,Mid-Value,Potential Loyalists
42371,272,1,"244,75",5,1,1,7,Mid-Value,Potential Loyalists
42372,626,4,"359,0",4,1,1,6,Mid-Value,Potential Loyalists
42373,195,3,"329,75",5,1,1,7,Mid-Value,Potential Loyalists
42375,151,3,"192,05",5,1,1,7,Mid-Value,Potential Loyalists
42376,23,3,"171,15",5,1,1,7,Mid-Value,Potential Loyalists
42377,1256,4,"130,65",2,1,1,4,Low-Value,Can't Lose
42379,87,10,"571,5500000000001",5,2,1,8,High-Value,Potential Loyalists
42383,70,5,"390,3",5,1,1,7,Mid-Value,Potential Loyalists
42384,646,1,"82,85",4,1,1,6,Mid-Value,Potential Loyalists
42385,1056,1,"47,4",3,1,1,5,Low-Value,At Risk Customers
42386,127,5,"109,05",5,1,1,7,Mid-Value,Potential Loyalists
42387,1657,2,"121,4",1,1,1,3,Low-Value,Lost
42390,613,5,"334,29999999999995",4,1,1,6,Mid-Value,Potential Loyalists
42393,487,7,"639,45",4,2,1,7,Mid-Value,Potential Loyalists
42394,368,2,"263,7",4,1,1,6,Mid-Value,Potential Loyalists
42395,1046,1,"4,3",3,1,1,5,Low-Value,At Risk Customers
42396,288,2,"17,75",5,1,1,7,Mid-Value,Potential Loyalists
42397,720,1,"20,0",4,1,1,6,Mid-Value,Potential Loyalists
42400,458,2,"63,4",4,1,1,6,Mid-Value,Potential Loyalists
42402,918,3,"281,45000000000005",3,1,1,5,Low-Value,At Risk Customers
42403,3,7,"338,0",5,2,1,8,High-Value,Potential Loyalists
42404,222,2,"103,8",5,1,1,7,Mid-Value,Potential Loyalists
42406,53,5,"386,55",5,1,1,7,Mid-Value,Potential Loyalists
42407,883,4,"281,0",3,1,1,5,Low-Value,At Risk Customers
42408,570,2,"80,6",4,1,1,6,Mid-Value,Potential Loyalists
42409,920,1,"146,3",3,1,1,5,Low-Value,At Risk Customers
42410,458,2,"92,75",4,1,1,6,Mid-Value,Potential Loyalists
42412,1338,2,"210,3",2,1,1,4,Low-Value,Can't Lose
42413,79,3,"231,65",5,1,1,7,Mid-Value,Potential Loyalists
42414,200,2,"56,1",5,1,1,7,Mid-Value,Potential Loyalists
42416,185,2,"472,2",5,1,1,7,Mid-Value,Potential Loyalists
42417,28,5,"610,8",5,1,1,7,Mid-Value,Potential Loyalists
42421,232,3,"131,8",5,1,1,7,Mid-Value,Potential Loyalists
42424,1008,2,"24,35",3,1,1,5,Low-Value,At Risk Customers
42427,1616,1,"41,400000000000006",1,1,1,3,Low-Value,Lost
42428,414,3,"75,2",4,1,1,6,Mid-Value,Potential Loyalists
42430,1564,1,"31,2",1,1,1,3,Low-Value,Lost
42432,14,3,"204,35000000000002",5,1,1,7,Mid-Value,Potential Loyalists
42433,994,1,"91,5",3,1,1,5,Low-Value,At Risk Customers
42435,1701,1,"30,25",1,1,1,3,Low-Value,Lost
42436,57,4,"121,4",5,1,1,7,Mid-Value,Potential Loyalists
42438,181,3,"219,75",5,1,1,7,Mid-Value,Potential Loyalists
42439,218,9,"507,30000000000007",5,2,1,8,High-Value,Potential Loyalists
42440,1595,1,"255,9",1,1,1,3,Low-Value,Lost
42442,301,9,"582,9",5,2,1,8,High-Value,Potential Loyalists
42443,9,3,"278,45",5,1,1,7,Mid-Value,Potential Loyalists
42445,383,3,"106,8",4,1,1,6,Mid-Value,Potential Loyalists
42447,1629,1,"454,6",1,1,1,3,Low-Value,Lost
42449,483,7,"320,0",4,2,1,7,Mid-Value,Potential Loyalists
42452,766,2,"90,55",3,1,1,5,Low-Value,At Risk Customers
42453,30,4,"180,65",5,1,1,7,Mid-Value,Potential Loyalists
42455,1438,1,"8,5",2,1,1,4,Low-Value,Can't Lose
42456,662,2,"141,9",4,1,1,6,Mid-Value,Potential Loyalists
42457,179,2,"41,3",5,1,1,7,Mid-Value,Potential Loyalists
42458,1305,1,"16,8",2,1,1,4,Low-Value,Can't Lose
42459,1117,6,"762,2",2,1,2,5,Low-Value,At Risk Customers
42461,1211,3,"192,3",2,1,1,4,Low-Value,Can't Lose
42463,620,2,"19,55",4,1,1,6,Mid-Value,Potential Loyalists
42466,141,4,"307,9",5,1,1,7,Mid-Value,Potential Loyalists
42467,222,2,"350,1",5,1,1,7,Mid-Value,Potential Loyalists
42468,127,1,"490,95000000000005",5,1,1,7,Mid-Value,Potential Loyalists
42470,301,3,"204,85",5,1,1,7,Mid-Value,Potential Loyalists
42471,1422,1,"40,65",2,1,1,4,Low-Value,Can't Lose
42472,11,3,"245,1",5,1,1,7,Mid-Value,Potential Loyalists
42474,1316,2,"263,4",2,1,1,4,Low-Value,Can't Lose
42475,515,9,"446,8",4,2,1,7,Mid-Value,Potential Loyalists
42476,133,3,"208,1",5,1,1,7,Mid-Value,Potential Loyalists
42478,602,2,"51,400000000000006",4,1,1,6,Mid-Value,Potential Loyalists
42479,523,2,"28,150000000000002",4,1,1,6,Mid-Value,Potential Loyalists
42480,1357,3,"121,05",2,1,1,4,Low-Value,Can't Lose
42481,686,1,"72,55",4,1,1,6,Mid-Value,Potential Loyalists
42483,511,6,"229,2",4,1,1,6,Mid-Value,Potential Loyalists
42486,1533,1,"103,55",1,1,1,3,Low-Value,Lost
42487,104,4,"429,7",5,1,1,7,Mid-Value,Potential Loyalists
42490,434,8,"273,2",4,2,1,7,Mid-Value,Potential Loyalists
42491,795,1,"135,0",3,1,1,5,Low-Value,At Risk Customers
42492,598,2,"170,2",4,1,1,6,Mid-Value,Potential Loyalists
42493,618,1,"10,8",4,1,1,6,Mid-Value,Potential Loyalists
42497,1093,1,"11,4",3,1,1,5,Low-Value,At Risk Customers
42498,368,2,"114,8",4,1,1,6,Mid-Value,Potential Loyalists
42499,1586,1,"36,3",1,1,1,3,Low-Value,Lost
42503,80,2,"111,30000000000001",5,1,1,7,Mid-Value,Potential Loyalists
42505,1629,2,"176,75",1,1,1,3,Low-Value,Lost
42506,475,2,"131,4",4,1,1,6,Mid-Value,Potential Loyalists
42507,315,4,"652,1",5,1,1,7,Mid-Value,Potential Loyalists
42508,124,9,"407,2",5,2,1,8,High-Value,Potential Loyalists
42509,1602,1,"7,9",1,1,1,3,Low-Value,Lost
42510,35,1,"30,35",5,1,1,7,Mid-Value,Potential Loyalists
42514,35,8,"292,85",5,2,1,8,High-Value,Potential Loyalists
42516,812,2,"28,8",3,1,1,5,Low-Value,At Risk Customers
42517,327,4,"77,95",5,1,1,7,Mid-Value,Potential Loyalists
42518,1140,2,"132,95000000000002",2,1,1,4,Low-Value,Can't Lose
42519,1133,1,"11,95",2,1,1,4,Low-Value,Can't Lose
42520,783,3,"295,90000000000003",3,1,1,5,Low-Value,At Risk Customers
42521,390,4,"371,2",4,1,1,6,Mid-Value,Potential Loyalists
42522,651,2,"36,3",4,1,1,6,Mid-Value,Potential Loyalists
42523,1646,1,"68,0",1,1,1,3,Low-Value,Lost
42524,167,4,"388,75",5,1,1,7,Mid-Value,Potential Loyalists
42525,813,3,"254,89999999999998",3,1,1,5,Low-Value,At Risk Customers
42526,197,2,"68,2",5,1,1,7,Mid-Value,Potential Loyalists
42528,686,2,"373,95",4,1,1,6,Mid-Value,Potential Loyalists
42530,1147,1,"20,5",2,1,1,4,Low-Value,Can't Lose
42532,3,3,"609,1",5,1,1,7,Mid-Value,Potential Loyalists
42534,62,3,"63,45",5,1,1,7,Mid-Value,Potential Loyalists
42539,1239,2,"66,0",2,1,1,4,Low-Value,Can't Lose
42541,18,9,"1198,35",5,2,2,9,High-Value,Champions
42543,1270,2,"206,5",2,1,1,4,Low-Value,Can't Lose
42545,817,1,"12,2",3,1,1,5,Low-Value,At Risk Customers
42546,1764,1,"40,0",1,1,1,3,Low-Value,Lost
42547,294,11,"519,7",5,2,1,8,High-Value,Potential Loyalists
42548,944,2,"78,94999999999999",3,1,1,5,Low-Value,At Risk Customers
42549,152,2,"289,75",5,1,1,7,Mid-Value,Potential Loyalists
42550,50,2,"37,0",5,1,1,7,Mid-Value,Potential Loyalists
42554,558,3,"189,2",4,1,1,6,Mid-Value,Potential Loyalists
42555,379,3,"111,1",4,1,1,6,Mid-Value,Potential Loyalists
42557,623,1,"28,25",4,1,1,6,Mid-Value,Potential Loyalists
42558,1303,1,"18,4",2,1,1,4,Low-Value,Can't Lose
42559,522,9,"463,7",4,2,1,7,Mid-Value,Potential Loyalists
42561,48,4,"289,70000000000005",5,1,1,7,Mid-Value,Potential Loyalists
42562,906,3,"126,0",3,1,1,5,Low-Value,At Risk Customers
42563,742,2,"96,94999999999999",3,1,1,5,Low-Value,At Risk Customers
42564,122,6,"445,6",5,1,1,7,Mid-Value,Potential Loyalists
42565,808,3,"224,20000000000002",3,1,1,5,Low-Value,At Risk Customers
42567,725,2,"17,85",4,1,1,6,Mid-Value,Potential Loyalists
42568,1492,1,"105,3",1,1,1,3,Low-Value,Lost
42569,1125,1,"59,4",2,1,1,4,Low-Value,Can't Lose
42572,525,3,"461,9",4,1,1,6,Mid-Value,Potential Loyalists
42574,904,2,"94,45",3,1,1,5,Low-Value,At Risk Customers
42578,310,3,"273,05",5,1,1,7,Mid-Value,Potential Loyalists
42581,1,3,"378,15",5,1,1,7,Mid-Value,Potential Loyalists
42583,53,2,"117,05000000000001",5,1,1,7,Mid-Value,Potential Loyalists
42585,265,7,"342,5",5,2,1,8,High-Value,Potential Loyalists
42586,272,7,"593,6999999999999",5,2,1,8,High-Value,Potential Loyalists
42587,47,2,"54,85",5,1,1,7,Mid-Value,Potential Loyalists
42588,169,2,"74,85",5,1,1,7,Mid-Value,Potential Loyalists
42590,495,3,"144,8",4,1,1,6,Mid-Value,Potential Loyalists
42592,533,1,"63,150000000000006",4,1,1,6,Mid-Value,Potential Loyalists
42594,331,4,"281,8",5,1,1,7,Mid-Value,Potential Loyalists
42595,160,5,"173,45",5,1,1,7,Mid-Value,Potential Loyalists
42596,446,4,"120,0",4,1,1,6,Mid-Value,Potential Loyalists
42599,360,5,"222,05",5,1,1,7,Mid-Value,Potential Loyalists
42600,1474,3,"81,7",1,1,1,3,Low-Value,Lost
42601,1081,1,"63,2",3,1,1,5,Low-Value,At Risk Customers
42603,153,5,"156,7",5,1,1,7,Mid-Value,Potential Loyalists
42605,138,5,"569,7",5,1,1,7,Mid-Value,Potential Loyalists
42607,1124,1,"42,2",2,1,1,4,Low-Value,Can't Lose
42608,277,4,"215,15",5,1,1,7,Mid-Value,Potential Loyalists
42610,853,2,"224,0",3,1,1,5,Low-Value,At Risk Customers
42612,28,3,"209,1",5,1,1,7,Mid-Value,Potential Loyalists
42614,1358,1,"125,65",2,1,1,4,Low-Value,Can't Lose
42615,1435,2,"19,65",2,1,1,4,Low-Value,Can't Lose
42616,265,2,"31,25",5,1,1,7,Mid-Value,Potential Loyalists
42617,1104,3,"172,95",2,1,1,4,Low-Value,Can't Lose
42619,1075,1,"9,15",3,1,1,5,Low-Value,At Risk Customers
42620,451,6,"230,15",4,1,1,6,Mid-Value,Potential Loyalists
42623,89,3,"59,6",5,1,1,7,Mid-Value,Potential Loyalists
42625,1317,1,"20,25",2,1,1,4,Low-Value,Can't Lose
42628,27,4,"87,25",5,1,1,7,Mid-Value,Potential Loyalists
42632,1043,1,"83,8",3,1,1,5,Low-Value,At Risk Customers
42633,1650,1,"84,4",1,1,1,3,Low-Value,Lost
42635,1278,2,"172,65",2,1,1,4,Low-Value,Can't Lose
42637,144,1,"158,0",5,1,1,7,Mid-Value,Potential Loyalists
42638,223,2,"27,060000000000002",5,1,1,7,Mid-Value,Potential Loyalists
42644,986,1,"37,85",3,1,1,5,Low-Value,At Risk Customers
42646,211,7,"375,15000000000003",5,2,1,8,High-Value,Potential Loyalists
42648,745,3,"29,0",3,1,1,5,Low-Value,At Risk Customers
42652,896,1,"73,9",3,1,1,5,Low-Value,At Risk Customers
42654,3,1,"16,2",5,1,1,7,Mid-Value,Potential Loyalists
42655,19,2,"689,55",5,1,2,8,High-Value,Potential Loyalists
42656,61,4,"628,7",5,1,1,7,Mid-Value,Potential Loyalists
42657,396,6,"344,2",4,1,1,6,Mid-Value,Potential Loyalists
42658,631,1,"24,2",4,1,1,6,Mid-Value,Potential Loyalists
42659,1550,1,"116,0",1,1,1,3,Low-Value,Lost
42660,1122,3,"62,63000000000001",2,1,1,4,Low-Value,Can't Lose
42661,117,9,"429,9",5,2,1,8,High-Value,Potential Loyalists
42663,150,13,"1032,7",5,3,2,10,High-Value,Champions
42664,368,4,"393,8",4,1,1,6,Mid-Value,Potential Loyalists
42666,780,2,"526,4",3,1,1,5,Low-Value,At Risk Customers
42667,658,2,"35,4",4,1,1,6,Mid-Value,Potential Loyalists
42668,1520,3,"238,9",1,1,1,3,Low-Value,Lost
42669,760,17,"1365,7",3,4,3,10,High-Value,Champions
42671,216,3,"124,1",5,1,1,7,Mid-Value,Potential Loyalists
42672,868,1,"222,0",3,1,1,5,Low-Value,At Risk Customers
42673,585,1,"148,2",4,1,1,6,Mid-Value,Potential Loyalists
42674,223,4,"138,6",5,1,1,7,Mid-Value,Potential Loyalists
42676,572,2,"52,400000000000006",4,1,1,6,Mid-Value,Potential Loyalists
42677,363,5,"328,29999999999995",5,1,1,7,Mid-Value,Potential Loyalists
42678,363,3,"339,7",5,1,1,7,Mid-Value,Potential Loyalists
42679,1527,3,"233,45",1,1,1,3,Low-Value,Lost
42681,623,1,"36,65",4,1,1,6,Mid-Value,Potential Loyalists
42682,433,5,"146,75",4,1,1,6,Mid-Value,Potential Loyalists
42683,656,1,"19,7",4,1,1,6,Mid-Value,Potential Loyalists
42684,1677,1,"82,85",1,1,1,3,Low-Value,Lost
42685,1512,1,"18,75",1,1,1,3,Low-Value,Lost
42687,1457,1,"42,45",2,1,1,4,Low-Value,Can't Lose
42688,1194,2,"141,1",2,1,1,4,Low-Value,Can't Lose
42689,1006,1,"149,9",3,1,1,5,Low-Value,At Risk Customers
42692,1783,1,"729,9000000000001",1,1,2,4,Low-Value,Can't Lose
42694,7,1,"33,6",5,1,1,7,Mid-Value,Potential Loyalists
42696,770,1,"6,55",3,1,1,5,Low-Value,At Risk Customers
42697,379,3,"94,5",4,1,1,6,Mid-Value,Potential Loyalists
42698,1207,2,"116,55",2,1,1,4,Low-Value,Can't Lose
42699,705,1,"50,9",4,1,1,6,Mid-Value,Potential Loyalists
42700,588,5,"298,7",4,1,1,6,Mid-Value,Potential Loyalists
42702,732,1,"150,5",3,1,1,5,Low-Value,At Risk Customers
42703,1096,3,"153,4",2,1,1,4,Low-Value,Can't Lose
42704,1325,1,"6,6000000000000005",2,1,1,4,Low-Value,Can't Lose
42705,749,4,"122,1",3,1,1,5,Low-Value,At Risk Customers
42706,859,1,"77,7",3,1,1,5,Low-Value,At Risk Customers
42708,1346,2,"46,85",2,1,1,4,Low-Value,Can't Lose
42709,122,1,"81,0",5,1,1,7,Mid-Value,Potential Loyalists
42710,1239,3,"129,4",2,1,1,4,Low-Value,Can't Lose
42714,127,2,"93,15",5,1,1,7,Mid-Value,Potential Loyalists
42715,171,4,"855,5",5,1,2,8,High-Value,Potential Loyalists
42717,194,13,"684,3",5,3,2,10,High-Value,Champions
42718,34,2,"39,85",5,1,1,7,Mid-Value,Potential Loyalists
42720,986,1,"42,15",3,1,1,5,Low-Value,At Risk Customers
42721,1453,1,"6,35",2,1,1,4,Low-Value,Can't Lose
42723,287,7,"234,45",5,2,1,8,High-Value,Potential Loyalists
42724,411,21,"1306,45",4,4,2,10,High-Value,Champions
42726,21,6,"453,8",5,1,1,7,Mid-Value,Potential Loyalists
42728,410,5,"745,4",4,1,2,7,Mid-Value,Potential Loyalists
42729,392,6,"352,1",4,1,1,6,Mid-Value,Potential Loyalists
42730,33,11,"690,55",5,2,2,9,High-Value,Champions
42733,790,1,"38,3",3,1,1,5,Low-Value,At Risk Customers
42734,398,1,"5,95",4,1,1,6,Mid-Value,Potential Loyalists
42735,38,1,"125,65",5,1,1,7,Mid-Value,Potential Loyalists
42737,397,3,"121,9",4,1,1,6,Mid-Value,Potential Loyalists
42741,1179,3,"188,75",2,1,1,4,Low-Value,Can't Lose
42742,573,4,"401,7",4,1,1,6,Mid-Value,Potential Loyalists
42743,991,1,"19,55",3,1,1,5,Low-Value,At Risk Customers
42744,1049,1,"20,45",3,1,1,5,Low-Value,At Risk Customers
42745,1208,1,"17,4",2,1,1,4,Low-Value,Can't Lose
42746,175,1,"52,650000000000006",5,1,1,7,Mid-Value,Potential Loyalists
42747,575,2,"118,19999999999999",4,1,1,6,Mid-Value,Potential Loyalists
42748,340,1,"78,0",5,1,1,7,Mid-Value,Potential Loyalists
42751,154,4,"71,65",5,1,1,7,Mid-Value,Potential Loyalists
42752,187,3,"137,7",5,1,1,7,Mid-Value,Potential Loyalists
42753,171,2,"170,1",5,1,1,7,Mid-Value,Potential Loyalists
42754,659,7,"776,4",4,2,2,8,High-Value,Potential Loyalists
42755,140,7,"503,65000000000003",5,2,1,8,High-Value,Potential Loyalists
42757,203,2,"235,0",5,1,1,7,Mid-Value,Potential Loyalists
42758,194,2,"167,8",5,1,1,7,Mid-Value,Potential Loyalists
42761,381,2,"39,150000000000006",4,1,1,6,Mid-Value,Potential Loyalists
42762,365,1,"82,5",5,1,1,7,Mid-Value,Potential Loyalists
42763,864,5,"142,8",3,1,1,5,Low-Value,At Risk Customers
42764,256,2,"109,85000000000001",5,1,1,7,Mid-Value,Potential Loyalists
42767,1310,1,"12,75",2,1,1,4,Low-Value,Can't Lose
42768,50,4,"341,65",5,1,1,7,Mid-Value,Potential Loyalists
42769,211,5,"98,75",5,1,1,7,Mid-Value,Potential Loyalists
42773,1815,1,"28,5",1,1,1,3,Low-Value,Lost
42776,157,2,"56,95",5,1,1,7,Mid-Value,Potential Loyalists
42779,879,4,"149,0",3,1,1,5,Low-Value,At Risk Customers
42780,13,2,"150,95",5,1,1,7,Mid-Value,Potential Loyalists
42781,157,2,"23,85",5,1,1,7,Mid-Value,Potential Loyalists
42782,352,1,"253,2",5,1,1,7,Mid-Value,Potential Loyalists
42784,1172,2,"33,550000000000004",2,1,1,4,Low-Value,Can't Lose
42785,295,6,"204,1",5,1,1,7,Mid-Value,Potential Loyalists
42788,1425,1,"39,2",2,1,1,4,Low-Value,Can't Lose
42789,1805,1,"2,75",1,1,1,3,Low-Value,Lost
42790,757,2,"469,1",3,1,1,5,Low-Value,At Risk Customers
42791,26,4,"356,55",5,1,1,7,Mid-Value,Potential Loyalists
42793,558,2,"181,6",4,1,1,6,Mid-Value,Potential Loyalists
42796,399,2,"77,6",4,1,1,6,Mid-Value,Potential Loyalists
42797,102,6,"187,6",5,1,1,7,Mid-Value,Potential Loyalists
42800,104,2,"310,4",5,1,1,7,Mid-Value,Potential Loyalists
42801,1295,1,"22,3",2,1,1,4,Low-Value,Can't Lose
42802,25,3,"396,15",5,1,1,7,Mid-Value,Potential Loyalists
42803,165,1,"123,0",5,1,1,7,Mid-Value,Potential Loyalists
42804,21,2,"200,0",5,1,1,7,Mid-Value,Potential Loyalists
42806,132,6,"478,25",5,1,1,7,Mid-Value,Potential Loyalists
42807,1027,1,"2,75",3,1,1,5,Low-Value,At Risk Customers
42808,7,4,"268,0",5,1,1,7,Mid-Value,Potential Loyalists
42812,1,4,"183,45",5,1,1,7,Mid-Value,Potential Loyalists
42814,162,2,"73,3",5,1,1,7,Mid-Value,Potential Loyalists
42815,139,5,"642,5",5,1,1,7,Mid-Value,Potential Loyalists
42816,567,8,"378,95",4,2,1,7,Mid-Value,Potential Loyalists
42818,670,1,"102,3",4,1,1,6,Mid-Value,Potential Loyalists
42819,154,5,"279,9",5,1,1,7,Mid-Value,Potential Loyalists
42820,1001,2,"38,4",3,1,1,5,Low-Value,At Risk Customers
42821,423,2,"83,95",4,1,1,6,Mid-Value,Potential Loyalists
42822,25,3,"132,35000000000002",5,1,1,7,Mid-Value,Potential Loyalists
42823,267,3,"68,7",5,1,1,7,Mid-Value,Potential Loyalists
42824,1708,1,"139,5",1,1,1,3,Low-Value,Lost
42826,105,1,"41,75",5,1,1,7,Mid-Value,Potential Loyalists
42827,1583,1,"17,1",1,1,1,3,Low-Value,Lost
42828,1,5,"350,6",5,1,1,7,Mid-Value,Potential Loyalists
42829,471,2,"184,7",4,1,1,6,Mid-Value,Potential Loyalists
42830,797,6,"215,6",3,1,1,5,Low-Value,At Risk Customers
42831,11,7,"323,1",5,2,1,8,High-Value,Potential Loyalists
42832,3,7,"493,55",5,2,1,8,High-Value,Potential Loyalists
42833,34,1,"23,0",5,1,1,7,Mid-Value,Potential Loyalists
42837,1012,2,"229,5",3,1,1,5,Low-Value,At Risk Customers
42838,1184,3,"231,7",2,1,1,4,Low-Value,Can't Lose
42839,1525,1,"58,9",1,1,1,3,Low-Value,Lost
42840,19,7,"365,45",5,2,1,8,High-Value,Potential Loyalists
42841,1694,1,"12,45",1,1,1,3,Low-Value,Lost
42842,1627,1,"141,2",1,1,1,3,Low-Value,Lost
42843,1679,2,"95,15",1,1,1,3,Low-Value,Lost
42844,7,3,"318,1",5,1,1,7,Mid-Value,Potential Loyalists
42845,1071,2,"313,0",3,1,1,5,Low-Value,At Risk Customers
42848,483,3,"600,2",4,1,1,6,Mid-Value,Potential Loyalists
42851,279,4,"112,85",5,1,1,7,Mid-Value,Potential Loyalists
42852,8,9,"712,6500000000001",5,2,2,9,High-Value,Champions
42854,921,3,"173,6",3,1,1,5,Low-Value,At Risk Customers
42855,681,3,"164,7",4,1,1,6,Mid-Value,Potential Loyalists
42858,307,1,"5,65",5,1,1,7,Mid-Value,Potential Loyalists
42859,694,4,"190,2",4,1,1,6,Mid-Value,Potential Loyalists
42860,104,5,"221,20000000000002",5,1,1,7,Mid-Value,Potential Loyalists
42861,207,1,"255,9",5,1,1,7,Mid-Value,Potential Loyalists
42862,449,3,"268,3",4,1,1,6,Mid-Value,Potential Loyalists
42863,410,5,"526,4",4,1,1,6,Mid-Value,Potential Loyalists
42864,347,2,"367,9",5,1,1,7,Mid-Value,Potential Loyalists
42865,316,8,"320,65",5,2,1,8,High-Value,Potential Loyalists
42867,868,1,"5,5",3,1,1,5,Low-Value,At Risk Customers
42868,395,8,"482,90000000000003",4,2,1,7,Mid-Value,Potential Loyalists
42869,8,3,"92,5",5,1,1,7,Mid-Value,Potential Loyalists
42871,1291,2,"136,0",2,1,1,4,Low-Value,Can't Lose
42874,1056,1,"135,6",3,1,1,5,Low-Value,At Risk Customers
42875,185,7,"294,65000000000003",5,2,1,8,High-Value,Potential Loyalists
42877,951,5,"277,4",3,1,1,5,Low-Value,At Risk Customers
42878,63,7,"305,0",5,2,1,8,High-Value,Potential Loyalists
42879,122,5,"254,10000000000002",5,1,1,7,Mid-Value,Potential Loyalists
42882,220,1,"66,7",5,1,1,7,Mid-Value,Potential Loyalists
42883,77,5,"527,6",5,1,1,7,Mid-Value,Potential Loyalists
42884,357,1,"18,45",5,1,1,7,Mid-Value,Potential Loyalists
42885,716,1,"9,5",4,1,1,6,Mid-Value,Potential Loyalists
42886,1142,1,"29,25",2,1,1,4,Low-Value,Can't Lose
42887,1714,1,"19,2",1,1,1,3,Low-Value,Lost
42888,1153,1,"45,5",2,1,1,4,Low-Value,Can't Lose
42890,549,5,"161,65",4,1,1,6,Mid-Value,Potential Loyalists
42891,45,4,"146,2",5,1,1,7,Mid-Value,Potential Loyalists
42893,187,2,"101,05000000000001",5,1,1,7,Mid-Value,Potential Loyalists
42894,342,5,"343,05",5,1,1,7,Mid-Value,Potential Loyalists
42895,155,3,"253,85",5,1,1,7,Mid-Value,Potential Loyalists
42897,78,5,"156,7",5,1,1,7,Mid-Value,Potential Loyalists
42898,53,3,"32,85",5,1,1,7,Mid-Value,Potential Loyalists
42900,12,2,"156,2",5,1,1,7,Mid-Value,Potential Loyalists
42901,891,5,"291,95000000000005",3,1,1,5,Low-Value,At Risk Customers
42905,66,2,"118,0",5,1,1,7,Mid-Value,Potential Loyalists
42906,280,2,"156,86",5,1,1,7,Mid-Value,Potential Loyalists
42907,630,2,"25,25",4,1,1,6,Mid-Value,Potential Loyalists
42908,1425,1,"25,45",2,1,1,4,Low-Value,Can't Lose
42909,816,3,"135,25",3,1,1,5,Low-Value,At Risk Customers
42910,469,1,"15,5",4,1,1,6,Mid-Value,Potential Loyalists
42911,142,4,"211,45",5,1,1,7,Mid-Value,Potential Loyalists
42912,1263,6,"203,2",2,1,1,4,Low-Value,Can't Lose
42913,270,8,"564,8",5,2,1,8,High-Value,Potential Loyalists
42916,1141,3,"54,0",2,1,1,4,Low-Value,Can't Lose
42918,94,10,"694,9",5,2,2,9,High-Value,Champions
42920,962,5,"368,40000000000003",3,1,1,5,Low-Value,At Risk Customers
42923,1735,1,"57,05",1,1,1,3,Low-Value,Lost
42925,187,5,"368,6",5,1,1,7,Mid-Value,Potential Loyalists
42927,876,1,"45,6",3,1,1,5,Low-Value,At Risk Customers
42929,91,1,"13,25",5,1,1,7,Mid-Value,Potential Loyalists
42930,153,9,"458,45000000000005",5,2,1,8,High-Value,Potential Loyalists
42931,164,6,"355,6",5,1,1,7,Mid-Value,Potential Loyalists
42932,1105,1,"99,8",2,1,1,4,Low-Value,Can't Lose
42933,1274,1,"6,6000000000000005",2,1,1,4,Low-Value,Can't Lose
42937,773,4,"803,0999999999999",3,1,2,6,Mid-Value,Potential Loyalists
42938,201,6,"274,35",5,1,1,7,Mid-Value,Potential Loyalists
42939,127,6,"392,85",5,1,1,7,Mid-Value,Potential Loyalists
42940,340,6,"687,75",5,1,2,8,High-Value,Potential Loyalists
42941,412,1,"10,45",4,1,1,6,Mid-Value,Potential Loyalists
42942,754,2,"78,85",3,1,1,5,Low-Value,At Risk Customers
42943,970,4,"693,0500000000001",3,1,2,6,Mid-Value,Potential Loyalists
42944,624,3,"168,8",4,1,1,6,Mid-Value,Potential Loyalists
42947,1080,1,"122,0",3,1,1,5,Low-Value,At Risk Customers
42948,428,2,"55,2",4,1,1,6,Mid-Value,Potential Loyalists
42950,474,3,"90,15",4,1,1,6,Mid-Value,Potential Loyalists
42952,35,7,"390,95",5,2,1,8,High-Value,Potential Loyalists
42953,29,4,"296,15",5,1,1,7,Mid-Value,Potential Loyalists
42954,434,2,"171,35",4,1,1,6,Mid-Value,Potential Loyalists
42955,734,9,"1194,95",3,2,2,7,Mid-Value,Potential Loyalists
42956,269,4,"76,25",5,1,1,7,Mid-Value,Potential Loyalists
42958,551,1,"29,6",4,1,1,6,Mid-Value,Potential Loyalists
42959,1211,1,"24,5",2,1,1,4,Low-Value,Can't Lose
42963,1601,1,"76,05000000000001",1,1,1,3,Low-Value,Lost
42964,762,4,"84,35",3,1,1,5,Low-Value,At Risk Customers
42967,1533,3,"92,8",1,1,1,3,Low-Value,Lost
42969,789,1,"169,7",3,1,1,5,Low-Value,At Risk Customers
42970,1421,1,"55,25",2,1,1,4,Low-Value,Can't Lose
42971,1187,2,"60,45",2,1,1,4,Low-Value,Can't Lose
42973,798,3,"59,550000000000004",3,1,1,5,Low-Value,At Risk Customers
42974,14,6,"478,1",5,1,1,7,Mid-Value,Potential Loyalists
42975,323,3,"120,80000000000001",5,1,1,7,Mid-Value,Potential Loyalists
42976,575,2,"71,0",4,1,1,6,Mid-Value,Potential Loyalists
42977,699,3,"116,65",4,1,1,6,Mid-Value,Potential Loyalists
42978,802,2,"101,30000000000001",3,1,1,5,Low-Value,At Risk Customers
42981,398,8,"876,05",4,2,2,8,High-Value,Potential Loyalists
42982,753,1,"164,39999999999998",3,1,1,5,Low-Value,At Risk Customers
42984,195,4,"110,80000000000001",5,1,1,7,Mid-Value,Potential Loyalists
42985,49,5,"77,8",5,1,1,7,Mid-Value,Potential Loyalists
42986,300,3,"143,85000000000002",5,1,1,7,Mid-Value,Potential Loyalists
42987,488,3,"262,65",4,1,1,6,Mid-Value,Potential Loyalists
42988,864,2,"90,64999999999999",3,1,1,5,Low-Value,At Risk Customers
42992,1664,1,"95,4",1,1,1,3,Low-Value,Lost
42993,1432,1,"67,45",2,1,1,4,Low-Value,Can't Lose
42994,123,5,"526,2",5,1,1,7,Mid-Value,Potential Loyalists
42996,144,11,"380,55",5,2,1,8,High-Value,Potential Loyalists
42999,12,3,"39,5",5,1,1,7,Mid-Value,Potential Loyalists
43000,1259,1,"109,5",2,1,1,4,Low-Value,Can't Lose
43001,797,5,"231,0",3,1,1,5,Low-Value,At Risk Customers
43004,1348,2,"124,94999999999999",2,1,1,4,Low-Value,Can't Lose
43005,20,2,"170,35",5,1,1,7,Mid-Value,Potential Loyalists
43006,622,2,"90,0",4,1,1,6,Mid-Value,Potential Loyalists
43008,1227,3,"61,8",2,1,1,4,Low-Value,Can't Lose
43009,1100,1,"23,2",2,1,1,4,Low-Value,Can't Lose
43010,125,3,"291,75",5,1,1,7,Mid-Value,Potential Loyalists
43011,228,11,"577,05",5,2,1,8,High-Value,Potential Loyalists
43012,3,15,"1498,6",5,3,3,11,High-Value,Champions
43013,1427,1,"33,2",2,1,1,4,Low-Value,Can't Lose
43014,1116,1,"469,1",2,1,1,4,Low-Value,Can't Lose
43015,1099,2,"135,25",2,1,1,4,Low-Value,Can't Lose
43016,1138,3,"193,79999999999998",2,1,1,4,Low-Value,Can't Lose
43018,23,3,"351,55",5,1,1,7,Mid-Value,Potential Loyalists
43019,389,4,"373,2",4,1,1,6,Mid-Value,Potential Loyalists
43021,955,2,"101,1",3,1,1,5,Low-Value,At Risk Customers
43023,80,2,"197,4",5,1,1,7,Mid-Value,Potential Loyalists
43024,173,2,"89,65",5,1,1,7,Mid-Value,Potential Loyalists
43026,927,3,"282,75",3,1,1,5,Low-Value,At Risk Customers
43027,173,4,"367,2",5,1,1,7,Mid-Value,Potential Loyalists
43028,49,12,"796,85",5,3,2,10,High-Value,Champions
43029,30,8,"748,75",5,2,2,9,High-Value,Champions
43031,742,11,"612,3499999999999",3,2,1,6,Mid-Value,Potential Loyalists
43032,602,2,"66,55",4,1,1,6,Mid-Value,Potential Loyalists
43033,808,7,"573,6",3,2,1,6,Mid-Value,Potential Loyalists
43035,118,2,"147,29999999999998",5,1,1,7,Mid-Value,Potential Loyalists
43036,812,4,"156,55",3,1,1,5,Low-Value,At Risk Customers
43037,49,2,"68,0",5,1,1,7,Mid-Value,Potential Loyalists
43038,1051,3,"217,65",3,1,1,5,Low-Value,At Risk Customers
43040,793,1,"50,9",3,1,1,5,Low-Value,At Risk Customers
43041,148,3,"321,4",5,1,1,7,Mid-Value,Potential Loyalists
43042,581,1,"20,9",4,1,1,6,Mid-Value,Potential Loyalists
43046,318,3,"77,95",5,1,1,7,Mid-Value,Potential Loyalists
43048,1040,4,"210,75",3,1,1,5,Low-Value,At Risk Customers
43049,122,2,"878,6",5,1,2,8,High-Value,Potential Loyalists
43052,145,6,"326,6",5,1,1,7,Mid-Value,Potential Loyalists
43053,116,8,"220,1",5,2,1,8,High-Value,Potential Loyalists
43054,1696,1,"80,0",1,1,1,3,Low-Value,Lost
43055,1137,1,"59,2",2,1,1,4,Low-Value,Can't Lose
43056,11,1,"39,2",5,1,1,7,Mid-Value,Potential Loyalists
43057,167,2,"52,6",5,1,1,7,Mid-Value,Potential Loyalists
43058,930,1,"50,9",3,1,1,5,Low-Value,At Risk Customers
43060,1068,1,"50,55",3,1,1,5,Low-Value,At Risk Customers
43061,774,2,"26,65",3,1,1,5,Low-Value,At Risk Customers
43064,116,5,"406,5",5,1,1,7,Mid-Value,Potential Loyalists
43065,1472,3,"185,05",1,1,1,3,Low-Value,Lost
43066,136,2,"595,1",5,1,1,7,Mid-Value,Potential Loyalists
43067,488,3,"154,3",4,1,1,6,Mid-Value,Potential Loyalists
43069,225,2,"132,0",5,1,1,7,Mid-Value,Potential Loyalists
43070,1279,1,"5,6",2,1,1,4,Low-Value,Can't Lose
43071,30,7,"274,05",5,2,1,8,High-Value,Potential Loyalists
43072,1641,2,"78,0",1,1,1,3,Low-Value,Lost
43074,190,1,"23,4",5,1,1,7,Mid-Value,Potential Loyalists
43075,13,3,"113,85",5,1,1,7,Mid-Value,Potential Loyalists
43076,334,6,"647,8",5,1,1,7,Mid-Value,Potential Loyalists
43077,404,3,"214,45000000000002",4,1,1,6,Mid-Value,Potential Loyalists
43079,153,3,"116,15",5,1,1,7,Mid-Value,Potential Loyalists
43080,464,3,"390,95000000000005",4,1,1,6,Mid-Value,Potential Loyalists
43081,10,3,"101,65",5,1,1,7,Mid-Value,Potential Loyalists
43083,724,3,"235,15",4,1,1,6,Mid-Value,Potential Loyalists
43084,18,5,"189,75",5,1,1,7,Mid-Value,Potential Loyalists
43085,162,1,"157,0",5,1,1,7,Mid-Value,Potential Loyalists
43086,154,6,"178,9",5,1,1,7,Mid-Value,Potential Loyalists
43088,6,3,"655,3",5,1,1,7,Mid-Value,Potential Loyalists
43089,750,2,"100,45",3,1,1,5,Low-Value,At Risk Customers
43091,528,6,"733,5",4,1,2,7,Mid-Value,Potential Loyalists
43092,1242,1,"11,9",2,1,1,4,Low-Value,Can't Lose
43093,683,1,"36,3",4,1,1,6,Mid-Value,Potential Loyalists
43094,611,2,"13,25",4,1,1,6,Mid-Value,Potential Loyalists
43095,1414,1,"14,05",2,1,1,4,Low-Value,Can't Lose
43096,281,1,"55,85",5,1,1,7,Mid-Value,Potential Loyalists
43097,1475,1,"42,3",1,1,1,3,Low-Value,Lost
43098,905,2,"106,15",3,1,1,5,Low-Value,At Risk Customers
43100,479,3,"180,15",4,1,1,6,Mid-Value,Potential Loyalists
43101,892,1,"35,4",3,1,1,5,Low-Value,At Risk Customers
43102,192,4,"145,0",5,1,1,7,Mid-Value,Potential Loyalists
43103,685,2,"40,65",4,1,1,6,Mid-Value,Potential Loyalists
43104,1277,4,"268,85",2,1,1,4,Low-Value,Can't Lose
43105,503,1,"222,45000000000002",4,1,1,6,Mid-Value,Potential Loyalists
43106,909,2,"138,7",3,1,1,5,Low-Value,At Risk Customers
43108,378,2,"85,60000000000001",4,1,1,6,Mid-Value,Potential Loyalists
43110,984,4,"263,05",3,1,1,5,Low-Value,At Risk Customers
43111,53,7,"606,55",5,2,1,8,High-Value,Potential Loyalists
43112,126,5,"273,5",5,1,1,7,Mid-Value,Potential Loyalists
43113,1401,1,"5,65",2,1,1,4,Low-Value,Can't Lose
43115,136,3,"282,8",5,1,1,7,Mid-Value,Potential Loyalists
43117,435,3,"162,75",4,1,1,6,Mid-Value,Potential Loyalists
43118,1324,1,"160,95",2,1,1,4,Low-Value,Can't Lose
43122,1271,1,"98,8",2,1,1,4,Low-Value,Can't Lose
43124,4,3,"132,65",5,1,1,7,Mid-Value,Potential Loyalists
43126,547,3,"214,0",4,1,1,6,Mid-Value,Potential Loyalists
43129,944,1,"6,15",3,1,1,5,Low-Value,At Risk Customers
43130,160,4,"171,70000000000002",5,1,1,7,Mid-Value,Potential Loyalists
43132,612,3,"49,65",4,1,1,6,Mid-Value,Potential Loyalists
43133,239,1,"19,7",5,1,1,7,Mid-Value,Potential Loyalists
43135,396,3,"257,29999999999995",4,1,1,6,Mid-Value,Potential Loyalists
43136,821,2,"230,39999999999998",3,1,1,5,Low-Value,At Risk Customers
43139,1042,2,"103,9",3,1,1,5,Low-Value,At Risk Customers
43140,376,2,"81,15",4,1,1,6,Mid-Value,Potential Loyalists
43141,1194,3,"169,5",2,1,1,4,Low-Value,Can't Lose
43143,559,5,"160,55",4,1,1,6,Mid-Value,Potential Loyalists
43144,810,1,"86,05",3,1,1,5,Low-Value,At Risk Customers
43146,458,1,"15,6",4,1,1,6,Mid-Value,Potential Loyalists
43147,18,2,"100,64999999999999",5,1,1,7,Mid-Value,Potential Loyalists
43148,733,5,"191,35",3,1,1,5,Low-Value,At Risk Customers
43149,360,2,"98,15",5,1,1,7,Mid-Value,Potential Loyalists
43150,1240,3,"64,05",2,1,1,4,Low-Value,Can't Lose
43151,1405,1,"7,0",2,1,1,4,Low-Value,Can't Lose
43153,147,5,"449,85",5,1,1,7,Mid-Value,Potential Loyalists
43154,1278,1,"29,0",2,1,1,4,Low-Value,Can't Lose
43155,438,1,"67,65",4,1,1,6,Mid-Value,Potential Loyalists
43156,1505,2,"184,55",1,1,1,3,Low-Value,Lost
43157,497,2,"39,2",4,1,1,6,Mid-Value,Potential Loyalists
43158,1683,3,"59,0",1,1,1,3,Low-Value,Lost
43160,260,2,"44,849999999999994",5,1,1,7,Mid-Value,Potential Loyalists
43162,75,6,"384,95000000000005",5,1,1,7,Mid-Value,Potential Loyalists
43163,577,2,"333,70000000000005",4,1,1,6,Mid-Value,Potential Loyalists
43166,750,3,"107,2",3,1,1,5,Low-Value,At Risk Customers
43168,60,10,"469,4",5,2,1,8,High-Value,Potential Loyalists
43169,440,2,"63,1",4,1,1,6,Mid-Value,Potential Loyalists
43171,40,2,"69,1",5,1,1,7,Mid-Value,Potential Loyalists
43173,699,3,"48,650000000000006",4,1,1,6,Mid-Value,Potential Loyalists
43177,594,1,"17,85",4,1,1,6,Mid-Value,Potential Loyalists
43178,830,5,"416,7",3,1,1,5,Low-Value,At Risk Customers
43179,1432,1,"43,5",2,1,1,4,Low-Value,Can't Lose
43180,152,4,"171,7",5,1,1,7,Mid-Value,Potential Loyalists
43182,1205,1,"83,6",2,1,1,4,Low-Value,Can't Lose
43184,1327,1,"23,45",2,1,1,4,Low-Value,Can't Lose
43185,832,4,"464,15",3,1,1,5,Low-Value,At Risk Customers
43186,1197,3,"147,85",2,1,1,4,Low-Value,Can't Lose
43187,0,4,"304,45",5,1,1,7,Mid-Value,Potential Loyalists
43188,903,4,"79,0",3,1,1,5,Low-Value,At Risk Customers
43189,917,1,"40,0",3,1,1,5,Low-Value,At Risk Customers
43190,375,1,"33,599999999999994",4,1,1,6,Mid-Value,Potential Loyalists
43194,550,4,"550,85",4,1,1,6,Mid-Value,Potential Loyalists
43196,472,7,"953,55",4,2,2,8,High-Value,Potential Loyalists
43197,238,7,"436,84999999999997",5,2,1,8,High-Value,Potential Loyalists
43198,256,1,"44,25",5,1,1,7,Mid-Value,Potential Loyalists
43199,363,2,"92,19999999999999",5,1,1,7,Mid-Value,Potential Loyalists
43200,890,2,"280,79999999999995",3,1,1,5,Low-Value,At Risk Customers
43201,168,10,"1623,0",5,2,3,10,High-Value,Champions
43202,195,1,"78,4",5,1,1,7,Mid-Value,Potential Loyalists
43203,334,2,"123,75",5,1,1,7,Mid-Value,Potential Loyalists
43204,177,1,"35,0",5,1,1,7,Mid-Value,Potential Loyalists
43205,404,2,"57,15",4,1,1,6,Mid-Value,Potential Loyalists
43206,1197,2,"58,95",2,1,1,4,Low-Value,Can't Lose
43208,59,10,"342,45",5,2,1,8,High-Value,Potential Loyalists
43209,897,1,"62,9",3,1,1,5,Low-Value,At Risk Customers
43212,153,4,"137,0",5,1,1,7,Mid-Value,Potential Loyalists
43213,293,2,"67,75",5,1,1,7,Mid-Value,Potential Loyalists
43214,1189,1,"24,0",2,1,1,4,Low-Value,Can't Lose
43217,159,3,"279,09999999999997",5,1,1,7,Mid-Value,Potential Loyalists
43218,1686,1,"3,9",1,1,1,3,Low-Value,Lost
43220,300,4,"389,34999999999997",5,1,1,7,Mid-Value,Potential Loyalists
43221,942,2,"124,6",3,1,1,5,Low-Value,At Risk Customers
43222,545,3,"211,25",4,1,1,6,Mid-Value,Potential Loyalists
43226,159,5,"124,9",5,1,1,7,Mid-Value,Potential Loyalists
43227,1,11,"587,3",5,2,1,8,High-Value,Potential Loyalists
43229,41,9,"537,65",5,2,1,8,High-Value,Potential Loyalists
43230,90,2,"63,7",5,1,1,7,Mid-Value,Potential Loyalists
43231,18,6,"203,0",5,1,1,7,Mid-Value,Potential Loyalists
43232,634,5,"342,1",4,1,1,6,Mid-Value,Potential Loyalists
43233,201,3,"372,2",5,1,1,7,Mid-Value,Potential Loyalists
43234,247,4,"116,35",5,1,1,7,Mid-Value,Potential Loyalists
43236,146,7,"272,3",5,2,1,8,High-Value,Potential Loyalists
43239,51,2,"254,05",5,1,1,7,Mid-Value,Potential Loyalists
43240,746,2,"91,8",3,1,1,5,Low-Value,At Risk Customers
43242,386,2,"157,95",4,1,1,6,Mid-Value,Potential Loyalists
43243,877,2,"217,25",3,1,1,5,Low-Value,At Risk Customers
43244,183,2,"172,95",5,1,1,7,Mid-Value,Potential Loyalists
43247,80,7,"205,05",5,2,1,8,High-Value,Potential Loyalists
43250,248,3,"531,05",5,1,1,7,Mid-Value,Potential Loyalists
43251,224,3,"418,35",5,1,1,7,Mid-Value,Potential Loyalists
43252,5,4,"328,79999999999995",5,1,1,7,Mid-Value,Potential Loyalists
43253,602,2,"49,5",4,1,1,6,Mid-Value,Potential Loyalists
43254,54,3,"147,5",5,1,1,7,Mid-Value,Potential Loyalists
43255,0,6,"191,05",5,1,1,7,Mid-Value,Potential Loyalists
43256,1560,1,"174,3",1,1,1,3,Low-Value,Lost
43257,1089,1,"31,7",3,1,1,5,Low-Value,At Risk Customers
43258,285,1,"7,9",5,1,1,7,Mid-Value,Potential Loyalists
43259,906,2,"98,5",3,1,1,5,Low-Value,At Risk Customers
43260,748,4,"136,65",3,1,1,5,Low-Value,At Risk Customers
43261,286,1,"67,4",5,1,1,7,Mid-Value,Potential Loyalists
43263,265,4,"415,1",5,1,1,7,Mid-Value,Potential Loyalists
43264,757,5,"356,84999999999997",3,1,1,5,Low-Value,At Risk Customers
43268,460,2,"64,7",4,1,1,6,Mid-Value,Potential Loyalists
43269,204,1,"49,7",5,1,1,7,Mid-Value,Potential Loyalists
43270,164,2,"174,7",5,1,1,7,Mid-Value,Potential Loyalists
43271,917,1,"255,3",3,1,1,5,Low-Value,At Risk Customers
43273,1248,1,"42,45",2,1,1,4,Low-Value,Can't Lose
43275,285,5,"501,65000000000003",5,1,1,7,Mid-Value,Potential Loyalists
43276,1125,3,"263,5",2,1,1,4,Low-Value,Can't Lose
43280,473,3,"104,45",4,1,1,6,Mid-Value,Potential Loyalists
43281,809,1,"80,45",3,1,1,5,Low-Value,At Risk Customers
43282,631,2,"138,8",4,1,1,6,Mid-Value,Potential Loyalists
43289,1571,1,"21,2",1,1,1,3,Low-Value,Lost
43290,507,1,"48,1",4,1,1,6,Mid-Value,Potential Loyalists
43291,246,2,"59,15",5,1,1,7,Mid-Value,Potential Loyalists
43292,298,6,"225,65",5,1,1,7,Mid-Value,Potential Loyalists
43294,343,2,"22,400000000000002",5,1,1,7,Mid-Value,Potential Loyalists
43295,146,1,"121,94999999999999",5,1,1,7,Mid-Value,Potential Loyalists
43296,1215,2,"162,1",2,1,1,4,Low-Value,Can't Lose
43298,446,2,"130,95",4,1,1,6,Mid-Value,Potential Loyalists
43299,804,4,"156,8",3,1,1,5,Low-Value,At Risk Customers
43300,43,5,"283,05",5,1,1,7,Mid-Value,Potential Loyalists
43301,245,4,"246,0",5,1,1,7,Mid-Value,Potential Loyalists
43302,80,4,"144,6",5,1,1,7,Mid-Value,Potential Loyalists
43303,539,2,"123,1",4,1,1,6,Mid-Value,Potential Loyalists
43305,53,8,"220,8",5,2,1,8,High-Value,Potential Loyalists
43308,832,4,"285,75",3,1,1,5,Low-Value,At Risk Customers
43314,1098,2,"106,75",2,1,1,4,Low-Value,Can't Lose
43316,416,5,"493,1",4,1,1,6,Mid-Value,Potential Loyalists
43317,95,7,"562,9",5,2,1,8,High-Value,Potential Loyalists
43318,377,4,"130,1",4,1,1,6,Mid-Value,Potential Loyalists
43319,557,4,"377,9",4,1,1,6,Mid-Value,Potential Loyalists
43320,1652,3,"199,1",1,1,1,3,Low-Value,Lost
43321,31,2,"114,1",5,1,1,7,Mid-Value,Potential Loyalists
43322,532,1,"145,1",4,1,1,6,Mid-Value,Potential Loyalists
43323,1039,1,"15,35",3,1,1,5,Low-Value,At Risk Customers
43324,17,1,"97,8",5,1,1,7,Mid-Value,Potential Loyalists
43325,421,6,"412,7",4,1,1,6,Mid-Value,Potential Loyalists
43327,651,1,"63,2",4,1,1,6,Mid-Value,Potential Loyalists
43328,1393,1,"61,0",2,1,1,4,Low-Value,Can't Lose
43329,208,8,"272,65",5,2,1,8,High-Value,Potential Loyalists
43331,759,1,"96,9",3,1,1,5,Low-Value,At Risk Customers
43332,61,7,"412,35",5,2,1,8,High-Value,Potential Loyalists
43335,64,8,"899,35",5,2,2,9,High-Value,Champions
43336,263,5,"135,29999999999998",5,1,1,7,Mid-Value,Potential Loyalists
43337,1128,2,"41,65",2,1,1,4,Low-Value,Can't Lose
43339,823,3,"407,25",3,1,1,5,Low-Value,At Risk Customers
43341,95,2,"13,0",5,1,1,7,Mid-Value,Potential Loyalists
43342,1146,4,"150,55",2,1,1,4,Low-Value,Can't Lose
43345,1098,1,"145,0",2,1,1,4,Low-Value,Can't Lose
43346,12,10,"541,75",5,2,1,8,High-Value,Potential Loyalists
43347,5,11,"639,5",5,2,1,8,High-Value,Potential Loyalists
43348,147,4,"75,25",5,1,1,7,Mid-Value,Potential Loyalists
43349,797,4,"90,55",3,1,1,5,Low-Value,At Risk Customers
43350,881,1,"91,2",3,1,1,5,Low-Value,At Risk Customers
43351,857,4,"197,75",3,1,1,5,Low-Value,At Risk Customers
43353,117,3,"240,85",5,1,1,7,Mid-Value,Potential Loyalists
43355,1097,4,"669,8499999999999",2,1,2,5,Low-Value,At Risk Customers
43356,25,4,"97,05",5,1,1,7,Mid-Value,Potential Loyalists
43357,1560,1,"19,45",1,1,1,3,Low-Value,Lost
43361,1323,1,"29,849999999999998",2,1,1,4,Low-Value,Can't Lose
43362,192,4,"330,95",5,1,1,7,Mid-Value,Potential Loyalists
43363,167,6,"358,1",5,1,1,7,Mid-Value,Potential Loyalists
43365,330,1,"553,25",5,1,1,7,Mid-Value,Potential Loyalists
43366,621,1,"251,3",4,1,1,6,Mid-Value,Potential Loyalists
43367,1183,2,"31,95",2,1,1,4,Low-Value,Can't Lose
43368,59,2,"135,29999999999998",5,1,1,7,Mid-Value,Potential Loyalists
43371,1485,1,"111,0",1,1,1,3,Low-Value,Lost
43372,221,4,"338,05",5,1,1,7,Mid-Value,Potential Loyalists
43375,1066,4,"1098,1",3,1,2,6,Mid-Value,Potential Loyalists
43376,1804,1,"26,75",1,1,1,3,Low-Value,Lost
43377,1451,1,"95,7",2,1,1,4,Low-Value,Can't Lose
43380,178,12,"527,6",5,3,1,9,High-Value,Champions
43381,34,1,"13,9",5,1,1,7,Mid-Value,Potential Loyalists
43383,1522,1,"37,8",1,1,1,3,Low-Value,Lost
43386,435,1,"12,85",4,1,1,6,Mid-Value,Potential Loyalists
43388,231,3,"592,65",5,1,1,7,Mid-Value,Potential Loyalists
43390,127,1,"42,1",5,1,1,7,Mid-Value,Potential Loyalists
43391,602,1,"50,55",4,1,1,6,Mid-Value,Potential Loyalists
43392,1376,2,"45,75",2,1,1,4,Low-Value,Can't Lose
43396,447,3,"72,2",4,1,1,6,Mid-Value,Potential Loyalists
43397,688,2,"43,35",4,1,1,6,Mid-Value,Potential Loyalists
43398,1308,1,"15,3",2,1,1,4,Low-Value,Can't Lose
43399,21,1,"170,6",5,1,1,7,Mid-Value,Potential Loyalists
43400,377,1,"24,150000000000002",4,1,1,6,Mid-Value,Potential Loyalists
43402,4,2,"194,20000000000002",5,1,1,7,Mid-Value,Potential Loyalists
43403,370,2,"241,79999999999998",4,1,1,6,Mid-Value,Potential Loyalists
43405,53,4,"79,35000000000001",5,1,1,7,Mid-Value,Potential Loyalists
43407,259,5,"95,45",5,1,1,7,Mid-Value,Potential Loyalists
43409,7,5,"129,79999999999998",5,1,1,7,Mid-Value,Potential Loyalists
43410,60,10,"549,5",5,2,1,8,High-Value,Potential Loyalists
43411,868,5,"339,15000000000003",3,1,1,5,Low-Value,At Risk Customers
43413,818,2,"96,3",3,1,1,5,Low-Value,At Risk Customers
43414,1483,1,"5,9",1,1,1,3,Low-Value,Lost
43416,261,3,"193,9",5,1,1,7,Mid-Value,Potential Loyalists
43417,423,6,"226,0",4,1,1,6,Mid-Value,Potential Loyalists
43419,1691,2,"35,0",1,1,1,3,Low-Value,Lost
43420,395,4,"295,65",4,1,1,6,Mid-Value,Potential Loyalists
43422,1054,2,"45,35",3,1,1,5,Low-Value,At Risk Customers
43424,237,2,"218,89999999999998",5,1,1,7,Mid-Value,Potential Loyalists
43430,24,4,"325,35",5,1,1,7,Mid-Value,Potential Loyalists
43431,1709,1,"152,7",1,1,1,3,Low-Value,Lost
43432,609,2,"206,10000000000002",4,1,1,6,Mid-Value,Potential Loyalists
43435,157,3,"306,6",5,1,1,7,Mid-Value,Potential Loyalists
43436,447,8,"360,7",4,2,1,7,Mid-Value,Potential Loyalists
43438,886,1,"7,2",3,1,1,5,Low-Value,At Risk Customers
43439,1330,3,"146,4",2,1,1,4,Low-Value,Can't Lose
43444,194,2,"100,6",5,1,1,7,Mid-Value,Potential Loyalists
43445,730,2,"578,8000000000001",4,1,1,6,Mid-Value,Potential Loyalists
43446,202,2,"169,7",5,1,1,7,Mid-Value,Potential Loyalists
43447,1316,1,"17,8",2,1,1,4,Low-Value,Can't Lose
43448,382,13,"786,6",4,3,2,9,High-Value,Champions
43449,1716,3,"110,6",1,1,1,3,Low-Value,Lost
43450,172,14,"527,6",5,3,1,9,High-Value,Champions
43451,235,3,"358,75",5,1,1,7,Mid-Value,Potential Loyalists
43453,132,6,"230,0",5,1,1,7,Mid-Value,Potential Loyalists
43454,1767,1,"15,5",1,1,1,3,Low-Value,Lost
43455,363,1,"24,2",5,1,1,7,Mid-Value,Potential Loyalists
43456,700,2,"69,95",4,1,1,6,Mid-Value,Potential Loyalists
43460,302,4,"285,05",5,1,1,7,Mid-Value,Potential Loyalists
43461,746,6,"791,5",3,1,2,6,Mid-Value,Potential Loyalists
43462,1399,2,"51,05",2,1,1,4,Low-Value,Can't Lose
43467,32,5,"267,34999999999997",5,1,1,7,Mid-Value,Potential Loyalists
43469,271,4,"238,3",5,1,1,7,Mid-Value,Potential Loyalists
43470,33,8,"317,8",5,2,1,8,High-Value,Potential Loyalists
43472,521,6,"422,75",4,1,1,6,Mid-Value,Potential Loyalists
43473,328,1,"117,8",5,1,1,7,Mid-Value,Potential Loyalists
43474,147,3,"315,0",5,1,1,7,Mid-Value,Potential Loyalists
43475,179,3,"80,39999999999999",5,1,1,7,Mid-Value,Potential Loyalists
43478,405,4,"92,85",4,1,1,6,Mid-Value,Potential Loyalists
43479,604,2,"185,60000000000002",4,1,1,6,Mid-Value,Potential Loyalists
43480,10,6,"304,55",5,1,1,7,Mid-Value,Potential Loyalists
43484,840,3,"81,4",3,1,1,5,Low-Value,At Risk Customers
43485,71,3,"45,9",5,1,1,7,Mid-Value,Potential Loyalists
43488,850,1,"76,3",3,1,1,5,Low-Value,At Risk Customers
43491,915,1,"29,0",3,1,1,5,Low-Value,At Risk Customers
43492,1169,3,"124,9",2,1,1,4,Low-Value,Can't Lose
43494,379,5,"437,95",4,1,1,6,Mid-Value,Potential Loyalists
43495,1106,4,"126,8",2,1,1,4,Low-Value,Can't Lose
43496,971,1,"121,94999999999999",3,1,1,5,Low-Value,At Risk Customers
43497,938,2,"44,7",3,1,1,5,Low-Value,At Risk Customers
43498,220,1,"34,2",5,1,1,7,Mid-Value,Potential Loyalists
43499,26,2,"33,45",5,1,1,7,Mid-Value,Potential Loyalists
43501,17,1,"63,05",5,1,1,7,Mid-Value,Potential Loyalists
43502,161,3,"202,75",5,1,1,7,Mid-Value,Potential Loyalists
43503,930,1,"10,0",3,1,1,5,Low-Value,At Risk Customers
43504,1490,1,"281,5",1,1,1,3,Low-Value,Lost
43505,365,1,"19,1",5,1,1,7,Mid-Value,Potential Loyalists
43506,1380,4,"356,2",2,1,1,4,Low-Value,Can't Lose
43509,15,5,"153,5",5,1,1,7,Mid-Value,Potential Loyalists
43511,234,6,"97,75",5,1,1,7,Mid-Value,Potential Loyalists
43512,1546,1,"36,2",1,1,1,3,Low-Value,Lost
43513,41,3,"181,85",5,1,1,7,Mid-Value,Potential Loyalists
43515,358,4,"593,95",5,1,1,7,Mid-Value,Potential Loyalists
43516,57,4,"326,85",5,1,1,7,Mid-Value,Potential Loyalists
43517,588,1,"34,1",4,1,1,6,Mid-Value,Potential Loyalists
43519,1025,4,"365,55",3,1,1,5,Low-Value,At Risk Customers
43520,171,1,"48,8",5,1,1,7,Mid-Value,Potential Loyalists
43523,391,1,"21,1",4,1,1,6,Mid-Value,Potential Loyalists
43524,4,5,"577,65",5,1,1,7,Mid-Value,Potential Loyalists
43525,479,4,"92,7",4,1,1,6,Mid-Value,Potential Loyalists
43528,598,2,"105,75",4,1,1,6,Mid-Value,Potential Loyalists
43529,1465,2,"62,7",1,1,1,3,Low-Value,Lost
43530,511,1,"132,0",4,1,1,6,Mid-Value,Potential Loyalists
43531,1160,2,"27,200000000000003",2,1,1,4,Low-Value,Can't Lose
43532,4,9,"913,5500000000001",5,2,2,9,High-Value,Champions
43533,23,3,"232,45",5,1,1,7,Mid-Value,Potential Loyalists
43534,1301,2,"83,5",2,1,1,4,Low-Value,Can't Lose
43535,1354,1,"161,7",2,1,1,4,Low-Value,Can't Lose
43536,43,7,"707,9",5,2,2,9,High-Value,Champions
43545,388,3,"504,45",4,1,1,6,Mid-Value,Potential Loyalists
43546,136,6,"323,65",5,1,1,7,Mid-Value,Potential Loyalists
43547,450,10,"1282,8",4,2,2,8,High-Value,Potential Loyalists
43549,976,2,"208,05",3,1,1,5,Low-Value,At Risk Customers
43550,192,1,"52,25",5,1,1,7,Mid-Value,Potential Loyalists
43552,537,2,"57,65",4,1,1,6,Mid-Value,Potential Loyalists
43553,74,13,"955,05",5,3,2,10,High-Value,Champions
43554,892,1,"19,049999999999997",3,1,1,5,Low-Value,At Risk Customers
43555,881,2,"89,1",3,1,1,5,Low-Value,At Risk Customers
43557,171,6,"186,20000000000002",5,1,1,7,Mid-Value,Potential Loyalists
43558,507,1,"69,3",4,1,1,6,Mid-Value,Potential Loyalists
43560,159,7,"237,95",5,2,1,8,High-Value,Potential Loyalists
43561,724,5,"478,3",4,1,1,6,Mid-Value,Potential Loyalists
43562,488,5,"185,7",4,1,1,6,Mid-Value,Potential Loyalists
43563,1622,1,"25,349999999999998",1,1,1,3,Low-Value,Lost
43564,931,1,"189,0",3,1,1,5,Low-Value,At Risk Customers
43569,999,2,"240,45",3,1,1,5,Low-Value,At Risk Customers
43570,493,1,"63,1",4,1,1,6,Mid-Value,Potential Loyalists
43571,92,4,"156,4",5,1,1,7,Mid-Value,Potential Loyalists
43572,579,1,"19,35",4,1,1,6,Mid-Value,Potential Loyalists
43573,649,1,"20,85",4,1,1,6,Mid-Value,Potential Loyalists
43575,27,4,"152,9",5,1,1,7,Mid-Value,Potential Loyalists
43576,266,4,"468,9",5,1,1,7,Mid-Value,Potential Loyalists
43578,32,6,"246,95",5,1,1,7,Mid-Value,Potential Loyalists
43579,1031,4,"455,34999999999997",3,1,1,5,Low-Value,At Risk Customers
43580,205,9,"239,2",5,2,1,8,High-Value,Potential Loyalists
43581,28,3,"52,1",5,1,1,7,Mid-Value,Potential Loyalists
43582,410,1,"73,4",4,1,1,6,Mid-Value,Potential Loyalists
43585,503,2,"55,699999999999996",4,1,1,6,Mid-Value,Potential Loyalists
43588,501,2,"46,5",4,1,1,6,Mid-Value,Potential Loyalists
43591,657,2,"48,6",4,1,1,6,Mid-Value,Potential Loyalists
43592,1630,1,"21,8",1,1,1,3,Low-Value,Lost
43593,395,1,"81,5",4,1,1,6,Mid-Value,Potential Loyalists
43594,887,1,"9,5",3,1,1,5,Low-Value,At Risk Customers
43595,1590,2,"44,2",1,1,1,3,Low-Value,Lost
43596,896,3,"122,1",3,1,1,5,Low-Value,At Risk Customers
43597,1110,3,"193,45",2,1,1,4,Low-Value,Can't Lose
43599,230,3,"180,35000000000002",5,1,1,7,Mid-Value,Potential Loyalists
43600,1266,2,"24,9",2,1,1,4,Low-Value,Can't Lose
43601,0,5,"233,45",5,1,1,7,Mid-Value,Potential Loyalists
43603,396,2,"138,8",4,1,1,6,Mid-Value,Potential Loyalists
43605,1286,1,"91,2",2,1,1,4,Low-Value,Can't Lose
43606,538,2,"157,15",4,1,1,6,Mid-Value,Potential Loyalists
43607,449,4,"84,0",4,1,1,6,Mid-Value,Potential Loyalists
43609,493,1,"60,599999999999994",4,1,1,6,Mid-Value,Potential Loyalists
43610,60,2,"299,15",5,1,1,7,Mid-Value,Potential Loyalists
43611,146,1,"105,1",5,1,1,7,Mid-Value,Potential Loyalists
43612,655,4,"217,55",4,1,1,6,Mid-Value,Potential Loyalists
43616,399,4,"122,1",4,1,1,6,Mid-Value,Potential Loyalists
43617,405,4,"108,0",4,1,1,6,Mid-Value,Potential Loyalists
43618,460,5,"247,75",4,1,1,6,Mid-Value,Potential Loyalists
43620,918,2,"83,95",3,1,1,5,Low-Value,At Risk Customers
43622,1393,1,"33,25",2,1,1,4,Low-Value,Can't Lose
43623,522,1,"16,2",4,1,1,6,Mid-Value,Potential Loyalists
43625,24,10,"1012,1",5,2,2,9,High-Value,Champions
43626,191,3,"176,0",5,1,1,7,Mid-Value,Potential Loyalists
43628,1676,1,"159,89999999999998",1,1,1,3,Low-Value,Lost
43630,871,3,"222,64999999999998",3,1,1,5,Low-Value,At Risk Customers
43631,1483,1,"102,4",1,1,1,3,Low-Value,Lost
43633,25,6,"192,9",5,1,1,7,Mid-Value,Potential Loyalists
43634,158,10,"409,35",5,2,1,8,High-Value,Potential Loyalists
43635,319,1,"44,6",5,1,1,7,Mid-Value,Potential Loyalists
43637,206,1,"114,9",5,1,1,7,Mid-Value,Potential Loyalists
43640,939,1,"90,7",3,1,1,5,Low-Value,At Risk Customers
43643,672,19,"747,2",4,4,2,10,High-Value,Champions
43644,75,9,"706,6999999999999",5,2,2,9,High-Value,Champions
43645,774,8,"376,95",3,2,1,6,Mid-Value,Potential Loyalists
43646,494,3,"330,5",4,1,1,6,Mid-Value,Potential Loyalists
43647,17,2,"219,75",5,1,1,7,Mid-Value,Potential Loyalists
43648,449,3,"114,25",4,1,1,6,Mid-Value,Potential Loyalists
43650,232,3,"386,8",5,1,1,7,Mid-Value,Potential Loyalists
43651,18,10,"914,6",5,2,2,9,High-Value,Champions
43652,598,3,"228,65",4,1,1,6,Mid-Value,Potential Loyalists
43653,207,9,"379,3",5,2,1,8,High-Value,Potential Loyalists
43654,1671,1,"149,9",1,1,1,3,Low-Value,Lost
43657,897,3,"98,4",3,1,1,5,Low-Value,At Risk Customers
43658,143,7,"457,65000000000003",5,2,1,8,High-Value,Potential Loyalists
43660,170,2,"110,64999999999999",5,1,1,7,Mid-Value,Potential Loyalists
43662,546,5,"440,9",4,1,1,6,Mid-Value,Potential Loyalists
43663,345,1,"23,45",5,1,1,7,Mid-Value,Potential Loyalists
43667,59,5,"340,3999999999999",5,1,1,7,Mid-Value,Potential Loyalists
43668,797,3,"149,55",3,1,1,5,Low-Value,At Risk Customers
43669,939,8,"869,75",3,2,2,7,Mid-Value,Potential Loyalists
43671,583,1,"15,4",4,1,1,6,Mid-Value,Potential Loyalists
43672,5,5,"249,79999999999998",5,1,1,7,Mid-Value,Potential Loyalists
43673,385,6,"316,15",4,1,1,6,Mid-Value,Potential Loyalists
43674,637,6,"131,7",4,1,1,6,Mid-Value,Potential Loyalists
43675,1347,2,"126,35",2,1,1,4,Low-Value,Can't Lose
43676,383,3,"117,75000000000001",4,1,1,6,Mid-Value,Potential Loyalists
43677,735,1,"141,14999999999998",3,1,1,5,Low-Value,At Risk Customers
43678,1228,2,"363,25000000000006",2,1,1,4,Low-Value,Can't Lose
43679,486,1,"21,1",4,1,1,6,Mid-Value,Potential Loyalists
43680,966,5,"799,1",3,1,2,6,Mid-Value,Potential Loyalists
43683,230,6,"317,65",5,1,1,7,Mid-Value,Potential Loyalists
43686,110,6,"155,05",5,1,1,7,Mid-Value,Potential Loyalists
43687,1588,2,"268,25",1,1,1,3,Low-Value,Lost
43691,27,3,"104,0",5,1,1,7,Mid-Value,Potential Loyalists
43692,225,4,"129,15",5,1,1,7,Mid-Value,Potential Loyalists
43695,1477,4,"236,35",1,1,1,3,Low-Value,Lost
43697,669,1,"42,45",4,1,1,6,Mid-Value,Potential Loyalists
43700,1462,1,"348,6",1,1,1,3,Low-Value,Lost
43701,77,2,"210,05",5,1,1,7,Mid-Value,Potential Loyalists
43703,505,3,"197,2",4,1,1,6,Mid-Value,Potential Loyalists
43704,409,6,"503,25",4,1,1,6,Mid-Value,Potential Loyalists
43705,1681,1,"46,5",1,1,1,3,Low-Value,Lost
43708,444,3,"167,55",4,1,1,6,Mid-Value,Potential Loyalists
43710,96,3,"67,35",5,1,1,7,Mid-Value,Potential Loyalists
43711,346,2,"77,80000000000001",5,1,1,7,Mid-Value,Potential Loyalists
43712,3,6,"177,2",5,1,1,7,Mid-Value,Potential Loyalists
43714,65,3,"167,65",5,1,1,7,Mid-Value,Potential Loyalists
43717,382,1,"16,1",4,1,1,6,Mid-Value,Potential Loyalists
43720,1105,2,"165,15",2,1,1,4,Low-Value,Can't Lose
43722,505,1,"135,14999999999998",4,1,1,6,Mid-Value,Potential Loyalists
43723,141,1,"53,099999999999994",5,1,1,7,Mid-Value,Potential Loyalists
43724,66,7,"298,7",5,2,1,8,High-Value,Potential Loyalists
43725,1294,2,"85,85",2,1,1,4,Low-Value,Can't Lose
43726,225,1,"579,9",5,1,1,7,Mid-Value,Potential Loyalists
43727,1480,1,"95,5",1,1,1,3,Low-Value,Lost
43728,1283,2,"70,65",2,1,1,4,Low-Value,Can't Lose
43732,1378,2,"41,9",2,1,1,4,Low-Value,Can't Lose
43733,279,4,"237,54999999999998",5,1,1,7,Mid-Value,Potential Loyalists
43734,382,1,"89,8",4,1,1,6,Mid-Value,Potential Loyalists
43737,214,3,"99,13000000000001",5,1,1,7,Mid-Value,Potential Loyalists
43739,313,6,"193,0",5,1,1,7,Mid-Value,Potential Loyalists
43740,11,2,"164,0",5,1,1,7,Mid-Value,Potential Loyalists
43743,1346,1,"46,5",2,1,1,4,Low-Value,Can't Lose
43744,334,8,"219,45000000000002",5,2,1,8,High-Value,Potential Loyalists
43746,5,4,"212,45",5,1,1,7,Mid-Value,Potential Loyalists
43747,475,4,"94,39999999999999",4,1,1,6,Mid-Value,Potential Loyalists
43748,939,2,"285,05",3,1,1,5,Low-Value,At Risk Customers
43751,916,2,"53,05",3,1,1,5,Low-Value,At Risk Customers
43753,187,9,"407,35",5,2,1,8,High-Value,Potential Loyalists
43755,1368,2,"87,25",2,1,1,4,Low-Value,Can't Lose
43756,326,2,"250,6",5,1,1,7,Mid-Value,Potential Loyalists
43757,28,3,"132,9",5,1,1,7,Mid-Value,Potential Loyalists
43760,871,1,"501,4",3,1,1,5,Low-Value,At Risk Customers
43761,516,2,"245,5",4,1,1,6,Mid-Value,Potential Loyalists
43762,158,4,"441,8",5,1,1,7,Mid-Value,Potential Loyalists
43763,882,7,"420,45",3,2,1,6,Mid-Value,Potential Loyalists
43764,1141,3,"246,39999999999998",2,1,1,4,Low-Value,Can't Lose
43765,418,1,"0,6",4,1,1,6,Mid-Value,Potential Loyalists
43767,411,2,"66,0",4,1,1,6,Mid-Value,Potential Loyalists
43768,398,3,"296,65",4,1,1,6,Mid-Value,Potential Loyalists
43769,124,3,"195,7",5,1,1,7,Mid-Value,Potential Loyalists
43770,190,4,"290,25",5,1,1,7,Mid-Value,Potential Loyalists
43771,58,2,"39,45",5,1,1,7,Mid-Value,Potential Loyalists
43773,248,9,"409,9",5,2,1,8,High-Value,Potential Loyalists
43776,1751,2,"56,65",1,1,1,3,Low-Value,Lost
43777,108,9,"371,4",5,2,1,8,High-Value,Potential Loyalists
43778,501,4,"273,6",4,1,1,6,Mid-Value,Potential Loyalists
43779,549,4,"132,75",4,1,1,6,Mid-Value,Potential Loyalists
43781,286,1,"261,45000000000005",5,1,1,7,Mid-Value,Potential Loyalists
43782,1076,1,"4,55",3,1,1,5,Low-Value,At Risk Customers
43783,388,4,"148,55",4,1,1,6,Mid-Value,Potential Loyalists
43784,188,3,"29,450000000000003",5,1,1,7,Mid-Value,Potential Loyalists
43785,178,2,"250,50000000000003",5,1,1,7,Mid-Value,Potential Loyalists
43787,126,7,"212,4",5,2,1,8,High-Value,Potential Loyalists
43788,21,9,"391,2",5,2,1,8,High-Value,Potential Loyalists
43789,15,7,"440,2",5,2,1,8,High-Value,Potential Loyalists
43790,638,2,"197,55",4,1,1,6,Mid-Value,Potential Loyalists
43791,508,2,"249,9",4,1,1,6,Mid-Value,Potential Loyalists
43794,40,8,"274,95",5,2,1,8,High-Value,Potential Loyalists
43795,862,1,"19,3",3,1,1,5,Low-Value,At Risk Customers
43796,725,3,"76,2",4,1,1,6,Mid-Value,Potential Loyalists
43798,7,3,"109,55000000000001",5,1,1,7,Mid-Value,Potential Loyalists
43799,211,3,"137,4",5,1,1,7,Mid-Value,Potential Loyalists
43803,995,4,"90,6",3,1,1,5,Low-Value,At Risk Customers
43805,817,1,"19,5",3,1,1,5,Low-Value,At Risk Customers
43806,922,1,"179,8",3,1,1,5,Low-Value,At Risk Customers
43807,99,3,"282,1",5,1,1,7,Mid-Value,Potential Loyalists
43810,1218,1,"5,6",2,1,1,4,Low-Value,Can't Lose
43812,5,6,"382,15",5,1,1,7,Mid-Value,Potential Loyalists
43813,628,4,"368,95",4,1,1,6,Mid-Value,Potential Loyalists
43814,1064,2,"67,3",3,1,1,5,Low-Value,At Risk Customers
43815,24,3,"76,5",5,1,1,7,Mid-Value,Potential Loyalists
43816,165,8,"387,1",5,2,1,8,High-Value,Potential Loyalists
43817,87,7,"257,90000000000003",5,2,1,8,High-Value,Potential Loyalists
43819,130,11,"1005,75",5,2,2,9,High-Value,Champions
43821,1230,2,"305,0",2,1,1,4,Low-Value,Can't Lose
43826,598,4,"331,65",4,1,1,6,Mid-Value,Potential Loyalists
43828,74,4,"197,1",5,1,1,7,Mid-Value,Potential Loyalists
43829,510,4,"97,89999999999999",4,1,1,6,Mid-Value,Potential Loyalists
43832,7,6,"314,65",5,1,1,7,Mid-Value,Potential Loyalists
43834,413,2,"32,95",4,1,1,6,Mid-Value,Potential Loyalists
43835,190,4,"319,15",5,1,1,7,Mid-Value,Potential Loyalists
43836,764,3,"249,4",3,1,1,5,Low-Value,At Risk Customers
43841,97,3,"178,4",5,1,1,7,Mid-Value,Potential Loyalists
43842,822,4,"213,29999999999998",3,1,1,5,Low-Value,At Risk Customers
43843,381,2,"268,9",4,1,1,6,Mid-Value,Potential Loyalists
43845,1435,2,"119,25",2,1,1,4,Low-Value,Can't Lose
43846,796,1,"199,0",3,1,1,5,Low-Value,At Risk Customers
43848,253,2,"97,45",5,1,1,7,Mid-Value,Potential Loyalists
43849,83,2,"19,9",5,1,1,7,Mid-Value,Potential Loyalists
43850,1274,1,"112,85",2,1,1,4,Low-Value,Can't Lose
43851,73,6,"558,75",5,1,1,7,Mid-Value,Potential Loyalists
43852,266,4,"216,05",5,1,1,7,Mid-Value,Potential Loyalists
43857,965,2,"81,8",3,1,1,5,Low-Value,At Risk Customers
43860,97,5,"586,95",5,1,1,7,Mid-Value,Potential Loyalists
43861,84,2,"147,35",5,1,1,7,Mid-Value,Potential Loyalists
43862,960,1,"125,15",3,1,1,5,Low-Value,At Risk Customers
43864,986,1,"18,7",3,1,1,5,Low-Value,At Risk Customers
43865,1381,1,"29,7",2,1,1,4,Low-Value,Can't Lose
43868,29,8,"332,55",5,2,1,8,High-Value,Potential Loyalists
43869,819,4,"194,10000000000002",3,1,1,5,Low-Value,At Risk Customers
43870,114,3,"183,65",5,1,1,7,Mid-Value,Potential Loyalists
43871,1611,2,"291,25",1,1,1,3,Low-Value,Lost
43872,1013,1,"113,6",3,1,1,5,Low-Value,At Risk Customers
43876,170,6,"699,4000000000001",5,1,2,8,High-Value,Potential Loyalists
43877,830,7,"290,0",3,2,1,6,Mid-Value,Potential Loyalists
43878,754,8,"284,65",3,2,1,6,Mid-Value,Potential Loyalists
43879,1074,1,"67,7",3,1,1,5,Low-Value,At Risk Customers
43882,182,2,"55,050000000000004",5,1,1,7,Mid-Value,Potential Loyalists
43883,1204,3,"66,15",2,1,1,4,Low-Value,Can't Lose
43884,4,9,"735,65",5,2,2,9,High-Value,Champions
43885,380,3,"261,9",4,1,1,6,Mid-Value,Potential Loyalists
43886,426,7,"260,0",4,2,1,7,Mid-Value,Potential Loyalists
43887,645,1,"57,5",4,1,1,6,Mid-Value,Potential Loyalists
43890,705,1,"124,2",4,1,1,6,Mid-Value,Potential Loyalists
43892,260,1,"29,95",5,1,1,7,Mid-Value,Potential Loyalists
43893,1709,1,"11,35",1,1,1,3,Low-Value,Lost
43894,399,6,"282,5",4,1,1,6,Mid-Value,Potential Loyalists
43895,340,2,"70,75",5,1,1,7,Mid-Value,Potential Loyalists
43897,601,6,"719,4000000000001",4,1,2,7,Mid-Value,Potential Loyalists
43900,345,3,"133,65",5,1,1,7,Mid-Value,Potential Loyalists
43901,1315,1,"161,39999999999998",2,1,1,4,Low-Value,Can't Lose
43903,1555,1,"126,7",1,1,1,3,Low-Value,Lost
43905,929,1,"65,6",3,1,1,5,Low-Value,At Risk Customers
43906,545,5,"719,15",4,1,2,7,Mid-Value,Potential Loyalists
43907,241,5,"328,54999999999995",5,1,1,7,Mid-Value,Potential Loyalists
43909,29,6,"211,9",5,1,1,7,Mid-Value,Potential Loyalists
43910,883,2,"253,3",3,1,1,5,Low-Value,At Risk Customers
43911,90,2,"50,15",5,1,1,7,Mid-Value,Potential Loyalists
43913,314,6,"147,35",5,1,1,7,Mid-Value,Potential Loyalists
43914,514,1,"50,6",4,1,1,6,Mid-Value,Potential Loyalists
43915,1275,3,"343,5",2,1,1,4,Low-Value,Can't Lose
43917,1626,3,"479,4",1,1,1,3,Low-Value,Lost
43919,75,4,"200,4",5,1,1,7,Mid-Value,Potential Loyalists
43921,846,5,"366,6",3,1,1,5,Low-Value,At Risk Customers
43924,1448,2,"20,95",2,1,1,4,Low-Value,Can't Lose
43925,769,3,"150,15",3,1,1,5,Low-Value,At Risk Customers
43927,112,7,"485,84999999999997",5,2,1,8,High-Value,Potential Loyalists
43928,1317,1,"63,0",2,1,1,4,Low-Value,Can't Lose
43929,1502,3,"242,1",1,1,1,3,Low-Value,Lost
43931,395,2,"84,35",4,1,1,6,Mid-Value,Potential Loyalists
43932,583,4,"321,45",4,1,1,6,Mid-Value,Potential Loyalists
43933,410,3,"502,3",4,1,1,6,Mid-Value,Potential Loyalists
43934,578,1,"47,25",4,1,1,6,Mid-Value,Potential Loyalists
43935,317,1,"42,15",5,1,1,7,Mid-Value,Potential Loyalists
43938,624,4,"579,65",4,1,1,6,Mid-Value,Potential Loyalists
43940,1091,1,"40,75",3,1,1,5,Low-Value,At Risk Customers
43941,1592,2,"24,05",1,1,1,3,Low-Value,Lost
43942,1354,1,"10,45",2,1,1,4,Low-Value,Can't Lose
43943,1386,1,"3,25",2,1,1,4,Low-Value,Can't Lose
43947,906,1,"88,8",3,1,1,5,Low-Value,At Risk Customers
43950,1117,1,"176,39999999999998",2,1,1,4,Low-Value,Can't Lose
43951,17,5,"384,79999999999995",5,1,1,7,Mid-Value,Potential Loyalists
43955,1674,1,"315,0",1,1,1,3,Low-Value,Lost
43958,3,6,"267,85",5,1,1,7,Mid-Value,Potential Loyalists
43959,395,3,"222,65",4,1,1,6,Mid-Value,Potential Loyalists
43960,3,3,"61,05",5,1,1,7,Mid-Value,Potential Loyalists
43962,778,1,"38,2",3,1,1,5,Low-Value,At Risk Customers
43963,113,2,"141,5",5,1,1,7,Mid-Value,Potential Loyalists
43969,315,3,"236,50000000000003",5,1,1,7,Mid-Value,Potential Loyalists
43970,209,3,"315,1",5,1,1,7,Mid-Value,Potential Loyalists
43971,595,1,"12,85",4,1,1,6,Mid-Value,Potential Loyalists
43976,1259,1,"25,9",2,1,1,4,Low-Value,Can't Lose
43977,1160,1,"118,9",2,1,1,4,Low-Value,Can't Lose
43979,60,1,"195,4",5,1,1,7,Mid-Value,Potential Loyalists
43981,1663,1,"108,0",1,1,1,3,Low-Value,Lost
43982,423,2,"126,6",4,1,1,6,Mid-Value,Potential Loyalists
43985,400,9,"252,64999999999998",4,2,1,7,Mid-Value,Potential Loyalists
43986,475,2,"91,75",4,1,1,6,Mid-Value,Potential Loyalists
43987,213,5,"312,45",5,1,1,7,Mid-Value,Potential Loyalists
43990,162,2,"35,5",5,1,1,7,Mid-Value,Potential Loyalists
43993,176,2,"24,95",5,1,1,7,Mid-Value,Potential Loyalists
43994,64,2,"105,6",5,1,1,7,Mid-Value,Potential Loyalists
43997,911,1,"93,3",3,1,1,5,Low-Value,At Risk Customers
43998,51,2,"89,9",5,1,1,7,Mid-Value,Potential Loyalists
43999,50,2,"81,0",5,1,1,7,Mid-Value,Potential Loyalists
44001,208,3,"165,8",5,1,1,7,Mid-Value,Potential Loyalists
44002,248,1,"6,6",5,1,1,7,Mid-Value,Potential Loyalists
44003,1720,1,"7,8",1,1,1,3,Low-Value,Lost
44004,603,5,"489,9",4,1,1,6,Mid-Value,Potential Loyalists
44005,1653,1,"8,25",1,1,1,3,Low-Value,Lost
44007,21,2,"196,84999999999997",5,1,1,7,Mid-Value,Potential Loyalists
44008,1147,4,"181,95",2,1,1,4,Low-Value,Can't Lose
44010,1570,1,"170,7",1,1,1,3,Low-Value,Lost
44012,1495,1,"38,6",1,1,1,3,Low-Value,Lost
44014,40,2,"284,75",5,1,1,7,Mid-Value,Potential Loyalists
44016,553,5,"420,40000000000003",4,1,1,6,Mid-Value,Potential Loyalists
44017,791,5,"188,25",3,1,1,5,Low-Value,At Risk Customers
44018,274,6,"454,6",5,1,1,7,Mid-Value,Potential Loyalists
44019,470,7,"269,7",4,2,1,7,Mid-Value,Potential Loyalists
44021,475,4,"662,0",4,1,1,6,Mid-Value,Potential Loyalists
44022,1569,1,"192,35",1,1,1,3,Low-Value,Lost
44023,1315,2,"34,099999999999994",2,1,1,4,Low-Value,Can't Lose
44024,150,5,"156,15",5,1,1,7,Mid-Value,Potential Loyalists
44026,501,5,"382,05",4,1,1,6,Mid-Value,Potential Loyalists
44030,318,5,"261,35",5,1,1,7,Mid-Value,Potential Loyalists
44042,1477,2,"45,099999999999994",1,1,1,3,Low-Value,Lost
44043,394,3,"134,95",4,1,1,6,Mid-Value,Potential Loyalists
44044,1408,1,"79,8",2,1,1,4,Low-Value,Can't Lose
44047,153,2,"254,25",5,1,1,7,Mid-Value,Potential Loyalists
44048,11,13,"611,65",5,3,1,9,High-Value,Champions
44050,1119,8,"192,95",2,2,1,5,Low-Value,At Risk Customers
44051,54,4,"90,65",5,1,1,7,Mid-Value,Potential Loyalists
44052,199,4,"116,1",5,1,1,7,Mid-Value,Potential Loyalists
44054,353,7,"376,2",5,2,1,8,High-Value,Potential Loyalists
44055,339,2,"187,7",5,1,1,7,Mid-Value,Potential Loyalists
44056,269,3,"191,0",5,1,1,7,Mid-Value,Potential Loyalists
44057,1399,1,"1,35",2,1,1,4,Low-Value,Can't Lose
44058,167,7,"274,75",5,2,1,8,High-Value,Potential Loyalists
44059,1108,6,"91,25",2,1,1,4,Low-Value,Can't Lose
44060,388,5,"262,0",4,1,1,6,Mid-Value,Potential Loyalists
44063,469,4,"76,1",4,1,1,6,Mid-Value,Potential Loyalists
44064,245,1,"53,6",5,1,1,7,Mid-Value,Potential Loyalists
44065,35,3,"157,7",5,1,1,7,Mid-Value,Potential Loyalists
44066,341,7,"547,45",5,2,1,8,High-Value,Potential Loyalists
44067,752,2,"31,4",3,1,1,5,Low-Value,At Risk Customers
44069,319,3,"280,15000000000003",5,1,1,7,Mid-Value,Potential Loyalists
44070,178,10,"718,15",5,2,2,9,High-Value,Champions
44072,739,2,"134,0",3,1,1,5,Low-Value,At Risk Customers
44073,90,13,"944,0999999999999",5,3,2,10,High-Value,Champions
44074,57,12,"388,1",5,3,1,9,High-Value,Champions
44077,360,1,"62,1",5,1,1,7,Mid-Value,Potential Loyalists
44079,837,3,"169,70000000000002",3,1,1,5,Low-Value,At Risk Customers
44080,1693,1,"170,10000000000002",1,1,1,3,Low-Value,Lost
44082,400,1,"64,5",4,1,1,6,Mid-Value,Potential Loyalists
44083,815,1,"27,0",3,1,1,5,Low-Value,At Risk Customers
44084,855,7,"397,29999999999995",3,2,1,6,Mid-Value,Potential Loyalists
44085,998,1,"28,5",3,1,1,5,Low-Value,At Risk Customers
44086,1135,5,"452,29999999999995",2,1,1,4,Low-Value,Can't Lose
44087,402,5,"340,84999999999997",4,1,1,6,Mid-Value,Potential Loyalists
44090,328,2,"572,6",5,1,1,7,Mid-Value,Potential Loyalists
44092,61,2,"45,4",5,1,1,7,Mid-Value,Potential Loyalists
44093,737,1,"1,4",3,1,1,5,Low-Value,At Risk Customers
44094,35,4,"145,3",5,1,1,7,Mid-Value,Potential Loyalists
44095,392,1,"53,3",4,1,1,6,Mid-Value,Potential Loyalists
44096,774,3,"703,65",3,1,2,6,Mid-Value,Potential Loyalists
44097,1257,1,"204,9",2,1,1,4,Low-Value,Can't Lose
44098,51,17,"1521,8999999999999",5,4,3,12,High-Value,Champions
44100,493,10,"295,15",4,2,1,7,Mid-Value,Potential Loyalists
44101,1579,1,"23,65",1,1,1,3,Low-Value,Lost
44102,668,4,"500,49999999999994",4,1,1,6,Mid-Value,Potential Loyalists
44104,4,3,"365,0",5,1,1,7,Mid-Value,Potential Loyalists
44105,32,12,"636,3",5,3,1,9,High-Value,Champions
44109,609,1,"8,55",4,1,1,6,Mid-Value,Potential Loyalists
44110,566,2,"56,8",4,1,1,6,Mid-Value,Potential Loyalists
44111,864,3,"192,75",3,1,1,5,Low-Value,At Risk Customers
44112,383,2,"54,5",4,1,1,6,Mid-Value,Potential Loyalists
44113,766,4,"192,64999999999998",3,1,1,5,Low-Value,At Risk Customers
44114,112,2,"33,65",5,1,1,7,Mid-Value,Potential Loyalists
44115,1254,1,"117,2",2,1,1,4,Low-Value,Can't Lose
44116,411,1,"20,75",4,1,1,6,Mid-Value,Potential Loyalists
44117,1140,2,"35,65",2,1,1,4,Low-Value,Can't Lose
44118,517,3,"157,7",4,1,1,6,Mid-Value,Potential Loyalists
44119,1340,2,"190,75",2,1,1,4,Low-Value,Can't Lose
44121,740,1,"22,4",3,1,1,5,Low-Value,At Risk Customers
44122,1488,1,"227,2",1,1,1,3,Low-Value,Lost
44123,1126,1,"93,8",2,1,1,4,Low-Value,Can't Lose
44124,1347,1,"29,3",2,1,1,4,Low-Value,Can't Lose
44126,405,3,"164,75",4,1,1,6,Mid-Value,Potential Loyalists
44129,799,3,"268,7",3,1,1,5,Low-Value,At Risk Customers
44131,631,4,"377,0",4,1,1,6,Mid-Value,Potential Loyalists
44132,735,3,"139,05",3,1,1,5,Low-Value,At Risk Customers
44133,560,1,"54,150000000000006",4,1,1,6,Mid-Value,Potential Loyalists
44134,156,1,"20,6",5,1,1,7,Mid-Value,Potential Loyalists
44135,1328,1,"30,7",2,1,1,4,Low-Value,Can't Lose
44136,393,2,"162,3",4,1,1,6,Mid-Value,Potential Loyalists
44137,27,5,"1185,1",5,1,2,8,High-Value,Potential Loyalists
44140,369,5,"100,45",4,1,1,6,Mid-Value,Potential Loyalists
44141,519,12,"429,45",4,3,1,8,High-Value,Potential Loyalists
44142,616,4,"199,85000000000002",4,1,1,6,Mid-Value,Potential Loyalists
44143,801,2,"116,8",3,1,1,5,Low-Value,At Risk Customers
44144,1127,1,"48,6",2,1,1,4,Low-Value,Can't Lose
44146,183,2,"660,85",5,1,1,7,Mid-Value,Potential Loyalists
44147,423,1,"30,45",4,1,1,6,Mid-Value,Potential Loyalists
44148,412,8,"793,45",4,2,2,8,High-Value,Potential Loyalists
44149,1502,1,"20,95",1,1,1,3,Low-Value,Lost
44150,425,5,"972,05",4,1,2,7,Mid-Value,Potential Loyalists
44151,1106,1,"12,7",2,1,1,4,Low-Value,Can't Lose
44152,544,1,"171,6",4,1,1,6,Mid-Value,Potential Loyalists
44153,97,2,"31,049999999999997",5,1,1,7,Mid-Value,Potential Loyalists
44155,859,2,"40,5",3,1,1,5,Low-Value,At Risk Customers
44157,5,3,"406,05",5,1,1,7,Mid-Value,Potential Loyalists
44158,390,7,"594,75",4,2,1,7,Mid-Value,Potential Loyalists
44162,124,2,"65,25",5,1,1,7,Mid-Value,Potential Loyalists
44164,124,9,"220,5",5,2,1,8,High-Value,Potential Loyalists
44165,739,4,"1013,9",3,1,2,6,Mid-Value,Potential Loyalists
44166,81,2,"134,5",5,1,1,7,Mid-Value,Potential Loyalists
44167,611,1,"36,900000000000006",4,1,1,6,Mid-Value,Potential Loyalists
44168,1096,3,"174,55",2,1,1,4,Low-Value,Can't Lose
44169,575,2,"133,8",4,1,1,6,Mid-Value,Potential Loyalists
44170,303,9,"335,6",5,2,1,8,High-Value,Potential Loyalists
44172,616,2,"264,55",4,1,1,6,Mid-Value,Potential Loyalists
44173,1043,2,"158,89999999999998",3,1,1,5,Low-Value,At Risk Customers
44174,69,4,"271,8",5,1,1,7,Mid-Value,Potential Loyalists
44176,7,4,"231,6",5,1,1,7,Mid-Value,Potential Loyalists
44177,380,6,"180,85",4,1,1,6,Mid-Value,Potential Loyalists
44178,81,7,"319,1",5,2,1,8,High-Value,Potential Loyalists
44180,416,1,"7,95",4,1,1,6,Mid-Value,Potential Loyalists
44181,511,1,"17,0",4,1,1,6,Mid-Value,Potential Loyalists
44183,3,2,"40,0",5,1,1,7,Mid-Value,Potential Loyalists
44184,304,5,"360,45",5,1,1,7,Mid-Value,Potential Loyalists
44185,500,3,"211,3",4,1,1,6,Mid-Value,Potential Loyalists
44189,154,3,"200,09999999999997",5,1,1,7,Mid-Value,Potential Loyalists
44190,502,1,"18,4",4,1,1,6,Mid-Value,Potential Loyalists
44191,1117,1,"32,15",2,1,1,4,Low-Value,Can't Lose
44192,69,1,"11,95",5,1,1,7,Mid-Value,Potential Loyalists
44194,274,4,"444,8",5,1,1,7,Mid-Value,Potential Loyalists
44197,485,3,"151,10000000000002",4,1,1,6,Mid-Value,Potential Loyalists
44199,17,6,"319,20000000000005",5,1,1,7,Mid-Value,Potential Loyalists
44200,847,2,"27,299999999999997",3,1,1,5,Low-Value,At Risk Customers
44203,488,1,"40,8",4,1,1,6,Mid-Value,Potential Loyalists
44204,657,2,"215,0",4,1,1,6,Mid-Value,Potential Loyalists
44205,170,6,"514,6",5,1,1,7,Mid-Value,Potential Loyalists
44206,719,1,"10,55",4,1,1,6,Mid-Value,Potential Loyalists
44208,258,1,"20,2",5,1,1,7,Mid-Value,Potential Loyalists
44209,376,5,"60,45",4,1,1,6,Mid-Value,Potential Loyalists
44210,26,5,"147,9",5,1,1,7,Mid-Value,Potential Loyalists
44211,1695,2,"13,0",1,1,1,3,Low-Value,Lost
44215,67,5,"108,45",5,1,1,7,Mid-Value,Potential Loyalists
44216,0,9,"2300,5499999999997",5,2,4,11,High-Value,Champions
44217,468,3,"109,2",4,1,1,6,Mid-Value,Potential Loyalists
44218,145,2,"19,349999999999998",5,1,1,7,Mid-Value,Potential Loyalists
44219,538,5,"169,5",4,1,1,6,Mid-Value,Potential Loyalists
44220,663,4,"197,3",4,1,1,6,Mid-Value,Potential Loyalists
44222,10,5,"408,4",5,1,1,7,Mid-Value,Potential Loyalists
44225,1211,5,"219,64999999999998",2,1,1,4,Low-Value,Can't Lose
44226,1156,2,"125,89999999999999",2,1,1,4,Low-Value,Can't Lose
44227,1684,1,"5,2",1,1,1,3,Low-Value,Lost
44229,50,3,"110,5",5,1,1,7,Mid-Value,Potential Loyalists
44230,739,3,"595,1",3,1,1,5,Low-Value,At Risk Customers
44232,731,8,"286,15",3,2,1,6,Mid-Value,Potential Loyalists
44233,933,1,"19,799999999999997",3,1,1,5,Low-Value,At Risk Customers
44234,533,10,"492,3",4,2,1,7,Mid-Value,Potential Loyalists
44236,15,4,"678,05",5,1,2,8,High-Value,Potential Loyalists
44238,398,4,"148,1",4,1,1,6,Mid-Value,Potential Loyalists
44239,1790,1,"25,5",1,1,1,3,Low-Value,Lost
44240,1273,2,"229,75",2,1,1,4,Low-Value,Can't Lose
44241,274,7,"336,55",5,2,1,8,High-Value,Potential Loyalists
44242,143,5,"278,65",5,1,1,7,Mid-Value,Potential Loyalists
44247,419,3,"85,4",4,1,1,6,Mid-Value,Potential Loyalists
44248,289,5,"305,0",5,1,1,7,Mid-Value,Potential Loyalists
44249,1004,2,"72,35",3,1,1,5,Low-Value,At Risk Customers
44250,62,7,"414,2",5,2,1,8,High-Value,Potential Loyalists
44251,134,4,"275,6",5,1,1,7,Mid-Value,Potential Loyalists
44252,722,1,"1754,8999999999999",4,1,3,8,High-Value,Potential Loyalists
44254,492,3,"106,0",4,1,1,6,Mid-Value,Potential Loyalists
44255,1051,1,"121,65",3,1,1,5,Low-Value,At Risk Customers
44256,1365,1,"98,45",2,1,1,4,Low-Value,Can't Lose
44257,1096,4,"475,75",2,1,1,4,Low-Value,Can't Lose
44258,596,2,"351,20000000000005",4,1,1,6,Mid-Value,Potential Loyalists
44260,264,2,"208,2",5,1,1,7,Mid-Value,Potential Loyalists
44267,375,10,"803,9",4,2,2,8,High-Value,Potential Loyalists
44269,18,2,"203,1",5,1,1,7,Mid-Value,Potential Loyalists
44272,22,2,"357,0",5,1,1,7,Mid-Value,Potential Loyalists
44273,779,9,"908,85",3,2,2,7,Mid-Value,Potential Loyalists
44274,182,4,"340,8",5,1,1,7,Mid-Value,Potential Loyalists
44275,20,9,"424,55",5,2,1,8,High-Value,Potential Loyalists
44276,999,1,"753,9000000000001",3,1,2,6,Mid-Value,Potential Loyalists
44278,1437,1,"92,0",2,1,1,4,Low-Value,Can't Lose
44279,31,2,"40,699999999999996",5,1,1,7,Mid-Value,Potential Loyalists
44281,626,4,"68,4",4,1,1,6,Mid-Value,Potential Loyalists
44282,301,4,"295,05",5,1,1,7,Mid-Value,Potential Loyalists
44283,1503,1,"85,35",1,1,1,3,Low-Value,Lost
44284,39,4,"169,35000000000002",5,1,1,7,Mid-Value,Potential Loyalists
44287,80,2,"38,599999999999994",5,1,1,7,Mid-Value,Potential Loyalists
44289,1184,1,"18,25",2,1,1,4,Low-Value,Can't Lose
44290,385,1,"20,0",4,1,1,6,Mid-Value,Potential Loyalists
44292,1062,3,"41,45",3,1,1,5,Low-Value,At Risk Customers
44293,594,1,"30,95",4,1,1,6,Mid-Value,Potential Loyalists
44294,169,2,"139,2",5,1,1,7,Mid-Value,Potential Loyalists
44295,74,8,"537,45",5,2,1,8,High-Value,Potential Loyalists
44296,132,3,"656,5",5,1,1,7,Mid-Value,Potential Loyalists
44298,302,3,"243,39999999999998",5,1,1,7,Mid-Value,Potential Loyalists
44299,633,3,"173,15",4,1,1,6,Mid-Value,Potential Loyalists
44301,300,1,"14,35",5,1,1,7,Mid-Value,Potential Loyalists
44305,1607,2,"257,5",1,1,1,3,Low-Value,Lost
44307,336,2,"287,4",5,1,1,7,Mid-Value,Potential Loyalists
44310,31,7,"558,25",5,2,1,8,High-Value,Potential Loyalists
44311,754,2,"123,89999999999999",3,1,1,5,Low-Value,At Risk Customers
44313,215,6,"364,35",5,1,1,7,Mid-Value,Potential Loyalists
44314,731,7,"281,05",3,2,1,6,Mid-Value,Potential Loyalists
44315,1661,1,"113,69999999999999",1,1,1,3,Low-Value,Lost
44318,1262,2,"232,39999999999998",2,1,1,4,Low-Value,Can't Lose
44320,199,5,"235,04999999999998",5,1,1,7,Mid-Value,Potential Loyalists
44322,567,7,"322,3",4,2,1,7,Mid-Value,Potential Loyalists
44324,97,2,"131,2",5,1,1,7,Mid-Value,Potential Loyalists
44325,1225,4,"291,65",2,1,1,4,Low-Value,Can't Lose
44326,1433,1,"254,6",2,1,1,4,Low-Value,Can't Lose
44329,1254,1,"102,8",2,1,1,4,Low-Value,Can't Lose
44330,388,10,"732,4",4,2,2,8,High-Value,Potential Loyalists
44332,809,6,"411,85",3,1,1,5,Low-Value,At Risk Customers
44333,869,3,"63,05",3,1,1,5,Low-Value,At Risk Customers
44334,1567,1,"95,5",1,1,1,3,Low-Value,Lost
44335,12,7,"406,85",5,2,1,8,High-Value,Potential Loyalists
44340,205,3,"214,9",5,1,1,7,Mid-Value,Potential Loyalists
44341,243,9,"251,10000000000002",5,2,1,8,High-Value,Potential Loyalists
44342,95,5,"293,3",5,1,1,7,Mid-Value,Potential Loyalists
44343,426,4,"103,95",4,1,1,6,Mid-Value,Potential Loyalists
44344,634,3,"122,45",4,1,1,6,Mid-Value,Potential Loyalists
44347,84,7,"609,1",5,2,1,8,High-Value,Potential Loyalists
44348,369,3,"131,8",4,1,1,6,Mid-Value,Potential Loyalists
44349,279,7,"517,3",5,2,1,8,High-Value,Potential Loyalists
44352,157,4,"146,54999999999998",5,1,1,7,Mid-Value,Potential Loyalists
44354,206,3,"322,8",5,1,1,7,Mid-Value,Potential Loyalists
44355,588,4,"147,9",4,1,1,6,Mid-Value,Potential Loyalists
44358,974,1,"574,2",3,1,1,5,Low-Value,At Risk Customers
44359,25,4,"304,45",5,1,1,7,Mid-Value,Potential Loyalists
44360,314,2,"70,5",5,1,1,7,Mid-Value,Potential Loyalists
44361,8,2,"481,45",5,1,1,7,Mid-Value,Potential Loyalists
44364,52,2,"97,7",5,1,1,7,Mid-Value,Potential Loyalists
44365,35,7,"311,35",5,2,1,8,High-Value,Potential Loyalists
44370,1483,2,"65,69999999999999",1,1,1,3,Low-Value,Lost
44371,752,1,"23,9",3,1,1,5,Low-Value,At Risk Customers
44375,520,2,"63,699999999999996",4,1,1,6,Mid-Value,Potential Loyalists
44376,34,2,"50,75",5,1,1,7,Mid-Value,Potential Loyalists
44377,205,1,"91,7",5,1,1,7,Mid-Value,Potential Loyalists
44378,39,1,"79,0",5,1,1,7,Mid-Value,Potential Loyalists
44379,1435,2,"128,05",2,1,1,4,Low-Value,Can't Lose
44380,466,3,"121,3",4,1,1,6,Mid-Value,Potential Loyalists
44382,1033,2,"86,6",3,1,1,5,Low-Value,At Risk Customers
44385,513,7,"152,05",4,2,1,7,Mid-Value,Potential Loyalists
44386,44,2,"90,95",5,1,1,7,Mid-Value,Potential Loyalists
44387,512,1,"20,1",4,1,1,6,Mid-Value,Potential Loyalists
44388,784,1,"7,7",3,1,1,5,Low-Value,At Risk Customers
44389,107,11,"393,95000000000005",5,2,1,8,High-Value,Potential Loyalists
44392,1476,2,"153,45",1,1,1,3,Low-Value,Lost
44394,283,5,"63,75",5,1,1,7,Mid-Value,Potential Loyalists
44395,71,1,"5,4",5,1,1,7,Mid-Value,Potential Loyalists
44398,411,4,"185,65",4,1,1,6,Mid-Value,Potential Loyalists
44399,26,9,"366,85",5,2,1,8,High-Value,Potential Loyalists
44401,400,2,"62,05",4,1,1,6,Mid-Value,Potential Loyalists
44402,243,4,"153,95",5,1,1,7,Mid-Value,Potential Loyalists
44403,864,2,"78,4",3,1,1,5,Low-Value,At Risk Customers
44404,1284,4,"270,09999999999997",2,1,1,4,Low-Value,Can't Lose
44405,90,4,"178,05",5,1,1,7,Mid-Value,Potential Loyalists
44406,416,6,"591,5999999999999",4,1,1,6,Mid-Value,Potential Loyalists
44409,31,1,"8,6",5,1,1,7,Mid-Value,Potential Loyalists
44410,519,8,"617,3499999999999",4,2,1,7,Mid-Value,Potential Loyalists
44411,73,3,"134,45",5,1,1,7,Mid-Value,Potential Loyalists
44413,11,2,"71,9",5,1,1,7,Mid-Value,Potential Loyalists
44414,815,1,"35,099999999999994",3,1,1,5,Low-Value,At Risk Customers
44418,309,6,"404,55",5,1,1,7,Mid-Value,Potential Loyalists
44419,333,2,"52,35",5,1,1,7,Mid-Value,Potential Loyalists
44420,1134,2,"33,65",2,1,1,4,Low-Value,Can't Lose
44421,581,7,"572,45",4,2,1,7,Mid-Value,Potential Loyalists
44422,701,1,"32,15",4,1,1,6,Mid-Value,Potential Loyalists
44425,1178,1,"7,199999999999999",2,1,1,4,Low-Value,Can't Lose
44426,19,5,"424,15",5,1,1,7,Mid-Value,Potential Loyalists
44427,365,5,"310,35",5,1,1,7,Mid-Value,Potential Loyalists
44428,1595,1,"112,80000000000001",1,1,1,3,Low-Value,Lost
44429,853,3,"81,2",3,1,1,5,Low-Value,At Risk Customers
44430,323,4,"176,35",5,1,1,7,Mid-Value,Potential Loyalists
44433,315,5,"497,95",5,1,1,7,Mid-Value,Potential Loyalists
44434,255,8,"240,79999999999998",5,2,1,8,High-Value,Potential Loyalists
44435,1684,1,"89,4",1,1,1,3,Low-Value,Lost
44436,620,4,"292,5",4,1,1,6,Mid-Value,Potential Loyalists
44437,5,4,"270,9",5,1,1,7,Mid-Value,Potential Loyalists
44439,410,14,"1693,1",4,3,3,10,High-Value,Champions
44440,431,2,"126,95",4,1,1,6,Mid-Value,Potential Loyalists
44445,1658,1,"132,0",1,1,1,3,Low-Value,Lost
44446,199,1,"204,0",5,1,1,7,Mid-Value,Potential Loyalists
44449,342,8,"335,4",5,2,1,8,High-Value,Potential Loyalists
44451,124,1,"151,2",5,1,1,7,Mid-Value,Potential Loyalists
44454,536,4,"176,0",4,1,1,6,Mid-Value,Potential Loyalists
44455,30,1,"436,6",5,1,1,7,Mid-Value,Potential Loyalists
44456,893,2,"49,25",3,1,1,5,Low-Value,At Risk Customers
44457,953,1,"38,25",3,1,1,5,Low-Value,At Risk Customers
44458,187,2,"127,55000000000001",5,1,1,7,Mid-Value,Potential Loyalists
44459,903,2,"66,85",3,1,1,5,Low-Value,At Risk Customers
44460,1160,1,"37,85",2,1,1,4,Low-Value,Can't Lose
44462,153,3,"53,099999999999994",5,1,1,7,Mid-Value,Potential Loyalists
44464,391,1,"372,6",4,1,1,6,Mid-Value,Potential Loyalists
44465,1815,1,"25,1",1,1,1,3,Low-Value,Lost
44466,425,9,"696,15",4,2,2,8,High-Value,Potential Loyalists
44468,1151,2,"77,55000000000001",2,1,1,4,Low-Value,Can't Lose
44469,699,4,"309,15000000000003",4,1,1,6,Mid-Value,Potential Loyalists
44470,14,9,"467,05",5,2,1,8,High-Value,Potential Loyalists
44471,755,2,"255,1",3,1,1,5,Low-Value,At Risk Customers
44472,246,11,"775,7",5,2,2,9,High-Value,Champions
44474,722,6,"478,15",4,1,1,6,Mid-Value,Potential Loyalists
44476,615,1,"52,7",4,1,1,6,Mid-Value,Potential Loyalists
44479,376,5,"601,05",4,1,1,6,Mid-Value,Potential Loyalists
44482,77,4,"279,9",5,1,1,7,Mid-Value,Potential Loyalists
44484,802,1,"49,2",3,1,1,5,Low-Value,At Risk Customers
44490,558,1,"115,94999999999999",4,1,1,6,Mid-Value,Potential Loyalists
44491,1154,3,"31,85",2,1,1,4,Low-Value,Can't Lose
44492,498,5,"267,05",4,1,1,6,Mid-Value,Potential Loyalists
44494,495,7,"837,9",4,2,2,8,High-Value,Potential Loyalists
44495,416,2,"113,2",4,1,1,6,Mid-Value,Potential Loyalists
44496,1446,1,"53,0",2,1,1,4,Low-Value,Can't Lose
44497,738,1,"10,4",3,1,1,5,Low-Value,At Risk Customers
44498,119,1,"156,3",5,1,1,7,Mid-Value,Potential Loyalists
44499,1109,1,"12,4",2,1,1,4,Low-Value,Can't Lose
44500,108,5,"131,45",5,1,1,7,Mid-Value,Potential Loyalists
44501,847,3,"147,5",3,1,1,5,Low-Value,At Risk Customers
44503,630,2,"103,35",4,1,1,6,Mid-Value,Potential Loyalists
44504,797,3,"193,75",3,1,1,5,Low-Value,At Risk Customers
44505,737,3,"48,2",3,1,1,5,Low-Value,At Risk Customers
44508,1487,1,"35,95",1,1,1,3,Low-Value,Lost
44509,182,5,"227,85000000000002",5,1,1,7,Mid-Value,Potential Loyalists
44510,1263,2,"63,05",2,1,1,4,Low-Value,Can't Lose
44512,62,12,"326,4",5,3,1,9,High-Value,Champions
44513,1792,1,"9,75",1,1,1,3,Low-Value,Lost
44514,412,2,"353,90000000000003",4,1,1,6,Mid-Value,Potential Loyalists
44515,369,8,"968,35",4,2,2,8,High-Value,Potential Loyalists
44517,643,2,"137,89999999999998",4,1,1,6,Mid-Value,Potential Loyalists
44518,1221,1,"44,1",2,1,1,4,Low-Value,Can't Lose
44519,481,2,"51,5",4,1,1,6,Mid-Value,Potential Loyalists
44521,721,1,"38,1",4,1,1,6,Mid-Value,Potential Loyalists
44522,1165,3,"83,35",2,1,1,4,Low-Value,Can't Lose
44523,854,4,"217,65",3,1,1,5,Low-Value,At Risk Customers
44524,22,8,"331,4",5,2,1,8,High-Value,Potential Loyalists
44525,61,5,"200,05",5,1,1,7,Mid-Value,Potential Loyalists
44526,1591,1,"16,2",1,1,1,3,Low-Value,Lost
44527,878,3,"24,0",3,1,1,5,Low-Value,At Risk Customers
44529,170,12,"951,55",5,3,2,10,High-Value,Champions
44530,1357,1,"19,4",2,1,1,4,Low-Value,Can't Lose
44532,1228,2,"328,69999999999993",2,1,1,4,Low-Value,Can't Lose
44535,123,4,"223,25",5,1,1,7,Mid-Value,Potential Loyalists
44536,109,5,"369,9",5,1,1,7,Mid-Value,Potential Loyalists
44538,239,7,"387,3",5,2,1,8,High-Value,Potential Loyalists
44540,962,1,"29,3",3,1,1,5,Low-Value,At Risk Customers
44542,829,9,"718,25",3,2,2,7,Mid-Value,Potential Loyalists
44543,685,4,"121,39999999999999",4,1,1,6,Mid-Value,Potential Loyalists
44544,453,9,"719,05",4,2,2,8,High-Value,Potential Loyalists
44549,186,1,"86,1",5,1,1,7,Mid-Value,Potential Loyalists
44551,34,14,"2029,25",5,3,4,12,High-Value,Champions
44552,1591,2,"34,25",1,1,1,3,Low-Value,Lost
44554,711,8,"187,0",4,2,1,7,Mid-Value,Potential Loyalists
44556,317,8,"503,5",5,2,1,8,High-Value,Potential Loyalists
44557,213,3,"512,9499999999999",5,1,1,7,Mid-Value,Potential Loyalists
44558,1530,2,"48,25",1,1,1,3,Low-Value,Lost
44560,1676,2,"82,25",1,1,1,3,Low-Value,Lost
44561,1629,1,"174,8",1,1,1,3,Low-Value,Lost
44562,450,2,"100,4",4,1,1,6,Mid-Value,Potential Loyalists
44563,412,3,"77,4",4,1,1,6,Mid-Value,Potential Loyalists
44564,17,5,"370,1",5,1,1,7,Mid-Value,Potential Loyalists
44565,311,4,"87,0",5,1,1,7,Mid-Value,Potential Loyalists
44566,795,1,"177,9",3,1,1,5,Low-Value,At Risk Customers
44567,1022,1,"16,9",3,1,1,5,Low-Value,At Risk Customers
44568,728,4,"265,40000000000003",4,1,1,6,Mid-Value,Potential Loyalists
44569,269,5,"355,1",5,1,1,7,Mid-Value,Potential Loyalists
44570,1403,4,"151,2",2,1,1,4,Low-Value,Can't Lose
44572,800,6,"926,0499999999998",3,1,2,6,Mid-Value,Potential Loyalists
44576,310,2,"161,75",5,1,1,7,Mid-Value,Potential Loyalists
44579,243,4,"421,6",5,1,1,7,Mid-Value,Potential Loyalists
44580,3,8,"723,35",5,2,2,9,High-Value,Champions
44581,823,4,"111,1",3,1,1,5,Low-Value,At Risk Customers
44583,574,3,"366,35",4,1,1,6,Mid-Value,Potential Loyalists
44584,83,10,"364,0",5,2,1,8,High-Value,Potential Loyalists
44586,434,1,"24,95",4,1,1,6,Mid-Value,Potential Loyalists
44588,382,5,"289,75",4,1,1,6,Mid-Value,Potential Loyalists
44589,326,3,"166,79999999999998",5,1,1,7,Mid-Value,Potential Loyalists
44590,231,3,"55,65",5,1,1,7,Mid-Value,Potential Loyalists
44591,839,3,"174,45",3,1,1,5,Low-Value,At Risk Customers
44593,304,3,"85,6",5,1,1,7,Mid-Value,Potential Loyalists
44596,137,4,"430,6",5,1,1,7,Mid-Value,Potential Loyalists
44597,443,2,"67,5",4,1,1,6,Mid-Value,Potential Loyalists
44598,565,3,"347,3",4,1,1,6,Mid-Value,Potential Loyalists
44600,718,1,"9,3",4,1,1,6,Mid-Value,Potential Loyalists
44601,55,15,"875,75",5,3,2,10,High-Value,Champions
44602,611,2,"68,8",4,1,1,6,Mid-Value,Potential Loyalists
44604,12,2,"117,39999999999999",5,1,1,7,Mid-Value,Potential Loyalists
44605,876,3,"142,9",3,1,1,5,Low-Value,At Risk Customers
44607,40,4,"171,0",5,1,1,7,Mid-Value,Potential Loyalists
44608,140,3,"150,75",5,1,1,7,Mid-Value,Potential Loyalists
44609,451,4,"464,29999999999995",4,1,1,6,Mid-Value,Potential Loyalists
44614,15,9,"442,40000000000003",5,2,1,8,High-Value,Potential Loyalists
44615,1,3,"166,7",5,1,1,7,Mid-Value,Potential Loyalists
44616,1650,1,"143,25",1,1,1,3,Low-Value,Lost
44617,194,4,"248,5",5,1,1,7,Mid-Value,Potential Loyalists
44618,1381,1,"17,65",2,1,1,4,Low-Value,Can't Lose
44619,1103,2,"129,15",2,1,1,4,Low-Value,Can't Lose
44620,1160,8,"688,5",2,2,2,6,Mid-Value,Potential Loyalists
44621,4,7,"430,7",5,2,1,8,High-Value,Potential Loyalists
44623,684,4,"232,9",4,1,1,6,Mid-Value,Potential Loyalists
44626,660,4,"366,09999999999997",4,1,1,6,Mid-Value,Potential Loyalists
44627,874,2,"745,3",3,1,2,6,Mid-Value,Potential Loyalists
44628,11,11,"427,5",5,2,1,8,High-Value,Potential Loyalists
44629,459,2,"17,9",4,1,1,6,Mid-Value,Potential Loyalists
44631,277,1,"11,8",5,1,1,7,Mid-Value,Potential Loyalists
44633,1589,1,"17,6",1,1,1,3,Low-Value,Lost
44634,984,3,"96,64999999999999",3,1,1,5,Low-Value,At Risk Customers
44635,1037,1,"51,35",3,1,1,5,Low-Value,At Risk Customers
44636,1181,3,"117,05",2,1,1,4,Low-Value,Can't Lose
44637,558,8,"438,65",4,2,1,7,Mid-Value,Potential Loyalists
44640,1213,3,"217,05",2,1,1,4,Low-Value,Can't Lose
44645,1200,3,"88,67999999999999",2,1,1,4,Low-Value,Can't Lose
44647,358,3,"955,4",5,1,2,8,High-Value,Potential Loyalists
44649,102,9,"307,6",5,2,1,8,High-Value,Potential Loyalists
44650,83,1,"116,6",5,1,1,7,Mid-Value,Potential Loyalists
44651,1214,3,"282,45",2,1,1,4,Low-Value,Can't Lose
44652,1770,1,"11,65",1,1,1,3,Low-Value,Lost
44653,539,2,"56,849999999999994",4,1,1,6,Mid-Value,Potential Loyalists
44654,569,2,"75,0",4,1,1,6,Mid-Value,Potential Loyalists
44655,255,4,"156,9",5,1,1,7,Mid-Value,Potential Loyalists
44656,809,1,"11,7",3,1,1,5,Low-Value,At Risk Customers
44659,1813,1,"71,95",1,1,1,3,Low-Value,Lost
44660,1338,2,"125,25",2,1,1,4,Low-Value,Can't Lose
44661,1170,5,"326,7",2,1,1,4,Low-Value,Can't Lose
44662,1701,1,"53,6",1,1,1,3,Low-Value,Lost
44663,1407,1,"25,8",2,1,1,4,Low-Value,Can't Lose
44664,665,2,"114,30000000000001",4,1,1,6,Mid-Value,Potential Loyalists
44667,201,1,"64,95",5,1,1,7,Mid-Value,Potential Loyalists
44669,96,3,"92,30000000000001",5,1,1,7,Mid-Value,Potential Loyalists
44672,475,1,"57,4",4,1,1,6,Mid-Value,Potential Loyalists
44673,235,2,"95,5",5,1,1,7,Mid-Value,Potential Loyalists
44674,23,7,"446,75",5,2,1,8,High-Value,Potential Loyalists
44675,809,3,"265,8",3,1,1,5,Low-Value,At Risk Customers
44676,760,6,"429,79999999999995",3,1,1,5,Low-Value,At Risk Customers
44681,384,2,"146,20000000000002",4,1,1,6,Mid-Value,Potential Loyalists
44683,412,2,"45,05",4,1,1,6,Mid-Value,Potential Loyalists
44684,174,3,"521,6",5,1,1,7,Mid-Value,Potential Loyalists
44685,629,3,"161,9",4,1,1,6,Mid-Value,Potential Loyalists
44686,258,2,"172,05",5,1,1,7,Mid-Value,Potential Loyalists
44689,774,3,"307,15",3,1,1,5,Low-Value,At Risk Customers
44690,203,1,"76,8",5,1,1,7,Mid-Value,Potential Loyalists
44691,0,6,"648,4",5,1,1,7,Mid-Value,Potential Loyalists
44692,27,5,"165,39999999999998",5,1,1,7,Mid-Value,Potential Loyalists
44693,52,5,"668,75",5,1,2,8,High-Value,Potential Loyalists
44694,1148,1,"35,45",2,1,1,4,Low-Value,Can't Lose
44695,5,4,"115,2",5,1,1,7,Mid-Value,Potential Loyalists
44696,15,12,"931,8",5,3,2,10,High-Value,Champions
44697,741,4,"64,25",3,1,1,5,Low-Value,At Risk Customers
44699,386,4,"168,65",4,1,1,6,Mid-Value,Potential Loyalists
44700,202,2,"96,4",5,1,1,7,Mid-Value,Potential Loyalists
44705,388,5,"394,25",4,1,1,6,Mid-Value,Potential Loyalists
44706,426,4,"154,0",4,1,1,6,Mid-Value,Potential Loyalists
44707,206,1,"35,0",5,1,1,7,Mid-Value,Potential Loyalists
44711,760,3,"265,05",3,1,1,5,Low-Value,At Risk Customers
44713,407,3,"223,8",4,1,1,6,Mid-Value,Potential Loyalists
44714,12,7,"326,75",5,2,1,8,High-Value,Potential Loyalists
44715,1310,1,"61,6",2,1,1,4,Low-Value,Can't Lose
44716,1191,1,"62,25",2,1,1,4,Low-Value,Can't Lose
44717,450,2,"21,65",4,1,1,6,Mid-Value,Potential Loyalists
44719,392,2,"317,65",4,1,1,6,Mid-Value,Potential Loyalists
44720,9,2,"71,2",5,1,1,7,Mid-Value,Potential Loyalists
44721,207,1,"133,0",5,1,1,7,Mid-Value,Potential Loyalists
44722,1182,4,"109,0",2,1,1,4,Low-Value,Can't Lose
44723,586,1,"7,8",4,1,1,6,Mid-Value,Potential Loyalists
44724,547,1,"14,4",4,1,1,6,Mid-Value,Potential Loyalists
44725,990,1,"42,15",3,1,1,5,Low-Value,At Risk Customers
44726,424,1,"34,5",4,1,1,6,Mid-Value,Potential Loyalists
44727,759,1,"63,9",3,1,1,5,Low-Value,At Risk Customers
44728,47,3,"107,64999999999999",5,1,1,7,Mid-Value,Potential Loyalists
44729,122,7,"305,54999999999995",5,2,1,8,High-Value,Potential Loyalists
44730,1618,1,"93,3",1,1,1,3,Low-Value,Lost
44731,302,1,"26,05",5,1,1,7,Mid-Value,Potential Loyalists
44732,378,3,"52,0",4,1,1,6,Mid-Value,Potential Loyalists
44733,395,3,"157,1",4,1,1,6,Mid-Value,Potential Loyalists
44734,15,6,"483,25",5,1,1,7,Mid-Value,Potential Loyalists
44735,284,4,"256,2",5,1,1,7,Mid-Value,Potential Loyalists
44736,813,5,"140,65",3,1,1,5,Low-Value,At Risk Customers
44737,3,11,"269,95",5,2,1,8,High-Value,Potential Loyalists
44738,21,12,"738,6999999999999",5,3,2,10,High-Value,Champions
44740,887,4,"319,70000000000005",3,1,1,5,Low-Value,At Risk Customers
44741,117,7,"425,6",5,2,1,8,High-Value,Potential Loyalists
44742,853,1,"41,5",3,1,1,5,Low-Value,At Risk Customers
44744,82,5,"368,59999999999997",5,1,1,7,Mid-Value,Potential Loyalists
44745,1384,1,"112,5",2,1,1,4,Low-Value,Can't Lose
44746,265,4,"679,0500000000001",5,1,2,8,High-Value,Potential Loyalists
44750,42,2,"45,75",5,1,1,7,Mid-Value,Potential Loyalists
44751,1142,2,"306,2",2,1,1,4,Low-Value,Can't Lose
44752,202,3,"470,84999999999997",5,1,1,7,Mid-Value,Potential Loyalists
44753,1753,1,"66,1",1,1,1,3,Low-Value,Lost
44756,15,2,"270,95000000000005",5,1,1,7,Mid-Value,Potential Loyalists
44757,259,2,"29,2",5,1,1,7,Mid-Value,Potential Loyalists
44758,529,4,"232,10000000000002",4,1,1,6,Mid-Value,Potential Loyalists
44760,1571,1,"9,9",1,1,1,3,Low-Value,Lost
44762,62,2,"216,0",5,1,1,7,Mid-Value,Potential Loyalists
44765,587,4,"295,54999999999995",4,1,1,6,Mid-Value,Potential Loyalists
44766,218,3,"74,45",5,1,1,7,Mid-Value,Potential Loyalists
44769,430,2,"388,20000000000005",4,1,1,6,Mid-Value,Potential Loyalists
44770,254,4,"568,5",5,1,1,7,Mid-Value,Potential Loyalists
44774,227,1,"228,0",5,1,1,7,Mid-Value,Potential Loyalists
44775,638,7,"247,10000000000002",4,2,1,7,Mid-Value,Potential Loyalists
44776,126,2,"78,04999999999998",5,1,1,7,Mid-Value,Potential Loyalists
44777,684,3,"224,2",4,1,1,6,Mid-Value,Potential Loyalists
44778,1074,2,"322,05",3,1,1,5,Low-Value,At Risk Customers
44779,20,4,"353,25",5,1,1,7,Mid-Value,Potential Loyalists
44781,911,7,"452,95",3,2,1,6,Mid-Value,Potential Loyalists
44783,5,5,"247,25",5,1,1,7,Mid-Value,Potential Loyalists
44785,754,3,"244,60000000000002",3,1,1,5,Low-Value,At Risk Customers
44786,257,2,"70,9",5,1,1,7,Mid-Value,Potential Loyalists
44787,1463,1,"81,8",1,1,1,3,Low-Value,Lost
44789,54,1,"58,6",5,1,1,7,Mid-Value,Potential Loyalists
44790,151,4,"162,7",5,1,1,7,Mid-Value,Potential Loyalists
44791,58,7,"724,1",5,2,2,9,High-Value,Champions
44792,7,7,"332,79999999999995",5,2,1,8,High-Value,Potential Loyalists
44795,806,1,"19,9",3,1,1,5,Low-Value,At Risk Customers
44797,1232,3,"326,9",2,1,1,4,Low-Value,Can't Lose
44798,183,8,"449,0",5,2,1,8,High-Value,Potential Loyalists
44800,187,4,"193,2",5,1,1,7,Mid-Value,Potential Loyalists
44801,157,5,"422,35",5,1,1,7,Mid-Value,Potential Loyalists
44802,1122,5,"370,40000000000003",2,1,1,4,Low-Value,Can't Lose
44803,1190,3,"115,45",2,1,1,4,Low-Value,Can't Lose
44805,21,6,"822,5",5,1,2,8,High-Value,Potential Loyalists
44806,1537,2,"443,4",1,1,1,3,Low-Value,Lost
44809,160,6,"367,8",5,1,1,7,Mid-Value,Potential Loyalists
44811,209,3,"50,3",5,1,1,7,Mid-Value,Potential Loyalists
44813,61,6,"170,85",5,1,1,7,Mid-Value,Potential Loyalists
44814,613,2,"317,45",4,1,1,6,Mid-Value,Potential Loyalists
44815,760,2,"113,10000000000001",3,1,1,5,Low-Value,At Risk Customers
44816,290,2,"27,950000000000003",5,1,1,7,Mid-Value,Potential Loyalists
44822,260,1,"85,4",5,1,1,7,Mid-Value,Potential Loyalists
44823,39,3,"53,3",5,1,1,7,Mid-Value,Potential Loyalists
44824,781,8,"309,5",3,2,1,6,Mid-Value,Potential Loyalists
44826,1215,3,"43,85",2,1,1,4,Low-Value,Can't Lose
44830,535,2,"294,1",4,1,1,6,Mid-Value,Potential Loyalists
44833,585,3,"231,14999999999998",4,1,1,6,Mid-Value,Potential Loyalists
44834,531,3,"90,35",4,1,1,6,Mid-Value,Potential Loyalists
44835,416,2,"103,2",4,1,1,6,Mid-Value,Potential Loyalists
44838,218,2,"173,6",5,1,1,7,Mid-Value,Potential Loyalists
44839,1664,1,"234,4",1,1,1,3,Low-Value,Lost
44840,12,6,"417,8",5,1,1,7,Mid-Value,Potential Loyalists
44844,83,12,"563,4",5,3,1,9,High-Value,Champions
44846,1712,1,"9,9",1,1,1,3,Low-Value,Lost
44848,28,2,"173,05",5,1,1,7,Mid-Value,Potential Loyalists
44849,8,3,"77,85",5,1,1,7,Mid-Value,Potential Loyalists
44854,680,1,"26,3",4,1,1,6,Mid-Value,Potential Loyalists
44856,117,9,"1345,6",5,2,3,10,High-Value,Champions
44858,1562,1,"19,5",1,1,1,3,Low-Value,Lost
44862,949,2,"181,6",3,1,1,5,Low-Value,At Risk Customers
44864,857,2,"154,39999999999998",3,1,1,5,Low-Value,At Risk Customers
44866,15,10,"339,35",5,2,1,8,High-Value,Potential Loyalists
44869,20,4,"178,6",5,1,1,7,Mid-Value,Potential Loyalists
44870,409,1,"27,0",4,1,1,6,Mid-Value,Potential Loyalists
44872,501,11,"853,2",4,2,2,8,High-Value,Potential Loyalists
44873,402,1,"73,85",4,1,1,6,Mid-Value,Potential Loyalists
44874,465,2,"28,95",4,1,1,6,Mid-Value,Potential Loyalists
44876,15,5,"563,7",5,1,1,7,Mid-Value,Potential Loyalists
44880,416,1,"18,05",4,1,1,6,Mid-Value,Potential Loyalists
44881,749,2,"86,1",3,1,1,5,Low-Value,At Risk Customers
44883,369,9,"492,85",4,2,1,7,Mid-Value,Potential Loyalists
44886,206,7,"682,25",5,2,2,9,High-Value,Champions
44887,516,2,"34,099999999999994",4,1,1,6,Mid-Value,Potential Loyalists
44888,62,3,"359,90000000000003",5,1,1,7,Mid-Value,Potential Loyalists
44889,242,7,"366,25",5,2,1,8,High-Value,Potential Loyalists
44891,197,1,"123,60000000000001",5,1,1,7,Mid-Value,Potential Loyalists
44893,160,1,"32,7",5,1,1,7,Mid-Value,Potential Loyalists
44894,33,7,"494,15000000000003",5,2,1,8,High-Value,Potential Loyalists
44895,517,3,"227,65000000000003",4,1,1,6,Mid-Value,Potential Loyalists
44896,55,6,"490,3",5,1,1,7,Mid-Value,Potential Loyalists
44899,753,3,"262,15",3,1,1,5,Low-Value,At Risk Customers
44900,1362,2,"166,95",2,1,1,4,Low-Value,Can't Lose
44901,113,5,"267,4",5,1,1,7,Mid-Value,Potential Loyalists
44902,259,3,"39,35",5,1,1,7,Mid-Value,Potential Loyalists
44904,202,2,"95,75",5,1,1,7,Mid-Value,Potential Loyalists
44905,883,2,"25,200000000000003",3,1,1,5,Low-Value,At Risk Customers
44906,314,1,"66,7",5,1,1,7,Mid-Value,Potential Loyalists
44907,175,1,"73,6",5,1,1,7,Mid-Value,Potential Loyalists
44909,254,1,"12,9",5,1,1,7,Mid-Value,Potential Loyalists
44910,534,2,"120,44999999999999",4,1,1,6,Mid-Value,Potential Loyalists
44912,378,1,"87,4",4,1,1,6,Mid-Value,Potential Loyalists
44914,553,2,"236,10000000000002",4,1,1,6,Mid-Value,Potential Loyalists
44915,85,2,"57,5",5,1,1,7,Mid-Value,Potential Loyalists
44917,151,2,"79,2",5,1,1,7,Mid-Value,Potential Loyalists
44919,420,4,"151,45",4,1,1,6,Mid-Value,Potential Loyalists
44920,1601,2,"30,0",1,1,1,3,Low-Value,Lost
44921,41,10,"482,45",5,2,1,8,High-Value,Potential Loyalists
44922,1151,3,"95,3",2,1,1,4,Low-Value,Can't Lose
44924,359,3,"131,35",5,1,1,7,Mid-Value,Potential Loyalists
44925,1196,1,"6,15",2,1,1,4,Low-Value,Can't Lose
44927,99,4,"210,4",5,1,1,7,Mid-Value,Potential Loyalists
44928,313,1,"38,1",5,1,1,7,Mid-Value,Potential Loyalists
44929,130,5,"204,3",5,1,1,7,Mid-Value,Potential Loyalists
44930,146,1,"30,7",5,1,1,7,Mid-Value,Potential Loyalists
44931,501,4,"131,35",4,1,1,6,Mid-Value,Potential Loyalists
44934,283,2,"46,95",5,1,1,7,Mid-Value,Potential Loyalists
44935,777,4,"542,1999999999999",3,1,1,5,Low-Value,At Risk Customers
44936,353,2,"28,8",5,1,1,7,Mid-Value,Potential Loyalists
44939,580,1,"240,60000000000002",4,1,1,6,Mid-Value,Potential Loyalists
44940,467,3,"264,6",4,1,1,6,Mid-Value,Potential Loyalists
44942,1190,2,"65,3",2,1,1,4,Low-Value,Can't Lose
44943,19,3,"84,94999999999999",5,1,1,7,Mid-Value,Potential Loyalists
44945,188,4,"446,8",5,1,1,7,Mid-Value,Potential Loyalists
44946,1806,1,"119,25",1,1,1,3,Low-Value,Lost
44948,1363,1,"22,7",2,1,1,4,Low-Value,Can't Lose
44952,132,3,"97,75999999999999",5,1,1,7,Mid-Value,Potential Loyalists
44953,1165,1,"10,85",2,1,1,4,Low-Value,Can't Lose
44954,886,5,"263,85",3,1,1,5,Low-Value,At Risk Customers
44956,186,3,"353,85",5,1,1,7,Mid-Value,Potential Loyalists
44957,739,4,"496,35",3,1,1,5,Low-Value,At Risk Customers
44960,885,1,"31,9",3,1,1,5,Low-Value,At Risk Customers
44961,1796,1,"15,2",1,1,1,3,Low-Value,Lost
44962,929,3,"135,45",3,1,1,5,Low-Value,At Risk Customers
44964,126,3,"162,1",5,1,1,7,Mid-Value,Potential Loyalists
44965,1138,1,"11,3",2,1,1,4,Low-Value,Can't Lose
44966,167,3,"232,95",5,1,1,7,Mid-Value,Potential Loyalists
44967,134,2,"49,9",5,1,1,7,Mid-Value,Potential Loyalists
44968,1126,7,"388,15",2,2,1,5,Low-Value,At Risk Customers
44969,881,1,"45,1",3,1,1,5,Low-Value,At Risk Customers
44970,13,4,"361,4",5,1,1,7,Mid-Value,Potential Loyalists
44972,122,3,"105,7",5,1,1,7,Mid-Value,Potential Loyalists
44973,374,8,"228,5",4,2,1,7,Mid-Value,Potential Loyalists
44974,1148,2,"147,04999999999998",2,1,1,4,Low-Value,Can't Lose
44977,1336,1,"22,9",2,1,1,4,Low-Value,Can't Lose
44978,369,2,"137,45",4,1,1,6,Mid-Value,Potential Loyalists
44982,1484,1,"75,75",1,1,1,3,Low-Value,Lost
44983,1607,1,"28,3",1,1,1,3,Low-Value,Lost
44984,198,2,"126,85",5,1,1,7,Mid-Value,Potential Loyalists
44985,523,2,"103,55000000000001",4,1,1,6,Mid-Value,Potential Loyalists
44986,239,2,"39,25",5,1,1,7,Mid-Value,Potential Loyalists
44987,248,3,"109,4",5,1,1,7,Mid-Value,Potential Loyalists
44989,284,6,"301,45",5,1,1,7,Mid-Value,Potential Loyalists
44990,25,10,"297,55",5,2,1,8,High-Value,Potential Loyalists
44991,1383,2,"12,45",2,1,1,4,Low-Value,Can't Lose
44992,136,1,"36,9",5,1,1,7,Mid-Value,Potential Loyalists
44993,1098,4,"153,75",2,1,1,4,Low-Value,Can't Lose
44994,335,2,"94,94999999999999",5,1,1,7,Mid-Value,Potential Loyalists
44995,10,6,"129,5",5,1,1,7,Mid-Value,Potential Loyalists
44996,14,4,"488,85",5,1,1,7,Mid-Value,Potential Loyalists
44997,20,13,"479,9",5,3,1,9,High-Value,Champions
44998,699,2,"201,75",4,1,1,6,Mid-Value,Potential Loyalists
45000,599,2,"35,45",4,1,1,6,Mid-Value,Potential Loyalists
45002,1042,3,"94,55",3,1,1,5,Low-Value,At Risk Customers
45003,1439,2,"315,6",2,1,1,4,Low-Value,Can't Lose
45004,906,1,"85,5",3,1,1,5,Low-Value,At Risk Customers
45005,1776,1,"19,4",1,1,1,3,Low-Value,Lost
45006,1376,1,"76,9",2,1,1,4,Low-Value,Can't Lose
45010,998,3,"63,05",3,1,1,5,Low-Value,At Risk Customers
45011,21,5,"203,15",5,1,1,7,Mid-Value,Potential Loyalists
45012,1239,2,"26,1",2,1,1,4,Low-Value,Can't Lose
45014,248,2,"41,599999999999994",5,1,1,7,Mid-Value,Potential Loyalists
45017,205,3,"121,9",5,1,1,7,Mid-Value,Potential Loyalists
45021,1178,2,"25,950000000000003",2,1,1,4,Low-Value,Can't Lose
45025,137,4,"162,4",5,1,1,7,Mid-Value,Potential Loyalists
45026,32,5,"471,2",5,1,1,7,Mid-Value,Potential Loyalists
45028,881,2,"111,5",3,1,1,5,Low-Value,At Risk Customers
45031,1706,3,"77,1",1,1,1,3,Low-Value,Lost
45032,103,4,"62,2",5,1,1,7,Mid-Value,Potential Loyalists
45033,505,3,"44,7",4,1,1,6,Mid-Value,Potential Loyalists
45034,419,2,"274,5",4,1,1,6,Mid-Value,Potential Loyalists
45035,423,5,"307,0",4,1,1,6,Mid-Value,Potential Loyalists
45037,968,3,"129,13",3,1,1,5,Low-Value,At Risk Customers
45038,854,3,"62,3",3,1,1,5,Low-Value,At Risk Customers
45039,724,1,"31,35",4,1,1,6,Mid-Value,Potential Loyalists
45040,1275,2,"187,2",2,1,1,4,Low-Value,Can't Lose
45041,1769,1,"17,9",1,1,1,3,Low-Value,Lost
45042,463,3,"168,35",4,1,1,6,Mid-Value,Potential Loyalists
45043,700,2,"75,69999999999999",4,1,1,6,Mid-Value,Potential Loyalists
45044,966,2,"83,2",3,1,1,5,Low-Value,At Risk Customers
45045,270,4,"190,70000000000002",5,1,1,7,Mid-Value,Potential Loyalists
45046,392,7,"636,2",4,2,1,7,Mid-Value,Potential Loyalists
45048,792,4,"167,1",3,1,1,5,Low-Value,At Risk Customers
45049,1623,1,"130,5",1,1,1,3,Low-Value,Lost
45050,148,2,"208,6",5,1,1,7,Mid-Value,Potential Loyalists
45051,128,6,"387,25",5,1,1,7,Mid-Value,Potential Loyalists
45052,147,3,"189,75",5,1,1,7,Mid-Value,Potential Loyalists
45056,199,3,"186,85",5,1,1,7,Mid-Value,Potential Loyalists
45057,910,2,"169,05",3,1,1,5,Low-Value,At Risk Customers
45060,284,1,"15,9",5,1,1,7,Mid-Value,Potential Loyalists
45062,9,5,"121,55000000000001",5,1,1,7,Mid-Value,Potential Loyalists
45063,486,1,"59,65",4,1,1,6,Mid-Value,Potential Loyalists
45064,92,2,"50,599999999999994",5,1,1,7,Mid-Value,Potential Loyalists
45065,1559,5,"339,85",1,1,1,3,Low-Value,Lost
45067,126,7,"394,8",5,2,1,8,High-Value,Potential Loyalists
45068,738,2,"912,7",3,1,2,6,Mid-Value,Potential Loyalists
45069,1498,2,"60,95",1,1,1,3,Low-Value,Lost
45070,259,8,"181,05",5,2,1,8,High-Value,Potential Loyalists
45072,31,5,"218,10000000000002",5,1,1,7,Mid-Value,Potential Loyalists
45074,463,4,"266,35",4,1,1,6,Mid-Value,Potential Loyalists
45075,230,14,"738,6999999999999",5,3,2,10,High-Value,Champions
45076,1167,3,"145,45000000000002",2,1,1,4,Low-Value,Can't Lose
45077,826,3,"77,1",3,1,1,5,Low-Value,At Risk Customers
45078,1012,3,"153,05",3,1,1,5,Low-Value,At Risk Customers
45079,164,2,"235,1",5,1,1,7,Mid-Value,Potential Loyalists
45080,575,3,"133,05",4,1,1,6,Mid-Value,Potential Loyalists
45081,19,2,"34,150000000000006",5,1,1,7,Mid-Value,Potential Loyalists
45083,1150,4,"365,0",2,1,1,4,Low-Value,Can't Lose
45084,11,5,"154,25",5,1,1,7,Mid-Value,Potential Loyalists
45085,400,14,"731,7",4,3,2,9,High-Value,Champions
45087,183,4,"198,9",5,1,1,7,Mid-Value,Potential Loyalists
45088,11,5,"214,0",5,1,1,7,Mid-Value,Potential Loyalists
45089,25,8,"1330,3500000000001",5,2,3,10,High-Value,Champions
45091,670,1,"1,9",4,1,1,6,Mid-Value,Potential Loyalists
45092,237,1,"22,0",5,1,1,7,Mid-Value,Potential Loyalists
45093,37,2,"340,45000000000005",5,1,1,7,Mid-Value,Potential Loyalists
45094,59,2,"24,799999999999997",5,1,1,7,Mid-Value,Potential Loyalists
45095,440,2,"55,349999999999994",4,1,1,6,Mid-Value,Potential Loyalists
45096,10,4,"108,4",5,1,1,7,Mid-Value,Potential Loyalists
45098,181,4,"109,45",5,1,1,7,Mid-Value,Potential Loyalists
45099,66,8,"335,0",5,2,1,8,High-Value,Potential Loyalists
45100,1132,5,"282,40000000000003",2,1,1,4,Low-Value,Can't Lose
45101,333,3,"123,75",5,1,1,7,Mid-Value,Potential Loyalists
45102,1358,2,"90,05",2,1,1,4,Low-Value,Can't Lose
45103,1314,1,"116,05",2,1,1,4,Low-Value,Can't Lose
45105,501,1,"45,3",4,1,1,6,Mid-Value,Potential Loyalists
45107,160,2,"81,4",5,1,1,7,Mid-Value,Potential Loyalists
45108,864,2,"49,1",3,1,1,5,Low-Value,At Risk Customers
45112,238,4,"206,8",5,1,1,7,Mid-Value,Potential Loyalists
45113,1276,3,"41,95",2,1,1,4,Low-Value,Can't Lose
45114,923,2,"175,4",3,1,1,5,Low-Value,At Risk Customers
45115,126,3,"257,15000000000003",5,1,1,7,Mid-Value,Potential Loyalists
45116,249,1,"103,0",5,1,1,7,Mid-Value,Potential Loyalists
45117,222,5,"275,5",5,1,1,7,Mid-Value,Potential Loyalists
45119,10,6,"245,25",5,1,1,7,Mid-Value,Potential Loyalists
45120,92,4,"218,35000000000002",5,1,1,7,Mid-Value,Potential Loyalists
45121,130,13,"1044,8500000000001",5,3,2,10,High-Value,Champions
45122,1547,1,"276,0",1,1,1,3,Low-Value,Lost
45123,337,1,"125,65",5,1,1,7,Mid-Value,Potential Loyalists
45124,237,3,"219,85",5,1,1,7,Mid-Value,Potential Loyalists
45125,1153,2,"28,1",2,1,1,4,Low-Value,Can't Lose
45126,679,1,"608,75",4,1,1,6,Mid-Value,Potential Loyalists
45127,242,10,"379,0",5,2,1,8,High-Value,Potential Loyalists
45128,132,3,"247,10000000000002",5,1,1,7,Mid-Value,Potential Loyalists
45129,1302,1,"270,0",2,1,1,4,Low-Value,Can't Lose
45130,663,3,"115,85",4,1,1,6,Mid-Value,Potential Loyalists
45131,447,1,"6,3",4,1,1,6,Mid-Value,Potential Loyalists
45133,276,3,"116,6",5,1,1,7,Mid-Value,Potential Loyalists
45134,52,3,"205,79999999999998",5,1,1,7,Mid-Value,Potential Loyalists
45135,1707,1,"28,25",1,1,1,3,Low-Value,Lost
45136,1124,1,"32,3",2,1,1,4,Low-Value,Can't Lose
45138,20,7,"427,45",5,2,1,8,High-Value,Potential Loyalists
45140,734,4,"168,25",3,1,1,5,Low-Value,At Risk Customers
45142,21,10,"747,45",5,2,2,9,High-Value,Champions
45143,681,2,"65,05",4,1,1,6,Mid-Value,Potential Loyalists
45145,200,2,"152,54999999999998",5,1,1,7,Mid-Value,Potential Loyalists
45146,830,6,"118,55",3,1,1,5,Low-Value,At Risk Customers
45149,504,2,"224,5",4,1,1,6,Mid-Value,Potential Loyalists
45151,593,1,"63,2",4,1,1,6,Mid-Value,Potential Loyalists
45153,1114,3,"136,6",2,1,1,4,Low-Value,Can't Lose
45155,382,2,"75,35",4,1,1,6,Mid-Value,Potential Loyalists
45157,435,4,"209,45",4,1,1,6,Mid-Value,Potential Loyalists
45158,167,3,"224,74999999999997",5,1,1,7,Mid-Value,Potential Loyalists
45159,595,5,"455,65",4,1,1,6,Mid-Value,Potential Loyalists
45161,1305,2,"123,9",2,1,1,4,Low-Value,Can't Lose
45162,136,6,"561,3000000000001",5,1,1,7,Mid-Value,Potential Loyalists
45164,663,7,"410,1",4,2,1,7,Mid-Value,Potential Loyalists
45167,593,11,"1329,8",4,2,3,9,High-Value,Champions
45168,784,1,"155,3",3,1,1,5,Low-Value,At Risk Customers
45170,12,12,"735,85",5,3,2,10,High-Value,Champions
45173,1494,2,"95,25",1,1,1,3,Low-Value,Lost
45176,315,5,"151,95",5,1,1,7,Mid-Value,Potential Loyalists
45177,404,6,"271,0",4,1,1,6,Mid-Value,Potential Loyalists
45178,370,5,"186,10000000000002",4,1,1,6,Mid-Value,Potential Loyalists
45179,231,7,"754,5",5,2,2,9,High-Value,Champions
45180,568,1,"375,45000000000005",4,1,1,6,Mid-Value,Potential Loyalists
45183,787,3,"151,6",3,1,1,5,Low-Value,At Risk Customers
45184,326,3,"566,1",5,1,1,7,Mid-Value,Potential Loyalists
45187,382,4,"276,65",4,1,1,6,Mid-Value,Potential Loyalists
45188,733,4,"138,5",3,1,1,5,Low-Value,At Risk Customers
45189,502,1,"7,7",4,1,1,6,Mid-Value,Potential Loyalists
45191,36,3,"382,15",5,1,1,7,Mid-Value,Potential Loyalists
45192,60,9,"455,95",5,2,1,8,High-Value,Potential Loyalists
45196,1734,1,"55,5",1,1,1,3,Low-Value,Lost
45198,325,6,"484,3",5,1,1,7,Mid-Value,Potential Loyalists
45201,1694,1,"24,85",1,1,1,3,Low-Value,Lost
45203,1010,2,"42,35",3,1,1,5,Low-Value,At Risk Customers
45205,764,3,"120,75",3,1,1,5,Low-Value,At Risk Customers
45206,135,4,"210,8",5,1,1,7,Mid-Value,Potential Loyalists
45207,350,3,"156,1",5,1,1,7,Mid-Value,Potential Loyalists
45209,336,2,"349,55",5,1,1,7,Mid-Value,Potential Loyalists
45210,995,2,"649,6",3,1,1,5,Low-Value,At Risk Customers
45216,1407,2,"34,6",2,1,1,4,Low-Value,Can't Lose
45217,518,2,"48,05",4,1,1,6,Mid-Value,Potential Loyalists
45219,281,2,"60,2",5,1,1,7,Mid-Value,Potential Loyalists
45220,372,10,"572,95",4,2,1,7,Mid-Value,Potential Loyalists
45221,788,4,"407,70000000000005",3,1,1,5,Low-Value,At Risk Customers
45224,483,3,"96,85",4,1,1,6,Mid-Value,Potential Loyalists
45225,97,1,"23,95",5,1,1,7,Mid-Value,Potential Loyalists
45226,35,5,"127,30000000000001",5,1,1,7,Mid-Value,Potential Loyalists
45227,1494,2,"26,85",1,1,1,3,Low-Value,Lost
45228,917,5,"120,0",3,1,1,5,Low-Value,At Risk Customers
45229,322,4,"229,65",5,1,1,7,Mid-Value,Potential Loyalists
45230,25,5,"280,9",5,1,1,7,Mid-Value,Potential Loyalists
45231,9,9,"950,4",5,2,2,9,High-Value,Champions
45233,801,1,"11,95",3,1,1,5,Low-Value,At Risk Customers
45236,554,2,"90,1",4,1,1,6,Mid-Value,Potential Loyalists
45239,1053,1,"13,2",3,1,1,5,Low-Value,At Risk Customers
45240,92,5,"264,25",5,1,1,7,Mid-Value,Potential Loyalists
45242,31,5,"264,05",5,1,1,7,Mid-Value,Potential Loyalists
45244,1442,1,"38,1",2,1,1,4,Low-Value,Can't Lose
45245,1502,1,"23,6",1,1,1,3,Low-Value,Lost
45246,218,2,"75,25",5,1,1,7,Mid-Value,Potential Loyalists
45248,173,2,"451,0",5,1,1,7,Mid-Value,Potential Loyalists
45249,9,4,"199,29999999999998",5,1,1,7,Mid-Value,Potential Loyalists
45250,658,1,"32,7",4,1,1,6,Mid-Value,Potential Loyalists
45251,834,2,"130,8",3,1,1,5,Low-Value,At Risk Customers
45253,424,1,"1,35",4,1,1,6,Mid-Value,Potential Loyalists
45257,82,2,"332,34999999999997",5,1,1,7,Mid-Value,Potential Loyalists
45259,873,2,"236,65",3,1,1,5,Low-Value,At Risk Customers
45260,1417,1,"53,85",2,1,1,4,Low-Value,Can't Lose
45261,1504,6,"178,2",1,1,1,3,Low-Value,Lost
45262,835,1,"143,2",3,1,1,5,Low-Value,At Risk Customers
45263,188,9,"670,5",5,2,2,9,High-Value,Champions
45264,93,3,"247,85",5,1,1,7,Mid-Value,Potential Loyalists
45267,1307,2,"568,7",2,1,1,4,Low-Value,Can't Lose
45268,893,6,"1072,6",3,1,2,6,Mid-Value,Potential Loyalists
45272,950,1,"1,05",3,1,1,5,Low-Value,At Risk Customers
45274,1365,1,"118,19999999999999",2,1,1,4,Low-Value,Can't Lose
45277,337,3,"380,1",5,1,1,7,Mid-Value,Potential Loyalists
45278,390,7,"260,55",4,2,1,7,Mid-Value,Potential Loyalists
45279,6,2,"85,10000000000001",5,1,1,7,Mid-Value,Potential Loyalists
45280,38,1,"109,55",5,1,1,7,Mid-Value,Potential Loyalists
45281,59,6,"628,2",5,1,1,7,Mid-Value,Potential Loyalists
45282,1251,2,"86,9",2,1,1,4,Low-Value,Can't Lose
45283,29,7,"561,55",5,2,1,8,High-Value,Potential Loyalists
45284,25,1,"19,0",5,1,1,7,Mid-Value,Potential Loyalists
45285,315,1,"22,8",5,1,1,7,Mid-Value,Potential Loyalists
45286,449,1,"289,95",4,1,1,6,Mid-Value,Potential Loyalists
45288,175,1,"53,6",5,1,1,7,Mid-Value,Potential Loyalists
45289,181,3,"169,9",5,1,1,7,Mid-Value,Potential Loyalists
45290,412,1,"50,3",4,1,1,6,Mid-Value,Potential Loyalists
45291,194,6,"250,35",5,1,1,7,Mid-Value,Potential Loyalists
45292,883,4,"90,25",3,1,1,5,Low-Value,At Risk Customers
45293,21,5,"476,85",5,1,1,7,Mid-Value,Potential Loyalists
45295,5,3,"187,2",5,1,1,7,Mid-Value,Potential Loyalists
45296,782,3,"57,6",3,1,1,5,Low-Value,At Risk Customers
45297,368,11,"412,15",4,2,1,7,Mid-Value,Potential Loyalists
45299,1049,2,"212,5",3,1,1,5,Low-Value,At Risk Customers
45302,3,2,"245,39999999999998",5,1,1,7,Mid-Value,Potential Loyalists
45303,1076,1,"38,85",3,1,1,5,Low-Value,At Risk Customers
45305,67,4,"89,75",5,1,1,7,Mid-Value,Potential Loyalists
45306,1140,2,"18,2",2,1,1,4,Low-Value,Can't Lose
45307,85,3,"293,8",5,1,1,7,Mid-Value,Potential Loyalists
45308,968,7,"363,5",3,2,1,6,Mid-Value,Potential Loyalists
45310,562,3,"398,1000000000001",4,1,1,6,Mid-Value,Potential Loyalists
45313,789,1,"63,1",3,1,1,5,Low-Value,At Risk Customers
45314,2,7,"353,7",5,2,1,8,High-Value,Potential Loyalists
45315,1351,1,"42,45",2,1,1,4,Low-Value,Can't Lose
45316,194,7,"306,5",5,2,1,8,High-Value,Potential Loyalists
45317,530,9,"532,85",4,2,1,7,Mid-Value,Potential Loyalists
45318,1149,1,"24,3",2,1,1,4,Low-Value,Can't Lose
45319,187,1,"33,900000000000006",5,1,1,7,Mid-Value,Potential Loyalists
45321,378,4,"380,15",4,1,1,6,Mid-Value,Potential Loyalists
45322,55,6,"324,1",5,1,1,7,Mid-Value,Potential Loyalists
45324,1806,1,"63,2",1,1,1,3,Low-Value,Lost
45325,179,12,"1417,1499999999999",5,3,3,11,High-Value,Champions
45326,1731,1,"13,2",1,1,1,3,Low-Value,Lost
45327,347,1,"36,25",5,1,1,7,Mid-Value,Potential Loyalists
45328,454,3,"85,2",4,1,1,6,Mid-Value,Potential Loyalists
45329,410,1,"25,2",4,1,1,6,Mid-Value,Potential Loyalists
45331,1167,1,"112,85",2,1,1,4,Low-Value,Can't Lose
45332,132,1,"31,1",5,1,1,7,Mid-Value,Potential Loyalists
45333,1013,1,"29,8",3,1,1,5,Low-Value,At Risk Customers
45334,51,10,"620,7",5,2,1,8,High-Value,Potential Loyalists
45336,10,3,"136,1",5,1,1,7,Mid-Value,Potential Loyalists
45338,258,1,"30,25",5,1,1,7,Mid-Value,Potential Loyalists
45339,1613,1,"19,5",1,1,1,3,Low-Value,Lost
45340,340,1,"6,1",5,1,1,7,Mid-Value,Potential Loyalists
45341,799,2,"120,85",3,1,1,5,Low-Value,At Risk Customers
45342,271,1,"10,2",5,1,1,7,Mid-Value,Potential Loyalists
45344,1568,2,"170,15",1,1,1,3,Low-Value,Lost
45345,306,2,"42,45",5,1,1,7,Mid-Value,Potential Loyalists
45346,873,2,"165,7",3,1,1,5,Low-Value,At Risk Customers
45347,154,2,"98,0",5,1,1,7,Mid-Value,Potential Loyalists
45348,252,1,"36,7",5,1,1,7,Mid-Value,Potential Loyalists
45349,907,2,"51,65",3,1,1,5,Low-Value,At Risk Customers
45351,735,2,"97,7",3,1,1,5,Low-Value,At Risk Customers
45353,381,1,"101,2",4,1,1,6,Mid-Value,Potential Loyalists
45355,329,5,"184,8",5,1,1,7,Mid-Value,Potential Loyalists
45356,117,3,"131,10000000000002",5,1,1,7,Mid-Value,Potential Loyalists
45357,211,7,"533,6500000000001",5,2,1,8,High-Value,Potential Loyalists
45358,1727,1,"51,150000000000006",1,1,1,3,Low-Value,Lost
45359,731,2,"100,6",3,1,1,5,Low-Value,At Risk Customers
45360,521,5,"218,9",4,1,1,6,Mid-Value,Potential Loyalists
45362,522,2,"58,0",4,1,1,6,Mid-Value,Potential Loyalists
45363,1,4,"196,50000000000003",5,1,1,7,Mid-Value,Potential Loyalists
45364,382,4,"166,65",4,1,1,6,Mid-Value,Potential Loyalists
45366,650,2,"438,75",4,1,1,6,Mid-Value,Potential Loyalists
45367,451,6,"210,2",4,1,1,6,Mid-Value,Potential Loyalists
45368,166,3,"98,85",5,1,1,7,Mid-Value,Potential Loyalists
45369,928,2,"129,25",3,1,1,5,Low-Value,At Risk Customers
45373,302,3,"95,0",5,1,1,7,Mid-Value,Potential Loyalists
45375,228,7,"400,05",5,2,1,8,High-Value,Potential Loyalists
45376,777,3,"290,0",3,1,1,5,Low-Value,At Risk Customers
45377,222,5,"412,09999999999997",5,1,1,7,Mid-Value,Potential Loyalists
45379,202,2,"59,85",5,1,1,7,Mid-Value,Potential Loyalists
45380,101,5,"464,05",5,1,1,7,Mid-Value,Potential Loyalists
45382,124,7,"1106,0",5,2,2,9,High-Value,Champions
45383,203,7,"450,8",5,2,1,8,High-Value,Potential Loyalists
45385,130,2,"115,8",5,1,1,7,Mid-Value,Potential Loyalists
45386,57,2,"98,89999999999999",5,1,1,7,Mid-Value,Potential Loyalists
45388,691,1,"116,9",4,1,1,6,Mid-Value,Potential Loyalists
45390,116,5,"167,05",5,1,1,7,Mid-Value,Potential Loyalists
45391,26,9,"420,6",5,2,1,8,High-Value,Potential Loyalists
45393,858,1,"8,95",3,1,1,5,Low-Value,At Risk Customers
45395,35,3,"81,5",5,1,1,7,Mid-Value,Potential Loyalists
45396,998,1,"250,7",3,1,1,5,Low-Value,At Risk Customers
45397,280,4,"438,15",5,1,1,7,Mid-Value,Potential Loyalists
45399,454,2,"24,6",4,1,1,6,Mid-Value,Potential Loyalists
45400,466,1,"27,5",4,1,1,6,Mid-Value,Potential Loyalists
45401,608,5,"135,15",4,1,1,6,Mid-Value,Potential Loyalists
45404,747,2,"134,7",3,1,1,5,Low-Value,At Risk Customers
45408,276,1,"38,05",5,1,1,7,Mid-Value,Potential Loyalists
45409,866,2,"198,8",3,1,1,5,Low-Value,At Risk Customers
45410,501,4,"62,3",4,1,1,6,Mid-Value,Potential Loyalists
45411,1177,2,"114,5",2,1,1,4,Low-Value,Can't Lose
45414,430,5,"135,05",4,1,1,6,Mid-Value,Potential Loyalists
45416,501,2,"131,7",4,1,1,6,Mid-Value,Potential Loyalists
45417,22,3,"204,3",5,1,1,7,Mid-Value,Potential Loyalists
45418,997,1,"45,5",3,1,1,5,Low-Value,At Risk Customers
45419,107,3,"116,3",5,1,1,7,Mid-Value,Potential Loyalists
45421,13,7,"410,65",5,2,1,8,High-Value,Potential Loyalists
45422,2,3,"224,9",5,1,1,7,Mid-Value,Potential Loyalists
45425,1250,3,"172,4",2,1,1,4,Low-Value,Can't Lose
45428,24,3,"365,5",5,1,1,7,Mid-Value,Potential Loyalists
45429,890,5,"266,55",3,1,1,5,Low-Value,At Risk Customers
45431,230,3,"251,05",5,1,1,7,Mid-Value,Potential Loyalists
45432,491,3,"482,85",4,1,1,6,Mid-Value,Potential Loyalists
45433,515,4,"316,05",4,1,1,6,Mid-Value,Potential Loyalists
45434,256,2,"80,2",5,1,1,7,Mid-Value,Potential Loyalists
45436,481,1,"21,45",4,1,1,6,Mid-Value,Potential Loyalists
45439,66,4,"125,05",5,1,1,7,Mid-Value,Potential Loyalists
45440,29,3,"188,25",5,1,1,7,Mid-Value,Potential Loyalists
45443,753,3,"157,05",3,1,1,5,Low-Value,At Risk Customers
45444,264,8,"215,70000000000002",5,2,1,8,High-Value,Potential Loyalists
45445,319,7,"566,35",5,2,1,8,High-Value,Potential Loyalists
45447,441,7,"375,85",4,2,1,7,Mid-Value,Potential Loyalists
45448,796,1,"113,45",3,1,1,5,Low-Value,At Risk Customers
45449,554,9,"477,54999999999995",4,2,1,7,Mid-Value,Potential Loyalists
45450,617,4,"132,5",4,1,1,6,Mid-Value,Potential Loyalists
45452,1271,1,"81,0",2,1,1,4,Low-Value,Can't Lose
45455,607,3,"55,3",4,1,1,6,Mid-Value,Potential Loyalists
45457,930,1,"7,35",3,1,1,5,Low-Value,At Risk Customers
45458,181,4,"316,0",5,1,1,7,Mid-Value,Potential Loyalists
45459,24,5,"680,15",5,1,2,8,High-Value,Potential Loyalists
45460,1512,2,"886,0",1,1,2,4,Low-Value,Can't Lose
45461,129,2,"13,1",5,1,1,7,Mid-Value,Potential Loyalists
45463,25,3,"104,4",5,1,1,7,Mid-Value,Potential Loyalists
45469,1310,1,"41,75",2,1,1,4,Low-Value,Can't Lose
45470,619,3,"44,1",4,1,1,6,Mid-Value,Potential Loyalists
45471,537,2,"139,9",4,1,1,6,Mid-Value,Potential Loyalists
45474,391,8,"752,4",4,2,2,8,High-Value,Potential Loyalists
45479,937,1,"72,15",3,1,1,5,Low-Value,At Risk Customers
45483,560,5,"193,75",4,1,1,6,Mid-Value,Potential Loyalists
45486,126,3,"144,05",5,1,1,7,Mid-Value,Potential Loyalists
45488,393,1,"12,65",4,1,1,6,Mid-Value,Potential Loyalists
45489,86,2,"113,25",5,1,1,7,Mid-Value,Potential Loyalists
45490,619,2,"27,2",4,1,1,6,Mid-Value,Potential Loyalists
45491,265,6,"257,05",5,1,1,7,Mid-Value,Potential Loyalists
45493,1231,2,"101,19999999999999",2,1,1,4,Low-Value,Can't Lose
45494,1207,1,"128,3",2,1,1,4,Low-Value,Can't Lose
45495,979,1,"34,9",3,1,1,5,Low-Value,At Risk Customers
45496,377,16,"978,95",4,3,2,9,High-Value,Champions
45497,1449,1,"36,65",2,1,1,4,Low-Value,Can't Lose
45499,267,5,"341,15",5,1,1,7,Mid-Value,Potential Loyalists
45500,291,3,"190,04999999999998",5,1,1,7,Mid-Value,Potential Loyalists
45503,27,13,"933,3000000000001",5,3,2,10,High-Value,Champions
45504,461,3,"156,75",4,1,1,6,Mid-Value,Potential Loyalists
45506,1100,1,"12,25",2,1,1,4,Low-Value,Can't Lose
45507,431,5,"374,15",4,1,1,6,Mid-Value,Potential Loyalists
45508,585,6,"301,9",4,1,1,6,Mid-Value,Potential Loyalists
45509,213,2,"173,8",5,1,1,7,Mid-Value,Potential Loyalists
45512,41,2,"273,5",5,1,1,7,Mid-Value,Potential Loyalists
45513,379,4,"255,05",4,1,1,6,Mid-Value,Potential Loyalists
45514,355,1,"17,05",5,1,1,7,Mid-Value,Potential Loyalists
45516,283,1,"23,0",5,1,1,7,Mid-Value,Potential Loyalists
45517,1590,1,"13,799999999999999",1,1,1,3,Low-Value,Lost
45518,537,1,"162,5",4,1,1,6,Mid-Value,Potential Loyalists
45521,42,1,"18,9",5,1,1,7,Mid-Value,Potential Loyalists
45524,1001,2,"21,2",3,1,1,5,Low-Value,At Risk Customers
45525,494,2,"81,35",4,1,1,6,Mid-Value,Potential Loyalists
45526,1345,2,"223,0",2,1,1,4,Low-Value,Can't Lose
45527,57,5,"204,15",5,1,1,7,Mid-Value,Potential Loyalists
45528,418,5,"316,05",4,1,1,6,Mid-Value,Potential Loyalists
45529,1655,1,"195,9",1,1,1,3,Low-Value,Lost
45530,724,2,"101,35",4,1,1,6,Mid-Value,Potential Loyalists
45531,3,7,"472,90000000000003",5,2,1,8,High-Value,Potential Loyalists
45535,3,3,"459,7",5,1,1,7,Mid-Value,Potential Loyalists
45537,380,2,"208,3",4,1,1,6,Mid-Value,Potential Loyalists
45538,244,2,"32,4",5,1,1,7,Mid-Value,Potential Loyalists
45539,650,3,"65,7",4,1,1,6,Mid-Value,Potential Loyalists
45540,1411,1,"13,75",2,1,1,4,Low-Value,Can't Lose
45541,969,2,"67,45",3,1,1,5,Low-Value,At Risk Customers
45542,784,3,"50,65",3,1,1,5,Low-Value,At Risk Customers
45543,120,3,"81,4",5,1,1,7,Mid-Value,Potential Loyalists
45544,9,5,"218,3",5,1,1,7,Mid-Value,Potential Loyalists
45547,121,10,"573,65",5,2,1,8,High-Value,Potential Loyalists
45548,70,7,"329,75",5,2,1,8,High-Value,Potential Loyalists
45551,22,7,"297,7",5,2,1,8,High-Value,Potential Loyalists
45552,269,4,"148,60000000000002",5,1,1,7,Mid-Value,Potential Loyalists
45554,291,2,"145,4",5,1,1,7,Mid-Value,Potential Loyalists
45555,1293,1,"132,89999999999998",2,1,1,4,Low-Value,Can't Lose
45556,867,3,"121,75",3,1,1,5,Low-Value,At Risk Customers
45557,1631,1,"109,0",1,1,1,3,Low-Value,Lost
45558,89,7,"386,20000000000005",5,2,1,8,High-Value,Potential Loyalists
45559,413,12,"434,40000000000003",4,3,1,8,High-Value,Potential Loyalists
45560,1565,1,"17,25",1,1,1,3,Low-Value,Lost
45561,73,4,"136,75",5,1,1,7,Mid-Value,Potential Loyalists
45562,1353,2,"80,3",2,1,1,4,Low-Value,Can't Lose
45565,470,2,"34,95",4,1,1,6,Mid-Value,Potential Loyalists
45567,124,2,"73,85",5,1,1,7,Mid-Value,Potential Loyalists
45568,633,1,"16,2",4,1,1,6,Mid-Value,Potential Loyalists
45569,393,1,"125,65",4,1,1,6,Mid-Value,Potential Loyalists
45570,36,1,"67,25",5,1,1,7,Mid-Value,Potential Loyalists
45573,865,3,"314,9",3,1,1,5,Low-Value,At Risk Customers
45575,1063,2,"53,650000000000006",3,1,1,5,Low-Value,At Risk Customers
45576,1388,1,"23,85",2,1,1,4,Low-Value,Can't Lose
45577,903,1,"20,0",3,1,1,5,Low-Value,At Risk Customers
45578,1110,1,"9,1",2,1,1,4,Low-Value,Can't Lose
45580,121,4,"239,8",5,1,1,7,Mid-Value,Potential Loyalists
45581,1272,2,"574,6",2,1,1,4,Low-Value,Can't Lose
45582,1658,2,"147,9",1,1,1,3,Low-Value,Lost
45583,1531,2,"122,39999999999999",1,1,1,3,Low-Value,Lost
45584,60,6,"170,4",5,1,1,7,Mid-Value,Potential Loyalists
45585,440,3,"36,1",4,1,1,6,Mid-Value,Potential Loyalists
45586,430,1,"10,9",4,1,1,6,Mid-Value,Potential Loyalists
45587,31,2,"73,35",5,1,1,7,Mid-Value,Potential Loyalists
45588,532,5,"139,95",4,1,1,6,Mid-Value,Potential Loyalists
45589,328,2,"193,9",5,1,1,7,Mid-Value,Potential Loyalists
45592,119,3,"154,95",5,1,1,7,Mid-Value,Potential Loyalists
45593,644,3,"38,8",4,1,1,6,Mid-Value,Potential Loyalists
45597,925,3,"430,29999999999995",3,1,1,5,Low-Value,At Risk Customers
45598,363,1,"84,0",5,1,1,7,Mid-Value,Potential Loyalists
45600,1067,1,"21,15",3,1,1,5,Low-Value,At Risk Customers
45601,67,8,"261,25",5,2,1,8,High-Value,Potential Loyalists
45602,197,2,"57,75",5,1,1,7,Mid-Value,Potential Loyalists
45603,1176,5,"162,1",2,1,1,4,Low-Value,Can't Lose
45604,169,2,"60,6",5,1,1,7,Mid-Value,Potential Loyalists
45605,1346,2,"38,45",2,1,1,4,Low-Value,Can't Lose
45607,920,5,"192,55",3,1,1,5,Low-Value,At Risk Customers
45608,89,5,"347,6",5,1,1,7,Mid-Value,Potential Loyalists
45609,829,1,"50,55",3,1,1,5,Low-Value,At Risk Customers
45612,234,10,"1141,2",5,2,2,9,High-Value,Champions
45613,571,4,"96,6",4,1,1,6,Mid-Value,Potential Loyalists
45614,1097,1,"16,3",2,1,1,4,Low-Value,Can't Lose
45617,1323,1,"16,15",2,1,1,4,Low-Value,Can't Lose
45618,601,3,"64,15",4,1,1,6,Mid-Value,Potential Loyalists
45619,118,1,"28,9",5,1,1,7,Mid-Value,Potential Loyalists
45620,172,4,"279,7",5,1,1,7,Mid-Value,Potential Loyalists
45621,451,5,"554,5",4,1,1,6,Mid-Value,Potential Loyalists
45623,328,4,"171,25",5,1,1,7,Mid-Value,Potential Loyalists
45626,490,1,"96,75",4,1,1,6,Mid-Value,Potential Loyalists
45628,747,1,"43,0",3,1,1,5,Low-Value,At Risk Customers
45629,32,1,"18,15",5,1,1,7,Mid-Value,Potential Loyalists
45630,1531,2,"190,14999999999998",1,1,1,3,Low-Value,Lost
45633,419,7,"449,15",4,2,1,7,Mid-Value,Potential Loyalists
45639,106,3,"73,95",5,1,1,7,Mid-Value,Potential Loyalists
45640,265,3,"71,3",5,1,1,7,Mid-Value,Potential Loyalists
45641,1519,1,"12,1",1,1,1,3,Low-Value,Lost
45642,1571,1,"5,7",1,1,1,3,Low-Value,Lost
45643,423,5,"500,15",4,1,1,6,Mid-Value,Potential Loyalists
45644,356,1,"1391,4",5,1,3,9,High-Value,Champions
45645,199,5,"423,15",5,1,1,7,Mid-Value,Potential Loyalists
45646,819,2,"628,3499999999999",3,1,1,5,Low-Value,At Risk Customers
45647,867,1,"11,8",3,1,1,5,Low-Value,At Risk Customers
45649,836,2,"51,0",3,1,1,5,Low-Value,At Risk Customers
45651,770,2,"63,15",3,1,1,5,Low-Value,At Risk Customers
45652,120,1,"10,4",5,1,1,7,Mid-Value,Potential Loyalists
45653,1398,1,"61,4",2,1,1,4,Low-Value,Can't Lose
45654,298,6,"349,5",5,1,1,7,Mid-Value,Potential Loyalists
45655,1636,1,"42,1",1,1,1,3,Low-Value,Lost
45656,224,3,"189,75",5,1,1,7,Mid-Value,Potential Loyalists
45657,763,1,"22,75",3,1,1,5,Low-Value,At Risk Customers
45658,702,1,"81,8",4,1,1,6,Mid-Value,Potential Loyalists
45659,873,3,"230,89999999999998",3,1,1,5,Low-Value,At Risk Customers
45661,746,1,"43,1",3,1,1,5,Low-Value,At Risk Customers
45663,102,6,"728,1",5,1,2,8,High-Value,Potential Loyalists
45664,1503,1,"22,9",1,1,1,3,Low-Value,Lost
45666,535,1,"251,7",4,1,1,6,Mid-Value,Potential Loyalists
45668,236,1,"23,45",5,1,1,7,Mid-Value,Potential Loyalists
45669,96,5,"254,64999999999998",5,1,1,7,Mid-Value,Potential Loyalists
45670,409,1,"95,65",4,1,1,6,Mid-Value,Potential Loyalists
45671,76,2,"89,20000000000002",5,1,1,7,Mid-Value,Potential Loyalists
45672,28,4,"79,2",5,1,1,7,Mid-Value,Potential Loyalists
45675,129,4,"110,55",5,1,1,7,Mid-Value,Potential Loyalists
45676,31,7,"518,75",5,2,1,8,High-Value,Potential Loyalists
45678,763,5,"484,55",3,1,1,5,Low-Value,At Risk Customers
45683,599,3,"334,8",4,1,1,6,Mid-Value,Potential Loyalists
45684,1159,4,"217,05",2,1,1,4,Low-Value,Can't Lose
45686,367,2,"191,8",4,1,1,6,Mid-Value,Potential Loyalists
45689,25,4,"171,3",5,1,1,7,Mid-Value,Potential Loyalists
45691,281,3,"93,64999999999999",5,1,1,7,Mid-Value,Potential Loyalists
45693,280,4,"112,5",5,1,1,7,Mid-Value,Potential Loyalists
45694,35,4,"266,75",5,1,1,7,Mid-Value,Potential Loyalists
45698,974,2,"36,6",3,1,1,5,Low-Value,At Risk Customers
45699,161,5,"355,1",5,1,1,7,Mid-Value,Potential Loyalists
45700,607,1,"43,1",4,1,1,6,Mid-Value,Potential Loyalists
45707,10,16,"1198,35",5,3,2,10,High-Value,Champions
45708,448,3,"74,5",4,1,1,6,Mid-Value,Potential Loyalists
45710,1632,1,"171,14999999999998",1,1,1,3,Low-Value,Lost
45711,783,1,"17,25",3,1,1,5,Low-Value,At Risk Customers
45712,38,6,"210,25",5,1,1,7,Mid-Value,Potential Loyalists
45715,743,2,"188,0",3,1,1,5,Low-Value,At Risk Customers
45716,1545,3,"181,9",1,1,1,3,Low-Value,Lost
45717,31,11,"258,0",5,2,1,8,High-Value,Potential Loyalists
45719,1152,1,"1,3",2,1,1,4,Low-Value,Can't Lose
45720,39,5,"311,35",5,1,1,7,Mid-Value,Potential Loyalists
45721,472,4,"319,7",4,1,1,6,Mid-Value,Potential Loyalists
45722,1557,1,"14,75",1,1,1,3,Low-Value,Lost
45724,186,4,"414,2",5,1,1,7,Mid-Value,Potential Loyalists
45729,1693,1,"113,85000000000001",1,1,1,3,Low-Value,Lost
45730,288,3,"150,89999999999998",5,1,1,7,Mid-Value,Potential Loyalists
45733,410,4,"209,39999999999998",4,1,1,6,Mid-Value,Potential Loyalists
45734,668,4,"166,29999999999998",4,1,1,6,Mid-Value,Potential Loyalists
45736,193,4,"238,0",5,1,1,7,Mid-Value,Potential Loyalists
45737,92,2,"130,29999999999998",5,1,1,7,Mid-Value,Potential Loyalists
45738,1000,4,"284,45",3,1,1,5,Low-Value,At Risk Customers
45739,937,2,"318,9",3,1,1,5,Low-Value,At Risk Customers
45741,514,1,"233,7",4,1,1,6,Mid-Value,Potential Loyalists
45742,207,7,"256,6",5,2,1,8,High-Value,Potential Loyalists
45743,987,2,"84,25",3,1,1,5,Low-Value,At Risk Customers
45744,105,3,"178,70000000000002",5,1,1,7,Mid-Value,Potential Loyalists
45747,730,3,"249,25",4,1,1,6,Mid-Value,Potential Loyalists
45749,997,1,"18,9",3,1,1,5,Low-Value,At Risk Customers
45750,1531,3,"159,0",1,1,1,3,Low-Value,Lost
45751,179,6,"349,29999999999995",5,1,1,7,Mid-Value,Potential Loyalists
45752,492,2,"158,45",4,1,1,6,Mid-Value,Potential Loyalists
45753,184,12,"715,1",5,3,2,10,High-Value,Champions
45754,3,4,"383,65",5,1,1,7,Mid-Value,Potential Loyalists
45755,182,2,"103,4",5,1,1,7,Mid-Value,Potential Loyalists
45756,791,2,"160,25",3,1,1,5,Low-Value,At Risk Customers
45757,305,5,"352,29999999999995",5,1,1,7,Mid-Value,Potential Loyalists
45758,430,5,"579,8499999999999",4,1,1,6,Mid-Value,Potential Loyalists
45760,1370,3,"374,15",2,1,1,4,Low-Value,Can't Lose
45762,1156,2,"84,44999999999999",2,1,1,4,Low-Value,Can't Lose
45765,287,3,"56,849999999999994",5,1,1,7,Mid-Value,Potential Loyalists
45766,421,4,"151,60000000000002",4,1,1,6,Mid-Value,Potential Loyalists
45768,291,4,"275,6",5,1,1,7,Mid-Value,Potential Loyalists
45769,535,3,"93,75",4,1,1,6,Mid-Value,Potential Loyalists
45770,45,7,"462,1",5,2,1,8,High-Value,Potential Loyalists
45771,291,3,"211,0",5,1,1,7,Mid-Value,Potential Loyalists
45772,1469,4,"162,10000000000002",1,1,1,3,Low-Value,Lost
45773,600,2,"179,29999999999998",4,1,1,6,Mid-Value,Potential Loyalists
45774,340,5,"831,65",5,1,2,8,High-Value,Potential Loyalists
45775,1466,2,"40,3",1,1,1,3,Low-Value,Lost
45776,855,5,"423,65000000000003",3,1,1,5,Low-Value,At Risk Customers
45778,524,2,"114,35000000000001",4,1,1,6,Mid-Value,Potential Loyalists
45780,377,1,"85,8",4,1,1,6,Mid-Value,Potential Loyalists
45781,613,3,"160,75",4,1,1,6,Mid-Value,Potential Loyalists
45782,1726,1,"58,05",1,1,1,3,Low-Value,Lost
45783,46,3,"83,0",5,1,1,7,Mid-Value,Potential Loyalists
45786,864,1,"31,049999999999997",3,1,1,5,Low-Value,At Risk Customers
45787,273,3,"35,9",5,1,1,7,Mid-Value,Potential Loyalists
45788,80,1,"15,55",5,1,1,7,Mid-Value,Potential Loyalists
45789,45,6,"193,15",5,1,1,7,Mid-Value,Potential Loyalists
45791,1148,2,"26,5",2,1,1,4,Low-Value,Can't Lose
45792,903,2,"59,35",3,1,1,5,Low-Value,At Risk Customers
45793,1001,3,"97,5",3,1,1,5,Low-Value,At Risk Customers
45794,430,4,"175,79999999999998",4,1,1,6,Mid-Value,Potential Loyalists
45795,4,3,"140,4",5,1,1,7,Mid-Value,Potential Loyalists
45797,981,1,"120,4",3,1,1,5,Low-Value,At Risk Customers
45798,133,7,"210,2",5,2,1,8,High-Value,Potential Loyalists
45799,1361,2,"63,7",2,1,1,4,Low-Value,Can't Lose
45800,90,7,"355,59999999999997",5,2,1,8,High-Value,Potential Loyalists
45803,74,14,"929,65",5,3,2,10,High-Value,Champions
45804,168,6,"487,34999999999997",5,1,1,7,Mid-Value,Potential Loyalists
45806,475,3,"154,15",4,1,1,6,Mid-Value,Potential Loyalists
45808,844,2,"188,9",3,1,1,5,Low-Value,At Risk Customers
45809,367,2,"48,45",4,1,1,6,Mid-Value,Potential Loyalists
45811,477,2,"194,89999999999998",4,1,1,6,Mid-Value,Potential Loyalists
45813,489,1,"126,4",4,1,1,6,Mid-Value,Potential Loyalists
45816,799,3,"84,30000000000001",3,1,1,5,Low-Value,At Risk Customers
45818,1083,1,"70,0",3,1,1,5,Low-Value,At Risk Customers
45819,50,5,"965,4499999999999",5,1,2,8,High-Value,Potential Loyalists
45820,573,3,"136,55",4,1,1,6,Mid-Value,Potential Loyalists
45821,456,3,"357,0",4,1,1,6,Mid-Value,Potential Loyalists
45822,1695,1,"13,8",1,1,1,3,Low-Value,Lost
45826,836,4,"197,39999999999998",3,1,1,5,Low-Value,At Risk Customers
45827,1362,1,"40,65",2,1,1,4,Low-Value,Can't Lose
45828,34,10,"680,35",5,2,2,9,High-Value,Champions
45829,1044,2,"10,75",3,1,1,5,Low-Value,At Risk Customers
45830,538,2,"230,7",4,1,1,6,Mid-Value,Potential Loyalists
45832,467,4,"103,39999999999999",4,1,1,6,Mid-Value,Potential Loyalists
45833,1293,1,"20,4",2,1,1,4,Low-Value,Can't Lose
45836,14,3,"202,55",5,1,1,7,Mid-Value,Potential Loyalists
45838,1251,4,"407,55",2,1,1,4,Low-Value,Can't Lose
45839,10,1,"54,0",5,1,1,7,Mid-Value,Potential Loyalists
45841,680,2,"6,75",4,1,1,6,Mid-Value,Potential Loyalists
45843,445,1,"289,95",4,1,1,6,Mid-Value,Potential Loyalists
45845,281,2,"120,35",5,1,1,7,Mid-Value,Potential Loyalists
45847,1179,1,"24,3",2,1,1,4,Low-Value,Can't Lose
45849,1108,3,"158,3",2,1,1,4,Low-Value,Can't Lose
45850,488,1,"20,46",4,1,1,6,Mid-Value,Potential Loyalists
45851,62,1,"289,95",5,1,1,7,Mid-Value,Potential Loyalists
45852,737,3,"119,1",3,1,1,5,Low-Value,At Risk Customers
45853,29,5,"279,2",5,1,1,7,Mid-Value,Potential Loyalists
45855,139,2,"170,95",5,1,1,7,Mid-Value,Potential Loyalists
45856,615,1,"16,1",4,1,1,6,Mid-Value,Potential Loyalists
45857,283,2,"49,95",5,1,1,7,Mid-Value,Potential Loyalists
45858,159,4,"99,85",5,1,1,7,Mid-Value,Potential Loyalists
45860,209,3,"128,35",5,1,1,7,Mid-Value,Potential Loyalists
45861,1234,1,"27,1",2,1,1,4,Low-Value,Can't Lose
45862,482,8,"1067,45",4,2,2,8,High-Value,Potential Loyalists
45866,47,2,"607,6999999999999",5,1,1,7,Mid-Value,Potential Loyalists
45868,507,1,"40,2",4,1,1,6,Mid-Value,Potential Loyalists
45870,1218,1,"117,2",2,1,1,4,Low-Value,Can't Lose
45871,24,4,"83,45000000000002",5,1,1,7,Mid-Value,Potential Loyalists
45872,139,8,"243,55",5,2,1,8,High-Value,Potential Loyalists
45873,15,2,"75,65",5,1,1,7,Mid-Value,Potential Loyalists
45874,1358,1,"1460,8",2,1,3,6,Mid-Value,Potential Loyalists
45875,19,8,"501,45",5,2,1,8,High-Value,Potential Loyalists
45879,1147,1,"30,35",2,1,1,4,Low-Value,Can't Lose
45880,40,3,"92,05",5,1,1,7,Mid-Value,Potential Loyalists
45882,376,4,"82,6",4,1,1,6,Mid-Value,Potential Loyalists
45884,451,5,"548,5",4,1,1,6,Mid-Value,Potential Loyalists
45885,83,6,"211,5",5,1,1,7,Mid-Value,Potential Loyalists
45886,217,6,"230,75",5,1,1,7,Mid-Value,Potential Loyalists
45887,1336,1,"42,25",2,1,1,4,Low-Value,Can't Lose
45889,1471,1,"116,6",1,1,1,3,Low-Value,Lost
45890,628,3,"35,95",4,1,1,6,Mid-Value,Potential Loyalists
45891,1268,1,"13,75",2,1,1,4,Low-Value,Can't Lose
45892,304,2,"91,2",5,1,1,7,Mid-Value,Potential Loyalists
45893,75,5,"306,75",5,1,1,7,Mid-Value,Potential Loyalists
45894,1069,1,"56,25",3,1,1,5,Low-Value,At Risk Customers
45895,727,1,"22,05",4,1,1,6,Mid-Value,Potential Loyalists
45897,145,1,"117,1",5,1,1,7,Mid-Value,Potential Loyalists
45898,581,6,"493,0",4,1,1,6,Mid-Value,Potential Loyalists
45899,1811,2,"362,9",1,1,1,3,Low-Value,Lost
45900,59,1,"46,5",5,1,1,7,Mid-Value,Potential Loyalists
45901,372,3,"81,3",4,1,1,6,Mid-Value,Potential Loyalists
45903,508,3,"41,849999999999994",4,1,1,6,Mid-Value,Potential Loyalists
45904,441,2,"392,74999999999994",4,1,1,6,Mid-Value,Potential Loyalists
45905,1184,1,"7,95",2,1,1,4,Low-Value,Can't Lose
45909,1442,1,"80,2",2,1,1,4,Low-Value,Can't Lose
45913,665,6,"101,95",4,1,1,6,Mid-Value,Potential Loyalists
45916,1257,1,"52,2",2,1,1,4,Low-Value,Can't Lose
45917,467,4,"330,0",4,1,1,6,Mid-Value,Potential Loyalists
45919,976,2,"124,15",3,1,1,5,Low-Value,At Risk Customers
45921,1235,2,"117,05",2,1,1,4,Low-Value,Can't Lose
45922,666,1,"131,4",4,1,1,6,Mid-Value,Potential Loyalists
45923,566,2,"232,89999999999998",4,1,1,6,Mid-Value,Potential Loyalists
45925,470,6,"148,04999999999998",4,1,1,6,Mid-Value,Potential Loyalists
45931,1065,1,"50,3",3,1,1,5,Low-Value,At Risk Customers
45932,250,2,"80,65",5,1,1,7,Mid-Value,Potential Loyalists
45933,276,4,"384,45",5,1,1,7,Mid-Value,Potential Loyalists
45934,656,1,"11,05",4,1,1,6,Mid-Value,Potential Loyalists
45935,81,1,"57,2",5,1,1,7,Mid-Value,Potential Loyalists
45936,24,7,"339,7",5,2,1,8,High-Value,Potential Loyalists
45938,181,2,"457,25",5,1,1,7,Mid-Value,Potential Loyalists
45939,430,6,"311,6",4,1,1,6,Mid-Value,Potential Loyalists
45940,1149,3,"133,35000000000002",2,1,1,4,Low-Value,Can't Lose
45941,217,2,"76,89999999999999",5,1,1,7,Mid-Value,Potential Loyalists
45947,1304,2,"22,6",2,1,1,4,Low-Value,Can't Lose
45948,105,8,"374,9",5,2,1,8,High-Value,Potential Loyalists
45949,91,4,"239,14999999999998",5,1,1,7,Mid-Value,Potential Loyalists
45950,1144,3,"393,3",2,1,1,4,Low-Value,Can't Lose
45951,210,2,"113,69999999999999",5,1,1,7,Mid-Value,Potential Loyalists
45952,419,7,"257,3",4,2,1,7,Mid-Value,Potential Loyalists
45954,1112,6,"226,85000000000002",2,1,1,4,Low-Value,Can't Lose
45957,307,2,"87,25",5,1,1,7,Mid-Value,Potential Loyalists
45958,253,5,"400,05000000000007",5,1,1,7,Mid-Value,Potential Loyalists
45960,134,1,"55,5",5,1,1,7,Mid-Value,Potential Loyalists
45961,956,4,"143,0",3,1,1,5,Low-Value,At Risk Customers
45962,624,1,"16,3",4,1,1,6,Mid-Value,Potential Loyalists
45963,1636,1,"50,4",1,1,1,3,Low-Value,Lost
45964,274,6,"172,1",5,1,1,7,Mid-Value,Potential Loyalists
45967,229,3,"86,3",5,1,1,7,Mid-Value,Potential Loyalists
45970,630,2,"352,8",4,1,1,6,Mid-Value,Potential Loyalists
45971,376,1,"50,4",4,1,1,6,Mid-Value,Potential Loyalists
45972,53,1,"1,05",5,1,1,7,Mid-Value,Potential Loyalists
45974,354,5,"228,20000000000002",5,1,1,7,Mid-Value,Potential Loyalists
45975,381,3,"668,0",4,1,2,7,Mid-Value,Potential Loyalists
45976,164,4,"409,25",5,1,1,7,Mid-Value,Potential Loyalists
45977,351,4,"256,8",5,1,1,7,Mid-Value,Potential Loyalists
45979,45,5,"155,3",5,1,1,7,Mid-Value,Potential Loyalists
45981,14,4,"484,85",5,1,1,7,Mid-Value,Potential Loyalists
45984,452,1,"6,45",4,1,1,6,Mid-Value,Potential Loyalists
45987,118,11,"541,65",5,2,1,8,High-Value,Potential Loyalists
45988,1478,1,"46,7",1,1,1,3,Low-Value,Lost
45989,217,6,"610,75",5,1,1,7,Mid-Value,Potential Loyalists
45991,1511,1,"12,3",1,1,1,3,Low-Value,Lost
45993,248,2,"53,35",5,1,1,7,Mid-Value,Potential Loyalists
45995,266,2,"73,85",5,1,1,7,Mid-Value,Potential Loyalists
45996,1587,1,"18,45",1,1,1,3,Low-Value,Lost
45998,177,2,"108,69999999999999",5,1,1,7,Mid-Value,Potential Loyalists
45999,91,3,"131,8",5,1,1,7,Mid-Value,Potential Loyalists
46000,866,4,"203,5",3,1,1,5,Low-Value,At Risk Customers
46002,1806,1,"37,8",1,1,1,3,Low-Value,Lost
46003,557,1,"19,35",4,1,1,6,Mid-Value,Potential Loyalists
46004,742,3,"51,65",3,1,1,5,Low-Value,At Risk Customers
46005,1025,1,"10,2",3,1,1,5,Low-Value,At Risk Customers
46006,876,1,"2,2",3,1,1,5,Low-Value,At Risk Customers
46007,146,2,"61,599999999999994",5,1,1,7,Mid-Value,Potential Loyalists
46009,554,1,"18,3",4,1,1,6,Mid-Value,Potential Loyalists
46010,33,2,"69,0",5,1,1,7,Mid-Value,Potential Loyalists
46011,183,6,"229,79999999999998",5,1,1,7,Mid-Value,Potential Loyalists
46012,324,1,"64,5",5,1,1,7,Mid-Value,Potential Loyalists
46013,1372,1,"8,25",2,1,1,4,Low-Value,Can't Lose
46014,493,2,"166,1",4,1,1,6,Mid-Value,Potential Loyalists
46015,386,3,"313,85",4,1,1,6,Mid-Value,Potential Loyalists
46016,147,9,"1123,3",5,2,2,9,High-Value,Champions
46017,14,3,"146,25",5,1,1,7,Mid-Value,Potential Loyalists
46018,138,2,"137,85",5,1,1,7,Mid-Value,Potential Loyalists
46019,239,5,"649,45",5,1,1,7,Mid-Value,Potential Loyalists
46020,430,1,"8,25",4,1,1,6,Mid-Value,Potential Loyalists
46022,1616,1,"34,349999999999994",1,1,1,3,Low-Value,Lost
46025,950,2,"92,14999999999999",3,1,1,5,Low-Value,At Risk Customers
46026,915,3,"174,9",3,1,1,5,Low-Value,At Risk Customers
46027,1609,1,"74,5",1,1,1,3,Low-Value,Lost
46033,1509,1,"221,15",1,1,1,3,Low-Value,Lost
46034,173,3,"84,6",5,1,1,7,Mid-Value,Potential Loyalists
46038,269,8,"270,7",5,2,1,8,High-Value,Potential Loyalists
46039,418,7,"272,25",4,2,1,7,Mid-Value,Potential Loyalists
46040,1329,1,"20,0",2,1,1,4,Low-Value,Can't Lose
46041,753,9,"393,55",3,2,1,6,Mid-Value,Potential Loyalists
46043,230,7,"457,70000000000005",5,2,1,8,High-Value,Potential Loyalists
46044,751,15,"999,35",3,3,2,8,High-Value,Potential Loyalists
46045,983,4,"175,15",3,1,1,5,Low-Value,At Risk Customers
46047,407,1,"117,8",4,1,1,6,Mid-Value,Potential Loyalists
46048,94,1,"4,2",5,1,1,7,Mid-Value,Potential Loyalists
46050,802,4,"226,0",3,1,1,5,Low-Value,At Risk Customers
46051,784,4,"274,0",3,1,1,5,Low-Value,At Risk Customers
46052,1103,3,"281,85",2,1,1,4,Low-Value,Can't Lose
46053,349,3,"289,2",5,1,1,7,Mid-Value,Potential Loyalists
46054,201,4,"189,8",5,1,1,7,Mid-Value,Potential Loyalists
46058,449,3,"404,29999999999995",4,1,1,6,Mid-Value,Potential Loyalists
46060,1224,2,"185,5",2,1,1,4,Low-Value,Can't Lose
46062,1072,2,"68,3",3,1,1,5,Low-Value,At Risk Customers
46064,988,2,"79,55",3,1,1,5,Low-Value,At Risk Customers
46066,160,7,"559,0500000000001",5,2,1,8,High-Value,Potential Loyalists
46067,26,6,"395,25",5,1,1,7,Mid-Value,Potential Loyalists
46068,154,3,"86,25",5,1,1,7,Mid-Value,Potential Loyalists
46069,780,3,"89,9",3,1,1,5,Low-Value,At Risk Customers
46070,1537,1,"31,3",1,1,1,3,Low-Value,Lost
46071,40,5,"220,15",5,1,1,7,Mid-Value,Potential Loyalists
46072,244,2,"365,6",5,1,1,7,Mid-Value,Potential Loyalists
46073,441,2,"65,3",4,1,1,6,Mid-Value,Potential Loyalists
46074,1615,1,"70,19999999999999",1,1,1,3,Low-Value,Lost
46076,1808,1,"42,45",1,1,1,3,Low-Value,Lost
46078,1067,5,"213,8",3,1,1,5,Low-Value,At Risk Customers
46079,434,2,"44,7",4,1,1,6,Mid-Value,Potential Loyalists
46080,520,2,"43,55",4,1,1,6,Mid-Value,Potential Loyalists
46081,5,2,"128,7",5,1,1,7,Mid-Value,Potential Loyalists
46082,1096,1,"25,0",2,1,1,4,Low-Value,Can't Lose
46083,389,3,"44,65",4,1,1,6,Mid-Value,Potential Loyalists
46084,360,4,"306,4",5,1,1,7,Mid-Value,Potential Loyalists
46085,1047,1,"209,45",3,1,1,5,Low-Value,At Risk Customers
46088,168,2,"367,2",5,1,1,7,Mid-Value,Potential Loyalists
46091,58,2,"139,15",5,1,1,7,Mid-Value,Potential Loyalists
46092,1496,1,"6,8",1,1,1,3,Low-Value,Lost
46094,934,2,"109,0",3,1,1,5,Low-Value,At Risk Customers
46095,300,5,"238,7",5,1,1,7,Mid-Value,Potential Loyalists
46096,1520,1,"113,65",1,1,1,3,Low-Value,Lost
46097,65,5,"228,4",5,1,1,7,Mid-Value,Potential Loyalists
46098,60,8,"474,9",5,2,1,8,High-Value,Potential Loyalists
46102,882,3,"381,59999999999997",3,1,1,5,Low-Value,At Risk Customers
46103,648,1,"39,2",4,1,1,6,Mid-Value,Potential Loyalists
46104,524,3,"392,9",4,1,1,6,Mid-Value,Potential Loyalists
46105,594,2,"141,8",4,1,1,6,Mid-Value,Potential Loyalists
46106,1097,3,"187,7",2,1,1,4,Low-Value,Can't Lose
46110,204,6,"500,5",5,1,1,7,Mid-Value,Potential Loyalists
46111,558,4,"390,6",4,1,1,6,Mid-Value,Potential Loyalists
46112,828,4,"159,3",3,1,1,5,Low-Value,At Risk Customers
46113,557,2,"216,70000000000002",4,1,1,6,Mid-Value,Potential Loyalists
46114,103,1,"50,1",5,1,1,7,Mid-Value,Potential Loyalists
46115,397,7,"742,8100000000001",4,2,2,8,High-Value,Potential Loyalists
46116,483,2,"48,2",4,1,1,6,Mid-Value,Potential Loyalists
46119,1454,1,"37,8",2,1,1,4,Low-Value,Can't Lose
46121,1097,4,"356,20000000000005",2,1,1,4,Low-Value,Can't Lose
46122,27,4,"81,15",5,1,1,7,Mid-Value,Potential Loyalists
46123,1,3,"72,85",5,1,1,7,Mid-Value,Potential Loyalists
46124,8,3,"162,6",5,1,1,7,Mid-Value,Potential Loyalists
46125,154,1,"33,5",5,1,1,7,Mid-Value,Potential Loyalists
46126,1722,1,"0,7",1,1,1,3,Low-Value,Lost
46127,286,1,"86,65",5,1,1,7,Mid-Value,Potential Loyalists
46129,772,2,"253,25",3,1,1,5,Low-Value,At Risk Customers
46130,38,1,"134,8",5,1,1,7,Mid-Value,Potential Loyalists
46131,664,2,"202,8",4,1,1,6,Mid-Value,Potential Loyalists
46132,46,1,"18,0",5,1,1,7,Mid-Value,Potential Loyalists
46133,106,3,"63,300000000000004",5,1,1,7,Mid-Value,Potential Loyalists
46134,907,3,"362,7",3,1,1,5,Low-Value,At Risk Customers
46135,36,3,"152,75",5,1,1,7,Mid-Value,Potential Loyalists
46136,837,5,"108,3",3,1,1,5,Low-Value,At Risk Customers
46138,1113,7,"617,1",2,2,1,5,Low-Value,At Risk Customers
46139,791,2,"216,4",3,1,1,5,Low-Value,At Risk Customers
46140,1503,2,"44,0",1,1,1,3,Low-Value,Lost
46142,580,2,"123,55000000000001",4,1,1,6,Mid-Value,Potential Loyalists
46143,916,1,"86,1",3,1,1,5,Low-Value,At Risk Customers
46145,964,3,"85,9",3,1,1,5,Low-Value,At Risk Customers
46147,86,7,"671,55",5,2,2,9,High-Value,Champions
46148,620,2,"149,25",4,1,1,6,Mid-Value,Potential Loyalists
46150,166,2,"66,1",5,1,1,7,Mid-Value,Potential Loyalists
46152,498,2,"115,4",4,1,1,6,Mid-Value,Potential Loyalists
46153,1485,1,"8,0",1,1,1,3,Low-Value,Lost
46154,907,1,"113,55000000000001",3,1,1,5,Low-Value,At Risk Customers
46160,783,1,"54,0",3,1,1,5,Low-Value,At Risk Customers
46161,734,2,"216,79999999999998",3,1,1,5,Low-Value,At Risk Customers
46162,188,6,"214,24999999999997",5,1,1,7,Mid-Value,Potential Loyalists
46166,138,3,"265,8",5,1,1,7,Mid-Value,Potential Loyalists
46169,48,5,"210,85",5,1,1,7,Mid-Value,Potential Loyalists
46170,520,1,"43,5",4,1,1,6,Mid-Value,Potential Loyalists
46171,508,3,"130,6",4,1,1,6,Mid-Value,Potential Loyalists
46173,1000,5,"165,0",3,1,1,5,Low-Value,At Risk Customers
46174,1676,2,"134,05",1,1,1,3,Low-Value,Lost
46175,1175,3,"35,65",2,1,1,4,Low-Value,Can't Lose
46179,160,1,"191,3",5,1,1,7,Mid-Value,Potential Loyalists
46180,657,4,"221,6",4,1,1,6,Mid-Value,Potential Loyalists
46181,897,1,"67,5",3,1,1,5,Low-Value,At Risk Customers
46183,1650,1,"38,6",1,1,1,3,Low-Value,Lost
46186,123,2,"115,25",5,1,1,7,Mid-Value,Potential Loyalists
46188,518,2,"57,8",4,1,1,6,Mid-Value,Potential Loyalists
46190,658,3,"90,65",4,1,1,6,Mid-Value,Potential Loyalists
46191,1069,2,"67,95",3,1,1,5,Low-Value,At Risk Customers
46192,844,3,"57,7",3,1,1,5,Low-Value,At Risk Customers
46195,668,1,"71,55",4,1,1,6,Mid-Value,Potential Loyalists
46196,313,2,"218,75",5,1,1,7,Mid-Value,Potential Loyalists
46197,5,10,"497,5",5,2,1,8,High-Value,Potential Loyalists
46199,517,2,"145,60000000000002",4,1,1,6,Mid-Value,Potential Loyalists
46200,206,1,"14,0",5,1,1,7,Mid-Value,Potential Loyalists
46201,424,3,"141,0",4,1,1,6,Mid-Value,Potential Loyalists
46202,1665,1,"33,6",1,1,1,3,Low-Value,Lost
46203,1286,1,"252,14999999999998",2,1,1,4,Low-Value,Can't Lose
46204,80,5,"226,95",5,1,1,7,Mid-Value,Potential Loyalists
46206,110,6,"333,35",5,1,1,7,Mid-Value,Potential Loyalists
46207,571,6,"181,69",4,1,1,6,Mid-Value,Potential Loyalists
46208,934,3,"218,6",3,1,1,5,Low-Value,At Risk Customers
46210,400,8,"237,15",4,2,1,7,Mid-Value,Potential Loyalists
46212,341,2,"48,6",5,1,1,7,Mid-Value,Potential Loyalists
46215,773,3,"135,2",3,1,1,5,Low-Value,At Risk Customers
46216,580,4,"370,9",4,1,1,6,Mid-Value,Potential Loyalists
46219,36,5,"203,9",5,1,1,7,Mid-Value,Potential Loyalists
46220,525,4,"325,0",4,1,1,6,Mid-Value,Potential Loyalists
46222,1018,1,"50,55",3,1,1,5,Low-Value,At Risk Customers
46224,1463,2,"102,9",1,1,1,3,Low-Value,Lost
46228,790,2,"367,24999999999994",3,1,1,5,Low-Value,At Risk Customers
46229,999,1,"14,35",3,1,1,5,Low-Value,At Risk Customers
46230,930,2,"348,75",3,1,1,5,Low-Value,At Risk Customers
46232,848,4,"789,5",3,1,2,6,Mid-Value,Potential Loyalists
46233,1406,2,"140,35000000000002",2,1,1,4,Low-Value,Can't Lose
46235,1649,1,"11,65",1,1,1,3,Low-Value,Lost
46238,389,7,"796,5",4,2,2,8,High-Value,Potential Loyalists
46240,1393,1,"34,5",2,1,1,4,Low-Value,Can't Lose
46241,737,3,"309,15",3,1,1,5,Low-Value,At Risk Customers
46242,882,1,"37,8",3,1,1,5,Low-Value,At Risk Customers
46244,1189,1,"35,95",2,1,1,4,Low-Value,Can't Lose
46245,133,5,"229,9",5,1,1,7,Mid-Value,Potential Loyalists
46246,427,2,"76,1",4,1,1,6,Mid-Value,Potential Loyalists
46247,505,2,"123,3",4,1,1,6,Mid-Value,Potential Loyalists
46250,482,2,"106,95",4,1,1,6,Mid-Value,Potential Loyalists
46251,789,5,"152,10000000000002",3,1,1,5,Low-Value,At Risk Customers
46253,43,5,"258,15000000000003",5,1,1,7,Mid-Value,Potential Loyalists
46254,477,1,"39,4",4,1,1,6,Mid-Value,Potential Loyalists
46255,7,1,"47,2",5,1,1,7,Mid-Value,Potential Loyalists
46256,771,2,"48,2",3,1,1,5,Low-Value,At Risk Customers
46257,1509,2,"93,39999999999999",1,1,1,3,Low-Value,Lost
46259,115,8,"328,6",5,2,1,8,High-Value,Potential Loyalists
46260,524,5,"125,55000000000001",4,1,1,6,Mid-Value,Potential Loyalists
46261,328,2,"85,7",5,1,1,7,Mid-Value,Potential Loyalists
46263,1248,1,"24,4",2,1,1,4,Low-Value,Can't Lose
46265,1437,2,"225,74999999999997",2,1,1,4,Low-Value,Can't Lose
46266,1127,5,"310,25",2,1,1,4,Low-Value,Can't Lose
46268,367,6,"493,15",4,1,1,6,Mid-Value,Potential Loyalists
46269,385,5,"199,45",4,1,1,6,Mid-Value,Potential Loyalists
46271,505,5,"201,39999999999998",4,1,1,6,Mid-Value,Potential Loyalists
46272,0,1,"47,2",5,1,1,7,Mid-Value,Potential Loyalists
46280,136,5,"272,55",5,1,1,7,Mid-Value,Potential Loyalists
46281,933,1,"60,8",3,1,1,5,Low-Value,At Risk Customers
46282,3,6,"189,0",5,1,1,7,Mid-Value,Potential Loyalists
46284,1727,1,"59,2",1,1,1,3,Low-Value,Lost
46285,683,3,"134,25",4,1,1,6,Mid-Value,Potential Loyalists
46286,498,3,"197,5",4,1,1,6,Mid-Value,Potential Loyalists
46287,1088,1,"10,15",3,1,1,5,Low-Value,At Risk Customers
46289,56,9,"598,7",5,2,1,8,High-Value,Potential Loyalists
46291,796,1,"11,35",3,1,1,5,Low-Value,At Risk Customers
46292,35,7,"244,5",5,2,1,8,High-Value,Potential Loyalists
46293,146,4,"123,75",5,1,1,7,Mid-Value,Potential Loyalists
46296,84,11,"645,7",5,2,1,8,High-Value,Potential Loyalists
46299,1226,6,"291,9",2,1,1,4,Low-Value,Can't Lose
46300,483,2,"282,5",4,1,1,6,Mid-Value,Potential Loyalists
46302,405,4,"223,2",4,1,1,6,Mid-Value,Potential Loyalists
46303,735,4,"231,2",3,1,1,5,Low-Value,At Risk Customers
46304,561,2,"89,0",4,1,1,6,Mid-Value,Potential Loyalists
46306,85,2,"101,55000000000001",5,1,1,7,Mid-Value,Potential Loyalists
46307,58,12,"447,9",5,3,1,9,High-Value,Champions
46309,273,2,"127,80000000000001",5,1,1,7,Mid-Value,Potential Loyalists
46310,1010,1,"25,8",3,1,1,5,Low-Value,At Risk Customers
46311,104,2,"150,05",5,1,1,7,Mid-Value,Potential Loyalists
46312,592,2,"208,4",4,1,1,6,Mid-Value,Potential Loyalists
46314,197,3,"154,95",5,1,1,7,Mid-Value,Potential Loyalists
46317,1113,1,"25,8",2,1,1,4,Low-Value,Can't Lose
46319,1414,2,"173,6",2,1,1,4,Low-Value,Can't Lose
46321,499,1,"69,85",4,1,1,6,Mid-Value,Potential Loyalists
46323,184,2,"188,9",5,1,1,7,Mid-Value,Potential Loyalists
46324,368,4,"185,05",4,1,1,6,Mid-Value,Potential Loyalists
46327,355,1,"20,65",5,1,1,7,Mid-Value,Potential Loyalists
46328,59,2,"101,55",5,1,1,7,Mid-Value,Potential Loyalists
46329,185,1,"1,2",5,1,1,7,Mid-Value,Potential Loyalists
46330,174,7,"451,0",5,2,1,8,High-Value,Potential Loyalists
46331,365,4,"329,15000000000003",5,1,1,7,Mid-Value,Potential Loyalists
46332,978,2,"59,8",3,1,1,5,Low-Value,At Risk Customers
46334,1237,1,"51,75",2,1,1,4,Low-Value,Can't Lose
46336,325,3,"292,9",5,1,1,7,Mid-Value,Potential Loyalists
46338,19,5,"138,3",5,1,1,7,Mid-Value,Potential Loyalists
46339,734,6,"265,85",3,1,1,5,Low-Value,At Risk Customers
46342,221,3,"112,65",5,1,1,7,Mid-Value,Potential Loyalists
46344,228,1,"66,5",5,1,1,7,Mid-Value,Potential Loyalists
46347,1481,2,"57,2",1,1,1,3,Low-Value,Lost
46348,31,3,"60,650000000000006",5,1,1,7,Mid-Value,Potential Loyalists
46349,430,2,"48,0",4,1,1,6,Mid-Value,Potential Loyalists
46350,1553,1,"33,4",1,1,1,3,Low-Value,Lost
46351,8,5,"776,35",5,1,2,8,High-Value,Potential Loyalists
46352,72,4,"154,79999999999998",5,1,1,7,Mid-Value,Potential Loyalists
46355,1106,2,"49,85",2,1,1,4,Low-Value,Can't Lose
46357,28,4,"327,25",5,1,1,7,Mid-Value,Potential Loyalists
46361,1524,1,"37,85",1,1,1,3,Low-Value,Lost
46363,677,4,"95,55",4,1,1,6,Mid-Value,Potential Loyalists
46364,65,2,"65,75",5,1,1,7,Mid-Value,Potential Loyalists
46366,115,5,"292,9",5,1,1,7,Mid-Value,Potential Loyalists
46367,388,7,"506,45",4,2,1,7,Mid-Value,Potential Loyalists
46369,742,8,"506,95",3,2,1,6,Mid-Value,Potential Loyalists
46370,974,3,"161,5",3,1,1,5,Low-Value,At Risk Customers
46371,760,2,"243,79999999999998",3,1,1,5,Low-Value,At Risk Customers
46372,948,2,"105,25",3,1,1,5,Low-Value,At Risk Customers
46375,554,1,"132,7",4,1,1,6,Mid-Value,Potential Loyalists
46376,1660,1,"18,45",1,1,1,3,Low-Value,Lost
46378,1133,1,"19,35",2,1,1,4,Low-Value,Can't Lose
46379,1116,3,"163,4",2,1,1,4,Low-Value,Can't Lose
46380,55,5,"443,55",5,1,1,7,Mid-Value,Potential Loyalists
46381,920,2,"166,45",3,1,1,5,Low-Value,At Risk Customers
46382,1043,2,"88,55",3,1,1,5,Low-Value,At Risk Customers
46383,1278,1,"479,2",2,1,1,4,Low-Value,Can't Lose
46384,479,1,"15,0",4,1,1,6,Mid-Value,Potential Loyalists
46385,423,3,"118,7",4,1,1,6,Mid-Value,Potential Loyalists
46387,1149,6,"474,15",2,1,1,4,Low-Value,Can't Lose
46388,1766,1,"46,8",1,1,1,3,Low-Value,Lost
46389,374,3,"158,04999999999998",4,1,1,6,Mid-Value,Potential Loyalists
46390,91,9,"303,55",5,2,1,8,High-Value,Potential Loyalists
46391,929,2,"364,75",3,1,1,5,Low-Value,At Risk Customers
46393,1722,1,"36,8",1,1,1,3,Low-Value,Lost
46394,393,5,"372,54999999999995",4,1,1,6,Mid-Value,Potential Loyalists
46395,476,2,"136,20000000000002",4,1,1,6,Mid-Value,Potential Loyalists
46397,102,6,"633,3",5,1,1,7,Mid-Value,Potential Loyalists
46398,698,3,"367,8",4,1,1,6,Mid-Value,Potential Loyalists
46399,463,5,"313,0",4,1,1,6,Mid-Value,Potential Loyalists
46405,789,4,"58,349999999999994",3,1,1,5,Low-Value,At Risk Customers
46407,936,1,"27,8",3,1,1,5,Low-Value,At Risk Customers
46408,62,14,"611,05",5,3,1,9,High-Value,Champions
46409,728,1,"24,05",4,1,1,6,Mid-Value,Potential Loyalists
46410,1319,2,"67,9",2,1,1,4,Low-Value,Can't Lose
46412,252,2,"72,89999999999999",5,1,1,7,Mid-Value,Potential Loyalists
46413,687,3,"295,95",4,1,1,6,Mid-Value,Potential Loyalists
46417,366,5,"844,25",4,1,2,7,Mid-Value,Potential Loyalists
46418,1140,1,"24,75",2,1,1,4,Low-Value,Can't Lose
46419,655,1,"22,85",4,1,1,6,Mid-Value,Potential Loyalists
46420,300,1,"8,55",5,1,1,7,Mid-Value,Potential Loyalists
46421,31,5,"736,05",5,1,2,8,High-Value,Potential Loyalists
46422,697,1,"584,5",4,1,1,6,Mid-Value,Potential Loyalists
46423,1255,1,"78,1",2,1,1,4,Low-Value,Can't Lose
46424,351,6,"408,54999999999995",5,1,1,7,Mid-Value,Potential Loyalists
46427,1422,1,"584,75",2,1,1,4,Low-Value,Can't Lose
46428,745,1,"62,6",3,1,1,5,Low-Value,At Risk Customers
46430,70,10,"965,1",5,2,2,9,High-Value,Champions
46433,1278,1,"12,1",2,1,1,4,Low-Value,Can't Lose
46434,704,2,"74,00000000000001",4,1,1,6,Mid-Value,Potential Loyalists
46435,1542,4,"367,79999999999995",1,1,1,3,Low-Value,Lost
46436,1001,1,"86,9",3,1,1,5,Low-Value,At Risk Customers
46437,1471,2,"547,8000000000001",1,1,1,3,Low-Value,Lost
46438,257,1,"12,3",5,1,1,7,Mid-Value,Potential Loyalists
46439,985,2,"86,75",3,1,1,5,Low-Value,At Risk Customers
46440,40,4,"39,2",5,1,1,7,Mid-Value,Potential Loyalists
46441,94,4,"102,2",5,1,1,7,Mid-Value,Potential Loyalists
46443,381,3,"146,65",4,1,1,6,Mid-Value,Potential Loyalists
46444,1345,1,"32,6",2,1,1,4,Low-Value,Can't Lose
46446,25,7,"525,0",5,2,1,8,High-Value,Potential Loyalists
46447,132,2,"44,1",5,1,1,7,Mid-Value,Potential Loyalists
46449,145,9,"760,6",5,2,2,9,High-Value,Champions
46450,341,8,"1247,05",5,2,2,9,High-Value,Champions
46451,566,1,"22,25",4,1,1,6,Mid-Value,Potential Loyalists
46453,509,2,"224,35",4,1,1,6,Mid-Value,Potential Loyalists
46455,19,4,"125,4",5,1,1,7,Mid-Value,Potential Loyalists
46457,88,3,"150,25",5,1,1,7,Mid-Value,Potential Loyalists
46459,1379,6,"708,95",2,1,2,5,Low-Value,At Risk Customers
46460,1166,2,"138,6",2,1,1,4,Low-Value,Can't Lose
46462,493,6,"339,55",4,1,1,6,Mid-Value,Potential Loyalists
46465,1078,5,"142,4",3,1,1,5,Low-Value,At Risk Customers
46466,1232,3,"61,3",2,1,1,4,Low-Value,Can't Lose
46467,1740,1,"49,0",1,1,1,3,Low-Value,Lost
46468,1371,1,"16,95",2,1,1,4,Low-Value,Can't Lose
46469,399,4,"199,55",4,1,1,6,Mid-Value,Potential Loyalists
46471,189,7,"423,79999999999995",5,2,1,8,High-Value,Potential Loyalists
46473,42,4,"249,85",5,1,1,7,Mid-Value,Potential Loyalists
46475,172,4,"92,1",5,1,1,7,Mid-Value,Potential Loyalists
46476,60,11,"380,65000000000003",5,2,1,8,High-Value,Potential Loyalists
46477,96,5,"406,55000000000007",5,1,1,7,Mid-Value,Potential Loyalists
46478,1188,1,"83,2",2,1,1,4,Low-Value,Can't Lose
46479,409,4,"222,65",4,1,1,6,Mid-Value,Potential Loyalists
46482,754,9,"645,25",3,2,1,6,Mid-Value,Potential Loyalists
46483,92,1,"2,2",5,1,1,7,Mid-Value,Potential Loyalists
46485,741,3,"72,8",3,1,1,5,Low-Value,At Risk Customers
46486,643,1,"18,15",4,1,1,6,Mid-Value,Potential Loyalists
46488,87,3,"116,5",5,1,1,7,Mid-Value,Potential Loyalists
46490,419,3,"93,65",4,1,1,6,Mid-Value,Potential Loyalists
46491,1047,1,"10,75",3,1,1,5,Low-Value,At Risk Customers
46492,109,5,"200,0",5,1,1,7,Mid-Value,Potential Loyalists
46493,161,2,"64,9",5,1,1,7,Mid-Value,Potential Loyalists
46494,596,1,"86,1",4,1,1,6,Mid-Value,Potential Loyalists
46495,1128,3,"149,39999999999998",2,1,1,4,Low-Value,Can't Lose
46496,477,1,"40,75",4,1,1,6,Mid-Value,Potential Loyalists
46497,59,4,"86,6",5,1,1,7,Mid-Value,Potential Loyalists
46498,1172,2,"65,55",2,1,1,4,Low-Value,Can't Lose
46499,386,12,"536,05",4,3,1,8,High-Value,Potential Loyalists
46501,906,3,"114,25",3,1,1,5,Low-Value,At Risk Customers
46503,88,3,"111,6",5,1,1,7,Mid-Value,Potential Loyalists
46504,228,3,"170,1",5,1,1,7,Mid-Value,Potential Loyalists
46506,1279,2,"92,8",2,1,1,4,Low-Value,Can't Lose
46508,1478,6,"259,75",1,1,1,3,Low-Value,Lost
46509,796,1,"25,6",3,1,1,5,Low-Value,At Risk Customers
46510,94,4,"116,70000000000002",5,1,1,7,Mid-Value,Potential Loyalists
46511,43,4,"155,85000000000002",5,1,1,7,Mid-Value,Potential Loyalists
46512,498,1,"152,6",4,1,1,6,Mid-Value,Potential Loyalists
46513,5,5,"203,45999999999998",5,1,1,7,Mid-Value,Potential Loyalists
46517,1813,2,"72,15",1,1,1,3,Low-Value,Lost
46518,1235,1,"56,7",2,1,1,4,Low-Value,Can't Lose
46521,722,1,"6,25",4,1,1,6,Mid-Value,Potential Loyalists
46523,1005,1,"44,6",3,1,1,5,Low-Value,At Risk Customers
46524,882,3,"250,0",3,1,1,5,Low-Value,At Risk Customers
46525,5,5,"199,45",5,1,1,7,Mid-Value,Potential Loyalists
46529,325,1,"15,6",5,1,1,7,Mid-Value,Potential Loyalists
46530,1592,1,"40,75",1,1,1,3,Low-Value,Lost
46531,994,4,"306,5",3,1,1,5,Low-Value,At Risk Customers
46534,685,4,"77,75",4,1,1,6,Mid-Value,Potential Loyalists
46535,28,3,"116,8",5,1,1,7,Mid-Value,Potential Loyalists
46538,59,2,"21,25",5,1,1,7,Mid-Value,Potential Loyalists
46539,132,4,"85,35",5,1,1,7,Mid-Value,Potential Loyalists
46540,762,4,"239,6",3,1,1,5,Low-Value,At Risk Customers
46541,7,4,"593,75",5,1,1,7,Mid-Value,Potential Loyalists
46542,817,5,"257,8",3,1,1,5,Low-Value,At Risk Customers
46543,512,4,"158,2",4,1,1,6,Mid-Value,Potential Loyalists
46545,1509,1,"15,95",1,1,1,3,Low-Value,Lost
46546,161,4,"326,1",5,1,1,7,Mid-Value,Potential Loyalists
46548,60,1,"65,6",5,1,1,7,Mid-Value,Potential Loyalists
46550,102,2,"129,7",5,1,1,7,Mid-Value,Potential Loyalists
46555,882,2,"187,55",3,1,1,5,Low-Value,At Risk Customers
46556,99,2,"427,79999999999995",5,1,1,7,Mid-Value,Potential Loyalists
46559,789,3,"23,299999999999997",3,1,1,5,Low-Value,At Risk Customers
46561,502,3,"67,94999999999999",4,1,1,6,Mid-Value,Potential Loyalists
46562,560,1,"41,4",4,1,1,6,Mid-Value,Potential Loyalists
46563,470,4,"256,3",4,1,1,6,Mid-Value,Potential Loyalists
46564,780,7,"571,0",3,2,1,6,Mid-Value,Potential Loyalists
46568,1717,1,"9,4",1,1,1,3,Low-Value,Lost
46570,1688,1,"91,7",1,1,1,3,Low-Value,Lost
46571,406,8,"244,25",4,2,1,7,Mid-Value,Potential Loyalists
46572,990,3,"159,4",3,1,1,5,Low-Value,At Risk Customers
46573,1320,1,"35,099999999999994",2,1,1,4,Low-Value,Can't Lose
46574,26,8,"617,35",5,2,1,8,High-Value,Potential Loyalists
46577,375,5,"294,95000000000005",4,1,1,6,Mid-Value,Potential Loyalists
46580,346,2,"121,15",5,1,1,7,Mid-Value,Potential Loyalists
46582,1759,1,"10,85",1,1,1,3,Low-Value,Lost
46584,126,3,"62,75",5,1,1,7,Mid-Value,Potential Loyalists
46585,221,4,"262,79999999999995",5,1,1,7,Mid-Value,Potential Loyalists
46586,262,4,"270,7",5,1,1,7,Mid-Value,Potential Loyalists
46587,1145,1,"12,25",2,1,1,4,Low-Value,Can't Lose
46589,1026,1,"16,8",3,1,1,5,Low-Value,At Risk Customers
46590,134,3,"124,05000000000001",5,1,1,7,Mid-Value,Potential Loyalists
46591,399,5,"140,1",4,1,1,6,Mid-Value,Potential Loyalists
46592,1182,1,"8,55",2,1,1,4,Low-Value,Can't Lose
46593,10,1,"19,55",5,1,1,7,Mid-Value,Potential Loyalists
46595,793,2,"35,5",3,1,1,5,Low-Value,At Risk Customers
46596,1236,1,"23,0",2,1,1,4,Low-Value,Can't Lose
46597,818,1,"10,05",3,1,1,5,Low-Value,At Risk Customers
46598,1347,1,"201,6",2,1,1,4,Low-Value,Can't Lose
46604,381,1,"132,2",4,1,1,6,Mid-Value,Potential Loyalists
46606,91,5,"303,4",5,1,1,7,Mid-Value,Potential Loyalists
46609,388,3,"83,65",4,1,1,6,Mid-Value,Potential Loyalists
46610,452,2,"54,95",4,1,1,6,Mid-Value,Potential Loyalists
46611,1002,1,"255,3",3,1,1,5,Low-Value,At Risk Customers
46613,689,5,"393,2",4,1,1,6,Mid-Value,Potential Loyalists
46614,115,3,"123,1",5,1,1,7,Mid-Value,Potential Loyalists
46615,20,9,"683,45",5,2,2,9,High-Value,Champions
46616,219,7,"893,4",5,2,2,9,High-Value,Champions
46617,217,7,"403,1",5,2,1,8,High-Value,Potential Loyalists
46618,61,6,"360,6",5,1,1,7,Mid-Value,Potential Loyalists
46620,106,2,"277,90000000000003",5,1,1,7,Mid-Value,Potential Loyalists
46621,1514,2,"87,2",1,1,1,3,Low-Value,Lost
46622,394,4,"204,3",4,1,1,6,Mid-Value,Potential Loyalists
46623,426,2,"94,6",4,1,1,6,Mid-Value,Potential Loyalists
46624,253,12,"1010,9499999999999",5,3,2,10,High-Value,Champions
46627,37,6,"358,55",5,1,1,7,Mid-Value,Potential Loyalists
46631,215,3,"177,15",5,1,1,7,Mid-Value,Potential Loyalists
46632,476,4,"797,3499999999999",4,1,2,7,Mid-Value,Potential Loyalists
46633,908,3,"93,99999999999999",3,1,1,5,Low-Value,At Risk Customers
46635,13,3,"204,4",5,1,1,7,Mid-Value,Potential Loyalists
46639,111,2,"142,3",5,1,1,7,Mid-Value,Potential Loyalists
46646,75,2,"42,3",5,1,1,7,Mid-Value,Potential Loyalists
46648,549,2,"81,05",4,1,1,6,Mid-Value,Potential Loyalists
46650,189,2,"54,699999999999996",5,1,1,7,Mid-Value,Potential Loyalists
46651,286,6,"526,0",5,1,1,7,Mid-Value,Potential Loyalists
46654,1053,1,"74,15",3,1,1,5,Low-Value,At Risk Customers
46658,486,3,"63,400000000000006",4,1,1,6,Mid-Value,Potential Loyalists
46659,449,4,"344,2",4,1,1,6,Mid-Value,Potential Loyalists
46660,95,4,"508,75",5,1,1,7,Mid-Value,Potential Loyalists
46664,65,1,"51,85",5,1,1,7,Mid-Value,Potential Loyalists
46665,302,1,"29,6",5,1,1,7,Mid-Value,Potential Loyalists
46666,920,2,"93,45",3,1,1,5,Low-Value,At Risk Customers
46667,1515,1,"47,05",1,1,1,3,Low-Value,Lost
46670,314,6,"955,75",5,1,2,8,High-Value,Potential Loyalists
46671,367,2,"57,1",4,1,1,6,Mid-Value,Potential Loyalists
46672,134,1,"53,849999999999994",5,1,1,7,Mid-Value,Potential Loyalists
46674,1117,2,"143,25",2,1,1,4,Low-Value,Can't Lose
46675,295,3,"38,199999999999996",5,1,1,7,Mid-Value,Potential Loyalists
46676,1769,1,"56,8",1,1,1,3,Low-Value,Lost
46677,1491,2,"178,75",1,1,1,3,Low-Value,Lost
46680,572,2,"172,45",4,1,1,6,Mid-Value,Potential Loyalists
46681,74,5,"220,9",5,1,1,7,Mid-Value,Potential Loyalists
46683,332,1,"39,2",5,1,1,7,Mid-Value,Potential Loyalists
46685,547,1,"27,2",4,1,1,6,Mid-Value,Potential Loyalists
46686,389,4,"209,15",4,1,1,6,Mid-Value,Potential Loyalists
46687,594,3,"61,2",4,1,1,6,Mid-Value,Potential Loyalists
46688,81,7,"328,75",5,2,1,8,High-Value,Potential Loyalists
46689,132,1,"340,20000000000005",5,1,1,7,Mid-Value,Potential Loyalists
46692,1161,1,"29,6",2,1,1,4,Low-Value,Can't Lose
46694,195,5,"367,45",5,1,1,7,Mid-Value,Potential Loyalists
46695,790,3,"109,65",3,1,1,5,Low-Value,At Risk Customers
46696,945,2,"75,35",3,1,1,5,Low-Value,At Risk Customers
46697,363,6,"381,4",5,1,1,7,Mid-Value,Potential Loyalists
46698,1147,1,"60,95",2,1,1,4,Low-Value,Can't Lose
46700,8,10,"474,04999999999995",5,2,1,8,High-Value,Potential Loyalists
46702,125,3,"463,4",5,1,1,7,Mid-Value,Potential Loyalists
46703,153,3,"207,65",5,1,1,7,Mid-Value,Potential Loyalists
46704,1161,2,"83,35",2,1,1,4,Low-Value,Can't Lose
46706,392,1,"60,9",4,1,1,6,Mid-Value,Potential Loyalists
46707,701,7,"331,13",4,2,1,7,Mid-Value,Potential Loyalists
46708,1007,1,"58,9",3,1,1,5,Low-Value,At Risk Customers
46710,1025,4,"66,85",3,1,1,5,Low-Value,At Risk Customers
46712,26,2,"62,400000000000006",5,1,1,7,Mid-Value,Potential Loyalists
46714,396,8,"476,85",4,2,1,7,Mid-Value,Potential Loyalists
46715,1013,2,"53,85",3,1,1,5,Low-Value,At Risk Customers
46717,374,4,"468,05",4,1,1,6,Mid-Value,Potential Loyalists
46718,111,3,"62,050000000000004",5,1,1,7,Mid-Value,Potential Loyalists
46722,15,6,"188,85",5,1,1,7,Mid-Value,Potential Loyalists
46723,1029,1,"56,25",3,1,1,5,Low-Value,At Risk Customers
46725,18,3,"94,3",5,1,1,7,Mid-Value,Potential Loyalists
46726,32,1,"15,35",5,1,1,7,Mid-Value,Potential Loyalists
46727,65,2,"56,35",5,1,1,7,Mid-Value,Potential Loyalists
46728,25,3,"502,75",5,1,1,7,Mid-Value,Potential Loyalists
46730,61,3,"94,6",5,1,1,7,Mid-Value,Potential Loyalists
46734,22,2,"262,29999999999995",5,1,1,7,Mid-Value,Potential Loyalists
46737,542,3,"204,9",4,1,1,6,Mid-Value,Potential Loyalists
46739,743,6,"184,85",3,1,1,5,Low-Value,At Risk Customers
46740,434,2,"183,05",4,1,1,6,Mid-Value,Potential Loyalists
46741,64,3,"300,0",5,1,1,7,Mid-Value,Potential Loyalists
46742,1161,2,"100,25",2,1,1,4,Low-Value,Can't Lose
46744,598,8,"531,1",4,2,1,7,Mid-Value,Potential Loyalists
46745,776,2,"36,75",3,1,1,5,Low-Value,At Risk Customers
46746,554,6,"396,3",4,1,1,6,Mid-Value,Potential Loyalists
46747,24,15,"1097,05",5,3,2,10,High-Value,Champions
46748,37,4,"202,05",5,1,1,7,Mid-Value,Potential Loyalists
46749,1594,1,"19,9",1,1,1,3,Low-Value,Lost
46751,1000,2,"538,5",3,1,1,5,Low-Value,At Risk Customers
46753,829,1,"6,0",3,1,1,5,Low-Value,At Risk Customers
46755,615,6,"464,25",4,1,1,6,Mid-Value,Potential Loyalists
46756,187,1,"14,55",5,1,1,7,Mid-Value,Potential Loyalists
46758,721,1,"29,2",4,1,1,6,Mid-Value,Potential Loyalists
46759,517,4,"81,1",4,1,1,6,Mid-Value,Potential Loyalists
46761,1686,1,"35,099999999999994",1,1,1,3,Low-Value,Lost
46765,3,2,"105,9",5,1,1,7,Mid-Value,Potential Loyalists
46766,193,2,"240,2",5,1,1,7,Mid-Value,Potential Loyalists
46767,917,2,"180,75",3,1,1,5,Low-Value,At Risk Customers
46769,797,2,"121,65",3,1,1,5,Low-Value,At Risk Customers
46771,162,3,"123,35",5,1,1,7,Mid-Value,Potential Loyalists
46772,285,2,"13,7",5,1,1,7,Mid-Value,Potential Loyalists
46773,1695,2,"244,54999999999998",1,1,1,3,Low-Value,Lost
46774,835,2,"50,150000000000006",3,1,1,5,Low-Value,At Risk Customers
46777,1155,1,"26,85",2,1,1,4,Low-Value,Can't Lose
46778,839,1,"23,9",3,1,1,5,Low-Value,At Risk Customers
46779,1036,6,"296,1",3,1,1,5,Low-Value,At Risk Customers
46780,335,6,"444,7",5,1,1,7,Mid-Value,Potential Loyalists
46782,518,3,"553,8",4,1,1,6,Mid-Value,Potential Loyalists
46783,1120,2,"89,69999999999999",2,1,1,4,Low-Value,Can't Lose
46785,519,3,"266,15",4,1,1,6,Mid-Value,Potential Loyalists
46786,1306,1,"47,4",2,1,1,4,Low-Value,Can't Lose
46787,106,5,"189,35",5,1,1,7,Mid-Value,Potential Loyalists
46790,1206,1,"14,6",2,1,1,4,Low-Value,Can't Lose
46791,29,12,"523,15",5,3,1,9,High-Value,Champions
46792,243,2,"35,95",5,1,1,7,Mid-Value,Potential Loyalists
46795,217,8,"573,7",5,2,1,8,High-Value,Potential Loyalists
46797,158,2,"101,39999999999999",5,1,1,7,Mid-Value,Potential Loyalists
46799,1115,1,"246,75",2,1,1,4,Low-Value,Can't Lose
46802,129,2,"122,8",5,1,1,7,Mid-Value,Potential Loyalists
46803,1554,2,"34,7",1,1,1,3,Low-Value,Lost
46804,119,4,"103,0",5,1,1,7,Mid-Value,Potential Loyalists
46806,283,1,"29,8",5,1,1,7,Mid-Value,Potential Loyalists
46807,382,4,"333,8",4,1,1,6,Mid-Value,Potential Loyalists
46808,26,5,"218,2",5,1,1,7,Mid-Value,Potential Loyalists
46810,508,2,"106,25",4,1,1,6,Mid-Value,Potential Loyalists
46813,427,9,"538,85",4,2,1,7,Mid-Value,Potential Loyalists
46814,165,9,"218,6",5,2,1,8,High-Value,Potential Loyalists
46815,141,3,"1212,2",5,1,2,8,High-Value,Potential Loyalists
46816,555,2,"285,95",4,1,1,6,Mid-Value,Potential Loyalists
46818,454,2,"54,849999999999994",4,1,1,6,Mid-Value,Potential Loyalists
46820,410,3,"51,1",4,1,1,6,Mid-Value,Potential Loyalists
46821,1246,2,"213,20000000000002",2,1,1,4,Low-Value,Can't Lose
46822,1673,1,"84,3",1,1,1,3,Low-Value,Lost
46825,794,2,"155,0",3,1,1,5,Low-Value,At Risk Customers
46828,786,2,"264,59999999999997",3,1,1,5,Low-Value,At Risk Customers
46829,1510,2,"224,75",1,1,1,3,Low-Value,Lost
46830,552,4,"302,09999999999997",4,1,1,6,Mid-Value,Potential Loyalists
46832,188,8,"693,75",5,2,2,9,High-Value,Champions
46833,624,2,"123,9",4,1,1,6,Mid-Value,Potential Loyalists
46835,1470,1,"39,3",1,1,1,3,Low-Value,Lost
46837,935,2,"134,75",3,1,1,5,Low-Value,At Risk Customers
46838,1770,1,"91,7",1,1,1,3,Low-Value,Lost
46840,78,2,"64,05",5,1,1,7,Mid-Value,Potential Loyalists
46841,3,3,"126,94999999999999",5,1,1,7,Mid-Value,Potential Loyalists
46842,384,5,"485,15",4,1,1,6,Mid-Value,Potential Loyalists
46843,1,9,"597,7",5,2,1,8,High-Value,Potential Loyalists
46844,883,3,"283,05",3,1,1,5,Low-Value,At Risk Customers
46846,416,6,"282,9",4,1,1,6,Mid-Value,Potential Loyalists
46847,241,9,"858,1999999999999",5,2,2,9,High-Value,Champions
46848,332,4,"402,45",5,1,1,7,Mid-Value,Potential Loyalists
46850,1118,1,"25,0",2,1,1,4,Low-Value,Can't Lose
46852,594,4,"237,95000000000002",4,1,1,6,Mid-Value,Potential Loyalists
46854,662,5,"826,55",4,1,2,7,Mid-Value,Potential Loyalists
46856,785,5,"382,2",3,1,1,5,Low-Value,At Risk Customers
46861,815,1,"19,1",3,1,1,5,Low-Value,At Risk Customers
46862,88,8,"337,7",5,2,1,8,High-Value,Potential Loyalists
46863,1049,1,"117,1",3,1,1,5,Low-Value,At Risk Customers
46866,22,5,"317,5",5,1,1,7,Mid-Value,Potential Loyalists
46867,230,1,"34,5",5,1,1,7,Mid-Value,Potential Loyalists
46869,797,4,"284,55",3,1,1,5,Low-Value,At Risk Customers
46870,31,10,"263,35",5,2,1,8,High-Value,Potential Loyalists
46871,1015,1,"65,6",3,1,1,5,Low-Value,At Risk Customers
46873,356,4,"72,6",5,1,1,7,Mid-Value,Potential Loyalists
46874,823,3,"84,45",3,1,1,5,Low-Value,At Risk Customers
46876,779,5,"137,2",3,1,1,5,Low-Value,At Risk Customers
46877,683,4,"110,60000000000001",4,1,1,6,Mid-Value,Potential Loyalists
46878,999,2,"22,05",3,1,1,5,Low-Value,At Risk Customers
46879,1352,1,"9,95",2,1,1,4,Low-Value,Can't Lose
46881,144,3,"216,7",5,1,1,7,Mid-Value,Potential Loyalists
46882,439,2,"26,95",4,1,1,6,Mid-Value,Potential Loyalists
46884,1223,2,"219,6",2,1,1,4,Low-Value,Can't Lose
46885,567,3,"69,7",4,1,1,6,Mid-Value,Potential Loyalists
46887,176,4,"1185,0",5,1,2,8,High-Value,Potential Loyalists
46890,393,5,"312,25",4,1,1,6,Mid-Value,Potential Loyalists
46891,529,6,"158,3",4,1,1,6,Mid-Value,Potential Loyalists
46892,83,3,"60,6",5,1,1,7,Mid-Value,Potential Loyalists
46896,426,1,"17,85",4,1,1,6,Mid-Value,Potential Loyalists
46899,237,11,"781,25",5,2,2,9,High-Value,Champions
46900,475,5,"214,95",4,1,1,6,Mid-Value,Potential Loyalists
46901,370,4,"598,7",4,1,1,6,Mid-Value,Potential Loyalists
46902,108,7,"335,75",5,2,1,8,High-Value,Potential Loyalists
46903,558,8,"399,7",4,2,1,7,Mid-Value,Potential Loyalists
46905,169,1,"2,0",5,1,1,7,Mid-Value,Potential Loyalists
46906,1758,1,"58,9",1,1,1,3,Low-Value,Lost
46908,820,1,"31,4",3,1,1,5,Low-Value,At Risk Customers
46909,242,4,"196,65",5,1,1,7,Mid-Value,Potential Loyalists
46910,1691,1,"21,15",1,1,1,3,Low-Value,Lost
46911,777,3,"121,5",3,1,1,5,Low-Value,At Risk Customers
46913,334,2,"61,5",5,1,1,7,Mid-Value,Potential Loyalists
46914,773,1,"65,3",3,1,1,5,Low-Value,At Risk Customers
46915,219,8,"403,75",5,2,1,8,High-Value,Potential Loyalists
46916,459,2,"95,9",4,1,1,6,Mid-Value,Potential Loyalists
46918,1657,2,"125,4",1,1,1,3,Low-Value,Lost
46919,1051,8,"351,7",3,2,1,6,Mid-Value,Potential Loyalists
46922,1,4,"137,1",5,1,1,7,Mid-Value,Potential Loyalists
46923,618,1,"20,0",4,1,1,6,Mid-Value,Potential Loyalists
46924,231,4,"110,3",5,1,1,7,Mid-Value,Potential Loyalists
46925,1108,1,"149,9",2,1,1,4,Low-Value,Can't Lose
46928,46,4,"260,95",5,1,1,7,Mid-Value,Potential Loyalists
46929,54,4,"308,3",5,1,1,7,Mid-Value,Potential Loyalists
46931,910,4,"110,15",3,1,1,5,Low-Value,At Risk Customers
46933,115,1,"20,75",5,1,1,7,Mid-Value,Potential Loyalists
46935,52,6,"461,3",5,1,1,7,Mid-Value,Potential Loyalists
46936,1583,3,"203,35",1,1,1,3,Low-Value,Lost
46941,1700,1,"383,85",1,1,1,3,Low-Value,Lost
46942,921,1,"215,85000000000002",3,1,1,5,Low-Value,At Risk Customers
46943,38,4,"101,94999999999999",5,1,1,7,Mid-Value,Potential Loyalists
46944,623,3,"31,549999999999997",4,1,1,6,Mid-Value,Potential Loyalists
46945,877,4,"230,70000000000002",3,1,1,5,Low-Value,At Risk Customers
46946,868,2,"121,75",3,1,1,5,Low-Value,At Risk Customers
46947,69,4,"225,35",5,1,1,7,Mid-Value,Potential Loyalists
46948,1265,4,"98,05000000000001",2,1,1,4,Low-Value,Can't Lose
46950,1277,1,"35,0",2,1,1,4,Low-Value,Can't Lose
46951,456,3,"32,25",4,1,1,6,Mid-Value,Potential Loyalists
46952,671,3,"702,6",4,1,2,7,Mid-Value,Potential Loyalists
46953,28,2,"84,5",5,1,1,7,Mid-Value,Potential Loyalists
46955,75,9,"578,45",5,2,1,8,High-Value,Potential Loyalists
46959,1601,5,"217,79999999999998",1,1,1,3,Low-Value,Lost
46962,519,3,"123,1",4,1,1,6,Mid-Value,Potential Loyalists
46965,312,8,"328,7",5,2,1,8,High-Value,Potential Loyalists
46970,416,4,"108,95",4,1,1,6,Mid-Value,Potential Loyalists
46971,746,2,"179,75",3,1,1,5,Low-Value,At Risk Customers
46972,773,1,"12,4",3,1,1,5,Low-Value,At Risk Customers
46973,496,2,"299,5",4,1,1,6,Mid-Value,Potential Loyalists
46975,1078,2,"45,2",3,1,1,5,Low-Value,At Risk Customers
46977,981,2,"103,05",3,1,1,5,Low-Value,At Risk Customers
46979,158,5,"312,5",5,1,1,7,Mid-Value,Potential Loyalists
46980,152,4,"672,25",5,1,2,8,High-Value,Potential Loyalists
46982,857,2,"30,9",3,1,1,5,Low-Value,At Risk Customers
46983,413,2,"68,5",4,1,1,6,Mid-Value,Potential Loyalists
46984,865,5,"174,5",3,1,1,5,Low-Value,At Risk Customers
46986,22,1,"40,6",5,1,1,7,Mid-Value,Potential Loyalists
46988,990,1,"16,8",3,1,1,5,Low-Value,At Risk Customers
46989,569,2,"66,65",4,1,1,6,Mid-Value,Potential Loyalists
46991,265,2,"50,099999999999994",5,1,1,7,Mid-Value,Potential Loyalists
46992,225,2,"22,450000000000003",5,1,1,7,Mid-Value,Potential Loyalists
46993,77,7,"225,75",5,2,1,8,High-Value,Potential Loyalists
46994,489,2,"131,3",4,1,1,6,Mid-Value,Potential Loyalists
46995,238,1,"155,10000000000002",5,1,1,7,Mid-Value,Potential Loyalists
46996,1075,1,"88,15",3,1,1,5,Low-Value,At Risk Customers
46997,8,4,"225,1",5,1,1,7,Mid-Value,Potential Loyalists
47000,760,2,"73,94999999999999",3,1,1,5,Low-Value,At Risk Customers
47001,116,11,"1066,05",5,2,2,9,High-Value,Champions
47004,10,3,"64,10000000000001",5,1,1,7,Mid-Value,Potential Loyalists
47005,1344,1,"34,1",2,1,1,4,Low-Value,Can't Lose
47007,719,2,"45,55",4,1,1,6,Mid-Value,Potential Loyalists
47009,12,1,"35,0",5,1,1,7,Mid-Value,Potential Loyalists
47010,775,4,"138,65",3,1,1,5,Low-Value,At Risk Customers
47011,393,3,"200,35",4,1,1,6,Mid-Value,Potential Loyalists
47012,346,2,"57,7",5,1,1,7,Mid-Value,Potential Loyalists
47015,74,13,"996,1499999999999",5,3,2,10,High-Value,Champions
47017,35,4,"108,3",5,1,1,7,Mid-Value,Potential Loyalists
47018,250,2,"82,39999999999999",5,1,1,7,Mid-Value,Potential Loyalists
47020,352,10,"385,34999999999997",5,2,1,8,High-Value,Potential Loyalists
47026,1047,1,"43,55",3,1,1,5,Low-Value,At Risk Customers
47027,343,3,"162,60000000000002",5,1,1,7,Mid-Value,Potential Loyalists
47028,624,2,"28,700000000000003",4,1,1,6,Mid-Value,Potential Loyalists
47029,220,1,"7,85",5,1,1,7,Mid-Value,Potential Loyalists
47031,4,5,"218,70000000000002",5,1,1,7,Mid-Value,Potential Loyalists
47033,24,5,"758,7",5,1,2,8,High-Value,Potential Loyalists
47035,1445,1,"21,45",2,1,1,4,Low-Value,Can't Lose
47036,1,5,"284,20000000000005",5,1,1,7,Mid-Value,Potential Loyalists
47040,870,3,"75,1",3,1,1,5,Low-Value,At Risk Customers
47041,650,5,"320,35",4,1,1,6,Mid-Value,Potential Loyalists
47042,420,7,"504,29999999999995",4,2,1,7,Mid-Value,Potential Loyalists
47045,249,3,"175,7",5,1,1,7,Mid-Value,Potential Loyalists
47046,1134,2,"70,1",2,1,1,4,Low-Value,Can't Lose
47047,29,6,"276,84999999999997",5,1,1,7,Mid-Value,Potential Loyalists
47048,385,5,"336,75",4,1,1,6,Mid-Value,Potential Loyalists
47049,200,5,"470,54999999999995",5,1,1,7,Mid-Value,Potential Loyalists
47051,3,4,"117,55",5,1,1,7,Mid-Value,Potential Loyalists
47055,540,3,"134,0",4,1,1,6,Mid-Value,Potential Loyalists
47058,334,1,"18,9",5,1,1,7,Mid-Value,Potential Loyalists
47060,258,1,"141,75",5,1,1,7,Mid-Value,Potential Loyalists
47061,1499,2,"192,0",1,1,1,3,Low-Value,Lost
47062,76,1,"5,95",5,1,1,7,Mid-Value,Potential Loyalists
47064,1127,1,"43,6",2,1,1,4,Low-Value,Can't Lose
47066,1722,1,"32,25",1,1,1,3,Low-Value,Lost
47069,902,3,"211,39999999999998",3,1,1,5,Low-Value,At Risk Customers
47070,372,2,"195,6",4,1,1,6,Mid-Value,Potential Loyalists
47071,45,3,"68,15",5,1,1,7,Mid-Value,Potential Loyalists
47072,12,8,"238,25",5,2,1,8,High-Value,Potential Loyalists
47073,53,2,"16,9",5,1,1,7,Mid-Value,Potential Loyalists
47078,171,5,"241,15",5,1,1,7,Mid-Value,Potential Loyalists
47080,440,3,"290,09999999999997",4,1,1,6,Mid-Value,Potential Loyalists
47082,1144,5,"336,65000000000003",2,1,1,4,Low-Value,Can't Lose
47084,572,1,"261,4",4,1,1,6,Mid-Value,Potential Loyalists
47085,430,3,"137,2",4,1,1,6,Mid-Value,Potential Loyalists
47087,346,4,"222,5",5,1,1,7,Mid-Value,Potential Loyalists
47088,106,5,"404,90000000000003",5,1,1,7,Mid-Value,Potential Loyalists
47089,1369,2,"70,45",2,1,1,4,Low-Value,Can't Lose
47090,1629,5,"249,70000000000002",1,1,1,3,Low-Value,Lost
47091,157,3,"334,1",5,1,1,7,Mid-Value,Potential Loyalists
47092,809,4,"527,25",3,1,1,5,Low-Value,At Risk Customers
47094,108,9,"526,5",5,2,1,8,High-Value,Potential Loyalists
47096,1558,2,"106,7",1,1,1,3,Low-Value,Lost
47097,1201,3,"39,45",2,1,1,4,Low-Value,Can't Lose
47098,424,2,"58,35",4,1,1,6,Mid-Value,Potential Loyalists
47099,474,2,"84,39999999999999",4,1,1,6,Mid-Value,Potential Loyalists
47100,4,1,"24,2",5,1,1,7,Mid-Value,Potential Loyalists
47102,297,6,"294,3",5,1,1,7,Mid-Value,Potential Loyalists
47103,104,5,"362,59999999999997",5,1,1,7,Mid-Value,Potential Loyalists
47104,115,8,"752,0",5,2,2,9,High-Value,Champions
47105,1155,2,"136,85",2,1,1,4,Low-Value,Can't Lose
47106,1496,1,"85,4",1,1,1,3,Low-Value,Lost
47107,791,1,"112,85",3,1,1,5,Low-Value,At Risk Customers
47108,127,6,"309,6",5,1,1,7,Mid-Value,Potential Loyalists
47109,166,10,"471,8",5,2,1,8,High-Value,Potential Loyalists
47111,13,1,"10,7",5,1,1,7,Mid-Value,Potential Loyalists
47112,18,4,"265,75",5,1,1,7,Mid-Value,Potential Loyalists
47113,83,7,"470,04999999999995",5,2,1,8,High-Value,Potential Loyalists
47114,549,4,"71,05",4,1,1,6,Mid-Value,Potential Loyalists
47115,577,6,"750,05",4,1,2,7,Mid-Value,Potential Loyalists
47116,32,11,"605,5",5,2,1,8,High-Value,Potential Loyalists
47120,1237,4,"122,75",2,1,1,4,Low-Value,Can't Lose
47121,38,4,"75,05",5,1,1,7,Mid-Value,Potential Loyalists
47122,1219,1,"20,5",2,1,1,4,Low-Value,Can't Lose
47125,519,2,"41,4",4,1,1,6,Mid-Value,Potential Loyalists
47127,87,9,"481,9",5,2,1,8,High-Value,Potential Loyalists
47128,154,3,"152,35",5,1,1,7,Mid-Value,Potential Loyalists
47129,1233,2,"386,45",2,1,1,4,Low-Value,Can't Lose
47131,452,2,"78,4",4,1,1,6,Mid-Value,Potential Loyalists
47132,426,4,"283,5",4,1,1,6,Mid-Value,Potential Loyalists
47134,416,2,"9,35",4,1,1,6,Mid-Value,Potential Loyalists
47135,791,2,"347,0",3,1,1,5,Low-Value,At Risk Customers
47136,26,2,"615,55",5,1,1,7,Mid-Value,Potential Loyalists
47137,28,2,"190,7",5,1,1,7,Mid-Value,Potential Loyalists
47138,445,2,"19,1",4,1,1,6,Mid-Value,Potential Loyalists
47139,379,2,"152,6",4,1,1,6,Mid-Value,Potential Loyalists
47140,64,4,"185,85000000000002",5,1,1,7,Mid-Value,Potential Loyalists
47141,174,1,"22,8",5,1,1,7,Mid-Value,Potential Loyalists
47147,113,6,"339,2",5,1,1,7,Mid-Value,Potential Loyalists
47150,182,1,"151,9",5,1,1,7,Mid-Value,Potential Loyalists
47151,172,2,"125,5",5,1,1,7,Mid-Value,Potential Loyalists
47152,1287,1,"24,8",2,1,1,4,Low-Value,Can't Lose
47153,924,2,"196,10000000000002",3,1,1,5,Low-Value,At Risk Customers
47154,334,6,"323,9",5,1,1,7,Mid-Value,Potential Loyalists
47155,652,6,"279,75",4,1,1,6,Mid-Value,Potential Loyalists
47156,329,4,"113,15",5,1,1,7,Mid-Value,Potential Loyalists
47158,1232,4,"307,9",2,1,1,4,Low-Value,Can't Lose
47159,3,8,"291,75",5,2,1,8,High-Value,Potential Loyalists
47160,1315,2,"427,0",2,1,1,4,Low-Value,Can't Lose
47161,71,3,"75,5",5,1,1,7,Mid-Value,Potential Loyalists
47163,1,4,"87,9",5,1,1,7,Mid-Value,Potential Loyalists
47164,808,2,"39,95",3,1,1,5,Low-Value,At Risk Customers
47165,845,2,"197,65",3,1,1,5,Low-Value,At Risk Customers
47166,720,9,"1200,55",4,2,2,8,High-Value,Potential Loyalists
47167,1123,2,"61,0",2,1,1,4,Low-Value,Can't Lose
47169,51,6,"401,2",5,1,1,7,Mid-Value,Potential Loyalists
47170,5,2,"427,8",5,1,1,7,Mid-Value,Potential Loyalists
47171,593,2,"236,14999999999998",4,1,1,6,Mid-Value,Potential Loyalists
47172,256,9,"623,65",5,2,1,8,High-Value,Potential Loyalists
47173,1519,2,"81,15",1,1,1,3,Low-Value,Lost
47178,115,3,"61,2",5,1,1,7,Mid-Value,Potential Loyalists
47179,457,2,"44,4",4,1,1,6,Mid-Value,Potential Loyalists
47180,215,5,"361,9",5,1,1,7,Mid-Value,Potential Loyalists
47183,779,2,"112,89999999999999",3,1,1,5,Low-Value,At Risk Customers
47186,996,2,"313,05",3,1,1,5,Low-Value,At Risk Customers
47188,64,4,"281,09999999999997",5,1,1,7,Mid-Value,Potential Loyalists
47189,750,4,"522,05",3,1,1,5,Low-Value,At Risk Customers
47190,1210,1,"19,75",2,1,1,4,Low-Value,Can't Lose
47191,214,3,"176,1",5,1,1,7,Mid-Value,Potential Loyalists
47195,752,1,"33,6",3,1,1,5,Low-Value,At Risk Customers
47196,1473,1,"101,8",1,1,1,3,Low-Value,Lost
47197,175,1,"60,7",5,1,1,7,Mid-Value,Potential Loyalists
47198,1203,1,"157,0",2,1,1,4,Low-Value,Can't Lose
47199,480,5,"180,79999999999998",4,1,1,6,Mid-Value,Potential Loyalists
47201,350,7,"424,55",5,2,1,8,High-Value,Potential Loyalists
47202,40,3,"129,5",5,1,1,7,Mid-Value,Potential Loyalists
47204,525,5,"126,65",4,1,1,6,Mid-Value,Potential Loyalists
47205,678,5,"358,59999999999997",4,1,1,6,Mid-Value,Potential Loyalists
47206,1257,1,"28,0",2,1,1,4,Low-Value,Can't Lose
47207,36,4,"169,6",5,1,1,7,Mid-Value,Potential Loyalists
47208,385,5,"351,29999999999995",4,1,1,6,Mid-Value,Potential Loyalists
47212,10,2,"75,95",5,1,1,7,Mid-Value,Potential Loyalists
47214,392,4,"765,5",4,1,2,7,Mid-Value,Potential Loyalists
47218,153,1,"63,6",5,1,1,7,Mid-Value,Potential Loyalists
47219,521,4,"225,0",4,1,1,6,Mid-Value,Potential Loyalists
47220,71,5,"140,45",5,1,1,7,Mid-Value,Potential Loyalists
47223,953,7,"455,4",3,2,1,6,Mid-Value,Potential Loyalists
47227,24,6,"156,05",5,1,1,7,Mid-Value,Potential Loyalists
47228,30,10,"418,2",5,2,1,8,High-Value,Potential Loyalists
47229,504,3,"108,94999999999999",4,1,1,6,Mid-Value,Potential Loyalists
47231,50,6,"232,55",5,1,1,7,Mid-Value,Potential Loyalists
47232,461,5,"608,6",4,1,1,6,Mid-Value,Potential Loyalists
47234,321,1,"61,15",5,1,1,7,Mid-Value,Potential Loyalists
47235,388,5,"493,75",4,1,1,6,Mid-Value,Potential Loyalists
47240,1821,1,"45,75",1,1,1,3,Low-Value,Lost
47241,198,4,"116,65",5,1,1,7,Mid-Value,Potential Loyalists
47243,19,1,"67,9",5,1,1,7,Mid-Value,Potential Loyalists
47245,1342,1,"27,45",2,1,1,4,Low-Value,Can't Lose
47248,444,5,"227,85",4,1,1,6,Mid-Value,Potential Loyalists
47249,804,3,"364,7",3,1,1,5,Low-Value,At Risk Customers
47250,498,6,"121,8",4,1,1,6,Mid-Value,Potential Loyalists
47253,1402,1,"50,75",2,1,1,4,Low-Value,Can't Lose
47254,114,4,"136,10000000000002",5,1,1,7,Mid-Value,Potential Loyalists
47255,54,2,"89,85",5,1,1,7,Mid-Value,Potential Loyalists
47258,968,5,"401,7",3,1,1,5,Low-Value,At Risk Customers
47259,1176,9,"324,3",2,2,1,5,Low-Value,At Risk Customers
47260,26,1,"255,45000000000002",5,1,1,7,Mid-Value,Potential Loyalists
47261,577,3,"436,3",4,1,1,6,Mid-Value,Potential Loyalists
47262,1125,3,"273,09999999999997",2,1,1,4,Low-Value,Can't Lose
47263,280,3,"87,6",5,1,1,7,Mid-Value,Potential Loyalists
47265,899,2,"95,1",3,1,1,5,Low-Value,At Risk Customers
47266,403,5,"320,25",4,1,1,6,Mid-Value,Potential Loyalists
47267,503,5,"303,2",4,1,1,6,Mid-Value,Potential Loyalists
47268,521,3,"261,85",4,1,1,6,Mid-Value,Potential Loyalists
47269,824,6,"171,15",3,1,1,5,Low-Value,At Risk Customers
47270,70,3,"152,35",5,1,1,7,Mid-Value,Potential Loyalists
47272,599,4,"120,0",4,1,1,6,Mid-Value,Potential Loyalists
47273,1617,1,"48,4",1,1,1,3,Low-Value,Lost
47274,1634,1,"184,0",1,1,1,3,Low-Value,Lost
47275,916,1,"59,3",3,1,1,5,Low-Value,At Risk Customers
47278,1744,1,"75,9",1,1,1,3,Low-Value,Lost
47279,1315,2,"148,75",2,1,1,4,Low-Value,Can't Lose
47280,1744,1,"58,7",1,1,1,3,Low-Value,Lost
47281,573,1,"102,4",4,1,1,6,Mid-Value,Potential Loyalists
47282,77,1,"82,85",5,1,1,7,Mid-Value,Potential Loyalists
47284,273,3,"67,15",5,1,1,7,Mid-Value,Potential Loyalists
47286,1484,2,"212,4",1,1,1,3,Low-Value,Lost
47290,325,4,"1458,1",5,1,3,9,High-Value,Champions
47293,1817,1,"52,9",1,1,1,3,Low-Value,Lost
47294,1576,1,"28,35",1,1,1,3,Low-Value,Lost
47295,613,4,"114,8",4,1,1,6,Mid-Value,Potential Loyalists
47296,803,5,"263,95",3,1,1,5,Low-Value,At Risk Customers
47297,192,1,"126,25",5,1,1,7,Mid-Value,Potential Loyalists
47299,71,7,"706,9000000000001",5,2,2,9,High-Value,Champions
47301,1365,2,"210,2",2,1,1,4,Low-Value,Can't Lose
47302,514,5,"187,4",4,1,1,6,Mid-Value,Potential Loyalists
47304,593,6,"531,0",4,1,1,6,Mid-Value,Potential Loyalists
47305,150,2,"138,9",5,1,1,7,Mid-Value,Potential Loyalists
47308,1134,3,"191,6",2,1,1,4,Low-Value,Can't Lose
47309,668,2,"117,75",4,1,1,6,Mid-Value,Potential Loyalists
47310,1821,1,"9,85",1,1,1,3,Low-Value,Lost
47312,154,12,"765,9",5,3,2,10,High-Value,Champions
47316,325,4,"466,95000000000005",5,1,1,7,Mid-Value,Potential Loyalists
47317,248,2,"19,599999999999998",5,1,1,7,Mid-Value,Potential Loyalists
47319,1513,1,"19,0",1,1,1,3,Low-Value,Lost
47320,287,1,"38,7",5,1,1,7,Mid-Value,Potential Loyalists
47322,628,6,"300,95",4,1,1,6,Mid-Value,Potential Loyalists
47323,838,5,"253,35",3,1,1,5,Low-Value,At Risk Customers
47324,335,6,"185,15",5,1,1,7,Mid-Value,Potential Loyalists
47325,47,5,"168,05",5,1,1,7,Mid-Value,Potential Loyalists
47326,54,5,"379,3",5,1,1,7,Mid-Value,Potential Loyalists
47328,1438,1,"7,85",2,1,1,4,Low-Value,Can't Lose
47329,772,3,"46,1",3,1,1,5,Low-Value,At Risk Customers
47330,860,1,"6,45",3,1,1,5,Low-Value,At Risk Customers
47332,314,4,"203,4",5,1,1,7,Mid-Value,Potential Loyalists
47333,577,1,"467,4",4,1,1,6,Mid-Value,Potential Loyalists
47334,397,9,"133,75",4,2,1,7,Mid-Value,Potential Loyalists
47337,141,2,"171,9",5,1,1,7,Mid-Value,Potential Loyalists
47338,1218,1,"346,35",2,1,1,4,Low-Value,Can't Lose
47340,323,1,"99,9",5,1,1,7,Mid-Value,Potential Loyalists
47341,21,9,"449,1",5,2,1,8,High-Value,Potential Loyalists
47342,67,3,"331,75",5,1,1,7,Mid-Value,Potential Loyalists
47343,897,1,"18,3",3,1,1,5,Low-Value,At Risk Customers
47344,1498,3,"243,1",1,1,1,3,Low-Value,Lost
47345,311,5,"160,35",5,1,1,7,Mid-Value,Potential Loyalists
47347,164,5,"408,15",5,1,1,7,Mid-Value,Potential Loyalists
47351,474,5,"212,7",4,1,1,6,Mid-Value,Potential Loyalists
47352,532,3,"324,84999999999997",4,1,1,6,Mid-Value,Potential Loyalists
47353,319,4,"198,85",5,1,1,7,Mid-Value,Potential Loyalists
47354,1060,1,"233,2",3,1,1,5,Low-Value,At Risk Customers
47355,260,1,"19,25",5,1,1,7,Mid-Value,Potential Loyalists
47356,420,6,"308,3",4,1,1,6,Mid-Value,Potential Loyalists
47357,627,1,"5,0",4,1,1,6,Mid-Value,Potential Loyalists
47358,768,2,"85,35",3,1,1,5,Low-Value,At Risk Customers
47359,1308,2,"89,65",2,1,1,4,Low-Value,Can't Lose
47361,84,3,"181,2",5,1,1,7,Mid-Value,Potential Loyalists
47362,547,1,"117,2",4,1,1,6,Mid-Value,Potential Loyalists
47364,745,3,"484,55",3,1,1,5,Low-Value,At Risk Customers
47365,1169,4,"551,8",2,1,1,4,Low-Value,Can't Lose
47366,1132,1,"36,7",2,1,1,4,Low-Value,Can't Lose
47367,1608,3,"286,5",1,1,1,3,Low-Value,Lost
47368,672,3,"522,7",4,1,1,6,Mid-Value,Potential Loyalists
47372,5,12,"413,45",5,3,1,9,High-Value,Champions
47373,409,2,"87,39999999999999",4,1,1,6,Mid-Value,Potential Loyalists
47375,991,1,"13,9",3,1,1,5,Low-Value,At Risk Customers
47378,1348,1,"74,5",2,1,1,4,Low-Value,Can't Lose
47380,32,3,"58,3",5,1,1,7,Mid-Value,Potential Loyalists
47382,832,4,"167,45",3,1,1,5,Low-Value,At Risk Customers
47383,1116,1,"11,4",2,1,1,4,Low-Value,Can't Lose
47384,1131,3,"720,8499999999999",2,1,2,5,Low-Value,At Risk Customers
47386,147,2,"85,75",5,1,1,7,Mid-Value,Potential Loyalists
47387,452,2,"208,0",4,1,1,6,Mid-Value,Potential Loyalists
47388,1527,1,"47,35",1,1,1,3,Low-Value,Lost
47389,465,3,"51,4",4,1,1,6,Mid-Value,Potential Loyalists
47390,498,5,"410,84999999999997",4,1,1,6,Mid-Value,Potential Loyalists
47391,392,1,"196,0",4,1,1,6,Mid-Value,Potential Loyalists
47392,838,3,"69,9",3,1,1,5,Low-Value,At Risk Customers
47394,1638,1,"64,1",1,1,1,3,Low-Value,Lost
47395,1798,1,"2,2",1,1,1,3,Low-Value,Lost
47397,1307,2,"127,55",2,1,1,4,Low-Value,Can't Lose
47398,59,2,"92,7",5,1,1,7,Mid-Value,Potential Loyalists
47399,414,3,"240,55",4,1,1,6,Mid-Value,Potential Loyalists
47402,152,3,"181,5",5,1,1,7,Mid-Value,Potential Loyalists
47404,9,9,"397,25",5,2,1,8,High-Value,Potential Loyalists
47405,43,6,"1312,5",5,1,2,8,High-Value,Potential Loyalists
47406,166,5,"1053,0",5,1,2,8,High-Value,Potential Loyalists
47407,1543,1,"8,4",1,1,1,3,Low-Value,Lost
47410,1663,1,"128,2",1,1,1,3,Low-Value,Lost
47415,1390,1,"9,3",2,1,1,4,Low-Value,Can't Lose
47416,29,6,"214,7",5,1,1,7,Mid-Value,Potential Loyalists
47418,1628,1,"38,9",1,1,1,3,Low-Value,Lost
47419,811,2,"506,7",3,1,1,5,Low-Value,At Risk Customers
47421,1107,2,"593,85",2,1,1,4,Low-Value,Can't Lose
47422,781,5,"378,0",3,1,1,5,Low-Value,At Risk Customers
47423,353,1,"13,1",5,1,1,7,Mid-Value,Potential Loyalists
47424,852,1,"10,5",3,1,1,5,Low-Value,At Risk Customers
47425,549,2,"45,15",4,1,1,6,Mid-Value,Potential Loyalists
47426,491,2,"42,2",4,1,1,6,Mid-Value,Potential Loyalists
47428,573,1,"16,5",4,1,1,6,Mid-Value,Potential Loyalists
47429,15,5,"302,0",5,1,1,7,Mid-Value,Potential Loyalists
47430,414,6,"63,05",4,1,1,6,Mid-Value,Potential Loyalists
47431,160,11,"575,1",5,2,1,8,High-Value,Potential Loyalists
47432,872,2,"173,3",3,1,1,5,Low-Value,At Risk Customers
47434,75,3,"473,79999999999995",5,1,1,7,Mid-Value,Potential Loyalists
47435,1783,1,"0,6",1,1,1,3,Low-Value,Lost
47436,142,10,"636,65",5,2,1,8,High-Value,Potential Loyalists
47437,571,3,"424,1",4,1,1,6,Mid-Value,Potential Loyalists
47438,1581,1,"63,5",1,1,1,3,Low-Value,Lost
47439,391,1,"11,5",4,1,1,6,Mid-Value,Potential Loyalists
47440,1600,1,"194,2",1,1,1,3,Low-Value,Lost
47442,1233,1,"34,2",2,1,1,4,Low-Value,Can't Lose
47443,1477,2,"266,0",1,1,1,3,Low-Value,Lost
47444,1243,1,"19,9",2,1,1,4,Low-Value,Can't Lose
47445,836,2,"290,95",3,1,1,5,Low-Value,At Risk Customers
47446,200,2,"62,5",5,1,1,7,Mid-Value,Potential Loyalists
47447,178,2,"93,69999999999999",5,1,1,7,Mid-Value,Potential Loyalists
47449,113,2,"121,9",5,1,1,7,Mid-Value,Potential Loyalists
47451,387,6,"218,9",4,1,1,6,Mid-Value,Potential Loyalists
47452,463,5,"380,29999999999995",4,1,1,6,Mid-Value,Potential Loyalists
47453,1802,1,"240,4",1,1,1,3,Low-Value,Lost
47454,262,3,"195,70000000000002",5,1,1,7,Mid-Value,Potential Loyalists
47455,1196,1,"3,9",2,1,1,4,Low-Value,Can't Lose
47456,1343,2,"78,2",2,1,1,4,Low-Value,Can't Lose
47457,430,4,"68,95",4,1,1,6,Mid-Value,Potential Loyalists
47460,1758,1,"14,8",1,1,1,3,Low-Value,Lost
47461,128,3,"232,5",5,1,1,7,Mid-Value,Potential Loyalists
47462,14,16,"839,85",5,3,2,10,High-Value,Champions
47463,1188,2,"16,75",2,1,1,4,Low-Value,Can't Lose
47464,782,3,"473,79999999999995",3,1,1,5,Low-Value,At Risk Customers
47465,1407,1,"167,2",2,1,1,4,Low-Value,Can't Lose
47467,3,14,"860,6600000000001",5,3,2,10,High-Value,Champions
47468,244,5,"77,6",5,1,1,7,Mid-Value,Potential Loyalists
47469,1122,1,"14,25",2,1,1,4,Low-Value,Can't Lose
47472,748,7,"828,4",3,2,2,7,Mid-Value,Potential Loyalists
47474,199,4,"331,5",5,1,1,7,Mid-Value,Potential Loyalists
47475,1201,1,"12,2",2,1,1,4,Low-Value,Can't Lose
47476,136,2,"103,65",5,1,1,7,Mid-Value,Potential Loyalists
47478,759,4,"104,65",3,1,1,5,Low-Value,At Risk Customers
47480,32,11,"410,54999999999995",5,2,1,8,High-Value,Potential Loyalists
47482,828,1,"174,3",3,1,1,5,Low-Value,At Risk Customers
47483,777,4,"174,45",3,1,1,5,Low-Value,At Risk Customers
47484,920,3,"1273,6",3,1,2,6,Mid-Value,Potential Loyalists
47485,846,2,"110,55",3,1,1,5,Low-Value,At Risk Customers
47486,122,6,"723,95",5,1,2,8,High-Value,Potential Loyalists
47487,500,1,"67,8",4,1,1,6,Mid-Value,Potential Loyalists
47488,284,3,"169,0",5,1,1,7,Mid-Value,Potential Loyalists
47489,845,4,"186,05",3,1,1,5,Low-Value,At Risk Customers
47490,4,3,"212,09999999999997",5,1,1,7,Mid-Value,Potential Loyalists
47491,771,5,"187,70000000000002",3,1,1,5,Low-Value,At Risk Customers
47496,1098,1,"165,95",2,1,1,4,Low-Value,Can't Lose
47497,46,15,"1028,4",5,3,2,10,High-Value,Champions
47498,885,2,"164,3",3,1,1,5,Low-Value,At Risk Customers
47499,86,7,"485,45",5,2,1,8,High-Value,Potential Loyalists
47500,680,2,"106,25",4,1,1,6,Mid-Value,Potential Loyalists
47502,5,8,"306,35",5,2,1,8,High-Value,Potential Loyalists
47503,13,6,"416,6",5,1,1,7,Mid-Value,Potential Loyalists
47504,154,2,"218,55",5,1,1,7,Mid-Value,Potential Loyalists
47505,1217,2,"97,75",2,1,1,4,Low-Value,Can't Lose
47507,325,1,"129,9",5,1,1,7,Mid-Value,Potential Loyalists
47508,189,7,"575,0999999999999",5,2,1,8,High-Value,Potential Loyalists
47509,73,4,"174,15",5,1,1,7,Mid-Value,Potential Loyalists
47510,112,3,"370,75",5,1,1,7,Mid-Value,Potential Loyalists
47513,502,1,"117,2",4,1,1,6,Mid-Value,Potential Loyalists
47514,60,2,"74,5",5,1,1,7,Mid-Value,Potential Loyalists
47515,221,12,"947,5999999999999",5,3,2,10,High-Value,Champions
47516,426,3,"54,45",4,1,1,6,Mid-Value,Potential Loyalists
47517,771,2,"345,0",3,1,1,5,Low-Value,At Risk Customers
47518,14,1,"143,6",5,1,1,7,Mid-Value,Potential Loyalists
47519,15,15,"978,5",5,3,2,10,High-Value,Champions
47520,167,2,"289,8",5,1,1,7,Mid-Value,Potential Loyalists
47521,683,1,"11,35",4,1,1,6,Mid-Value,Potential Loyalists
47522,254,1,"225,75",5,1,1,7,Mid-Value,Potential Loyalists
47523,84,4,"283,85",5,1,1,7,Mid-Value,Potential Loyalists
47524,264,7,"706,9",5,2,2,9,High-Value,Champions
47525,167,9,"722,1999999999999",5,2,2,9,High-Value,Champions
47526,134,4,"116,65",5,1,1,7,Mid-Value,Potential Loyalists
47529,4,6,"288,2",5,1,1,7,Mid-Value,Potential Loyalists
47530,177,4,"600,35",5,1,1,7,Mid-Value,Potential Loyalists
47531,890,2,"453,59999999999997",3,1,1,5,Low-Value,At Risk Customers
47532,745,2,"80,4",3,1,1,5,Low-Value,At Risk Customers
47533,994,2,"390,30000000000007",3,1,1,5,Low-Value,At Risk Customers
47534,440,6,"272,35",4,1,1,6,Mid-Value,Potential Loyalists
47535,88,3,"100,25",5,1,1,7,Mid-Value,Potential Loyalists
47536,952,2,"72,19999999999999",3,1,1,5,Low-Value,At Risk Customers
47538,1537,2,"44,85",1,1,1,3,Low-Value,Lost
47539,15,5,"408,15",5,1,1,7,Mid-Value,Potential Loyalists
47541,908,3,"460,25",3,1,1,5,Low-Value,At Risk Customers
47542,390,3,"170,65",4,1,1,6,Mid-Value,Potential Loyalists
47543,188,2,"410,0",5,1,1,7,Mid-Value,Potential Loyalists
47546,256,2,"132,70000000000002",5,1,1,7,Mid-Value,Potential Loyalists
47547,1351,2,"60,699999999999996",2,1,1,4,Low-Value,Can't Lose
47552,706,1,"42,4",4,1,1,6,Mid-Value,Potential Loyalists
47553,773,4,"115,3",3,1,1,5,Low-Value,At Risk Customers
47554,246,3,"65,15",5,1,1,7,Mid-Value,Potential Loyalists
47555,40,8,"493,4",5,2,1,8,High-Value,Potential Loyalists
47557,1168,2,"118,6",2,1,1,4,Low-Value,Can't Lose
47560,206,4,"281,05",5,1,1,7,Mid-Value,Potential Loyalists
47561,14,9,"741,5500000000001",5,2,2,9,High-Value,Champions
47562,1653,1,"47,9",1,1,1,3,Low-Value,Lost
47563,1225,2,"134,8",2,1,1,4,Low-Value,Can't Lose
47565,393,4,"259,65",4,1,1,6,Mid-Value,Potential Loyalists
47566,176,2,"292,4",5,1,1,7,Mid-Value,Potential Loyalists
47569,110,3,"307,59999999999997",5,1,1,7,Mid-Value,Potential Loyalists
47570,140,4,"214,1",5,1,1,7,Mid-Value,Potential Loyalists
47572,70,10,"552,55",5,2,1,8,High-Value,Potential Loyalists
47576,1239,2,"202,15",2,1,1,4,Low-Value,Can't Lose
47577,271,6,"527,6",5,1,1,7,Mid-Value,Potential Loyalists
47579,916,2,"139,1",3,1,1,5,Low-Value,At Risk Customers
47582,795,3,"200,2",3,1,1,5,Low-Value,At Risk Customers
47583,1096,2,"202,59999999999997",2,1,1,4,Low-Value,Can't Lose
47585,607,1,"30,900000000000002",4,1,1,6,Mid-Value,Potential Loyalists
47586,1100,1,"40,92",2,1,1,4,Low-Value,Can't Lose
47587,1284,1,"130,64999999999998",2,1,1,4,Low-Value,Can't Lose
47588,511,4,"104,24999999999999",4,1,1,6,Mid-Value,Potential Loyalists
47589,722,2,"182,85",4,1,1,6,Mid-Value,Potential Loyalists
47592,30,5,"234,45",5,1,1,7,Mid-Value,Potential Loyalists
47594,11,3,"102,9",5,1,1,7,Mid-Value,Potential Loyalists
47595,172,9,"425,0",5,2,1,8,High-Value,Potential Loyalists
47596,1501,1,"32,65",1,1,1,3,Low-Value,Lost
47600,11,8,"670,85",5,2,2,9,High-Value,Champions
47601,42,4,"148,04999999999998",5,1,1,7,Mid-Value,Potential Loyalists
47602,426,3,"69,55",4,1,1,6,Mid-Value,Potential Loyalists
47603,2,7,"708,75",5,2,2,9,High-Value,Champions
47604,274,3,"56,800000000000004",5,1,1,7,Mid-Value,Potential Loyalists
47606,185,5,"203,8",5,1,1,7,Mid-Value,Potential Loyalists
47607,417,3,"203,4",4,1,1,6,Mid-Value,Potential Loyalists
47610,454,8,"232,85",4,2,1,7,Mid-Value,Potential Loyalists
47612,639,1,"17,6",4,1,1,6,Mid-Value,Potential Loyalists
47613,1611,1,"109,7",1,1,1,3,Low-Value,Lost
47614,952,1,"33,35",3,1,1,5,Low-Value,At Risk Customers
47619,152,2,"46,3",5,1,1,7,Mid-Value,Potential Loyalists
47622,1550,2,"49,4",1,1,1,3,Low-Value,Lost
47623,1608,1,"23,4",1,1,1,3,Low-Value,Lost
47626,959,2,"220,0",3,1,1,5,Low-Value,At Risk Customers
47627,771,1,"15,75",3,1,1,5,Low-Value,At Risk Customers
47628,326,1,"9,9",5,1,1,7,Mid-Value,Potential Loyalists
47630,1110,2,"311,70000000000005",2,1,1,4,Low-Value,Can't Lose
47631,23,5,"217,55",5,1,1,7,Mid-Value,Potential Loyalists
47632,1456,1,"8,3",2,1,1,4,Low-Value,Can't Lose
47633,545,2,"126,5",4,1,1,6,Mid-Value,Potential Loyalists
47634,766,2,"159,35",3,1,1,5,Low-Value,At Risk Customers
47635,195,2,"304,8",5,1,1,7,Mid-Value,Potential Loyalists
47638,505,6,"277,4",4,1,1,6,Mid-Value,Potential Loyalists
47639,139,1,"94,0",5,1,1,7,Mid-Value,Potential Loyalists
47640,798,1,"63,2",3,1,1,5,Low-Value,At Risk Customers
47641,19,1,"69,0",5,1,1,7,Mid-Value,Potential Loyalists
47645,1373,2,"125,9",2,1,1,4,Low-Value,Can't Lose
47646,448,1,"172,2",4,1,1,6,Mid-Value,Potential Loyalists
47648,209,1,"148,7",5,1,1,7,Mid-Value,Potential Loyalists
47649,749,3,"93,25",3,1,1,5,Low-Value,At Risk Customers
47650,236,1,"91,94999999999999",5,1,1,7,Mid-Value,Potential Loyalists
47655,720,2,"99,5",4,1,1,6,Mid-Value,Potential Loyalists
47659,862,3,"56,0",3,1,1,5,Low-Value,At Risk Customers
47661,1551,1,"4,85",1,1,1,3,Low-Value,Lost
47662,348,1,"165,95",5,1,1,7,Mid-Value,Potential Loyalists
47663,750,1,"201,5",3,1,1,5,Low-Value,At Risk Customers
47664,157,5,"524,2",5,1,1,7,Mid-Value,Potential Loyalists
47665,367,4,"180,9",4,1,1,6,Mid-Value,Potential Loyalists
47666,11,5,"199,15",5,1,1,7,Mid-Value,Potential Loyalists
47667,1386,1,"58,35",2,1,1,4,Low-Value,Can't Lose
47668,756,3,"126,10000000000001",3,1,1,5,Low-Value,At Risk Customers
47669,201,5,"444,8",5,1,1,7,Mid-Value,Potential Loyalists
47674,310,2,"109,95",5,1,1,7,Mid-Value,Potential Loyalists
47675,426,4,"145,75",4,1,1,6,Mid-Value,Potential Loyalists
47680,875,1,"11,2",3,1,1,5,Low-Value,At Risk Customers
47682,1062,1,"24,299999999999997",3,1,1,5,Low-Value,At Risk Customers
47684,102,5,"104,1",5,1,1,7,Mid-Value,Potential Loyalists
47686,918,2,"143,9",3,1,1,5,Low-Value,At Risk Customers
47687,733,5,"293,09999999999997",3,1,1,5,Low-Value,At Risk Customers
47690,199,6,"341,75",5,1,1,7,Mid-Value,Potential Loyalists
47691,122,3,"63,3",5,1,1,7,Mid-Value,Potential Loyalists
47692,510,3,"178,7",4,1,1,6,Mid-Value,Potential Loyalists
47693,10,3,"117,2",5,1,1,7,Mid-Value,Potential Loyalists
47696,722,1,"52,85",4,1,1,6,Mid-Value,Potential Loyalists
47698,918,2,"125,4",3,1,1,5,Low-Value,At Risk Customers
47699,1085,1,"54,5",3,1,1,5,Low-Value,At Risk Customers
47701,656,2,"31,0",4,1,1,6,Mid-Value,Potential Loyalists
47703,120,2,"15,6",5,1,1,7,Mid-Value,Potential Loyalists
47704,314,1,"22,9",5,1,1,7,Mid-Value,Potential Loyalists
47706,241,4,"139,9",5,1,1,7,Mid-Value,Potential Loyalists
47707,1265,2,"1041,75",2,1,2,5,Low-Value,At Risk Customers
47709,222,5,"368,55",5,1,1,7,Mid-Value,Potential Loyalists
47710,5,2,"238,85",5,1,1,7,Mid-Value,Potential Loyalists
47711,896,1,"53,9",3,1,1,5,Low-Value,At Risk Customers
47712,927,2,"347,05",3,1,1,5,Low-Value,At Risk Customers
47714,15,6,"205,85",5,1,1,7,Mid-Value,Potential Loyalists
47715,615,7,"291,15",4,2,1,7,Mid-Value,Potential Loyalists
47717,95,2,"222,1",5,1,1,7,Mid-Value,Potential Loyalists
47718,885,2,"225,35",3,1,1,5,Low-Value,At Risk Customers
47719,493,1,"30,8",4,1,1,6,Mid-Value,Potential Loyalists
47721,1366,1,"16,2",2,1,1,4,Low-Value,Can't Lose
47722,1806,1,"147,7",1,1,1,3,Low-Value,Lost
47724,512,7,"504,90000000000003",4,2,1,7,Mid-Value,Potential Loyalists
47725,23,2,"278,0",5,1,1,7,Mid-Value,Potential Loyalists
47726,1137,3,"140,8",2,1,1,4,Low-Value,Can't Lose
47727,74,10,"708,9",5,2,2,9,High-Value,Champions
47728,626,1,"62,25",4,1,1,6,Mid-Value,Potential Loyalists
47730,188,4,"902,75",5,1,2,8,High-Value,Potential Loyalists
47731,370,5,"264,04999999999995",4,1,1,6,Mid-Value,Potential Loyalists
47733,297,1,"34,1",5,1,1,7,Mid-Value,Potential Loyalists
47736,425,2,"55,85",4,1,1,6,Mid-Value,Potential Loyalists
47738,1125,1,"491,6",2,1,1,4,Low-Value,Can't Lose
47740,900,1,"47,6",3,1,1,5,Low-Value,At Risk Customers
47741,1763,1,"48,7",1,1,1,3,Low-Value,Lost
47743,1458,1,"8,4",2,1,1,4,Low-Value,Can't Lose
47744,199,3,"180,3",5,1,1,7,Mid-Value,Potential Loyalists
47745,488,3,"168,45",4,1,1,6,Mid-Value,Potential Loyalists
47746,487,1,"39,4",4,1,1,6,Mid-Value,Potential Loyalists
47747,120,5,"273,4",5,1,1,7,Mid-Value,Potential Loyalists
47748,987,3,"510,76",3,1,1,5,Low-Value,At Risk Customers
47749,526,2,"113,1",4,1,1,6,Mid-Value,Potential Loyalists
47750,169,2,"630,8",5,1,1,7,Mid-Value,Potential Loyalists
47751,124,13,"336,79999999999995",5,3,1,9,High-Value,Champions
47753,308,1,"20,1",5,1,1,7,Mid-Value,Potential Loyalists
47754,397,2,"133,60000000000002",4,1,1,6,Mid-Value,Potential Loyalists
47755,864,4,"168,5",3,1,1,5,Low-Value,At Risk Customers
47756,1157,1,"47,849999999999994",2,1,1,4,Low-Value,Can't Lose
47757,279,5,"275,04999999999995",5,1,1,7,Mid-Value,Potential Loyalists
47758,211,3,"204,6",5,1,1,7,Mid-Value,Potential Loyalists
47762,14,3,"72,4",5,1,1,7,Mid-Value,Potential Loyalists
47763,568,3,"103,15",4,1,1,6,Mid-Value,Potential Loyalists
47764,59,5,"173,0",5,1,1,7,Mid-Value,Potential Loyalists
47765,354,6,"115,05",5,1,1,7,Mid-Value,Potential Loyalists
47769,77,10,"993,66",5,2,2,9,High-Value,Champions
47770,110,1,"22,5",5,1,1,7,Mid-Value,Potential Loyalists
47771,1201,1,"83,0",2,1,1,4,Low-Value,Can't Lose
47772,134,4,"823,9",5,1,2,8,High-Value,Potential Loyalists
47773,1588,2,"202,6",1,1,1,3,Low-Value,Lost
47775,400,4,"109,14999999999999",4,1,1,6,Mid-Value,Potential Loyalists
47778,770,1,"14,35",3,1,1,5,Low-Value,At Risk Customers
47779,1667,1,"102,2",1,1,1,3,Low-Value,Lost
47780,794,4,"406,45",3,1,1,5,Low-Value,At Risk Customers
47784,737,2,"60,2",3,1,1,5,Low-Value,At Risk Customers
47785,61,6,"438,2",5,1,1,7,Mid-Value,Potential Loyalists
47787,1639,2,"95,5",1,1,1,3,Low-Value,Lost
47789,737,2,"135,55",3,1,1,5,Low-Value,At Risk Customers
47790,291,2,"452,35",5,1,1,7,Mid-Value,Potential Loyalists
47791,365,5,"62,0",5,1,1,7,Mid-Value,Potential Loyalists
47792,1336,1,"17,0",2,1,1,4,Low-Value,Can't Lose
47793,1527,4,"91,35",1,1,1,3,Low-Value,Lost
47794,714,1,"24,3",4,1,1,6,Mid-Value,Potential Loyalists
47795,1803,1,"22,8",1,1,1,3,Low-Value,Lost
47796,528,8,"686,05",4,2,2,8,High-Value,Potential Loyalists
47797,1125,1,"57,4",2,1,1,4,Low-Value,Can't Lose
47799,398,2,"184,29999999999998",4,1,1,6,Mid-Value,Potential Loyalists
47800,3,2,"61,45",5,1,1,7,Mid-Value,Potential Loyalists
47801,56,2,"83,44999999999999",5,1,1,7,Mid-Value,Potential Loyalists
47803,230,2,"165,55",5,1,1,7,Mid-Value,Potential Loyalists
47804,306,1,"85,6",5,1,1,7,Mid-Value,Potential Loyalists
47805,1264,1,"8,4",2,1,1,4,Low-Value,Can't Lose
47808,49,7,"228,75",5,2,1,8,High-Value,Potential Loyalists
47812,9,2,"26,6",5,1,1,7,Mid-Value,Potential Loyalists
47815,883,1,"111,0",3,1,1,5,Low-Value,At Risk Customers
47816,692,2,"141,60000000000002",4,1,1,6,Mid-Value,Potential Loyalists
47817,135,4,"174,6",5,1,1,7,Mid-Value,Potential Loyalists
47818,254,4,"336,70000000000005",5,1,1,7,Mid-Value,Potential Loyalists
47820,1074,1,"24,1",3,1,1,5,Low-Value,At Risk Customers
47821,200,3,"91,55000000000001",5,1,1,7,Mid-Value,Potential Loyalists
47823,1584,1,"215,85000000000002",1,1,1,3,Low-Value,Lost
47824,1597,1,"66,75",1,1,1,3,Low-Value,Lost
47825,796,1,"21,3",3,1,1,5,Low-Value,At Risk Customers
47826,2,7,"625,85",5,2,1,8,High-Value,Potential Loyalists
47828,1557,2,"28,3",1,1,1,3,Low-Value,Lost
47829,138,1,"60,4",5,1,1,7,Mid-Value,Potential Loyalists
47831,1198,3,"256,55",2,1,1,4,Low-Value,Can't Lose
47832,154,6,"192,4",5,1,1,7,Mid-Value,Potential Loyalists
47834,989,1,"56,849999999999994",3,1,1,5,Low-Value,At Risk Customers
47835,949,2,"326,65",3,1,1,5,Low-Value,At Risk Customers
47837,27,22,"872,3",5,5,2,12,High-Value,Champions
47840,626,2,"97,0",4,1,1,6,Mid-Value,Potential Loyalists
47841,36,4,"499,25",5,1,1,7,Mid-Value,Potential Loyalists
47842,62,5,"183,35",5,1,1,7,Mid-Value,Potential Loyalists
47844,541,6,"310,8",4,1,1,6,Mid-Value,Potential Loyalists
47846,14,7,"360,65",5,2,1,8,High-Value,Potential Loyalists
47847,30,3,"244,95",5,1,1,7,Mid-Value,Potential Loyalists
47849,1160,1,"6,7",2,1,1,4,Low-Value,Can't Lose
47851,1640,1,"69,6",1,1,1,3,Low-Value,Lost
47855,152,3,"151,82999999999998",5,1,1,7,Mid-Value,Potential Loyalists
47856,81,4,"261,8",5,1,1,7,Mid-Value,Potential Loyalists
47857,668,4,"156,15",4,1,1,6,Mid-Value,Potential Loyalists
47859,130,1,"16,2",5,1,1,7,Mid-Value,Potential Loyalists
47860,250,4,"353,05",5,1,1,7,Mid-Value,Potential Loyalists
47861,62,8,"357,5",5,2,1,8,High-Value,Potential Loyalists
47863,1067,3,"35,15",3,1,1,5,Low-Value,At Risk Customers
47864,1456,1,"270,0",2,1,1,4,Low-Value,Can't Lose
47865,51,1,"44,95",5,1,1,7,Mid-Value,Potential Loyalists
47866,216,3,"364,3",5,1,1,7,Mid-Value,Potential Loyalists
47868,1029,3,"176,75",3,1,1,5,Low-Value,At Risk Customers
47870,900,4,"446,54999999999995",3,1,1,5,Low-Value,At Risk Customers
47871,166,3,"284,7",5,1,1,7,Mid-Value,Potential Loyalists
47872,77,14,"539,45",5,3,1,9,High-Value,Champions
47874,752,3,"251,54999999999995",3,1,1,5,Low-Value,At Risk Customers
47875,1454,1,"21,4",2,1,1,4,Low-Value,Can't Lose
47877,824,2,"168,0",3,1,1,5,Low-Value,At Risk Customers
47880,1143,1,"91,15",2,1,1,4,Low-Value,Can't Lose
47881,992,2,"134,75",3,1,1,5,Low-Value,At Risk Customers
47882,285,3,"216,05",5,1,1,7,Mid-Value,Potential Loyalists
47883,603,4,"135,5",4,1,1,6,Mid-Value,Potential Loyalists
47884,669,1,"202,8",4,1,1,6,Mid-Value,Potential Loyalists
47885,424,8,"174,9",4,2,1,7,Mid-Value,Potential Loyalists
47886,419,5,"212,65",4,1,1,6,Mid-Value,Potential Loyalists
47887,1579,1,"57,85",1,1,1,3,Low-Value,Lost
47889,1207,2,"37,2",2,1,1,4,Low-Value,Can't Lose
47890,532,3,"140,85",4,1,1,6,Mid-Value,Potential Loyalists
47891,153,9,"273,35",5,2,1,8,High-Value,Potential Loyalists
47894,368,12,"363,25",4,3,1,8,High-Value,Potential Loyalists
47896,19,7,"488,95000000000005",5,2,1,8,High-Value,Potential Loyalists
47898,65,3,"126,05",5,1,1,7,Mid-Value,Potential Loyalists
47900,167,8,"1076,85",5,2,2,9,High-Value,Champions
47901,49,4,"579,45",5,1,1,7,Mid-Value,Potential Loyalists
47903,10,12,"814,7",5,3,2,10,High-Value,Champions
47904,1633,1,"13,35",1,1,1,3,Low-Value,Lost
47905,1249,1,"100,8",2,1,1,4,Low-Value,Can't Lose
47907,3,5,"366,25",5,1,1,7,Mid-Value,Potential Loyalists
47908,1342,1,"60,449999999999996",2,1,1,4,Low-Value,Can't Lose
47909,11,4,"349,95000000000005",5,1,1,7,Mid-Value,Potential Loyalists
47912,179,1,"46,2",5,1,1,7,Mid-Value,Potential Loyalists
47915,56,9,"266,4",5,2,1,8,High-Value,Potential Loyalists
47916,17,5,"283,95",5,1,1,7,Mid-Value,Potential Loyalists
47917,366,7,"288,75",4,2,1,7,Mid-Value,Potential Loyalists
47918,366,1,"492,15000000000003",4,1,1,6,Mid-Value,Potential Loyalists
47919,795,6,"363,65",3,1,1,5,Low-Value,At Risk Customers
47921,615,1,"52,85",4,1,1,6,Mid-Value,Potential Loyalists
47923,607,1,"112,85",4,1,1,6,Mid-Value,Potential Loyalists
47924,229,2,"72,45",5,1,1,7,Mid-Value,Potential Loyalists
47925,1032,1,"38,65",3,1,1,5,Low-Value,At Risk Customers
47926,636,3,"101,2",4,1,1,6,Mid-Value,Potential Loyalists
47927,79,4,"116,85000000000001",5,1,1,7,Mid-Value,Potential Loyalists
47928,107,3,"151,39999999999998",5,1,1,7,Mid-Value,Potential Loyalists
47929,1607,1,"158,7",1,1,1,3,Low-Value,Lost
47931,308,2,"43,05",5,1,1,7,Mid-Value,Potential Loyalists
47932,1137,2,"53,849999999999994",2,1,1,4,Low-Value,Can't Lose
47933,1392,1,"41,5",2,1,1,4,Low-Value,Can't Lose
47934,71,4,"459,4",5,1,1,7,Mid-Value,Potential Loyalists
47935,811,4,"413,75",3,1,1,5,Low-Value,At Risk Customers
47937,53,3,"193,0",5,1,1,7,Mid-Value,Potential Loyalists
47938,456,3,"347,1",4,1,1,6,Mid-Value,Potential Loyalists
47940,28,5,"496,1",5,1,1,7,Mid-Value,Potential Loyalists
47941,378,2,"108,35",4,1,1,6,Mid-Value,Potential Loyalists
47942,237,6,"201,64999999999998",5,1,1,7,Mid-Value,Potential Loyalists
47944,340,2,"49,7",5,1,1,7,Mid-Value,Potential Loyalists
47945,1680,2,"58,95",1,1,1,3,Low-Value,Lost
47946,791,1,"67,55",3,1,1,5,Low-Value,At Risk Customers
47947,1653,1,"40,0",1,1,1,3,Low-Value,Lost
47948,404,2,"57,4",4,1,1,6,Mid-Value,Potential Loyalists
47949,28,3,"224,64999999999998",5,1,1,7,Mid-Value,Potential Loyalists
47950,182,1,"180,14999999999998",5,1,1,7,Mid-Value,Potential Loyalists
47953,405,1,"17,2",4,1,1,6,Mid-Value,Potential Loyalists
47954,160,7,"447,2",5,2,1,8,High-Value,Potential Loyalists
47955,292,5,"400,15",5,1,1,7,Mid-Value,Potential Loyalists
47956,30,3,"223,7",5,1,1,7,Mid-Value,Potential Loyalists
47957,649,3,"110,29999999999998",4,1,1,6,Mid-Value,Potential Loyalists
47959,155,2,"98,1",5,1,1,7,Mid-Value,Potential Loyalists
47961,244,1,"20,65",5,1,1,7,Mid-Value,Potential Loyalists
47962,1372,2,"85,65",2,1,1,4,Low-Value,Can't Lose
47963,622,1,"28,7",4,1,1,6,Mid-Value,Potential Loyalists
47967,585,5,"149,45000000000002",4,1,1,6,Mid-Value,Potential Loyalists
47968,175,5,"178,4",5,1,1,7,Mid-Value,Potential Loyalists
47969,91,4,"86,8",5,1,1,7,Mid-Value,Potential Loyalists
47970,28,3,"292,45",5,1,1,7,Mid-Value,Potential Loyalists
47971,161,7,"254,05",5,2,1,8,High-Value,Potential Loyalists
47972,254,4,"354,59999999999997",5,1,1,7,Mid-Value,Potential Loyalists
47974,600,4,"562,25",4,1,1,6,Mid-Value,Potential Loyalists
47976,18,15,"986,55",5,3,2,10,High-Value,Champions
47977,266,1,"199,0",5,1,1,7,Mid-Value,Potential Loyalists
47978,4,6,"285,05",5,1,1,7,Mid-Value,Potential Loyalists
47979,45,7,"144,9",5,2,1,8,High-Value,Potential Loyalists
47980,1799,1,"178,8",1,1,1,3,Low-Value,Lost
47981,414,4,"228,10000000000002",4,1,1,6,Mid-Value,Potential Loyalists
47982,768,5,"136,6",3,1,1,5,Low-Value,At Risk Customers
47983,557,4,"226,3",4,1,1,6,Mid-Value,Potential Loyalists
47984,215,7,"673,8",5,2,2,9,High-Value,Champions
47985,1008,3,"196,70000000000002",3,1,1,5,Low-Value,At Risk Customers
47986,0,5,"306,1",5,1,1,7,Mid-Value,Potential Loyalists
47987,1566,2,"93,3",1,1,1,3,Low-Value,Lost
47988,375,3,"157,8",4,1,1,6,Mid-Value,Potential Loyalists
47989,895,7,"156,6",3,2,1,6,Mid-Value,Potential Loyalists
47992,487,7,"256,05",4,2,1,7,Mid-Value,Potential Loyalists
47993,1103,7,"450,45",2,2,1,5,Low-Value,At Risk Customers
47995,760,2,"25,1",3,1,1,5,Low-Value,At Risk Customers
47997,31,5,"210,55",5,1,1,7,Mid-Value,Potential Loyalists
48000,113,1,"253,2",5,1,1,7,Mid-Value,Potential Loyalists
48001,143,1,"88,0",5,1,1,7,Mid-Value,Potential Loyalists
48003,1212,1,"20,45",2,1,1,4,Low-Value,Can't Lose
48004,701,3,"90,9",4,1,1,6,Mid-Value,Potential Loyalists
48006,4,9,"638,35",5,2,1,8,High-Value,Potential Loyalists
48008,509,3,"168,1",4,1,1,6,Mid-Value,Potential Loyalists
48010,1033,1,"8,3",3,1,1,5,Low-Value,At Risk Customers
48011,656,1,"10,3",4,1,1,6,Mid-Value,Potential Loyalists
48012,1618,2,"294,4",1,1,1,3,Low-Value,Lost
48013,1466,2,"85,7",1,1,1,3,Low-Value,Lost
48014,24,5,"241,55",5,1,1,7,Mid-Value,Potential Loyalists
48015,811,2,"71,85",3,1,1,5,Low-Value,At Risk Customers
48016,35,12,"933,6",5,3,2,10,High-Value,Champions
48020,20,12,"994,95",5,3,2,10,High-Value,Champions
48021,31,6,"309,9",5,1,1,7,Mid-Value,Potential Loyalists
48022,92,3,"490,7",5,1,1,7,Mid-Value,Potential Loyalists
48023,800,2,"93,05",3,1,1,5,Low-Value,At Risk Customers
48026,887,4,"97,7",3,1,1,5,Low-Value,At Risk Customers
48028,763,2,"59,8",3,1,1,5,Low-Value,At Risk Customers
48029,554,4,"170,04999999999998",4,1,1,6,Mid-Value,Potential Loyalists
48030,80,2,"33,8",5,1,1,7,Mid-Value,Potential Loyalists
48031,40,2,"31,8",5,1,1,7,Mid-Value,Potential Loyalists
48032,339,4,"127,15",5,1,1,7,Mid-Value,Potential Loyalists
48034,1522,3,"402,25",1,1,1,3,Low-Value,Lost
48038,18,7,"419,55",5,2,1,8,High-Value,Potential Loyalists
48041,754,2,"304,85",3,1,1,5,Low-Value,At Risk Customers
48042,1369,1,"2,2",2,1,1,4,Low-Value,Can't Lose
48044,13,9,"785,95",5,2,2,9,High-Value,Champions
48045,685,3,"41,1",4,1,1,6,Mid-Value,Potential Loyalists
48046,22,5,"283,1",5,1,1,7,Mid-Value,Potential Loyalists
48047,32,3,"99,7",5,1,1,7,Mid-Value,Potential Loyalists
48050,544,4,"244,85",4,1,1,6,Mid-Value,Potential Loyalists
48051,946,4,"141,4",3,1,1,5,Low-Value,At Risk Customers
48052,1672,1,"36,3",1,1,1,3,Low-Value,Lost
48053,35,5,"244,0",5,1,1,7,Mid-Value,Potential Loyalists
48055,172,2,"576,0",5,1,1,7,Mid-Value,Potential Loyalists
48056,175,3,"275,8",5,1,1,7,Mid-Value,Potential Loyalists
48057,113,1,"26,700000000000003",5,1,1,7,Mid-Value,Potential Loyalists
48058,123,3,"200,45000000000002",5,1,1,7,Mid-Value,Potential Loyalists
48059,636,1,"21,45",4,1,1,6,Mid-Value,Potential Loyalists
48060,589,1,"155,55",4,1,1,6,Mid-Value,Potential Loyalists
48061,586,1,"25,7",4,1,1,6,Mid-Value,Potential Loyalists
48063,1401,1,"8,2",2,1,1,4,Low-Value,Can't Lose
48064,716,1,"20,7",4,1,1,6,Mid-Value,Potential Loyalists
48065,902,4,"205,3",3,1,1,5,Low-Value,At Risk Customers
48066,1047,1,"67,35",3,1,1,5,Low-Value,At Risk Customers
48069,1757,1,"45,05",1,1,1,3,Low-Value,Lost
48070,99,6,"489,85",5,1,1,7,Mid-Value,Potential Loyalists
48071,623,3,"99,45",4,1,1,6,Mid-Value,Potential Loyalists
48074,259,7,"302,45",5,2,1,8,High-Value,Potential Loyalists
48076,201,2,"90,45",5,1,1,7,Mid-Value,Potential Loyalists
48077,354,2,"224,5",5,1,1,7,Mid-Value,Potential Loyalists
48078,493,4,"179,5",4,1,1,6,Mid-Value,Potential Loyalists
48080,315,7,"461,84999999999997",5,2,1,8,High-Value,Potential Loyalists
48082,1734,2,"129,05",1,1,1,3,Low-Value,Lost
48083,164,7,"890,1",5,2,2,9,High-Value,Champions
48084,484,3,"377,95",4,1,1,6,Mid-Value,Potential Loyalists
48085,226,1,"16,85",5,1,1,7,Mid-Value,Potential Loyalists
48086,1479,1,"241,0",1,1,1,3,Low-Value,Lost
48087,56,2,"42,35",5,1,1,7,Mid-Value,Potential Loyalists
48088,182,2,"169,54999999999998",5,1,1,7,Mid-Value,Potential Loyalists
48089,1495,1,"30,95",1,1,1,3,Low-Value,Lost
48090,149,6,"600,2",5,1,1,7,Mid-Value,Potential Loyalists
48092,1480,3,"98,63",1,1,1,3,Low-Value,Lost
48095,966,2,"239,2",3,1,1,5,Low-Value,At Risk Customers
48096,1585,1,"37,9",1,1,1,3,Low-Value,Lost
48097,46,9,"1264,25",5,2,2,9,High-Value,Champions
48099,521,1,"67,80000000000001",4,1,1,6,Mid-Value,Potential Loyalists
48100,763,1,"352,1",3,1,1,5,Low-Value,At Risk Customers
48101,751,2,"99,8",3,1,1,5,Low-Value,At Risk Customers
48102,831,2,"60,45",3,1,1,5,Low-Value,At Risk Customers
48106,418,4,"199,65",4,1,1,6,Mid-Value,Potential Loyalists
48107,451,6,"257,95",4,1,1,6,Mid-Value,Potential Loyalists
48108,409,2,"125,8",4,1,1,6,Mid-Value,Potential Loyalists
48109,811,3,"429,65",3,1,1,5,Low-Value,At Risk Customers
48112,525,7,"626,35",4,2,1,7,Mid-Value,Potential Loyalists
48115,732,2,"130,4",3,1,1,5,Low-Value,At Risk Customers
48116,249,4,"246,95",5,1,1,7,Mid-Value,Potential Loyalists
48117,335,3,"368,05",5,1,1,7,Mid-Value,Potential Loyalists
48118,1810,1,"148,6",1,1,1,3,Low-Value,Lost
48119,335,3,"79,19999999999999",5,1,1,7,Mid-Value,Potential Loyalists
48121,981,2,"94,35",3,1,1,5,Low-Value,At Risk Customers
48124,1636,1,"41,1",1,1,1,3,Low-Value,Lost
48125,240,3,"261,45",5,1,1,7,Mid-Value,Potential Loyalists
48126,634,2,"17,9",4,1,1,6,Mid-Value,Potential Loyalists
48128,352,1,"33,4",5,1,1,7,Mid-Value,Potential Loyalists
48130,1045,2,"44,349999999999994",3,1,1,5,Low-Value,At Risk Customers
48131,231,2,"45,7",5,1,1,7,Mid-Value,Potential Loyalists
48134,831,15,"673,15",3,3,2,8,High-Value,Potential Loyalists
48136,70,5,"209,25",5,1,1,7,Mid-Value,Potential Loyalists
48141,110,3,"153,7",5,1,1,7,Mid-Value,Potential Loyalists
48142,60,2,"245,89999999999998",5,1,1,7,Mid-Value,Potential Loyalists
48143,73,4,"123,0",5,1,1,7,Mid-Value,Potential Loyalists
48144,222,4,"185,1",5,1,1,7,Mid-Value,Potential Loyalists
48145,389,6,"225,95",4,1,1,6,Mid-Value,Potential Loyalists
48148,53,6,"787,8",5,1,2,8,High-Value,Potential Loyalists
48149,238,5,"295,4",5,1,1,7,Mid-Value,Potential Loyalists
48150,73,6,"592,45",5,1,1,7,Mid-Value,Potential Loyalists
48153,546,2,"50,4",4,1,1,6,Mid-Value,Potential Loyalists
48154,15,8,"397,75",5,2,1,8,High-Value,Potential Loyalists
48155,1707,2,"220,20000000000002",1,1,1,3,Low-Value,Lost
48159,721,4,"208,15",4,1,1,6,Mid-Value,Potential Loyalists
48161,406,3,"107,4",4,1,1,6,Mid-Value,Potential Loyalists
48163,20,3,"580,6",5,1,1,7,Mid-Value,Potential Loyalists
48164,558,2,"252,55",4,1,1,6,Mid-Value,Potential Loyalists
48166,280,2,"127,3",5,1,1,7,Mid-Value,Potential Loyalists
48167,9,3,"172,20000000000002",5,1,1,7,Mid-Value,Potential Loyalists
48168,24,6,"489,54999999999995",5,1,1,7,Mid-Value,Potential Loyalists
48169,1725,1,"20,0",1,1,1,3,Low-Value,Lost
48170,72,1,"14,35",5,1,1,7,Mid-Value,Potential Loyalists
48171,224,4,"119,7",5,1,1,7,Mid-Value,Potential Loyalists
48172,88,2,"28,549999999999997",5,1,1,7,Mid-Value,Potential Loyalists
48174,477,1,"12,85",4,1,1,6,Mid-Value,Potential Loyalists
48176,59,3,"51,7",5,1,1,7,Mid-Value,Potential Loyalists
48180,892,6,"835,1999999999999",3,1,2,6,Mid-Value,Potential Loyalists
48181,7,9,"342,0",5,2,1,8,High-Value,Potential Loyalists
48182,900,1,"46,9",3,1,1,5,Low-Value,At Risk Customers
48183,580,1,"15,6",4,1,1,6,Mid-Value,Potential Loyalists
48184,1244,1,"17,15",2,1,1,4,Low-Value,Can't Lose
48185,1449,1,"228,2",2,1,1,4,Low-Value,Can't Lose
48186,33,7,"243,4",5,2,1,8,High-Value,Potential Loyalists
48189,878,2,"157,1",3,1,1,5,Low-Value,At Risk Customers
48190,31,4,"307,45",5,1,1,7,Mid-Value,Potential Loyalists
48191,892,3,"206,95",3,1,1,5,Low-Value,At Risk Customers
48192,1477,2,"56,2",1,1,1,3,Low-Value,Lost
48193,1237,2,"301,8",2,1,1,4,Low-Value,Can't Lose
48195,294,2,"16,3",5,1,1,7,Mid-Value,Potential Loyalists
48196,1687,1,"47,75",1,1,1,3,Low-Value,Lost
48197,630,5,"304,85",4,1,1,6,Mid-Value,Potential Loyalists
48198,36,3,"248,85",5,1,1,7,Mid-Value,Potential Loyalists
48199,1592,1,"43,8",1,1,1,3,Low-Value,Lost
48200,499,5,"260,45",4,1,1,6,Mid-Value,Potential Loyalists
48201,945,2,"38,15",3,1,1,5,Low-Value,At Risk Customers
48202,1173,2,"691,65",2,1,2,5,Low-Value,At Risk Customers
48203,1184,2,"65,85000000000001",2,1,1,4,Low-Value,Can't Lose
48204,343,2,"76,05",5,1,1,7,Mid-Value,Potential Loyalists
48210,580,4,"77,85",4,1,1,6,Mid-Value,Potential Loyalists
48212,1750,1,"8,95",1,1,1,3,Low-Value,Lost
48214,917,2,"50,95",3,1,1,5,Low-Value,At Risk Customers
48215,131,14,"787,8",5,3,2,10,High-Value,Champions
48219,340,4,"158,3",5,1,1,7,Mid-Value,Potential Loyalists
48220,116,3,"103,05",5,1,1,7,Mid-Value,Potential Loyalists
48223,1532,1,"7,85",1,1,1,3,Low-Value,Lost
48226,697,1,"55,2",4,1,1,6,Mid-Value,Potential Loyalists
48227,505,1,"23,5",4,1,1,6,Mid-Value,Potential Loyalists
48228,380,1,"18,6",4,1,1,6,Mid-Value,Potential Loyalists
48229,382,2,"57,45",4,1,1,6,Mid-Value,Potential Loyalists
48230,491,3,"185,6",4,1,1,6,Mid-Value,Potential Loyalists
48231,193,6,"1490,05",5,1,3,9,High-Value,Champions
48233,36,1,"21,2",5,1,1,7,Mid-Value,Potential Loyalists
48235,326,6,"316,05",5,1,1,7,Mid-Value,Potential Loyalists
48237,559,6,"420,5",4,1,1,6,Mid-Value,Potential Loyalists
48238,1376,1,"53,1",2,1,1,4,Low-Value,Can't Lose
48241,664,4,"304,35",4,1,1,6,Mid-Value,Potential Loyalists
48243,1488,2,"241,2",1,1,1,3,Low-Value,Lost
48245,49,5,"291,4",5,1,1,7,Mid-Value,Potential Loyalists
48246,311,8,"462,85",5,2,1,8,High-Value,Potential Loyalists
48248,1366,4,"267,75",2,1,1,4,Low-Value,Can't Lose
48249,770,5,"723,75",3,1,2,6,Mid-Value,Potential Loyalists
48250,266,4,"136,0",5,1,1,7,Mid-Value,Potential Loyalists
48251,1046,3,"35,900000000000006",3,1,1,5,Low-Value,At Risk Customers
48254,427,4,"152,95",4,1,1,6,Mid-Value,Potential Loyalists
48255,342,5,"242,9",5,1,1,7,Mid-Value,Potential Loyalists
48256,131,7,"381,1",5,2,1,8,High-Value,Potential Loyalists
48257,1177,1,"97,85",2,1,1,4,Low-Value,Can't Lose
48258,271,7,"140,35",5,2,1,8,High-Value,Potential Loyalists
48260,215,2,"46,75",5,1,1,7,Mid-Value,Potential Loyalists
48261,356,3,"256,85",5,1,1,7,Mid-Value,Potential Loyalists
48265,19,11,"1011,95",5,2,2,9,High-Value,Champions
48266,1207,2,"167,79999999999998",2,1,1,4,Low-Value,Can't Lose
48272,413,8,"325,29999999999995",4,2,1,7,Mid-Value,Potential Loyalists
48273,1340,2,"61,400000000000006",2,1,1,4,Low-Value,Can't Lose
48274,81,9,"615,0500000000001",5,2,1,8,High-Value,Potential Loyalists
48276,1036,1,"18,45",3,1,1,5,Low-Value,At Risk Customers
48277,60,4,"449,55",5,1,1,7,Mid-Value,Potential Loyalists
48278,1780,1,"20,75",1,1,1,3,Low-Value,Lost
48280,144,8,"803,25",5,2,2,9,High-Value,Champions
48281,567,2,"53,7",4,1,1,6,Mid-Value,Potential Loyalists
48284,180,1,"14,8",5,1,1,7,Mid-Value,Potential Loyalists
48288,390,3,"330,5",4,1,1,6,Mid-Value,Potential Loyalists
48289,190,7,"586,45",5,2,1,8,High-Value,Potential Loyalists
48290,1512,1,"11,8",1,1,1,3,Low-Value,Lost
48291,1605,1,"44,7",1,1,1,3,Low-Value,Lost
48293,1630,1,"109,4",1,1,1,3,Low-Value,Lost
48294,1580,1,"27,1",1,1,1,3,Low-Value,Lost
48295,137,5,"451,68",5,1,1,7,Mid-Value,Potential Loyalists
48296,14,2,"123,8",5,1,1,7,Mid-Value,Potential Loyalists
48297,152,4,"175,8",5,1,1,7,Mid-Value,Potential Loyalists
48299,1106,2,"150,9",2,1,1,4,Low-Value,Can't Lose
48302,287,3,"38,85",5,1,1,7,Mid-Value,Potential Loyalists
48305,806,1,"9,55",3,1,1,5,Low-Value,At Risk Customers
48307,388,4,"178,25",4,1,1,6,Mid-Value,Potential Loyalists
48308,922,1,"72,0",3,1,1,5,Low-Value,At Risk Customers
48309,129,4,"353,45",5,1,1,7,Mid-Value,Potential Loyalists
48310,631,1,"28,75",4,1,1,6,Mid-Value,Potential Loyalists
48311,363,7,"401,5",5,2,1,8,High-Value,Potential Loyalists
48312,766,3,"72,8",3,1,1,5,Low-Value,At Risk Customers
48313,4,5,"480,7",5,1,1,7,Mid-Value,Potential Loyalists
48314,790,6,"234,8",3,1,1,5,Low-Value,At Risk Customers
48316,892,3,"378,1",3,1,1,5,Low-Value,At Risk Customers
48319,1643,1,"45,6",1,1,1,3,Low-Value,Lost
48321,952,1,"20,05",3,1,1,5,Low-Value,At Risk Customers
48322,608,7,"260,6",4,2,1,7,Mid-Value,Potential Loyalists
48325,1613,2,"150,6",1,1,1,3,Low-Value,Lost
48328,787,2,"34,95",3,1,1,5,Low-Value,At Risk Customers
48329,820,2,"134,9",3,1,1,5,Low-Value,At Risk Customers
48331,26,2,"208,2",5,1,1,7,Mid-Value,Potential Loyalists
48332,21,4,"395,6",5,1,1,7,Mid-Value,Potential Loyalists
48334,1019,1,"26,55",3,1,1,5,Low-Value,At Risk Customers
48335,1045,3,"60,15",3,1,1,5,Low-Value,At Risk Customers
48338,103,5,"203,29999999999998",5,1,1,7,Mid-Value,Potential Loyalists
48339,1112,2,"153,05",2,1,1,4,Low-Value,Can't Lose
48340,31,5,"292,34999999999997",5,1,1,7,Mid-Value,Potential Loyalists
48341,1117,2,"276,0",2,1,1,4,Low-Value,Can't Lose
48348,1305,1,"184,2",2,1,1,4,Low-Value,Can't Lose
48353,1359,1,"17,25",2,1,1,4,Low-Value,Can't Lose
48354,2,1,"56,0",5,1,1,7,Mid-Value,Potential Loyalists
48355,557,1,"77,2",4,1,1,6,Mid-Value,Potential Loyalists
48356,26,6,"207,2",5,1,1,7,Mid-Value,Potential Loyalists
48357,453,1,"18,65",4,1,1,6,Mid-Value,Potential Loyalists
48358,1152,5,"196,39999999999998",2,1,1,4,Low-Value,Can't Lose
48360,174,5,"302,7",5,1,1,7,Mid-Value,Potential Loyalists
48361,899,1,"67,2",3,1,1,5,Low-Value,At Risk Customers
48362,822,4,"136,39999999999998",3,1,1,5,Low-Value,At Risk Customers
48363,610,3,"110,6",4,1,1,6,Mid-Value,Potential Loyalists
48365,771,1,"16,15",3,1,1,5,Low-Value,At Risk Customers
48366,304,3,"137,35",5,1,1,7,Mid-Value,Potential Loyalists
48367,553,1,"143,1",4,1,1,6,Mid-Value,Potential Loyalists
48368,787,4,"151,89999999999998",3,1,1,5,Low-Value,At Risk Customers
48369,1034,1,"47,05",3,1,1,5,Low-Value,At Risk Customers
48370,194,3,"104,3",5,1,1,7,Mid-Value,Potential Loyalists
48371,466,5,"674,05",4,1,2,7,Mid-Value,Potential Loyalists
48372,773,4,"419,75",3,1,1,5,Low-Value,At Risk Customers
48373,353,2,"77,19999999999999",5,1,1,7,Mid-Value,Potential Loyalists
48374,270,3,"145,1",5,1,1,7,Mid-Value,Potential Loyalists
48375,126,1,"31,2",5,1,1,7,Mid-Value,Potential Loyalists
48376,1151,6,"327,85",2,1,1,4,Low-Value,Can't Lose
48379,932,5,"241,15",3,1,1,5,Low-Value,At Risk Customers
48383,201,3,"64,3",5,1,1,7,Mid-Value,Potential Loyalists
48384,12,4,"135,3",5,1,1,7,Mid-Value,Potential Loyalists
48385,1138,1,"109,0",2,1,1,4,Low-Value,Can't Lose
48388,514,3,"287,65",4,1,1,6,Mid-Value,Potential Loyalists
48389,350,6,"342,9",5,1,1,7,Mid-Value,Potential Loyalists
48391,363,1,"23,3",5,1,1,7,Mid-Value,Potential Loyalists
48392,1093,2,"50,05",3,1,1,5,Low-Value,At Risk Customers
48393,1126,1,"204,6",2,1,1,4,Low-Value,Can't Lose
48394,1140,1,"11,75",2,1,1,4,Low-Value,Can't Lose
48395,39,2,"62,85",5,1,1,7,Mid-Value,Potential Loyalists
48398,1349,1,"7,25",2,1,1,4,Low-Value,Can't Lose
48400,4,7,"417,75",5,2,1,8,High-Value,Potential Loyalists
48401,867,2,"41,5",3,1,1,5,Low-Value,At Risk Customers
48403,347,1,"16,8",5,1,1,7,Mid-Value,Potential Loyalists
48404,489,1,"67,8",4,1,1,6,Mid-Value,Potential Loyalists
48406,277,2,"12,8",5,1,1,7,Mid-Value,Potential Loyalists
48407,699,1,"41,4",4,1,1,6,Mid-Value,Potential Loyalists
48411,146,7,"612,25",5,2,1,8,High-Value,Potential Loyalists
48413,134,2,"748,9",5,1,2,8,High-Value,Potential Loyalists
48415,1164,4,"126,1",2,1,1,4,Low-Value,Can't Lose
48417,131,2,"267,65000000000003",5,1,1,7,Mid-Value,Potential Loyalists
48418,705,2,"35,8",4,1,1,6,Mid-Value,Potential Loyalists
48419,872,1,"270,0",3,1,1,5,Low-Value,At Risk Customers
48422,995,1,"11,75",3,1,1,5,Low-Value,At Risk Customers
48423,241,2,"15,25",5,1,1,7,Mid-Value,Potential Loyalists
48424,768,9,"315,85",3,2,1,6,Mid-Value,Potential Loyalists
48427,1000,1,"15,0",3,1,1,5,Low-Value,At Risk Customers
48431,1321,1,"68,0",2,1,1,4,Low-Value,Can't Lose
48432,21,3,"814,8499999999999",5,1,2,8,High-Value,Potential Loyalists
48433,901,3,"161,7",3,1,1,5,Low-Value,At Risk Customers
48434,461,4,"185,1",4,1,1,6,Mid-Value,Potential Loyalists
48437,127,1,"40,8",5,1,1,7,Mid-Value,Potential Loyalists
48439,705,5,"173,75",4,1,1,6,Mid-Value,Potential Loyalists
48440,94,3,"136,7",5,1,1,7,Mid-Value,Potential Loyalists
48443,1523,2,"74,35",1,1,1,3,Low-Value,Lost
48444,521,6,"379,5",4,1,1,6,Mid-Value,Potential Loyalists
48445,195,4,"436,55",5,1,1,7,Mid-Value,Potential Loyalists
48447,433,2,"18,95",4,1,1,6,Mid-Value,Potential Loyalists
48448,36,12,"571,4",5,3,1,9,High-Value,Champions
48449,497,6,"317,8",4,1,1,6,Mid-Value,Potential Loyalists
48454,391,4,"1022,4999999999999",4,1,2,7,Mid-Value,Potential Loyalists
48456,85,4,"200,4",5,1,1,7,Mid-Value,Potential Loyalists
48457,1335,1,"19,75",2,1,1,4,Low-Value,Can't Lose
48458,580,4,"186,65",4,1,1,6,Mid-Value,Potential Loyalists
48459,1779,1,"20,65",1,1,1,3,Low-Value,Lost
48460,692,2,"43,45",4,1,1,6,Mid-Value,Potential Loyalists
48461,104,3,"112,9",5,1,1,7,Mid-Value,Potential Loyalists
48462,785,1,"12,85",3,1,1,5,Low-Value,At Risk Customers
48463,978,1,"8,6",3,1,1,5,Low-Value,At Risk Customers
48464,1620,1,"29,700000000000003",1,1,1,3,Low-Value,Lost
48465,10,8,"375,84999999999997",5,2,1,8,High-Value,Potential Loyalists
48467,824,2,"79,2",3,1,1,5,Low-Value,At Risk Customers
48468,581,4,"372,45",4,1,1,6,Mid-Value,Potential Loyalists
48469,218,3,"154,9",5,1,1,7,Mid-Value,Potential Loyalists
48471,1183,2,"268,2",2,1,1,4,Low-Value,Can't Lose
48472,262,3,"81,35",5,1,1,7,Mid-Value,Potential Loyalists
48473,47,6,"265,5",5,1,1,7,Mid-Value,Potential Loyalists
48474,408,3,"115,44999999999999",4,1,1,6,Mid-Value,Potential Loyalists
48475,244,1,"147,0",5,1,1,7,Mid-Value,Potential Loyalists
48476,1327,1,"12,2",2,1,1,4,Low-Value,Can't Lose
48478,521,1,"16,35",4,1,1,6,Mid-Value,Potential Loyalists
48479,392,1,"110,95",4,1,1,6,Mid-Value,Potential Loyalists
48480,742,3,"77,6",3,1,1,5,Low-Value,At Risk Customers
48481,702,1,"26,7",4,1,1,6,Mid-Value,Potential Loyalists
48482,307,1,"26,5",5,1,1,7,Mid-Value,Potential Loyalists
48483,94,3,"305,3",5,1,1,7,Mid-Value,Potential Loyalists
48484,5,4,"216,29999999999998",5,1,1,7,Mid-Value,Potential Loyalists
48485,1101,7,"345,3",2,2,1,5,Low-Value,At Risk Customers
48486,430,4,"210,04999999999998",4,1,1,6,Mid-Value,Potential Loyalists
48487,182,7,"498,1",5,2,1,8,High-Value,Potential Loyalists
48489,192,1,"11,9",5,1,1,7,Mid-Value,Potential Loyalists
48492,76,8,"1105,55",5,2,2,9,High-Value,Champions
48493,198,6,"370,2",5,1,1,7,Mid-Value,Potential Loyalists
48496,1112,1,"47,4",2,1,1,4,Low-Value,Can't Lose
48498,1416,1,"56,35",2,1,1,4,Low-Value,Can't Lose
48500,1791,1,"7,4",1,1,1,3,Low-Value,Lost
48502,511,1,"142,2",4,1,1,6,Mid-Value,Potential Loyalists
48504,529,2,"90,85",4,1,1,6,Mid-Value,Potential Loyalists
48509,143,4,"119,14999999999999",5,1,1,7,Mid-Value,Potential Loyalists
48510,803,3,"48,25",3,1,1,5,Low-Value,At Risk Customers
48511,764,6,"664,0",3,1,2,6,Mid-Value,Potential Loyalists
48512,1104,1,"57,3",2,1,1,4,Low-Value,Can't Lose
48513,577,1,"121,5",4,1,1,6,Mid-Value,Potential Loyalists
48516,711,1,"277,4",4,1,1,6,Mid-Value,Potential Loyalists
48517,125,5,"336,8",5,1,1,7,Mid-Value,Potential Loyalists
48521,1785,1,"31,9",1,1,1,3,Low-Value,Lost
48522,80,1,"6,6",5,1,1,7,Mid-Value,Potential Loyalists
48525,259,3,"155,65",5,1,1,7,Mid-Value,Potential Loyalists
48528,1237,1,"92,1",2,1,1,4,Low-Value,Can't Lose
48529,84,5,"239,2",5,1,1,7,Mid-Value,Potential Loyalists
48530,451,3,"119,46000000000001",4,1,1,6,Mid-Value,Potential Loyalists
48532,820,5,"210,8",3,1,1,5,Low-Value,At Risk Customers
48533,836,2,"126,0",3,1,1,5,Low-Value,At Risk Customers
48535,752,5,"190,2",3,1,1,5,Low-Value,At Risk Customers
48536,592,4,"262,55",4,1,1,6,Mid-Value,Potential Loyalists
48537,1270,1,"27,6",2,1,1,4,Low-Value,Can't Lose
48538,71,1,"44,9",5,1,1,7,Mid-Value,Potential Loyalists
48540,779,3,"90,55",3,1,1,5,Low-Value,At Risk Customers
48541,12,6,"311,05",5,1,1,7,Mid-Value,Potential Loyalists
48542,3,5,"575,8",5,1,1,7,Mid-Value,Potential Loyalists
48543,81,6,"374,25",5,1,1,7,Mid-Value,Potential Loyalists
48544,883,2,"79,64999999999999",3,1,1,5,Low-Value,At Risk Customers
48548,542,6,"311,9",4,1,1,6,Mid-Value,Potential Loyalists
48552,1586,1,"110,39999999999999",1,1,1,3,Low-Value,Lost
48555,18,7,"485,7",5,2,1,8,High-Value,Potential Loyalists
48556,504,4,"201,5",4,1,1,6,Mid-Value,Potential Loyalists
48557,77,8,"468,9",5,2,1,8,High-Value,Potential Loyalists
48559,1727,1,"15,2",1,1,1,3,Low-Value,Lost
48560,1481,1,"110,69999999999999",1,1,1,3,Low-Value,Lost
48562,138,7,"224,3",5,2,1,8,High-Value,Potential Loyalists
48563,143,3,"63,75",5,1,1,7,Mid-Value,Potential Loyalists
48564,363,1,"26,9",5,1,1,7,Mid-Value,Potential Loyalists
48565,860,1,"92,4",3,1,1,5,Low-Value,At Risk Customers
48569,256,8,"469,45",5,2,1,8,High-Value,Potential Loyalists
48570,622,2,"125,30000000000001",4,1,1,6,Mid-Value,Potential Loyalists
48572,898,2,"86,5",3,1,1,5,Low-Value,At Risk Customers
48576,32,3,"177,1",5,1,1,7,Mid-Value,Potential Loyalists
48577,815,1,"32,15",3,1,1,5,Low-Value,At Risk Customers
48578,1446,1,"172,1",2,1,1,4,Low-Value,Can't Lose
48579,52,2,"141,45",5,1,1,7,Mid-Value,Potential Loyalists
48580,388,5,"210,25",4,1,1,6,Mid-Value,Potential Loyalists
48582,852,1,"14,15",3,1,1,5,Low-Value,At Risk Customers
48585,181,5,"124,19999999999999",5,1,1,7,Mid-Value,Potential Loyalists
48588,1691,1,"5,65",1,1,1,3,Low-Value,Lost
48589,947,1,"10,9",3,1,1,5,Low-Value,At Risk Customers
48590,946,1,"21,5",3,1,1,5,Low-Value,At Risk Customers
48591,222,1,"168,14999999999998",5,1,1,7,Mid-Value,Potential Loyalists
48594,1777,1,"95,1",1,1,1,3,Low-Value,Lost
48595,726,5,"76,5",4,1,1,6,Mid-Value,Potential Loyalists
48598,1444,2,"84,55",2,1,1,4,Low-Value,Can't Lose
48603,983,2,"89,5",3,1,1,5,Low-Value,At Risk Customers
48604,590,2,"84,45",4,1,1,6,Mid-Value,Potential Loyalists
48605,414,9,"321,15000000000003",4,2,1,7,Mid-Value,Potential Loyalists
48606,827,2,"186,05",3,1,1,5,Low-Value,At Risk Customers
48609,1174,2,"139,9",2,1,1,4,Low-Value,Can't Lose
48610,153,5,"367,85",5,1,1,7,Mid-Value,Potential Loyalists
48611,905,1,"57,3",3,1,1,5,Low-Value,At Risk Customers
48612,207,2,"32,3",5,1,1,7,Mid-Value,Potential Loyalists
48614,743,13,"683,68",3,3,2,8,High-Value,Potential Loyalists
48615,875,3,"425,45",3,1,1,5,Low-Value,At Risk Customers
48616,1612,2,"155,85",1,1,1,3,Low-Value,Lost
48618,70,3,"109,5",5,1,1,7,Mid-Value,Potential Loyalists
48619,1172,1,"4,05",2,1,1,4,Low-Value,Can't Lose
48620,1309,2,"127,5",2,1,1,4,Low-Value,Can't Lose
48621,753,3,"1013,0",3,1,2,6,Mid-Value,Potential Loyalists
48622,427,2,"182,3",4,1,1,6,Mid-Value,Potential Loyalists
48624,38,4,"200,5",5,1,1,7,Mid-Value,Potential Loyalists
48626,334,6,"346,40000000000003",5,1,1,7,Mid-Value,Potential Loyalists
48627,1254,1,"39,1",2,1,1,4,Low-Value,Can't Lose
48628,754,3,"219,95000000000002",3,1,1,5,Low-Value,At Risk Customers
48630,474,1,"31,4",4,1,1,6,Mid-Value,Potential Loyalists
48631,159,2,"146,3",5,1,1,7,Mid-Value,Potential Loyalists
48632,434,1,"21,85",4,1,1,6,Mid-Value,Potential Loyalists
48633,1519,1,"35,55",1,1,1,3,Low-Value,Lost
48634,132,4,"92,35",5,1,1,7,Mid-Value,Potential Loyalists
48635,52,2,"97,75",5,1,1,7,Mid-Value,Potential Loyalists
48636,781,4,"162,65",3,1,1,5,Low-Value,At Risk Customers
48639,42,3,"30,150000000000002",5,1,1,7,Mid-Value,Potential Loyalists
48640,236,13,"908,1",5,3,2,10,High-Value,Champions
48641,250,7,"490,85",5,2,1,8,High-Value,Potential Loyalists
48642,204,15,"503,8",5,3,1,9,High-Value,Champions
48644,582,4,"205,34999999999997",4,1,1,6,Mid-Value,Potential Loyalists
48645,486,1,"270,0",4,1,1,6,Mid-Value,Potential Loyalists
48647,670,2,"97,85",4,1,1,6,Mid-Value,Potential Loyalists
48648,149,2,"107,0",5,1,1,7,Mid-Value,Potential Loyalists
48649,504,1,"18,4",4,1,1,6,Mid-Value,Potential Loyalists
48652,754,2,"279,6",3,1,1,5,Low-Value,At Risk Customers
48653,706,5,"278,88",4,1,1,6,Mid-Value,Potential Loyalists
48656,391,2,"162,05",4,1,1,6,Mid-Value,Potential Loyalists
48657,1333,1,"349,79999999999995",2,1,1,4,Low-Value,Can't Lose
48658,511,5,"424,2",4,1,1,6,Mid-Value,Potential Loyalists
48659,1282,1,"19,5",2,1,1,4,Low-Value,Can't Lose
48660,23,3,"187,6",5,1,1,7,Mid-Value,Potential Loyalists
48663,313,3,"129,2",5,1,1,7,Mid-Value,Potential Loyalists
48664,10,4,"312,5",5,1,1,7,Mid-Value,Potential Loyalists
48666,451,3,"155,2",4,1,1,6,Mid-Value,Potential Loyalists
48667,1455,1,"79,0",2,1,1,4,Low-Value,Can't Lose
48668,339,1,"107,2",5,1,1,7,Mid-Value,Potential Loyalists
48669,44,3,"158,45",5,1,1,7,Mid-Value,Potential Loyalists
48670,834,3,"336,54999999999995",3,1,1,5,Low-Value,At Risk Customers
48672,346,2,"27,55",5,1,1,7,Mid-Value,Potential Loyalists
48673,853,1,"20,4",3,1,1,5,Low-Value,At Risk Customers
48674,599,5,"346,55",4,1,1,6,Mid-Value,Potential Loyalists
48675,1672,1,"68,6",1,1,1,3,Low-Value,Lost
48676,1474,1,"104,8",1,1,1,3,Low-Value,Lost
48677,460,4,"289,85",4,1,1,6,Mid-Value,Potential Loyalists
48679,787,9,"250,5",3,2,1,6,Mid-Value,Potential Loyalists
48680,759,2,"129,0",3,1,1,5,Low-Value,At Risk Customers
48681,633,1,"33,6",4,1,1,6,Mid-Value,Potential Loyalists
48684,689,1,"6,2",4,1,1,6,Mid-Value,Potential Loyalists
48685,174,4,"191,60000000000002",5,1,1,7,Mid-Value,Potential Loyalists
48687,869,2,"162,55",3,1,1,5,Low-Value,At Risk Customers
48688,1295,1,"483,59999999999997",2,1,1,4,Low-Value,Can't Lose
48689,272,7,"244,9",5,2,1,8,High-Value,Potential Loyalists
48693,286,1,"21,1",5,1,1,7,Mid-Value,Potential Loyalists
48695,512,2,"140,4",4,1,1,6,Mid-Value,Potential Loyalists
48696,190,4,"339,2",5,1,1,7,Mid-Value,Potential Loyalists
48697,780,2,"59,050000000000004",3,1,1,5,Low-Value,At Risk Customers
48698,4,13,"984,7",5,3,2,10,High-Value,Champions
48699,716,1,"11,35",4,1,1,6,Mid-Value,Potential Loyalists
48700,875,3,"112,65",3,1,1,5,Low-Value,At Risk Customers
48703,1572,2,"96,4",1,1,1,3,Low-Value,Lost
48704,204,4,"407,49999999999994",5,1,1,7,Mid-Value,Potential Loyalists
48706,227,3,"601,4",5,1,1,7,Mid-Value,Potential Loyalists
48707,885,4,"301,4",3,1,1,5,Low-Value,At Risk Customers
48708,1817,1,"140,55",1,1,1,3,Low-Value,Lost
48709,595,2,"120,1",4,1,1,6,Mid-Value,Potential Loyalists
48710,1805,1,"58,0",1,1,1,3,Low-Value,Lost
48711,559,6,"333,65",4,1,1,6,Mid-Value,Potential Loyalists
48712,626,1,"19,8",4,1,1,6,Mid-Value,Potential Loyalists
48713,451,5,"371,7",4,1,1,6,Mid-Value,Potential Loyalists
48714,208,5,"350,2",5,1,1,7,Mid-Value,Potential Loyalists
48715,67,3,"200,75",5,1,1,7,Mid-Value,Potential Loyalists
48716,194,11,"922,4",5,2,2,9,High-Value,Champions
48718,150,4,"144,10000000000002",5,1,1,7,Mid-Value,Potential Loyalists
48719,902,3,"328,25",3,1,1,5,Low-Value,At Risk Customers
48720,384,4,"670,95",4,1,2,7,Mid-Value,Potential Loyalists
48722,1537,1,"45,5",1,1,1,3,Low-Value,Lost
48725,410,1,"38,35",4,1,1,6,Mid-Value,Potential Loyalists
48726,19,8,"792,1",5,2,2,9,High-Value,Champions
48728,96,12,"573,85",5,3,1,9,High-Value,Champions
48729,169,6,"246,7",5,1,1,7,Mid-Value,Potential Loyalists
48732,774,3,"114,55",3,1,1,5,Low-Value,At Risk Customers
48733,122,6,"466,65000000000003",5,1,1,7,Mid-Value,Potential Loyalists
48735,1115,1,"47,5",2,1,1,4,Low-Value,Can't Lose
48736,1720,1,"28,5",1,1,1,3,Low-Value,Lost
48737,38,6,"251,85",5,1,1,7,Mid-Value,Potential Loyalists
48739,301,3,"62,25",5,1,1,7,Mid-Value,Potential Loyalists
48741,1659,1,"81,3",1,1,1,3,Low-Value,Lost
48745,505,7,"563,25",4,2,1,7,Mid-Value,Potential Loyalists
48746,988,2,"207,99999999999997",3,1,1,5,Low-Value,At Risk Customers
48747,46,4,"126,9",5,1,1,7,Mid-Value,Potential Loyalists
48748,169,2,"73,75",5,1,1,7,Mid-Value,Potential Loyalists
48750,356,1,"48,6",5,1,1,7,Mid-Value,Potential Loyalists
48751,83,3,"58,89",5,1,1,7,Mid-Value,Potential Loyalists
48753,215,9,"740,1999999999999",5,2,2,9,High-Value,Champions
48754,1470,1,"26,6",1,1,1,3,Low-Value,Lost
48755,40,1,"7,85",5,1,1,7,Mid-Value,Potential Loyalists
48756,142,2,"280,9",5,1,1,7,Mid-Value,Potential Loyalists
48757,84,4,"254,89999999999998",5,1,1,7,Mid-Value,Potential Loyalists
48759,985,1,"24,75",3,1,1,5,Low-Value,At Risk Customers
48761,892,1,"50,9",3,1,1,5,Low-Value,At Risk Customers
48762,968,1,"33,3",3,1,1,5,Low-Value,At Risk Customers
48763,1028,2,"130,4",3,1,1,5,Low-Value,At Risk Customers
48764,999,1,"135,0",3,1,1,5,Low-Value,At Risk Customers
48765,769,2,"81,70000000000002",3,1,1,5,Low-Value,At Risk Customers
48766,806,2,"257,7",3,1,1,5,Low-Value,At Risk Customers
48770,535,1,"2,75",4,1,1,6,Mid-Value,Potential Loyalists
48771,411,1,"18,9",4,1,1,6,Mid-Value,Potential Loyalists
48772,829,4,"219,85",3,1,1,5,Low-Value,At Risk Customers
48775,111,2,"211,6",5,1,1,7,Mid-Value,Potential Loyalists
48779,514,2,"150,1",4,1,1,6,Mid-Value,Potential Loyalists
48782,1729,2,"233,85",1,1,1,3,Low-Value,Lost
48783,138,3,"193,35",5,1,1,7,Mid-Value,Potential Loyalists
48784,30,2,"48,25",5,1,1,7,Mid-Value,Potential Loyalists
48785,39,1,"87,4",5,1,1,7,Mid-Value,Potential Loyalists
48786,116,4,"233,75",5,1,1,7,Mid-Value,Potential Loyalists
48789,1289,2,"287,55",2,1,1,4,Low-Value,Can't Lose
48790,636,1,"10,65",4,1,1,6,Mid-Value,Potential Loyalists
48791,437,3,"242,45",4,1,1,6,Mid-Value,Potential Loyalists
48793,455,2,"250,85000000000002",4,1,1,6,Mid-Value,Potential Loyalists
48795,855,2,"459,85",3,1,1,5,Low-Value,At Risk Customers
48796,791,1,"34,1",3,1,1,5,Low-Value,At Risk Customers
48802,41,2,"22,8",5,1,1,7,Mid-Value,Potential Loyalists
48803,949,1,"59,4",3,1,1,5,Low-Value,At Risk Customers
48804,412,5,"67,05",4,1,1,6,Mid-Value,Potential Loyalists
48805,3,2,"234,4",5,1,1,7,Mid-Value,Potential Loyalists
48806,1022,1,"4,75",3,1,1,5,Low-Value,At Risk Customers
48807,387,7,"527,5",4,2,1,7,Mid-Value,Potential Loyalists
48809,394,4,"448,09999999999997",4,1,1,6,Mid-Value,Potential Loyalists
48810,76,2,"63,2",5,1,1,7,Mid-Value,Potential Loyalists
48811,452,5,"277,95",4,1,1,6,Mid-Value,Potential Loyalists
48812,637,1,"9,55",4,1,1,6,Mid-Value,Potential Loyalists
48813,269,1,"25,9",5,1,1,7,Mid-Value,Potential Loyalists
48817,203,2,"183,85000000000002",5,1,1,7,Mid-Value,Potential Loyalists
48818,515,3,"99,95",4,1,1,6,Mid-Value,Potential Loyalists
48819,1001,4,"187,95",3,1,1,5,Low-Value,At Risk Customers
48820,1181,2,"25,7",2,1,1,4,Low-Value,Can't Lose
48823,172,6,"208,05",5,1,1,7,Mid-Value,Potential Loyalists
48824,999,2,"154,1",3,1,1,5,Low-Value,At Risk Customers
48825,466,5,"210,5",4,1,1,6,Mid-Value,Potential Loyalists
48828,130,5,"117,35",5,1,1,7,Mid-Value,Potential Loyalists
48829,996,2,"20,65",3,1,1,5,Low-Value,At Risk Customers
48830,584,1,"53,75",4,1,1,6,Mid-Value,Potential Loyalists
48832,263,4,"137,65",5,1,1,7,Mid-Value,Potential Loyalists
48834,75,8,"638,85",5,2,1,8,High-Value,Potential Loyalists
48835,614,1,"91,05000000000001",4,1,1,6,Mid-Value,Potential Loyalists
48837,1278,2,"269,8",2,1,1,4,Low-Value,Can't Lose
48838,1089,1,"48,4",3,1,1,5,Low-Value,At Risk Customers
48842,352,4,"460,4",5,1,1,7,Mid-Value,Potential Loyalists
48845,1137,1,"28,15",2,1,1,4,Low-Value,Can't Lose
48846,787,1,"10,6",3,1,1,5,Low-Value,At Risk Customers
48847,138,6,"501,04999999999995",5,1,1,7,Mid-Value,Potential Loyalists
48851,162,1,"57,05",5,1,1,7,Mid-Value,Potential Loyalists
48856,1796,1,"15,65",1,1,1,3,Low-Value,Lost
48857,811,1,"42,45",3,1,1,5,Low-Value,At Risk Customers
48860,407,10,"650,7",4,2,1,7,Mid-Value,Potential Loyalists
48861,253,5,"336,95",5,1,1,7,Mid-Value,Potential Loyalists
48864,1100,3,"84,7",2,1,1,4,Low-Value,Can't Lose
48866,1520,2,"57,05",1,1,1,3,Low-Value,Lost
48868,410,4,"191,4",4,1,1,6,Mid-Value,Potential Loyalists
48870,1108,3,"217,05",2,1,1,4,Low-Value,Can't Lose
48871,227,3,"215,6",5,1,1,7,Mid-Value,Potential Loyalists
48873,889,3,"276,09999999999997",3,1,1,5,Low-Value,At Risk Customers
48874,53,5,"216,45",5,1,1,7,Mid-Value,Potential Loyalists
48875,496,4,"188,6",4,1,1,6,Mid-Value,Potential Loyalists
48876,144,6,"286,75",5,1,1,7,Mid-Value,Potential Loyalists
48880,919,4,"570,55",3,1,1,5,Low-Value,At Risk Customers
48881,104,4,"52,8",5,1,1,7,Mid-Value,Potential Loyalists
48882,889,2,"165,1",3,1,1,5,Low-Value,At Risk Customers
48883,485,1,"25,75",4,1,1,6,Mid-Value,Potential Loyalists
48884,558,2,"132,70000000000002",4,1,1,6,Mid-Value,Potential Loyalists
48885,80,4,"276,5",5,1,1,7,Mid-Value,Potential Loyalists
48886,1307,1,"718,8",2,1,2,5,Low-Value,At Risk Customers
48889,109,4,"209,0",5,1,1,7,Mid-Value,Potential Loyalists
48894,125,1,"14,5",5,1,1,7,Mid-Value,Potential Loyalists
48895,778,2,"473,9",3,1,1,5,Low-Value,At Risk Customers
48898,78,5,"504,6499999999999",5,1,1,7,Mid-Value,Potential Loyalists
48899,479,3,"91,3",4,1,1,6,Mid-Value,Potential Loyalists
48900,1469,3,"136,0",1,1,1,3,Low-Value,Lost
48901,1511,2,"109,8",1,1,1,3,Low-Value,Lost
48902,1163,1,"54,0",2,1,1,4,Low-Value,Can't Lose
48904,1064,1,"97,1",3,1,1,5,Low-Value,At Risk Customers
48905,302,2,"61,45",5,1,1,7,Mid-Value,Potential Loyalists
48906,584,1,"110,95",4,1,1,6,Mid-Value,Potential Loyalists
48908,25,2,"98,7",5,1,1,7,Mid-Value,Potential Loyalists
48909,35,4,"244,35",5,1,1,7,Mid-Value,Potential Loyalists
48910,787,2,"280,15",3,1,1,5,Low-Value,At Risk Customers
48912,367,1,"114,8",4,1,1,6,Mid-Value,Potential Loyalists
48913,905,4,"122,8",3,1,1,5,Low-Value,At Risk Customers
48914,479,8,"513,45",4,2,1,7,Mid-Value,Potential Loyalists
48915,487,6,"286,8",4,1,1,6,Mid-Value,Potential Loyalists
48917,1585,1,"32,5",1,1,1,3,Low-Value,Lost
48918,1673,1,"109,05000000000001",1,1,1,3,Low-Value,Lost
48920,531,4,"467,5",4,1,1,6,Mid-Value,Potential Loyalists
48921,197,7,"571,4000000000001",5,2,1,8,High-Value,Potential Loyalists
48924,80,4,"270,5",5,1,1,7,Mid-Value,Potential Loyalists
48925,1613,1,"157,0",1,1,1,3,Low-Value,Lost
48926,1475,1,"131,0",1,1,1,3,Low-Value,Lost
48928,22,2,"35,3",5,1,1,7,Mid-Value,Potential Loyalists
48929,1511,1,"24,7",1,1,1,3,Low-Value,Lost
48930,682,2,"263,35",4,1,1,6,Mid-Value,Potential Loyalists
48932,445,2,"49,95",4,1,1,6,Mid-Value,Potential Loyalists
48933,285,7,"239,75",5,2,1,8,High-Value,Potential Loyalists
48935,507,3,"137,04999999999998",4,1,1,6,Mid-Value,Potential Loyalists
48937,949,1,"14,55",3,1,1,5,Low-Value,At Risk Customers
48938,444,5,"280,15",4,1,1,6,Mid-Value,Potential Loyalists
48939,661,7,"601,0",4,2,1,7,Mid-Value,Potential Loyalists
48940,559,2,"122,85",4,1,1,6,Mid-Value,Potential Loyalists
48942,7,2,"53,6",5,1,1,7,Mid-Value,Potential Loyalists
48943,129,2,"21,6",5,1,1,7,Mid-Value,Potential Loyalists
48945,390,6,"134,45000000000002",4,1,1,6,Mid-Value,Potential Loyalists
48948,203,4,"315,40000000000003",5,1,1,7,Mid-Value,Potential Loyalists
48951,1663,2,"175,35",1,1,1,3,Low-Value,Lost
48952,789,1,"13,3",3,1,1,5,Low-Value,At Risk Customers
48953,404,5,"277,55",4,1,1,6,Mid-Value,Potential Loyalists
48955,812,3,"58,2",3,1,1,5,Low-Value,At Risk Customers
48959,891,3,"271,85",3,1,1,5,Low-Value,At Risk Customers
48961,508,1,"34,35",4,1,1,6,Mid-Value,Potential Loyalists
48964,213,1,"53,5",5,1,1,7,Mid-Value,Potential Loyalists
48965,1349,1,"24,3",2,1,1,4,Low-Value,Can't Lose
48970,227,3,"50,05",5,1,1,7,Mid-Value,Potential Loyalists
48973,722,3,"80,7",4,1,1,6,Mid-Value,Potential Loyalists
48975,1335,1,"2,7",2,1,1,4,Low-Value,Can't Lose
48977,1128,2,"213,35",2,1,1,4,Low-Value,Can't Lose
48978,1802,1,"127,95",1,1,1,3,Low-Value,Lost
48980,73,3,"115,85000000000001",5,1,1,7,Mid-Value,Potential Loyalists
48981,602,1,"118,80000000000001",4,1,1,6,Mid-Value,Potential Loyalists
48982,1306,3,"67,85",2,1,1,4,Low-Value,Can't Lose
48983,1086,1,"10,45",3,1,1,5,Low-Value,At Risk Customers
48984,307,3,"35,58",5,1,1,7,Mid-Value,Potential Loyalists
48986,792,6,"659,65",3,1,1,5,Low-Value,At Risk Customers
48988,612,4,"165,25",4,1,1,6,Mid-Value,Potential Loyalists
48991,613,4,"76,55",4,1,1,6,Mid-Value,Potential Loyalists
48992,609,2,"54,45",4,1,1,6,Mid-Value,Potential Loyalists
48993,838,2,"40,5",3,1,1,5,Low-Value,At Risk Customers
48995,12,10,"840,1999999999999",5,2,2,9,High-Value,Champions
48996,26,9,"274,95",5,2,1,8,High-Value,Potential Loyalists
48997,208,2,"257,55",5,1,1,7,Mid-Value,Potential Loyalists
49000,749,2,"105,44999999999999",3,1,1,5,Low-Value,At Risk Customers
49001,102,1,"88,7",5,1,1,7,Mid-Value,Potential Loyalists
49002,299,1,"5,65",5,1,1,7,Mid-Value,Potential Loyalists
49004,1744,1,"4,1",1,1,1,3,Low-Value,Lost
49009,1488,2,"32,55",1,1,1,3,Low-Value,Lost
49011,1092,4,"203,64999999999998",3,1,1,5,Low-Value,At Risk Customers
49012,127,2,"70,95",5,1,1,7,Mid-Value,Potential Loyalists
49013,186,1,"14,4",5,1,1,7,Mid-Value,Potential Loyalists
49015,1221,3,"127,55",2,1,1,4,Low-Value,Can't Lose
49016,1095,5,"65,6",3,1,1,5,Low-Value,At Risk Customers
49017,1133,2,"96,3",2,1,1,4,Low-Value,Can't Lose
49018,698,1,"9,9",4,1,1,6,Mid-Value,Potential Loyalists
49022,91,6,"141,1",5,1,1,7,Mid-Value,Potential Loyalists
49023,126,6,"514,6",5,1,1,7,Mid-Value,Potential Loyalists
49027,377,1,"46,2",4,1,1,6,Mid-Value,Potential Loyalists
49028,969,1,"184,05",3,1,1,5,Low-Value,At Risk Customers
49029,281,3,"569,8499999999999",5,1,1,7,Mid-Value,Potential Loyalists
49030,331,6,"125,95",5,1,1,7,Mid-Value,Potential Loyalists
49031,767,2,"198,1",3,1,1,5,Low-Value,At Risk Customers
49032,976,3,"252,39999999999998",3,1,1,5,Low-Value,At Risk Customers
49033,411,2,"36,75",4,1,1,6,Mid-Value,Potential Loyalists
49034,589,2,"185,60000000000002",4,1,1,6,Mid-Value,Potential Loyalists
49036,27,7,"259,3",5,2,1,8,High-Value,Potential Loyalists
49037,252,2,"93,85",5,1,1,7,Mid-Value,Potential Loyalists
49039,627,3,"198,1",4,1,1,6,Mid-Value,Potential Loyalists
49040,147,1,"121,6",5,1,1,7,Mid-Value,Potential Loyalists
49042,124,2,"92,10000000000001",5,1,1,7,Mid-Value,Potential Loyalists
49044,155,2,"186,55",5,1,1,7,Mid-Value,Potential Loyalists
49051,1325,1,"64,4",2,1,1,4,Low-Value,Can't Lose
49052,109,2,"111,25",5,1,1,7,Mid-Value,Potential Loyalists
49055,385,3,"338,15",4,1,1,6,Mid-Value,Potential Loyalists
49056,431,3,"194,3",4,1,1,6,Mid-Value,Potential Loyalists
49057,183,4,"118,9",5,1,1,7,Mid-Value,Potential Loyalists
49058,261,2,"80,6",5,1,1,7,Mid-Value,Potential Loyalists
49059,16,2,"122,5",5,1,1,7,Mid-Value,Potential Loyalists
49063,155,2,"54,5",5,1,1,7,Mid-Value,Potential Loyalists
49064,471,3,"150,1",4,1,1,6,Mid-Value,Potential Loyalists
49066,369,5,"800,45",4,1,2,7,Mid-Value,Potential Loyalists
49067,49,3,"367,2",5,1,1,7,Mid-Value,Potential Loyalists
49069,174,3,"320,65000000000003",5,1,1,7,Mid-Value,Potential Loyalists
49070,150,8,"325,05",5,2,1,8,High-Value,Potential Loyalists
49071,991,2,"116,3",3,1,1,5,Low-Value,At Risk Customers
49072,367,6,"122,05",4,1,1,6,Mid-Value,Potential Loyalists
49073,89,9,"525,45",5,2,1,8,High-Value,Potential Loyalists
49076,17,6,"460,34999999999997",5,1,1,7,Mid-Value,Potential Loyalists
49077,32,2,"165,7",5,1,1,7,Mid-Value,Potential Loyalists
49078,1519,2,"98,3",1,1,1,3,Low-Value,Lost
49079,63,7,"469,25",5,2,1,8,High-Value,Potential Loyalists
49080,462,1,"18,7",4,1,1,6,Mid-Value,Potential Loyalists
49083,175,6,"541,15",5,1,1,7,Mid-Value,Potential Loyalists
49084,1536,1,"82,35",1,1,1,3,Low-Value,Lost
49088,886,1,"15,7",3,1,1,5,Low-Value,At Risk Customers
49089,991,1,"24,2",3,1,1,5,Low-Value,At Risk Customers
49091,537,2,"45,900000000000006",4,1,1,6,Mid-Value,Potential Loyalists
49093,931,3,"373,25",3,1,1,5,Low-Value,At Risk Customers
49094,1259,1,"23,3",2,1,1,4,Low-Value,Can't Lose
49096,1237,2,"79,2",2,1,1,4,Low-Value,Can't Lose
49097,59,2,"71,60000000000001",5,1,1,7,Mid-Value,Potential Loyalists
49098,1211,1,"44,2",2,1,1,4,Low-Value,Can't Lose
49099,814,1,"55,85",3,1,1,5,Low-Value,At Risk Customers
49102,311,3,"365,0",5,1,1,7,Mid-Value,Potential Loyalists
49103,26,6,"2033,1999999999998",5,1,4,10,High-Value,Champions
49104,952,2,"50,400000000000006",3,1,1,5,Low-Value,At Risk Customers
49105,350,1,"21,3",5,1,1,7,Mid-Value,Potential Loyalists
49106,1268,1,"268,79999999999995",2,1,1,4,Low-Value,Can't Lose
49108,887,3,"648,9",3,1,1,5,Low-Value,At Risk Customers
49110,265,3,"99,95",5,1,1,7,Mid-Value,Potential Loyalists
49113,1148,1,"2,7",2,1,1,4,Low-Value,Can't Lose
49114,42,5,"425,8",5,1,1,7,Mid-Value,Potential Loyalists
49115,25,8,"287,34999999999997",5,2,1,8,High-Value,Potential Loyalists
49117,198,3,"246,04999999999998",5,1,1,7,Mid-Value,Potential Loyalists
49119,552,6,"540,1",4,1,1,6,Mid-Value,Potential Loyalists
49120,434,2,"98,2",4,1,1,6,Mid-Value,Potential Loyalists
49122,687,4,"126,5",4,1,1,6,Mid-Value,Potential Loyalists
49128,129,5,"306,45",5,1,1,7,Mid-Value,Potential Loyalists
49129,61,3,"123,39999999999999",5,1,1,7,Mid-Value,Potential Loyalists
49131,131,10,"543,35",5,2,1,8,High-Value,Potential Loyalists
49132,1247,5,"556,3",2,1,1,4,Low-Value,Can't Lose
49134,519,3,"177,3",4,1,1,6,Mid-Value,Potential Loyalists
49136,1152,2,"37,0",2,1,1,4,Low-Value,Can't Lose
49137,1494,1,"8,55",1,1,1,3,Low-Value,Lost
49138,493,1,"45,5",4,1,1,6,Mid-Value,Potential Loyalists
49139,1548,1,"19,2",1,1,1,3,Low-Value,Lost
49140,937,1,"88,5",3,1,1,5,Low-Value,At Risk Customers
49141,1124,1,"141,7",2,1,1,4,Low-Value,Can't Lose
49143,89,7,"268,79999999999995",5,2,1,8,High-Value,Potential Loyalists
49144,40,3,"37,6",5,1,1,7,Mid-Value,Potential Loyalists
49145,62,3,"232,4",5,1,1,7,Mid-Value,Potential Loyalists
49146,220,1,"27,5",5,1,1,7,Mid-Value,Potential Loyalists
49147,1246,6,"314,69999999999993",2,1,1,4,Low-Value,Can't Lose
49148,643,2,"32,2",4,1,1,6,Mid-Value,Potential Loyalists
49150,17,6,"201,8",5,1,1,7,Mid-Value,Potential Loyalists
49151,3,5,"188,6",5,1,1,7,Mid-Value,Potential Loyalists
49152,147,7,"504,3",5,2,1,8,High-Value,Potential Loyalists
49153,26,6,"282,05",5,1,1,7,Mid-Value,Potential Loyalists
49155,1678,2,"46,099999999999994",1,1,1,3,Low-Value,Lost
49156,1139,5,"185,3",2,1,1,4,Low-Value,Can't Lose
49157,1549,1,"45,5",1,1,1,3,Low-Value,Lost
49161,551,1,"124,2",4,1,1,6,Mid-Value,Potential Loyalists
49163,762,1,"9,0",3,1,1,5,Low-Value,At Risk Customers
49164,815,2,"66,8",3,1,1,5,Low-Value,At Risk Customers
49165,399,2,"60,8",4,1,1,6,Mid-Value,Potential Loyalists
49166,1600,1,"50,7",1,1,1,3,Low-Value,Lost
49167,1341,1,"14,95",2,1,1,4,Low-Value,Can't Lose
49168,168,7,"549,1500000000001",5,2,1,8,High-Value,Potential Loyalists
49169,530,2,"38,7",4,1,1,6,Mid-Value,Potential Loyalists
49170,899,4,"517,1",3,1,1,5,Low-Value,At Risk Customers
49173,857,3,"86,95",3,1,1,5,Low-Value,At Risk Customers
49175,762,3,"71,85",3,1,1,5,Low-Value,At Risk Customers
49176,1119,3,"149,1",2,1,1,4,Low-Value,Can't Lose
49177,774,3,"136,25",3,1,1,5,Low-Value,At Risk Customers
49178,181,12,"783,25",5,3,2,10,High-Value,Champions
49179,1041,3,"157,05",3,1,1,5,Low-Value,At Risk Customers
49180,263,4,"109,45",5,1,1,7,Mid-Value,Potential Loyalists
49182,204,1,"19,1",5,1,1,7,Mid-Value,Potential Loyalists
49183,441,2,"112,6",4,1,1,6,Mid-Value,Potential Loyalists
49187,486,2,"59,75",4,1,1,6,Mid-Value,Potential Loyalists
49189,12,3,"380,2",5,1,1,7,Mid-Value,Potential Loyalists
49190,905,2,"419,65",3,1,1,5,Low-Value,At Risk Customers
49193,1018,2,"106,05",3,1,1,5,Low-Value,At Risk Customers
49194,36,3,"111,24999999999999",5,1,1,7,Mid-Value,Potential Loyalists
49196,880,3,"213,60000000000002",3,1,1,5,Low-Value,At Risk Customers
49201,133,4,"96,7",5,1,1,7,Mid-Value,Potential Loyalists
49205,186,5,"619,25",5,1,1,7,Mid-Value,Potential Loyalists
49206,211,6,"661,35",5,1,1,7,Mid-Value,Potential Loyalists
49207,1330,1,"35,400000000000006",2,1,1,4,Low-Value,Can't Lose
49208,89,5,"323,85",5,1,1,7,Mid-Value,Potential Loyalists
49210,14,3,"125,4",5,1,1,7,Mid-Value,Potential Loyalists
49214,239,8,"228,65",5,2,1,8,High-Value,Potential Loyalists
49215,1250,1,"19,0",2,1,1,4,Low-Value,Can't Lose
49216,307,4,"526,9",5,1,1,7,Mid-Value,Potential Loyalists
49217,90,2,"35,25",5,1,1,7,Mid-Value,Potential Loyalists
49218,1348,1,"8,25",2,1,1,4,Low-Value,Can't Lose
49219,193,1,"147,3",5,1,1,7,Mid-Value,Potential Loyalists
49220,88,4,"132,8",5,1,1,7,Mid-Value,Potential Loyalists
49222,68,4,"111,6",5,1,1,7,Mid-Value,Potential Loyalists
49223,105,8,"362,8",5,2,1,8,High-Value,Potential Loyalists
49224,352,1,"45,4",5,1,1,7,Mid-Value,Potential Loyalists
49226,580,1,"54,8",4,1,1,6,Mid-Value,Potential Loyalists
49228,962,4,"139,85",3,1,1,5,Low-Value,At Risk Customers
49229,384,4,"264,70000000000005",4,1,1,6,Mid-Value,Potential Loyalists
49231,50,8,"711,6",5,2,2,9,High-Value,Champions
49232,453,3,"291,5",4,1,1,6,Mid-Value,Potential Loyalists
49233,420,2,"115,60000000000001",4,1,1,6,Mid-Value,Potential Loyalists
49234,215,4,"186,0",5,1,1,7,Mid-Value,Potential Loyalists
49235,235,2,"113,7",5,1,1,7,Mid-Value,Potential Loyalists
49236,20,1,"11,5",5,1,1,7,Mid-Value,Potential Loyalists
49237,495,3,"65,0",4,1,1,6,Mid-Value,Potential Loyalists
49238,882,7,"362,75",3,2,1,6,Mid-Value,Potential Loyalists
49239,25,5,"310,34999999999997",5,1,1,7,Mid-Value,Potential Loyalists
49240,133,10,"564,25",5,2,1,8,High-Value,Potential Loyalists
49241,10,5,"163,2",5,1,1,7,Mid-Value,Potential Loyalists
49242,987,2,"198,0",3,1,1,5,Low-Value,At Risk Customers
49244,297,6,"183,54999999999998",5,1,1,7,Mid-Value,Potential Loyalists
49247,346,1,"17,9",5,1,1,7,Mid-Value,Potential Loyalists
49249,1322,1,"207,0",2,1,1,4,Low-Value,Can't Lose
49250,1643,1,"11,4",1,1,1,3,Low-Value,Lost
49252,1058,3,"138,9",3,1,1,5,Low-Value,At Risk Customers
49253,14,1,"80,2",5,1,1,7,Mid-Value,Potential Loyalists
49254,20,4,"143,25",5,1,1,7,Mid-Value,Potential Loyalists
49255,1105,1,"33,1",2,1,1,4,Low-Value,Can't Lose
49256,412,4,"423,0",4,1,1,6,Mid-Value,Potential Loyalists
49257,144,2,"87,8",5,1,1,7,Mid-Value,Potential Loyalists
49258,10,5,"494,25",5,1,1,7,Mid-Value,Potential Loyalists
49259,592,6,"248,10000000000002",4,1,1,6,Mid-Value,Potential Loyalists
49263,829,4,"145,5",3,1,1,5,Low-Value,At Risk Customers
49264,27,6,"297,0",5,1,1,7,Mid-Value,Potential Loyalists
49265,318,2,"28,9",5,1,1,7,Mid-Value,Potential Loyalists
49266,712,2,"262,90000000000003",4,1,1,6,Mid-Value,Potential Loyalists
49267,937,5,"231,75",3,1,1,5,Low-Value,At Risk Customers
49268,1292,1,"59,6",2,1,1,4,Low-Value,Can't Lose
49269,1353,4,"282,4",2,1,1,4,Low-Value,Can't Lose
49271,157,3,"185,24999999999997",5,1,1,7,Mid-Value,Potential Loyalists
49273,976,2,"172,95000000000002",3,1,1,5,Low-Value,At Risk Customers
49274,890,3,"294,04999999999995",3,1,1,5,Low-Value,At Risk Customers
49275,216,6,"148,55",5,1,1,7,Mid-Value,Potential Loyalists
49276,1651,1,"154,2",1,1,1,3,Low-Value,Lost
49277,149,7,"730,8",5,2,2,9,High-Value,Champions
49278,449,6,"369,15",4,1,1,6,Mid-Value,Potential Loyalists
49279,1133,3,"88,14999999999999",2,1,1,4,Low-Value,Can't Lose
49280,1585,1,"92,1",1,1,1,3,Low-Value,Lost
49281,401,3,"201,45",4,1,1,6,Mid-Value,Potential Loyalists
49282,146,3,"595,8000000000001",5,1,1,7,Mid-Value,Potential Loyalists
49283,1247,3,"429,6",2,1,1,4,Low-Value,Can't Lose
49284,136,2,"233,4",5,1,1,7,Mid-Value,Potential Loyalists
49288,27,9,"680,45",5,2,2,9,High-Value,Champions
49289,874,2,"242,65",3,1,1,5,Low-Value,At Risk Customers
49290,313,1,"7,8",5,1,1,7,Mid-Value,Potential Loyalists
49292,616,1,"183,45",4,1,1,6,Mid-Value,Potential Loyalists
49293,1761,1,"12,2",1,1,1,3,Low-Value,Lost
49295,5,1,"86,9",5,1,1,7,Mid-Value,Potential Loyalists
49297,1293,5,"453,75",2,1,1,4,Low-Value,Can't Lose
49299,73,2,"340,40000000000003",5,1,1,7,Mid-Value,Potential Loyalists
49301,653,3,"127,99",4,1,1,6,Mid-Value,Potential Loyalists
49303,14,2,"315,59999999999997",5,1,1,7,Mid-Value,Potential Loyalists
49305,290,2,"59,55",5,1,1,7,Mid-Value,Potential Loyalists
49307,542,3,"37,15",4,1,1,6,Mid-Value,Potential Loyalists
49309,154,10,"565,2",5,2,1,8,High-Value,Potential Loyalists
49310,722,2,"59,4",4,1,1,6,Mid-Value,Potential Loyalists
49312,196,1,"37,9",5,1,1,7,Mid-Value,Potential Loyalists
49314,323,1,"26,65",5,1,1,7,Mid-Value,Potential Loyalists
49315,109,4,"151,05",5,1,1,7,Mid-Value,Potential Loyalists
49317,313,3,"277,85",5,1,1,7,Mid-Value,Potential Loyalists
49319,1463,2,"317,90000000000003",1,1,1,3,Low-Value,Lost
49322,186,3,"129,3",5,1,1,7,Mid-Value,Potential Loyalists
49324,784,3,"160,3",3,1,1,5,Low-Value,At Risk Customers
49325,707,1,"5,4",4,1,1,6,Mid-Value,Potential Loyalists
49326,502,3,"70,3",4,1,1,6,Mid-Value,Potential Loyalists
49328,1624,1,"540,0",1,1,1,3,Low-Value,Lost
49329,374,2,"363,54999999999995",4,1,1,6,Mid-Value,Potential Loyalists
49330,1691,1,"15,450000000000001",1,1,1,3,Low-Value,Lost
49333,70,3,"418,45",5,1,1,7,Mid-Value,Potential Loyalists
49334,876,3,"267,74999999999994",3,1,1,5,Low-Value,At Risk Customers
49335,1525,1,"18,75",1,1,1,3,Low-Value,Lost
49337,84,9,"545,55",5,2,1,8,High-Value,Potential Loyalists
49340,99,2,"24,4",5,1,1,7,Mid-Value,Potential Loyalists
49342,791,2,"80,1",3,1,1,5,Low-Value,At Risk Customers
49344,287,2,"26,1",5,1,1,7,Mid-Value,Potential Loyalists
49345,739,3,"133,6",3,1,1,5,Low-Value,At Risk Customers
49347,245,1,"70,35",5,1,1,7,Mid-Value,Potential Loyalists
49349,733,1,"557,4",3,1,1,5,Low-Value,At Risk Customers
49350,785,4,"451,9",3,1,1,5,Low-Value,At Risk Customers
49351,751,3,"115,0",3,1,1,5,Low-Value,At Risk Customers
49352,456,8,"609,35",4,2,1,7,Mid-Value,Potential Loyalists
49354,363,2,"147,65",5,1,1,7,Mid-Value,Potential Loyalists
49356,728,3,"234,85",4,1,1,6,Mid-Value,Potential Loyalists
49358,61,3,"348,4",5,1,1,7,Mid-Value,Potential Loyalists
49361,732,13,"532,45",3,3,1,7,Mid-Value,Potential Loyalists
49362,196,5,"176,05",5,1,1,7,Mid-Value,Potential Loyalists
49365,133,9,"652,1",5,2,1,8,High-Value,Potential Loyalists
49366,130,8,"737,9",5,2,2,9,High-Value,Champions
49367,1587,1,"35,7",1,1,1,3,Low-Value,Lost
49368,1426,2,"74,60000000000001",2,1,1,4,Low-Value,Can't Lose
49369,1299,1,"26,25",2,1,1,4,Low-Value,Can't Lose
49370,218,3,"103,3",5,1,1,7,Mid-Value,Potential Loyalists
49372,551,4,"174,6",4,1,1,6,Mid-Value,Potential Loyalists
49373,548,2,"552,85",4,1,1,6,Mid-Value,Potential Loyalists
49374,340,1,"31,05",5,1,1,7,Mid-Value,Potential Loyalists
49377,452,2,"40,0",4,1,1,6,Mid-Value,Potential Loyalists
49378,741,1,"12,8",3,1,1,5,Low-Value,At Risk Customers
49379,1423,2,"400,75",2,1,1,4,Low-Value,Can't Lose
49380,1534,1,"55,75",1,1,1,3,Low-Value,Lost
49381,146,3,"284,6",5,1,1,7,Mid-Value,Potential Loyalists
49384,154,10,"470,3",5,2,1,8,High-Value,Potential Loyalists
49386,157,1,"35,7",5,1,1,7,Mid-Value,Potential Loyalists
49387,600,3,"209,60000000000002",4,1,1,6,Mid-Value,Potential Loyalists
49390,556,1,"53,3",4,1,1,6,Mid-Value,Potential Loyalists
49393,952,1,"36,4",3,1,1,5,Low-Value,At Risk Customers
49394,414,4,"89,30000000000001",4,1,1,6,Mid-Value,Potential Loyalists
49395,1,6,"242,85",5,1,1,7,Mid-Value,Potential Loyalists
49398,108,2,"128,9",5,1,1,7,Mid-Value,Potential Loyalists
49399,799,1,"76,3",3,1,1,5,Low-Value,At Risk Customers
49401,754,8,"736,2",3,2,2,7,Mid-Value,Potential Loyalists
49402,708,1,"12,2",4,1,1,6,Mid-Value,Potential Loyalists
49403,438,3,"108,75",4,1,1,6,Mid-Value,Potential Loyalists
49405,1422,1,"16,55",2,1,1,4,Low-Value,Can't Lose
49407,43,4,"102,05",5,1,1,7,Mid-Value,Potential Loyalists
49408,421,2,"166,95",4,1,1,6,Mid-Value,Potential Loyalists
49410,843,3,"132,45",3,1,1,5,Low-Value,At Risk Customers
49412,1132,2,"129,9",2,1,1,4,Low-Value,Can't Lose
49413,433,1,"25,25",4,1,1,6,Mid-Value,Potential Loyalists
49414,134,6,"239,45",5,1,1,7,Mid-Value,Potential Loyalists
49415,393,3,"491,15000000000003",4,1,1,6,Mid-Value,Potential Loyalists
49416,62,1,"4,85",5,1,1,7,Mid-Value,Potential Loyalists
49417,504,2,"209,1",4,1,1,6,Mid-Value,Potential Loyalists
49420,1485,1,"44,4",1,1,1,3,Low-Value,Lost
49422,580,5,"761,35",4,1,2,7,Mid-Value,Potential Loyalists
49428,421,4,"161,7",4,1,1,6,Mid-Value,Potential Loyalists
49429,614,3,"177,60000000000002",4,1,1,6,Mid-Value,Potential Loyalists
49430,14,2,"100,55",5,1,1,7,Mid-Value,Potential Loyalists
49431,648,2,"82,6",4,1,1,6,Mid-Value,Potential Loyalists
49432,170,8,"278,35",5,2,1,8,High-Value,Potential Loyalists
49434,480,3,"83,8",4,1,1,6,Mid-Value,Potential Loyalists
49435,389,5,"427,0",4,1,1,6,Mid-Value,Potential Loyalists
49439,1592,1,"160,4",1,1,1,3,Low-Value,Lost
49442,244,3,"150,5",5,1,1,7,Mid-Value,Potential Loyalists
49443,138,2,"212,6",5,1,1,7,Mid-Value,Potential Loyalists
49445,167,8,"728,75",5,2,2,9,High-Value,Champions
49446,777,2,"22,9",3,1,1,5,Low-Value,At Risk Customers
49447,115,11,"458,15000000000003",5,2,1,8,High-Value,Potential Loyalists
49450,722,7,"245,79999999999998",4,2,1,7,Mid-Value,Potential Loyalists
49452,464,1,"97,85",4,1,1,6,Mid-Value,Potential Loyalists
49453,946,1,"47,05",3,1,1,5,Low-Value,At Risk Customers
49454,1660,2,"195,1",1,1,1,3,Low-Value,Lost
49455,445,1,"85,3",4,1,1,6,Mid-Value,Potential Loyalists
49457,441,6,"188,85",4,1,1,6,Mid-Value,Potential Loyalists
49458,5,1,"38,15",5,1,1,7,Mid-Value,Potential Loyalists
49461,9,1,"107,2",5,1,1,7,Mid-Value,Potential Loyalists
49462,250,2,"132,1",5,1,1,7,Mid-Value,Potential Loyalists
49463,1720,1,"44,8",1,1,1,3,Low-Value,Lost
49465,985,1,"117,0",3,1,1,5,Low-Value,At Risk Customers
49466,0,1,"228,9",5,1,1,7,Mid-Value,Potential Loyalists
49467,13,3,"162,5",5,1,1,7,Mid-Value,Potential Loyalists
49468,1642,1,"154,0",1,1,1,3,Low-Value,Lost
49470,1391,1,"22,75",2,1,1,4,Low-Value,Can't Lose
49472,226,2,"51,49999999999999",5,1,1,7,Mid-Value,Potential Loyalists
49473,773,2,"171,8",3,1,1,5,Low-Value,At Risk Customers
49474,1176,1,"8,0",2,1,1,4,Low-Value,Can't Lose
49476,859,7,"384,2",3,2,1,6,Mid-Value,Potential Loyalists
49478,409,2,"101,80000000000001",4,1,1,6,Mid-Value,Potential Loyalists
49479,875,1,"35,2",3,1,1,5,Low-Value,At Risk Customers
49480,1567,1,"28,7",1,1,1,3,Low-Value,Lost
49481,274,6,"178,2",5,1,1,7,Mid-Value,Potential Loyalists
49483,20,6,"387,0",5,1,1,7,Mid-Value,Potential Loyalists
49484,428,1,"10,35",4,1,1,6,Mid-Value,Potential Loyalists
49485,166,5,"547,65",5,1,1,7,Mid-Value,Potential Loyalists
49487,372,7,"172,0",4,2,1,7,Mid-Value,Potential Loyalists
49490,1298,1,"5,8",2,1,1,4,Low-Value,Can't Lose
49492,582,2,"81,25",4,1,1,6,Mid-Value,Potential Loyalists
49494,416,5,"174,5",4,1,1,6,Mid-Value,Potential Loyalists
49495,149,6,"518,6",5,1,1,7,Mid-Value,Potential Loyalists
49496,473,3,"59,1",4,1,1,6,Mid-Value,Potential Loyalists
49497,56,3,"149,7",5,1,1,7,Mid-Value,Potential Loyalists
49500,276,6,"185,25",5,1,1,7,Mid-Value,Potential Loyalists
49501,441,7,"342,3",4,2,1,7,Mid-Value,Potential Loyalists
49503,91,2,"81,60000000000001",5,1,1,7,Mid-Value,Potential Loyalists
49504,373,5,"206,65",4,1,1,6,Mid-Value,Potential Loyalists
49505,406,4,"189,15",4,1,1,6,Mid-Value,Potential Loyalists
49506,1106,3,"178,09999999999997",2,1,1,4,Low-Value,Can't Lose
49507,1429,1,"9,1",2,1,1,4,Low-Value,Can't Lose
49510,307,10,"764,4",5,2,2,9,High-Value,Champions
49513,36,1,"5,45",5,1,1,7,Mid-Value,Potential Loyalists
49514,540,3,"195,6",4,1,1,6,Mid-Value,Potential Loyalists
49517,573,1,"18,2",4,1,1,6,Mid-Value,Potential Loyalists
49518,302,4,"184,70000000000002",5,1,1,7,Mid-Value,Potential Loyalists
49521,326,4,"104,15",5,1,1,7,Mid-Value,Potential Loyalists
49523,1656,1,"51,3",1,1,1,3,Low-Value,Lost
49524,1249,1,"74,55",2,1,1,4,Low-Value,Can't Lose
49526,725,2,"49,900000000000006",4,1,1,6,Mid-Value,Potential Loyalists
49527,162,9,"596,35",5,2,1,8,High-Value,Potential Loyalists
49528,753,4,"179,10000000000002",3,1,1,5,Low-Value,At Risk Customers
49529,877,1,"108,0",3,1,1,5,Low-Value,At Risk Customers
49534,13,4,"379,6",5,1,1,7,Mid-Value,Potential Loyalists
49536,1114,3,"195,4",2,1,1,4,Low-Value,Can't Lose
49538,159,2,"78,6",5,1,1,7,Mid-Value,Potential Loyalists
49539,213,1,"8,1",5,1,1,7,Mid-Value,Potential Loyalists
49540,128,3,"87,15",5,1,1,7,Mid-Value,Potential Loyalists
49542,838,1,"2,25",3,1,1,5,Low-Value,At Risk Customers
49544,133,2,"79,95",5,1,1,7,Mid-Value,Potential Loyalists
49546,412,3,"447,45",4,1,1,6,Mid-Value,Potential Loyalists
49548,1201,1,"79,1",2,1,1,4,Low-Value,Can't Lose
49550,116,3,"127,7",5,1,1,7,Mid-Value,Potential Loyalists
49552,232,2,"102,0",5,1,1,7,Mid-Value,Potential Loyalists
49553,585,2,"95,25",4,1,1,6,Mid-Value,Potential Loyalists
49554,1486,1,"57,4",1,1,1,3,Low-Value,Lost
49556,1027,3,"122,7",3,1,1,5,Low-Value,At Risk Customers
49558,1610,2,"85,5",1,1,1,3,Low-Value,Lost
49561,117,3,"426,85",5,1,1,7,Mid-Value,Potential Loyalists
49562,1424,1,"5,6",2,1,1,4,Low-Value,Can't Lose
49563,216,4,"302,35",5,1,1,7,Mid-Value,Potential Loyalists
49565,875,2,"37,3",3,1,1,5,Low-Value,At Risk Customers
49566,232,2,"105,05",5,1,1,7,Mid-Value,Potential Loyalists
49567,654,4,"288,40000000000003",4,1,1,6,Mid-Value,Potential Loyalists
49568,1091,1,"12,15",3,1,1,5,Low-Value,At Risk Customers
49572,100,3,"68,25",5,1,1,7,Mid-Value,Potential Loyalists
49573,183,2,"92,6",5,1,1,7,Mid-Value,Potential Loyalists
49575,1311,1,"43,4",2,1,1,4,Low-Value,Can't Lose
49576,643,1,"58,0",4,1,1,6,Mid-Value,Potential Loyalists
49577,683,5,"97,8",4,1,1,6,Mid-Value,Potential Loyalists
49578,56,3,"1468,6",5,1,3,9,High-Value,Champions
49579,909,1,"4,9",3,1,1,5,Low-Value,At Risk Customers
49581,46,3,"147,7",5,1,1,7,Mid-Value,Potential Loyalists
49582,21,12,"464,7",5,3,1,9,High-Value,Champions
49583,347,6,"473,9",5,1,1,7,Mid-Value,Potential Loyalists
49584,1121,2,"41,849999999999994",2,1,1,4,Low-Value,Can't Lose
49585,477,1,"39,2",4,1,1,6,Mid-Value,Potential Loyalists
49586,254,1,"51,4",5,1,1,7,Mid-Value,Potential Loyalists
49588,52,8,"363,1",5,2,1,8,High-Value,Potential Loyalists
49589,1292,1,"11,5",2,1,1,4,Low-Value,Can't Lose
49592,420,1,"26,35",4,1,1,6,Mid-Value,Potential Loyalists
49593,179,3,"142,0",5,1,1,7,Mid-Value,Potential Loyalists
49595,381,1,"46,9",4,1,1,6,Mid-Value,Potential Loyalists
49596,788,1,"20,75",3,1,1,5,Low-Value,At Risk Customers
49597,768,3,"125,5",3,1,1,5,Low-Value,At Risk Customers
49598,546,5,"117,75",4,1,1,6,Mid-Value,Potential Loyalists
49600,542,3,"189,05",4,1,1,6,Mid-Value,Potential Loyalists
49601,705,2,"93,4",4,1,1,6,Mid-Value,Potential Loyalists
49602,1531,1,"14,8",1,1,1,3,Low-Value,Lost
49603,20,7,"465,3",5,2,1,8,High-Value,Potential Loyalists
49605,1601,1,"143,75",1,1,1,3,Low-Value,Lost
49608,219,5,"168,55",5,1,1,7,Mid-Value,Potential Loyalists
49609,360,3,"28,3",5,1,1,7,Mid-Value,Potential Loyalists
49611,74,1,"21,45",5,1,1,7,Mid-Value,Potential Loyalists
49612,113,17,"1190,0",5,4,2,11,High-Value,Champions
49613,482,2,"103,65",4,1,1,6,Mid-Value,Potential Loyalists
49616,1194,3,"101,75",2,1,1,4,Low-Value,Can't Lose
49617,277,10,"487,55",5,2,1,8,High-Value,Potential Loyalists
49618,900,6,"711,2",3,1,2,6,Mid-Value,Potential Loyalists
49620,256,12,"1011,7",5,3,2,10,High-Value,Champions
49621,1275,1,"79,6",2,1,1,4,Low-Value,Can't Lose
49622,358,5,"82,15",5,1,1,7,Mid-Value,Potential Loyalists
49623,146,2,"206,45",5,1,1,7,Mid-Value,Potential Loyalists
49626,358,1,"6,45",5,1,1,7,Mid-Value,Potential Loyalists
49627,1121,4,"506,25",2,1,1,4,Low-Value,Can't Lose
49629,788,2,"55,550000000000004",3,1,1,5,Low-Value,At Risk Customers
49630,779,2,"180,3",3,1,1,5,Low-Value,At Risk Customers
49633,117,3,"84,0",5,1,1,7,Mid-Value,Potential Loyalists
49635,872,3,"114,4",3,1,1,5,Low-Value,At Risk Customers
49642,138,7,"347,75",5,2,1,8,High-Value,Potential Loyalists
49645,885,3,"441,75000000000006",3,1,1,5,Low-Value,At Risk Customers
49646,48,8,"374,84999999999997",5,2,1,8,High-Value,Potential Loyalists
49647,150,9,"407,75",5,2,1,8,High-Value,Potential Loyalists
49649,136,1,"31,6",5,1,1,7,Mid-Value,Potential Loyalists
49650,25,4,"401,95000000000005",5,1,1,7,Mid-Value,Potential Loyalists
49651,181,6,"514,6500000000001",5,1,1,7,Mid-Value,Potential Loyalists
49652,264,6,"644,4000000000001",5,1,1,7,Mid-Value,Potential Loyalists
49656,770,2,"108,15",3,1,1,5,Low-Value,At Risk Customers
49657,3,6,"477,85",5,1,1,7,Mid-Value,Potential Loyalists
49660,135,2,"34,1",5,1,1,7,Mid-Value,Potential Loyalists
49661,150,9,"377,25",5,2,1,8,High-Value,Potential Loyalists
49662,100,11,"1365,75",5,2,3,10,High-Value,Champions
49664,162,2,"392,8",5,1,1,7,Mid-Value,Potential Loyalists
49665,1607,1,"9,7",1,1,1,3,Low-Value,Lost
49666,419,3,"33,2",4,1,1,6,Mid-Value,Potential Loyalists
49668,52,2,"36,6",5,1,1,7,Mid-Value,Potential Loyalists
49669,13,13,"622,6",5,3,1,9,High-Value,Champions
49672,1650,1,"3,2",1,1,1,3,Low-Value,Lost
49673,1508,2,"64,95",1,1,1,3,Low-Value,Lost
49675,160,7,"495,40000000000003",5,2,1,8,High-Value,Potential Loyalists
49676,311,4,"380,79999999999995",5,1,1,7,Mid-Value,Potential Loyalists
49679,1728,1,"56,7",1,1,1,3,Low-Value,Lost
49681,420,2,"28,95",4,1,1,6,Mid-Value,Potential Loyalists
49682,743,3,"54,15",3,1,1,5,Low-Value,At Risk Customers
49683,479,2,"151,6",4,1,1,6,Mid-Value,Potential Loyalists
49686,1333,1,"6,6000000000000005",2,1,1,4,Low-Value,Can't Lose
49687,10,4,"109,35000000000001",5,1,1,7,Mid-Value,Potential Loyalists
49688,164,5,"509,85",5,1,1,7,Mid-Value,Potential Loyalists
49690,458,2,"264,2",4,1,1,6,Mid-Value,Potential Loyalists
49692,1082,1,"96,2",3,1,1,5,Low-Value,At Risk Customers
49694,7,4,"201,39999999999998",5,1,1,7,Mid-Value,Potential Loyalists
49695,748,2,"79,75",3,1,1,5,Low-Value,At Risk Customers
49696,489,7,"283,05",4,2,1,7,Mid-Value,Potential Loyalists
49699,28,7,"435,75",5,2,1,8,High-Value,Potential Loyalists
49700,581,3,"95,5",4,1,1,6,Mid-Value,Potential Loyalists
49701,833,3,"76,5",3,1,1,5,Low-Value,At Risk Customers
49702,75,2,"64,55",5,1,1,7,Mid-Value,Potential Loyalists
49705,30,3,"245,6",5,1,1,7,Mid-Value,Potential Loyalists
49706,301,4,"56,95",5,1,1,7,Mid-Value,Potential Loyalists
49708,1088,1,"113,65",3,1,1,5,Low-Value,At Risk Customers
49709,538,6,"723,0999999999999",4,1,2,7,Mid-Value,Potential Loyalists
49710,370,4,"162,4",4,1,1,6,Mid-Value,Potential Loyalists
49711,238,3,"152,85",5,1,1,7,Mid-Value,Potential Loyalists
49713,971,2,"104,5",3,1,1,5,Low-Value,At Risk Customers
49714,15,3,"194,55",5,1,1,7,Mid-Value,Potential Loyalists
49716,825,6,"233,3",3,1,1,5,Low-Value,At Risk Customers
49719,292,6,"778,8",5,1,2,8,High-Value,Potential Loyalists
49720,244,5,"239,75",5,1,1,7,Mid-Value,Potential Loyalists
49721,250,1,"95,4",5,1,1,7,Mid-Value,Potential Loyalists
49723,221,3,"171,45",5,1,1,7,Mid-Value,Potential Loyalists
49724,844,2,"104,05",3,1,1,5,Low-Value,At Risk Customers
49725,130,2,"33,050000000000004",5,1,1,7,Mid-Value,Potential Loyalists
49726,1591,1,"93,8",1,1,1,3,Low-Value,Lost
49727,214,1,"9,55",5,1,1,7,Mid-Value,Potential Loyalists
49729,29,9,"1192,95",5,2,2,9,High-Value,Champions
49732,94,6,"300,05",5,1,1,7,Mid-Value,Potential Loyalists
49733,221,1,"126,4",5,1,1,7,Mid-Value,Potential Loyalists
49738,207,1,"7,0",5,1,1,7,Mid-Value,Potential Loyalists
49739,540,3,"256,5",4,1,1,6,Mid-Value,Potential Loyalists
49741,1245,3,"173,7",2,1,1,4,Low-Value,Can't Lose
49743,935,4,"132,6",3,1,1,5,Low-Value,At Risk Customers
49744,1538,1,"29,1",1,1,1,3,Low-Value,Lost
49746,10,9,"633,35",5,2,1,8,High-Value,Potential Loyalists
49747,290,1,"67,5",5,1,1,7,Mid-Value,Potential Loyalists
49748,593,4,"229,55",4,1,1,6,Mid-Value,Potential Loyalists
49753,140,8,"371,5",5,2,1,8,High-Value,Potential Loyalists
49754,526,6,"256,1",4,1,1,6,Mid-Value,Potential Loyalists
49755,311,1,"24,1",5,1,1,7,Mid-Value,Potential Loyalists
49756,824,1,"14,3",3,1,1,5,Low-Value,At Risk Customers
49758,366,1,"22,7",4,1,1,6,Mid-Value,Potential Loyalists
49759,5,2,"188,0",5,1,1,7,Mid-Value,Potential Loyalists
49761,1240,1,"40,4",2,1,1,4,Low-Value,Can't Lose
49763,724,1,"13,75",4,1,1,6,Mid-Value,Potential Loyalists
49764,32,4,"187,55",5,1,1,7,Mid-Value,Potential Loyalists
49765,466,5,"224,05",4,1,1,6,Mid-Value,Potential Loyalists
49766,308,2,"49,25",5,1,1,7,Mid-Value,Potential Loyalists
49767,318,2,"139,5",5,1,1,7,Mid-Value,Potential Loyalists
49768,43,5,"201,45000000000002",5,1,1,7,Mid-Value,Potential Loyalists
49769,117,3,"155,54999999999998",5,1,1,7,Mid-Value,Potential Loyalists
49770,539,6,"180,8",4,1,1,6,Mid-Value,Potential Loyalists
49773,13,11,"543,9",5,2,1,8,High-Value,Potential Loyalists
49774,251,4,"298,29999999999995",5,1,1,7,Mid-Value,Potential Loyalists
49775,769,2,"290,25",3,1,1,5,Low-Value,At Risk Customers
49778,825,5,"302,1",3,1,1,5,Low-Value,At Risk Customers
49779,840,1,"38,85",3,1,1,5,Low-Value,At Risk Customers
49780,839,2,"162,54999999999998",3,1,1,5,Low-Value,At Risk Customers
49781,841,1,"43,3",3,1,1,5,Low-Value,At Risk Customers
49782,238,3,"123,2",5,1,1,7,Mid-Value,Potential Loyalists
49783,1714,1,"11,7",1,1,1,3,Low-Value,Lost
49784,614,2,"346,25",4,1,1,6,Mid-Value,Potential Loyalists
49785,892,3,"202,75",3,1,1,5,Low-Value,At Risk Customers
49789,1535,1,"127,95",1,1,1,3,Low-Value,Lost
49791,531,2,"130,6",4,1,1,6,Mid-Value,Potential Loyalists
49793,60,3,"172,4",5,1,1,7,Mid-Value,Potential Loyalists
49794,598,1,"3,95",4,1,1,6,Mid-Value,Potential Loyalists
49796,742,4,"317,55",3,1,1,5,Low-Value,At Risk Customers
49797,46,4,"14,35",5,1,1,7,Mid-Value,Potential Loyalists
49798,895,2,"105,35",3,1,1,5,Low-Value,At Risk Customers
49799,757,2,"25,15",3,1,1,5,Low-Value,At Risk Customers
49800,1358,1,"11,95",2,1,1,4,Low-Value,Can't Lose
49802,1459,1,"39,25",2,1,1,4,Low-Value,Can't Lose
49804,731,3,"78,75",3,1,1,5,Low-Value,At Risk Customers
49805,219,3,"96,95",5,1,1,7,Mid-Value,Potential Loyalists
49807,340,2,"310,7",5,1,1,7,Mid-Value,Potential Loyalists
49809,1598,1,"60,1",1,1,1,3,Low-Value,Lost
49810,1103,7,"658,85",2,2,1,5,Low-Value,At Risk Customers
49811,161,4,"285,55",5,1,1,7,Mid-Value,Potential Loyalists
49814,795,2,"105,35000000000001",3,1,1,5,Low-Value,At Risk Customers
49815,273,3,"128,0",5,1,1,7,Mid-Value,Potential Loyalists
49816,1014,1,"51,4",3,1,1,5,Low-Value,At Risk Customers
49817,180,5,"163,65",5,1,1,7,Mid-Value,Potential Loyalists
49818,25,3,"299,55",5,1,1,7,Mid-Value,Potential Loyalists
49819,1539,4,"121,35000000000001",1,1,1,3,Low-Value,Lost
49820,19,11,"940,8",5,2,2,9,High-Value,Champions
49821,57,9,"816,15",5,2,2,9,High-Value,Champions
49822,154,2,"770,6999999999999",5,1,2,8,High-Value,Potential Loyalists
49823,1294,2,"122,1",2,1,1,4,Low-Value,Can't Lose
49825,256,2,"509,9",5,1,1,7,Mid-Value,Potential Loyalists
49827,507,6,"414,3",4,1,1,6,Mid-Value,Potential Loyalists
49828,575,1,"5,5",4,1,1,6,Mid-Value,Potential Loyalists
49830,772,2,"538,9499999999999",3,1,1,5,Low-Value,At Risk Customers
49831,570,2,"41,95",4,1,1,6,Mid-Value,Potential Loyalists
49832,743,2,"951,3000000000001",3,1,2,6,Mid-Value,Potential Loyalists
49833,1660,1,"58,1",1,1,1,3,Low-Value,Lost
49834,630,2,"91,6",4,1,1,6,Mid-Value,Potential Loyalists
49835,585,2,"528,75",4,1,1,6,Mid-Value,Potential Loyalists
49836,127,6,"222,3",5,1,1,7,Mid-Value,Potential Loyalists
49837,762,2,"35,2",3,1,1,5,Low-Value,At Risk Customers
49838,396,2,"48,0",4,1,1,6,Mid-Value,Potential Loyalists
49842,598,2,"222,45",4,1,1,6,Mid-Value,Potential Loyalists
49843,997,1,"13,7",3,1,1,5,Low-Value,At Risk Customers
49845,1354,1,"120,2",2,1,1,4,Low-Value,Can't Lose
49847,162,3,"105,5",5,1,1,7,Mid-Value,Potential Loyalists
49849,721,6,"302,90000000000003",4,1,1,6,Mid-Value,Potential Loyalists
49850,190,1,"37,0",5,1,1,7,Mid-Value,Potential Loyalists
49851,89,2,"39,7",5,1,1,7,Mid-Value,Potential Loyalists
49852,140,1,"29,25",5,1,1,7,Mid-Value,Potential Loyalists
49853,1093,1,"47,5",3,1,1,5,Low-Value,At Risk Customers
49857,76,3,"265,5",5,1,1,7,Mid-Value,Potential Loyalists
49858,455,4,"126,44999999999999",4,1,1,6,Mid-Value,Potential Loyalists
49859,274,4,"251,35",5,1,1,7,Mid-Value,Potential Loyalists
49861,287,6,"239,59999999999997",5,1,1,7,Mid-Value,Potential Loyalists
49862,133,5,"166,2",5,1,1,7,Mid-Value,Potential Loyalists
49863,797,1,"3,95",3,1,1,5,Low-Value,At Risk Customers
49864,682,3,"195,7",4,1,1,6,Mid-Value,Potential Loyalists
49865,424,2,"36,95",4,1,1,6,Mid-Value,Potential Loyalists
49868,931,1,"45,6",3,1,1,5,Low-Value,At Risk Customers
49870,1243,1,"20,6",2,1,1,4,Low-Value,Can't Lose
49873,745,2,"279,40000000000003",3,1,1,5,Low-Value,At Risk Customers
49874,349,2,"68,95",5,1,1,7,Mid-Value,Potential Loyalists
49878,52,6,"262,3",5,1,1,7,Mid-Value,Potential Loyalists
49882,42,5,"322,85",5,1,1,7,Mid-Value,Potential Loyalists
49883,61,8,"398,15",5,2,1,8,High-Value,Potential Loyalists
49886,323,2,"454,45000000000005",5,1,1,7,Mid-Value,Potential Loyalists
49887,862,4,"324,2",3,1,1,5,Low-Value,At Risk Customers
49888,136,5,"509,1",5,1,1,7,Mid-Value,Potential Loyalists
49891,181,2,"92,14999999999999",5,1,1,7,Mid-Value,Potential Loyalists
49892,362,3,"397,09999999999997",5,1,1,7,Mid-Value,Potential Loyalists
49895,8,10,"569,5",5,2,1,8,High-Value,Potential Loyalists
49897,994,1,"153,89999999999998",3,1,1,5,Low-Value,At Risk Customers
49899,409,2,"67,0",4,1,1,6,Mid-Value,Potential Loyalists
49901,122,5,"516,35",5,1,1,7,Mid-Value,Potential Loyalists
49902,582,2,"300,05",4,1,1,6,Mid-Value,Potential Loyalists
49904,197,1,"153,1",5,1,1,7,Mid-Value,Potential Loyalists
49905,1075,2,"32,3",3,1,1,5,Low-Value,At Risk Customers
49906,358,5,"316,15",5,1,1,7,Mid-Value,Potential Loyalists
49907,1631,1,"969,8",1,1,2,4,Low-Value,Can't Lose
49908,1061,2,"88,1",3,1,1,5,Low-Value,At Risk Customers
49909,73,3,"75,1",5,1,1,7,Mid-Value,Potential Loyalists
49910,147,4,"430,1",5,1,1,7,Mid-Value,Potential Loyalists
49912,27,1,"219,1",5,1,1,7,Mid-Value,Potential Loyalists
49913,1240,2,"92,3",2,1,1,4,Low-Value,Can't Lose
49916,360,2,"79,85",5,1,1,7,Mid-Value,Potential Loyalists
49917,87,10,"695,0500000000001",5,2,2,9,High-Value,Champions
49918,629,2,"158,75",4,1,1,6,Mid-Value,Potential Loyalists
49920,123,1,"46,8",5,1,1,7,Mid-Value,Potential Loyalists
49922,107,2,"21,9",5,1,1,7,Mid-Value,Potential Loyalists
49923,1443,1,"50,4",2,1,1,4,Low-Value,Can't Lose
49926,221,4,"221,05",5,1,1,7,Mid-Value,Potential Loyalists
49927,769,2,"668,9",3,1,2,6,Mid-Value,Potential Loyalists
49931,26,17,"696,5500000000001",5,4,2,11,High-Value,Champions
49932,312,2,"441,35",5,1,1,7,Mid-Value,Potential Loyalists
49936,383,2,"67,55",4,1,1,6,Mid-Value,Potential Loyalists
49938,1696,1,"67,8",1,1,1,3,Low-Value,Lost
49939,255,3,"94,25",5,1,1,7,Mid-Value,Potential Loyalists
49941,1796,1,"8,55",1,1,1,3,Low-Value,Lost
49942,426,5,"346,05",4,1,1,6,Mid-Value,Potential Loyalists
49943,80,4,"306,5",5,1,1,7,Mid-Value,Potential Loyalists
49945,179,7,"352,15",5,2,1,8,High-Value,Potential Loyalists
49948,379,3,"79,85",4,1,1,6,Mid-Value,Potential Loyalists
49949,1639,1,"8,1",1,1,1,3,Low-Value,Lost
49950,878,2,"268,55",3,1,1,5,Low-Value,At Risk Customers
49952,882,2,"144,25",3,1,1,5,Low-Value,At Risk Customers
49953,35,4,"818,15",5,1,2,8,High-Value,Potential Loyalists
49954,136,6,"443,05",5,1,1,7,Mid-Value,Potential Loyalists
49955,31,5,"211,15",5,1,1,7,Mid-Value,Potential Loyalists
49956,225,2,"140,8",5,1,1,7,Mid-Value,Potential Loyalists
49957,1795,1,"2,95",1,1,1,3,Low-Value,Lost
49958,189,2,"85,6",5,1,1,7,Mid-Value,Potential Loyalists
49959,92,7,"335,75",5,2,1,8,High-Value,Potential Loyalists
49960,389,1,"35,6",4,1,1,6,Mid-Value,Potential Loyalists
49961,194,6,"463,65",5,1,1,7,Mid-Value,Potential Loyalists
49962,129,4,"382,33",5,1,1,7,Mid-Value,Potential Loyalists
49963,104,4,"356,95",5,1,1,7,Mid-Value,Potential Loyalists
49965,281,2,"91,0",5,1,1,7,Mid-Value,Potential Loyalists
49966,549,6,"812,3499999999999",4,1,2,7,Mid-Value,Potential Loyalists
49967,513,1,"15,0",4,1,1,6,Mid-Value,Potential Loyalists
49968,886,1,"156,05",3,1,1,5,Low-Value,At Risk Customers
49969,361,4,"272,6",5,1,1,7,Mid-Value,Potential Loyalists
49971,223,4,"91,05",5,1,1,7,Mid-Value,Potential Loyalists
49973,1252,1,"97,4",2,1,1,4,Low-Value,Can't Lose
49974,1151,2,"37,5",2,1,1,4,Low-Value,Can't Lose
49977,405,1,"253,2",4,1,1,6,Mid-Value,Potential Loyalists
49979,36,3,"222,5",5,1,1,7,Mid-Value,Potential Loyalists
49980,1111,1,"44,8",2,1,1,4,Low-Value,Can't Lose
49981,193,4,"263,7",5,1,1,7,Mid-Value,Potential Loyalists
49983,36,6,"115,55",5,1,1,7,Mid-Value,Potential Loyalists
49987,1677,1,"112,85",1,1,1,3,Low-Value,Lost
49989,89,6,"713,0500000000001",5,1,2,8,High-Value,Potential Loyalists
49990,10,4,"153,65",5,1,1,7,Mid-Value,Potential Loyalists
49993,1101,4,"847,05",2,1,2,5,Low-Value,At Risk Customers
49994,61,1,"50,6",5,1,1,7,Mid-Value,Potential Loyalists
49995,95,1,"201,5",5,1,1,7,Mid-Value,Potential Loyalists
49996,1580,2,"106,35",1,1,1,3,Low-Value,Lost
49997,1103,1,"23,5",2,1,1,4,Low-Value,Can't Lose
49998,378,4,"99,95",4,1,1,6,Mid-Value,Potential Loyalists
50002,1218,1,"83,5",2,1,1,4,Low-Value,Can't Lose
50003,148,1,"38,7",5,1,1,7,Mid-Value,Potential Loyalists
50004,1383,2,"42,65",2,1,1,4,Low-Value,Can't Lose
50005,879,2,"71,9",3,1,1,5,Low-Value,At Risk Customers
50006,826,1,"113,65",3,1,1,5,Low-Value,At Risk Customers
50007,1107,1,"91,2",2,1,1,4,Low-Value,Can't Lose
50008,978,1,"38,6",3,1,1,5,Low-Value,At Risk Customers
50010,1787,1,"214,4",1,1,1,3,Low-Value,Lost
50012,1064,1,"110,2",3,1,1,5,Low-Value,At Risk Customers
50015,204,3,"121,8",5,1,1,7,Mid-Value,Potential Loyalists
50016,1757,1,"87,15",1,1,1,3,Low-Value,Lost
50017,544,4,"94,19999999999999",4,1,1,6,Mid-Value,Potential Loyalists
50020,36,10,"832,75",5,2,2,9,High-Value,Champions
50021,300,2,"54,25",5,1,1,7,Mid-Value,Potential Loyalists
50023,599,3,"77,7",4,1,1,6,Mid-Value,Potential Loyalists
50024,22,5,"365,0",5,1,1,7,Mid-Value,Potential Loyalists
50025,940,3,"182,4",3,1,1,5,Low-Value,At Risk Customers
50026,810,6,"369,55",3,1,1,5,Low-Value,At Risk Customers
50028,375,2,"143,54999999999998",4,1,1,6,Mid-Value,Potential Loyalists
50029,266,2,"294,9",5,1,1,7,Mid-Value,Potential Loyalists
50031,743,6,"649,0999999999999",3,1,1,5,Low-Value,At Risk Customers
50033,1081,4,"314,59999999999997",3,1,1,5,Low-Value,At Risk Customers
50035,1258,3,"135,20000000000002",2,1,1,4,Low-Value,Can't Lose
50036,1501,1,"98,85",1,1,1,3,Low-Value,Lost
50037,994,3,"207,15",3,1,1,5,Low-Value,At Risk Customers
50038,405,3,"148,2",4,1,1,6,Mid-Value,Potential Loyalists
50040,1073,2,"29,1",3,1,1,5,Low-Value,At Risk Customers
50041,301,1,"1,5",5,1,1,7,Mid-Value,Potential Loyalists
50044,878,2,"117,60000000000001",3,1,1,5,Low-Value,At Risk Customers
50045,1080,1,"18,9",3,1,1,5,Low-Value,At Risk Customers
50046,1179,1,"36,75",2,1,1,4,Low-Value,Can't Lose
50047,138,1,"51,75",5,1,1,7,Mid-Value,Potential Loyalists
50049,523,4,"203,25",4,1,1,6,Mid-Value,Potential Loyalists
50051,85,10,"374,05",5,2,1,8,High-Value,Potential Loyalists
50055,1551,1,"16,35",1,1,1,3,Low-Value,Lost
50056,832,2,"93,0",3,1,1,5,Low-Value,At Risk Customers
50059,701,2,"112,1",4,1,1,6,Mid-Value,Potential Loyalists
50060,20,2,"160,5",5,1,1,7,Mid-Value,Potential Loyalists
50061,376,9,"394,8",4,2,1,7,Mid-Value,Potential Loyalists
50063,256,1,"44,25",5,1,1,7,Mid-Value,Potential Loyalists
50066,543,3,"427,55",4,1,1,6,Mid-Value,Potential Loyalists
50067,733,2,"113,4",3,1,1,5,Low-Value,At Risk Customers
50069,488,1,"51,900000000000006",4,1,1,6,Mid-Value,Potential Loyalists
50070,418,9,"551,05",4,2,1,7,Mid-Value,Potential Loyalists
50071,224,1,"17,85",5,1,1,7,Mid-Value,Potential Loyalists
50072,1527,3,"57,4",1,1,1,3,Low-Value,Lost
50073,1562,1,"45,5",1,1,1,3,Low-Value,Lost
50076,1249,6,"383,05",2,1,1,4,Low-Value,Can't Lose
50078,1470,2,"79,45",1,1,1,3,Low-Value,Lost
50079,530,2,"57,800000000000004",4,1,1,6,Mid-Value,Potential Loyalists
50080,441,2,"68,4",4,1,1,6,Mid-Value,Potential Loyalists
50082,760,6,"263,7",3,1,1,5,Low-Value,At Risk Customers
50084,1369,2,"106,14999999999999",2,1,1,4,Low-Value,Can't Lose
50085,1802,1,"21,7",1,1,1,3,Low-Value,Lost
50088,24,10,"295,45",5,2,1,8,High-Value,Potential Loyalists
50090,412,1,"30,7",4,1,1,6,Mid-Value,Potential Loyalists
50091,448,8,"373,4",4,2,1,7,Mid-Value,Potential Loyalists
50092,564,4,"177,5",4,1,1,6,Mid-Value,Potential Loyalists
50093,1590,1,"77,1",1,1,1,3,Low-Value,Lost
50095,444,5,"175,9",4,1,1,6,Mid-Value,Potential Loyalists
50097,91,5,"382,65",5,1,1,7,Mid-Value,Potential Loyalists
50098,988,6,"144,0",3,1,1,5,Low-Value,At Risk Customers
50099,1405,1,"18,4",2,1,1,4,Low-Value,Can't Lose
50100,1294,1,"33,5",2,1,1,4,Low-Value,Can't Lose
50101,409,2,"111,25",4,1,1,6,Mid-Value,Potential Loyalists
50102,560,2,"125,30000000000001",4,1,1,6,Mid-Value,Potential Loyalists
50103,117,3,"105,45",5,1,1,7,Mid-Value,Potential Loyalists
50104,283,6,"145,0",5,1,1,7,Mid-Value,Potential Loyalists
50105,473,2,"156,54999999999998",4,1,1,6,Mid-Value,Potential Loyalists
50106,398,5,"173,79999999999998",4,1,1,6,Mid-Value,Potential Loyalists
50107,1658,3,"263,55",1,1,1,3,Low-Value,Lost
50108,1450,1,"19,1",2,1,1,4,Low-Value,Can't Lose
50110,124,8,"205,35",5,2,1,8,High-Value,Potential Loyalists
50111,47,5,"381,7",5,1,1,7,Mid-Value,Potential Loyalists
50112,192,3,"586,95",5,1,1,7,Mid-Value,Potential Loyalists
50113,1393,1,"13,65",2,1,1,4,Low-Value,Can't Lose
50114,1513,1,"51,6",1,1,1,3,Low-Value,Lost
50115,546,8,"248,9",4,2,1,7,Mid-Value,Potential Loyalists
50116,790,2,"41,5",3,1,1,5,Low-Value,At Risk Customers
50118,825,5,"218,1",3,1,1,5,Low-Value,At Risk Customers
50119,4,2,"138,15",5,1,1,7,Mid-Value,Potential Loyalists
50120,934,2,"314,8",3,1,1,5,Low-Value,At Risk Customers
50121,748,4,"246,45",3,1,1,5,Low-Value,At Risk Customers
50123,101,2,"76,5",5,1,1,7,Mid-Value,Potential Loyalists
50124,635,2,"92,85",4,1,1,6,Mid-Value,Potential Loyalists
50126,798,5,"361,0",3,1,1,5,Low-Value,At Risk Customers
50127,736,2,"192,05",3,1,1,5,Low-Value,At Risk Customers
50128,396,1,"147,0",4,1,1,6,Mid-Value,Potential Loyalists
50130,44,5,"766,4",5,1,2,8,High-Value,Potential Loyalists
50133,43,5,"717,1",5,1,2,8,High-Value,Potential Loyalists
50134,135,1,"4,6",5,1,1,7,Mid-Value,Potential Loyalists
50135,892,1,"6,0",3,1,1,5,Low-Value,At Risk Customers
50136,525,2,"224,14999999999998",4,1,1,6,Mid-Value,Potential Loyalists
50137,906,1,"17,5",3,1,1,5,Low-Value,At Risk Customers
50139,741,4,"92,80000000000001",3,1,1,5,Low-Value,At Risk Customers
50140,337,4,"214,55",5,1,1,7,Mid-Value,Potential Loyalists
50142,1480,1,"36,3",1,1,1,3,Low-Value,Lost
50143,66,5,"222,85",5,1,1,7,Mid-Value,Potential Loyalists
50144,62,5,"245,3",5,1,1,7,Mid-Value,Potential Loyalists
50146,68,1,"4,4",5,1,1,7,Mid-Value,Potential Loyalists
50148,398,5,"216,35000000000002",4,1,1,6,Mid-Value,Potential Loyalists
50149,115,4,"141,05",5,1,1,7,Mid-Value,Potential Loyalists
50150,825,3,"461,45",3,1,1,5,Low-Value,At Risk Customers
50153,12,9,"729,75",5,2,2,9,High-Value,Champions
50154,222,3,"410,7",5,1,1,7,Mid-Value,Potential Loyalists
50156,11,2,"141,9",5,1,1,7,Mid-Value,Potential Loyalists
50157,733,2,"23,46",3,1,1,5,Low-Value,At Risk Customers
50158,4,5,"352,45",5,1,1,7,Mid-Value,Potential Loyalists
50159,1683,1,"23,1",1,1,1,3,Low-Value,Lost
50160,1390,1,"2,75",2,1,1,4,Low-Value,Can't Lose
50163,503,6,"963,65",4,1,2,7,Mid-Value,Potential Loyalists
50164,1238,1,"34,6",2,1,1,4,Low-Value,Can't Lose
50165,142,4,"397,85",5,1,1,7,Mid-Value,Potential Loyalists
50166,1620,1,"27,4",1,1,1,3,Low-Value,Lost
50167,586,1,"118,8",4,1,1,6,Mid-Value,Potential Loyalists
50169,385,1,"70,4",4,1,1,6,Mid-Value,Potential Loyalists
50170,284,3,"281,9",5,1,1,7,Mid-Value,Potential Loyalists
50172,1285,4,"492,4",2,1,1,4,Low-Value,Can't Lose
50173,519,2,"40,1",4,1,1,6,Mid-Value,Potential Loyalists
50175,13,6,"429,7",5,1,1,7,Mid-Value,Potential Loyalists
50176,77,5,"138,45",5,1,1,7,Mid-Value,Potential Loyalists
50177,182,5,"669,55",5,1,2,8,High-Value,Potential Loyalists
50178,701,1,"24,85",4,1,1,6,Mid-Value,Potential Loyalists
50180,339,3,"1017,5999999999999",5,1,2,8,High-Value,Potential Loyalists
50183,895,1,"80,5",3,1,1,5,Low-Value,At Risk Customers
50184,895,1,"80,6",3,1,1,5,Low-Value,At Risk Customers
50185,210,7,"255,51",5,2,1,8,High-Value,Potential Loyalists
50186,1450,1,"54,55",2,1,1,4,Low-Value,Can't Lose
50187,227,3,"80,6",5,1,1,7,Mid-Value,Potential Loyalists
50188,18,5,"305,4",5,1,1,7,Mid-Value,Potential Loyalists
50189,428,2,"136,9",4,1,1,6,Mid-Value,Potential Loyalists
50190,469,9,"810,45",4,2,2,8,High-Value,Potential Loyalists
50192,3,4,"243,55",5,1,1,7,Mid-Value,Potential Loyalists
50193,57,4,"569,65",5,1,1,7,Mid-Value,Potential Loyalists
50194,351,2,"404,45",5,1,1,7,Mid-Value,Potential Loyalists
50195,1140,5,"271,45",2,1,1,4,Low-Value,Can't Lose
50196,124,1,"39,2",5,1,1,7,Mid-Value,Potential Loyalists
50199,122,3,"88,5",5,1,1,7,Mid-Value,Potential Loyalists
50200,1286,2,"55,849999999999994",2,1,1,4,Low-Value,Can't Lose
50202,220,3,"70,0",5,1,1,7,Mid-Value,Potential Loyalists
50204,158,4,"95,2",5,1,1,7,Mid-Value,Potential Loyalists
50206,682,1,"41,4",4,1,1,6,Mid-Value,Potential Loyalists
50207,219,3,"371,2",5,1,1,7,Mid-Value,Potential Loyalists
50208,85,6,"602,25",5,1,1,7,Mid-Value,Potential Loyalists
50210,20,3,"259,1",5,1,1,7,Mid-Value,Potential Loyalists
50211,197,3,"627,3",5,1,1,7,Mid-Value,Potential Loyalists
50212,260,10,"660,25",5,2,1,8,High-Value,Potential Loyalists
50214,323,1,"6,15",5,1,1,7,Mid-Value,Potential Loyalists
50215,8,4,"191,75",5,1,1,7,Mid-Value,Potential Loyalists
50216,819,4,"315,3",3,1,1,5,Low-Value,At Risk Customers
50219,1795,1,"21,15",1,1,1,3,Low-Value,Lost
50220,1552,1,"168,05",1,1,1,3,Low-Value,Lost
50222,522,1,"86,1",4,1,1,6,Mid-Value,Potential Loyalists
50223,430,8,"550,75",4,2,1,7,Mid-Value,Potential Loyalists
50225,83,4,"1071,25",5,1,2,8,High-Value,Potential Loyalists
50227,397,3,"69,55",4,1,1,6,Mid-Value,Potential Loyalists
50228,18,5,"187,29999999999998",5,1,1,7,Mid-Value,Potential Loyalists
50229,109,2,"60,25",5,1,1,7,Mid-Value,Potential Loyalists
50231,18,11,"418,0",5,2,1,8,High-Value,Potential Loyalists
50233,352,4,"248,95",5,1,1,7,Mid-Value,Potential Loyalists
50234,177,6,"292,55",5,1,1,7,Mid-Value,Potential Loyalists
50236,34,2,"70,2",5,1,1,7,Mid-Value,Potential Loyalists
50238,892,2,"82,95",3,1,1,5,Low-Value,At Risk Customers
50239,922,3,"283,75",3,1,1,5,Low-Value,At Risk Customers
50242,209,8,"440,85",5,2,1,8,High-Value,Potential Loyalists
50243,1481,1,"72,75",1,1,1,3,Low-Value,Lost
50244,434,1,"15,6",4,1,1,6,Mid-Value,Potential Loyalists
50246,588,2,"150,2",4,1,1,6,Mid-Value,Potential Loyalists
50248,76,4,"255,75",5,1,1,7,Mid-Value,Potential Loyalists
50250,321,3,"200,7",5,1,1,7,Mid-Value,Potential Loyalists
50251,1807,1,"109,9",1,1,1,3,Low-Value,Lost
50252,816,1,"9,85",3,1,1,5,Low-Value,At Risk Customers
50253,181,1,"169,4",5,1,1,7,Mid-Value,Potential Loyalists
50254,1807,1,"21,75",1,1,1,3,Low-Value,Lost
50256,115,4,"262,5",5,1,1,7,Mid-Value,Potential Loyalists
50257,22,3,"543,0",5,1,1,7,Mid-Value,Potential Loyalists
50260,866,2,"73,95",3,1,1,5,Low-Value,At Risk Customers
50262,134,8,"613,95",5,2,1,8,High-Value,Potential Loyalists
50263,175,1,"117,2",5,1,1,7,Mid-Value,Potential Loyalists
50265,1077,3,"124,95",3,1,1,5,Low-Value,At Risk Customers
50266,985,2,"133,7",3,1,1,5,Low-Value,At Risk Customers
50267,542,1,"237,6",4,1,1,6,Mid-Value,Potential Loyalists
50268,773,3,"560,7",3,1,1,5,Low-Value,At Risk Customers
50269,269,2,"38,2",5,1,1,7,Mid-Value,Potential Loyalists
50270,80,2,"100,5",5,1,1,7,Mid-Value,Potential Loyalists
50272,242,7,"183,05",5,2,1,8,High-Value,Potential Loyalists
50274,334,2,"111,1",5,1,1,7,Mid-Value,Potential Loyalists
50275,1074,1,"132,2",3,1,1,5,Low-Value,At Risk Customers
50276,1597,3,"269,6",1,1,1,3,Low-Value,Lost
50277,97,2,"68,0",5,1,1,7,Mid-Value,Potential Loyalists
50278,1027,2,"170,14999999999998",3,1,1,5,Low-Value,At Risk Customers
50279,78,3,"89,65",5,1,1,7,Mid-Value,Potential Loyalists
50280,18,12,"1205,5",5,3,2,10,High-Value,Champions
50281,379,4,"64,15",4,1,1,6,Mid-Value,Potential Loyalists
50282,853,2,"278,8",3,1,1,5,Low-Value,At Risk Customers
50286,496,1,"131,10000000000002",4,1,1,6,Mid-Value,Potential Loyalists
50288,849,2,"201,05",3,1,1,5,Low-Value,At Risk Customers
50290,304,1,"22,45",5,1,1,7,Mid-Value,Potential Loyalists
50291,1070,1,"6,2",3,1,1,5,Low-Value,At Risk Customers
50292,19,8,"530,6",5,2,1,8,High-Value,Potential Loyalists
50294,110,5,"342,3",5,1,1,7,Mid-Value,Potential Loyalists
50295,270,1,"40,45",5,1,1,7,Mid-Value,Potential Loyalists
50297,103,3,"141,45",5,1,1,7,Mid-Value,Potential Loyalists
50299,1210,3,"183,75",2,1,1,4,Low-Value,Can't Lose
50302,70,6,"139,65",5,1,1,7,Mid-Value,Potential Loyalists
50306,612,1,"20,75",4,1,1,6,Mid-Value,Potential Loyalists
50308,25,6,"436,95000000000005",5,1,1,7,Mid-Value,Potential Loyalists
50310,909,1,"21,3",3,1,1,5,Low-Value,At Risk Customers
50311,1369,1,"24,85",2,1,1,4,Low-Value,Can't Lose
50312,360,4,"327,45",5,1,1,7,Mid-Value,Potential Loyalists
50313,81,5,"335,8",5,1,1,7,Mid-Value,Potential Loyalists
50314,739,6,"791,75",3,1,2,6,Mid-Value,Potential Loyalists
50316,1088,2,"65,1",3,1,1,5,Low-Value,At Risk Customers
50317,237,9,"733,45",5,2,2,9,High-Value,Champions
50318,1004,4,"242,4",3,1,1,5,Low-Value,At Risk Customers
50319,436,2,"123,85",4,1,1,6,Mid-Value,Potential Loyalists
50321,854,3,"709,6500000000001",3,1,2,6,Mid-Value,Potential Loyalists
50322,389,2,"298,3",4,1,1,6,Mid-Value,Potential Loyalists
50323,164,6,"425,90000000000003",5,1,1,7,Mid-Value,Potential Loyalists
50324,176,3,"102,0",5,1,1,7,Mid-Value,Potential Loyalists
50325,611,3,"23,25",4,1,1,6,Mid-Value,Potential Loyalists
50327,149,3,"121,5",5,1,1,7,Mid-Value,Potential Loyalists
50328,1160,2,"41,75",2,1,1,4,Low-Value,Can't Lose
50330,810,4,"1106,3",3,1,2,6,Mid-Value,Potential Loyalists
50331,530,2,"47,0",4,1,1,6,Mid-Value,Potential Loyalists
50332,1294,1,"14,0",2,1,1,4,Low-Value,Can't Lose
50333,237,1,"21,15",5,1,1,7,Mid-Value,Potential Loyalists
50337,523,5,"354,65",4,1,1,6,Mid-Value,Potential Loyalists
50338,377,10,"514,15",4,2,1,7,Mid-Value,Potential Loyalists
50339,1362,1,"58,9",2,1,1,4,Low-Value,Can't Lose
50340,121,3,"92,95",5,1,1,7,Mid-Value,Potential Loyalists
50342,1649,1,"49,5",1,1,1,3,Low-Value,Lost
50344,418,4,"179,9",4,1,1,6,Mid-Value,Potential Loyalists
50345,1182,2,"88,25",2,1,1,4,Low-Value,Can't Lose
50347,1119,4,"225,3",2,1,1,4,Low-Value,Can't Lose
50349,233,1,"183,89999999999998",5,1,1,7,Mid-Value,Potential Loyalists
50351,1764,1,"55,0",1,1,1,3,Low-Value,Lost
50354,14,4,"183,15",5,1,1,7,Mid-Value,Potential Loyalists
50355,129,7,"250,20000000000002",5,2,1,8,High-Value,Potential Loyalists
50356,148,2,"92,99999999999999",5,1,1,7,Mid-Value,Potential Loyalists
50358,224,3,"239,6",5,1,1,7,Mid-Value,Potential Loyalists
50361,122,5,"189,45",5,1,1,7,Mid-Value,Potential Loyalists
50363,1551,2,"118,0",1,1,1,3,Low-Value,Lost
50364,1068,1,"12,1",3,1,1,5,Low-Value,At Risk Customers
50365,81,12,"1150,35",5,3,2,10,High-Value,Champions
50366,209,1,"9,65",5,1,1,7,Mid-Value,Potential Loyalists
50367,5,3,"225,85000000000002",5,1,1,7,Mid-Value,Potential Loyalists
50369,244,6,"2015,5500000000002",5,1,4,10,High-Value,Champions
50371,1018,2,"66,25",3,1,1,5,Low-Value,At Risk Customers
50376,542,2,"35,099999999999994",4,1,1,6,Mid-Value,Potential Loyalists
50377,18,3,"176,0",5,1,1,7,Mid-Value,Potential Loyalists
50379,743,4,"118,0",3,1,1,5,Low-Value,At Risk Customers
50380,111,1,"4,8",5,1,1,7,Mid-Value,Potential Loyalists
50381,115,4,"175,95",5,1,1,7,Mid-Value,Potential Loyalists
50382,567,8,"358,40000000000003",4,2,1,7,Mid-Value,Potential Loyalists
50383,453,3,"136,1",4,1,1,6,Mid-Value,Potential Loyalists
50385,131,1,"191,5",5,1,1,7,Mid-Value,Potential Loyalists
50386,42,8,"629,5",5,2,1,8,High-Value,Potential Loyalists
50387,1520,2,"126,89999999999999",1,1,1,3,Low-Value,Lost
50388,157,1,"38,7",5,1,1,7,Mid-Value,Potential Loyalists
50389,1326,2,"105,05000000000001",2,1,1,4,Low-Value,Can't Lose
50391,416,2,"157,4",4,1,1,6,Mid-Value,Potential Loyalists
50392,1291,1,"159,8",2,1,1,4,Low-Value,Can't Lose
50393,864,4,"321,29999999999995",3,1,1,5,Low-Value,At Risk Customers
50394,18,1,"8,2",5,1,1,7,Mid-Value,Potential Loyalists
50395,785,1,"52,8",3,1,1,5,Low-Value,At Risk Customers
50397,267,5,"296,5",5,1,1,7,Mid-Value,Potential Loyalists
50398,600,3,"324,55",4,1,1,6,Mid-Value,Potential Loyalists
50400,324,1,"18,85",5,1,1,7,Mid-Value,Potential Loyalists
50401,74,4,"338,65",5,1,1,7,Mid-Value,Potential Loyalists
50402,543,2,"159,5",4,1,1,6,Mid-Value,Potential Loyalists
50403,358,2,"75,3",5,1,1,7,Mid-Value,Potential Loyalists
50404,745,3,"96,05",3,1,1,5,Low-Value,At Risk Customers
50405,439,1,"23,45",4,1,1,6,Mid-Value,Potential Loyalists
50406,588,2,"75,55",4,1,1,6,Mid-Value,Potential Loyalists
50409,446,3,"200,65",4,1,1,6,Mid-Value,Potential Loyalists
50412,501,6,"793,7",4,1,2,7,Mid-Value,Potential Loyalists
50414,916,1,"35,4",3,1,1,5,Low-Value,At Risk Customers
50415,22,1,"13,6",5,1,1,7,Mid-Value,Potential Loyalists
50418,175,3,"168,79999999999998",5,1,1,7,Mid-Value,Potential Loyalists
50420,1344,1,"147,45",2,1,1,4,Low-Value,Can't Lose
50421,77,7,"413,85",5,2,1,8,High-Value,Potential Loyalists
50422,119,5,"145,75",5,1,1,7,Mid-Value,Potential Loyalists
50423,45,8,"500,95",5,2,1,8,High-Value,Potential Loyalists
50424,176,2,"61,050000000000004",5,1,1,7,Mid-Value,Potential Loyalists
50425,29,5,"527,25",5,1,1,7,Mid-Value,Potential Loyalists
50427,1366,1,"18,95",2,1,1,4,Low-Value,Can't Lose
50428,301,2,"51,1",5,1,1,7,Mid-Value,Potential Loyalists
50429,112,3,"455,44999999999993",5,1,1,7,Mid-Value,Potential Loyalists
50431,116,2,"87,95",5,1,1,7,Mid-Value,Potential Loyalists
50432,8,2,"224,4",5,1,1,7,Mid-Value,Potential Loyalists
50433,19,4,"295,1",5,1,1,7,Mid-Value,Potential Loyalists
50434,884,2,"171,9",3,1,1,5,Low-Value,At Risk Customers
50435,112,2,"94,3",5,1,1,7,Mid-Value,Potential Loyalists
50436,355,5,"223,4",5,1,1,7,Mid-Value,Potential Loyalists
50439,1057,1,"23,85",3,1,1,5,Low-Value,At Risk Customers
50440,366,4,"134,6",4,1,1,6,Mid-Value,Potential Loyalists
50441,439,2,"19,5",4,1,1,6,Mid-Value,Potential Loyalists
50442,106,3,"135,21",5,1,1,7,Mid-Value,Potential Loyalists
50443,354,2,"103,6",5,1,1,7,Mid-Value,Potential Loyalists
50444,1065,3,"200,14999999999998",3,1,1,5,Low-Value,At Risk Customers
50445,22,7,"352,55",5,2,1,8,High-Value,Potential Loyalists
50446,561,2,"196,35",4,1,1,6,Mid-Value,Potential Loyalists
50447,21,1,"154,8",5,1,1,7,Mid-Value,Potential Loyalists
50450,538,4,"106,5",4,1,1,6,Mid-Value,Potential Loyalists
50451,119,3,"281,5",5,1,1,7,Mid-Value,Potential Loyalists
50453,1198,1,"8,35",2,1,1,4,Low-Value,Can't Lose
50454,1047,2,"64,8",3,1,1,5,Low-Value,At Risk Customers
50455,1294,1,"46,6",2,1,1,4,Low-Value,Can't Lose
50456,1479,1,"74,6",1,1,1,3,Low-Value,Lost
50458,746,1,"99,5",3,1,1,5,Low-Value,At Risk Customers
50459,819,1,"3,15",3,1,1,5,Low-Value,At Risk Customers
50460,751,2,"402,8",3,1,1,5,Low-Value,At Risk Customers
50462,1629,6,"367,6",1,1,1,3,Low-Value,Lost
50463,372,3,"358,85",4,1,1,6,Mid-Value,Potential Loyalists
50464,652,1,"172,2",4,1,1,6,Mid-Value,Potential Loyalists
50466,754,4,"273,85",3,1,1,5,Low-Value,At Risk Customers
50467,281,1,"28,9",5,1,1,7,Mid-Value,Potential Loyalists
50468,146,2,"35,75",5,1,1,7,Mid-Value,Potential Loyalists
50473,393,1,"109,2",4,1,1,6,Mid-Value,Potential Loyalists
50476,727,3,"121,6",4,1,1,6,Mid-Value,Potential Loyalists
50478,1267,2,"72,45",2,1,1,4,Low-Value,Can't Lose
50479,17,3,"446,1",5,1,1,7,Mid-Value,Potential Loyalists
50480,806,1,"5,1",3,1,1,5,Low-Value,At Risk Customers
50481,29,4,"275,2",5,1,1,7,Mid-Value,Potential Loyalists
50482,139,4,"361,7",5,1,1,7,Mid-Value,Potential Loyalists
50483,514,7,"438,55",4,2,1,7,Mid-Value,Potential Loyalists
50484,3,4,"370,6",5,1,1,7,Mid-Value,Potential Loyalists
50485,889,3,"95,8",3,1,1,5,Low-Value,At Risk Customers
50486,703,2,"216,0",4,1,1,6,Mid-Value,Potential Loyalists
50488,22,6,"380,34999999999997",5,1,1,7,Mid-Value,Potential Loyalists
50489,190,7,"632,5",5,2,1,8,High-Value,Potential Loyalists
50490,372,7,"748,5",4,2,2,8,High-Value,Potential Loyalists
50492,363,5,"1160,05",5,1,2,8,High-Value,Potential Loyalists
50493,211,5,"220,1",5,1,1,7,Mid-Value,Potential Loyalists
50495,474,5,"322,15",4,1,1,6,Mid-Value,Potential Loyalists
50497,881,2,"128,75",3,1,1,5,Low-Value,At Risk Customers
50498,806,1,"57,05",3,1,1,5,Low-Value,At Risk Customers
50499,1060,2,"81,69999999999999",3,1,1,5,Low-Value,At Risk Customers
50500,787,4,"71,7",3,1,1,5,Low-Value,At Risk Customers
50501,951,2,"86,85",3,1,1,5,Low-Value,At Risk Customers
50504,101,7,"135,4",5,2,1,8,High-Value,Potential Loyalists
50505,1673,1,"93,8",1,1,1,3,Low-Value,Lost
50509,1622,1,"20,6",1,1,1,3,Low-Value,Lost
50510,928,3,"649,9000000000001",3,1,1,5,Low-Value,At Risk Customers
50511,361,4,"113,2",5,1,1,7,Mid-Value,Potential Loyalists
50512,98,4,"261,20000000000005",5,1,1,7,Mid-Value,Potential Loyalists
50513,171,6,"271,25",5,1,1,7,Mid-Value,Potential Loyalists
50518,367,1,"16,6",4,1,1,6,Mid-Value,Potential Loyalists
50519,196,5,"160,05",5,1,1,7,Mid-Value,Potential Loyalists
50521,1599,1,"47,7",1,1,1,3,Low-Value,Lost
50522,301,1,"33,4",5,1,1,7,Mid-Value,Potential Loyalists
50523,369,1,"400,6",4,1,1,6,Mid-Value,Potential Loyalists
50525,743,2,"257,5",3,1,1,5,Low-Value,At Risk Customers
50526,820,3,"144,8",3,1,1,5,Low-Value,At Risk Customers
50527,1110,6,"298,6",2,1,1,4,Low-Value,Can't Lose
50530,8,3,"69,2",5,1,1,7,Mid-Value,Potential Loyalists
50531,609,4,"302,09999999999997",4,1,1,6,Mid-Value,Potential Loyalists
50533,1464,2,"54,550000000000004",1,1,1,3,Low-Value,Lost
50534,403,4,"437,20000000000005",4,1,1,6,Mid-Value,Potential Loyalists
50536,781,1,"15,9",3,1,1,5,Low-Value,At Risk Customers
50537,738,5,"682,35",3,1,2,6,Mid-Value,Potential Loyalists
50541,1247,2,"103,04999999999998",2,1,1,4,Low-Value,Can't Lose
50542,1770,1,"21,9",1,1,1,3,Low-Value,Lost
50543,792,2,"91,65",3,1,1,5,Low-Value,At Risk Customers
50544,444,5,"487,1",4,1,1,6,Mid-Value,Potential Loyalists
50546,712,1,"12,65",4,1,1,6,Mid-Value,Potential Loyalists
50547,973,1,"242,6",3,1,1,5,Low-Value,At Risk Customers
50548,1447,3,"338,9",2,1,1,4,Low-Value,Can't Lose
50550,571,4,"460,5",4,1,1,6,Mid-Value,Potential Loyalists
50552,420,6,"303,25",4,1,1,6,Mid-Value,Potential Loyalists
50553,80,8,"323,6",5,2,1,8,High-Value,Potential Loyalists
50554,1547,4,"123,1",1,1,1,3,Low-Value,Lost
50555,877,4,"116,3",3,1,1,5,Low-Value,At Risk Customers
50557,338,3,"174,54999999999998",5,1,1,7,Mid-Value,Potential Loyalists
50558,133,1,"22,4",5,1,1,7,Mid-Value,Potential Loyalists
50559,475,1,"38,8",4,1,1,6,Mid-Value,Potential Loyalists
50560,966,1,"62,8",3,1,1,5,Low-Value,At Risk Customers
50562,675,4,"358,3",4,1,1,6,Mid-Value,Potential Loyalists
50564,676,4,"363,4",4,1,1,6,Mid-Value,Potential Loyalists
50565,1271,4,"168,25",2,1,1,4,Low-Value,Can't Lose
50566,54,6,"354,95000000000005",5,1,1,7,Mid-Value,Potential Loyalists
50567,740,14,"847,2",3,3,2,8,High-Value,Potential Loyalists
50569,199,8,"846,5",5,2,2,9,High-Value,Champions
50571,239,3,"226,75",5,1,1,7,Mid-Value,Potential Loyalists
50572,150,3,"103,5",5,1,1,7,Mid-Value,Potential Loyalists
50574,1011,1,"11,95",3,1,1,5,Low-Value,At Risk Customers
50577,1075,2,"26,700000000000003",3,1,1,5,Low-Value,At Risk Customers
50578,481,1,"1,35",4,1,1,6,Mid-Value,Potential Loyalists
50579,1370,2,"12,7",2,1,1,4,Low-Value,Can't Lose
50581,24,3,"405,85",5,1,1,7,Mid-Value,Potential Loyalists
50582,605,2,"17,349999999999998",4,1,1,6,Mid-Value,Potential Loyalists
50583,54,3,"138,0",5,1,1,7,Mid-Value,Potential Loyalists
50584,189,1,"169,4",5,1,1,7,Mid-Value,Potential Loyalists
50586,885,1,"41,8",3,1,1,5,Low-Value,At Risk Customers
50589,133,4,"205,35",5,1,1,7,Mid-Value,Potential Loyalists
50590,239,4,"316,3",5,1,1,7,Mid-Value,Potential Loyalists
50591,1371,2,"61,800000000000004",2,1,1,4,Low-Value,Can't Lose
50592,1294,1,"12,75",2,1,1,4,Low-Value,Can't Lose
50594,173,2,"74,1",5,1,1,7,Mid-Value,Potential Loyalists
50595,1618,1,"66,0",1,1,1,3,Low-Value,Lost
50596,109,4,"122,80000000000001",5,1,1,7,Mid-Value,Potential Loyalists
50597,103,5,"286,25",5,1,1,7,Mid-Value,Potential Loyalists
50598,144,3,"51,400000000000006",5,1,1,7,Mid-Value,Potential Loyalists
50601,613,4,"459,5",4,1,1,6,Mid-Value,Potential Loyalists
50602,428,5,"437,4",4,1,1,6,Mid-Value,Potential Loyalists
50604,1522,1,"41,0",1,1,1,3,Low-Value,Lost
50606,370,7,"219,95",4,2,1,7,Mid-Value,Potential Loyalists
50607,781,2,"245,75",3,1,1,5,Low-Value,At Risk Customers
50608,560,3,"224,75",4,1,1,6,Mid-Value,Potential Loyalists
50610,589,3,"280,35",4,1,1,6,Mid-Value,Potential Loyalists
50611,144,2,"129,3",5,1,1,7,Mid-Value,Potential Loyalists
50612,901,2,"98,05000000000001",3,1,1,5,Low-Value,At Risk Customers
50613,169,2,"74,45",5,1,1,7,Mid-Value,Potential Loyalists
50614,260,3,"174,65",5,1,1,7,Mid-Value,Potential Loyalists
50616,123,3,"124,5",5,1,1,7,Mid-Value,Potential Loyalists
50617,330,4,"137,3",5,1,1,7,Mid-Value,Potential Loyalists
50618,866,3,"177,05",3,1,1,5,Low-Value,At Risk Customers
50619,31,1,"20,75",5,1,1,7,Mid-Value,Potential Loyalists
50622,495,2,"179,3",4,1,1,6,Mid-Value,Potential Loyalists
50623,64,3,"165,05",5,1,1,7,Mid-Value,Potential Loyalists
50626,715,1,"37,8",4,1,1,6,Mid-Value,Potential Loyalists
50629,74,5,"222,15000000000003",5,1,1,7,Mid-Value,Potential Loyalists
50630,48,4,"210,1",5,1,1,7,Mid-Value,Potential Loyalists
50631,1117,7,"383,8",2,2,1,5,Low-Value,At Risk Customers
50634,820,9,"426,76",3,2,1,6,Mid-Value,Potential Loyalists
50635,12,7,"780,55",5,2,2,9,High-Value,Champions
50637,1236,2,"151,05",2,1,1,4,Low-Value,Can't Lose
50638,1024,1,"46,25",3,1,1,5,Low-Value,At Risk Customers
50639,193,1,"91,6",5,1,1,7,Mid-Value,Potential Loyalists
50640,98,3,"47,45",5,1,1,7,Mid-Value,Potential Loyalists
50642,1248,2,"64,65",2,1,1,4,Low-Value,Can't Lose
50643,1282,1,"22,7",2,1,1,4,Low-Value,Can't Lose
50648,269,4,"230,45000000000002",5,1,1,7,Mid-Value,Potential Loyalists
50649,207,2,"88,7",5,1,1,7,Mid-Value,Potential Loyalists
50651,1305,2,"299,15",2,1,1,4,Low-Value,Can't Lose
50652,20,2,"95,89999999999999",5,1,1,7,Mid-Value,Potential Loyalists
50653,127,5,"288,95000000000005",5,1,1,7,Mid-Value,Potential Loyalists
50655,19,2,"148,4",5,1,1,7,Mid-Value,Potential Loyalists
50657,1306,1,"50,8",2,1,1,4,Low-Value,Can't Lose
50659,1754,1,"52,25",1,1,1,3,Low-Value,Lost
50661,255,3,"153,75",5,1,1,7,Mid-Value,Potential Loyalists
50662,157,3,"38,05",5,1,1,7,Mid-Value,Potential Loyalists
50664,396,6,"247,4",4,1,1,6,Mid-Value,Potential Loyalists
50666,73,5,"405,7",5,1,1,7,Mid-Value,Potential Loyalists
50669,124,3,"157,75",5,1,1,7,Mid-Value,Potential Loyalists
50672,523,2,"205,1",4,1,1,6,Mid-Value,Potential Loyalists
50674,122,10,"927,1",5,2,2,9,High-Value,Champions
50676,526,5,"172,4",4,1,1,6,Mid-Value,Potential Loyalists
50679,265,1,"9,7",5,1,1,7,Mid-Value,Potential Loyalists
50681,559,2,"238,79999999999998",4,1,1,6,Mid-Value,Potential Loyalists
50682,1491,1,"64,25",1,1,1,3,Low-Value,Lost
50683,556,1,"8,65",4,1,1,6,Mid-Value,Potential Loyalists
50684,18,4,"486,9",5,1,1,7,Mid-Value,Potential Loyalists
50685,207,2,"32,15",5,1,1,7,Mid-Value,Potential Loyalists
50688,400,3,"122,75",4,1,1,6,Mid-Value,Potential Loyalists
50689,152,3,"104,25",5,1,1,7,Mid-Value,Potential Loyalists
50691,879,1,"251,7",3,1,1,5,Low-Value,At Risk Customers
50692,185,4,"630,6",5,1,1,7,Mid-Value,Potential Loyalists
50693,101,4,"160,1",5,1,1,7,Mid-Value,Potential Loyalists
50694,47,2,"90,1",5,1,1,7,Mid-Value,Potential Loyalists
50695,106,2,"142,10000000000002",5,1,1,7,Mid-Value,Potential Loyalists
50696,700,1,"2,55",4,1,1,6,Mid-Value,Potential Loyalists
50699,532,3,"233,45000000000005",4,1,1,6,Mid-Value,Potential Loyalists
50700,422,1,"86,05",4,1,1,6,Mid-Value,Potential Loyalists
50701,241,2,"38,4",5,1,1,7,Mid-Value,Potential Loyalists
50703,1324,1,"2,25",2,1,1,4,Low-Value,Can't Lose
50706,388,1,"6,75",4,1,1,6,Mid-Value,Potential Loyalists
50708,104,2,"149,85",5,1,1,7,Mid-Value,Potential Loyalists
50709,954,2,"118,05",3,1,1,5,Low-Value,At Risk Customers
50710,155,1,"579,9",5,1,1,7,Mid-Value,Potential Loyalists
50711,28,7,"834,85",5,2,2,9,High-Value,Champions
50715,903,2,"51,8",3,1,1,5,Low-Value,At Risk Customers
50716,153,8,"1261,95",5,2,2,9,High-Value,Champions
50719,1258,1,"56,7",2,1,1,4,Low-Value,Can't Lose
50720,418,5,"259,65",4,1,1,6,Mid-Value,Potential Loyalists
50721,85,1,"38,4",5,1,1,7,Mid-Value,Potential Loyalists
50722,405,2,"67,3",4,1,1,6,Mid-Value,Potential Loyalists
50723,1,4,"204,5",5,1,1,7,Mid-Value,Potential Loyalists
50724,464,3,"220,49999999999997",4,1,1,6,Mid-Value,Potential Loyalists
50725,34,2,"137,0",5,1,1,7,Mid-Value,Potential Loyalists
50727,327,2,"24,25",5,1,1,7,Mid-Value,Potential Loyalists
50729,1009,1,"23,95",3,1,1,5,Low-Value,At Risk Customers
50730,108,3,"140,75",5,1,1,7,Mid-Value,Potential Loyalists
50731,208,2,"115,5",5,1,1,7,Mid-Value,Potential Loyalists
50732,783,2,"201,95",3,1,1,5,Low-Value,At Risk Customers
50733,1036,2,"538,6",3,1,1,5,Low-Value,At Risk Customers
50734,1305,1,"29,6",2,1,1,4,Low-Value,Can't Lose
50735,110,6,"686,5",5,1,2,8,High-Value,Potential Loyalists
50736,75,8,"265,05",5,2,1,8,High-Value,Potential Loyalists
50737,944,1,"58,0",3,1,1,5,Low-Value,At Risk Customers
50738,3,1,"36,3",5,1,1,7,Mid-Value,Potential Loyalists
50739,438,12,"697,3",4,3,2,9,High-Value,Champions
50740,89,7,"582,3",5,2,1,8,High-Value,Potential Loyalists
50741,161,4,"1022,35",5,1,2,8,High-Value,Potential Loyalists
50742,458,2,"204,85000000000002",4,1,1,6,Mid-Value,Potential Loyalists
50743,29,2,"102,14999999999999",5,1,1,7,Mid-Value,Potential Loyalists
50744,59,8,"329,3",5,2,1,8,High-Value,Potential Loyalists
50746,690,6,"512,9499999999999",4,1,1,6,Mid-Value,Potential Loyalists
50750,158,3,"109,35",5,1,1,7,Mid-Value,Potential Loyalists
50752,1504,1,"6,75",1,1,1,3,Low-Value,Lost
50753,16,3,"305,40000000000003",5,1,1,7,Mid-Value,Potential Loyalists
50755,743,2,"111,19999999999999",3,1,1,5,Low-Value,At Risk Customers
50756,1462,1,"68,6",1,1,1,3,Low-Value,Lost
50758,179,12,"1008,0999999999999",5,3,2,10,High-Value,Champions
50759,579,3,"148,3",4,1,1,6,Mid-Value,Potential Loyalists
50760,221,1,"54,0",5,1,1,7,Mid-Value,Potential Loyalists
50761,386,2,"187,25",4,1,1,6,Mid-Value,Potential Loyalists
50762,159,6,"631,35",5,1,1,7,Mid-Value,Potential Loyalists
50763,72,2,"75,2",5,1,1,7,Mid-Value,Potential Loyalists
50765,31,7,"553,1",5,2,1,8,High-Value,Potential Loyalists
50768,1133,1,"12,7",2,1,1,4,Low-Value,Can't Lose
50769,1651,1,"1,2",1,1,1,3,Low-Value,Lost
50770,846,1,"22,15",3,1,1,5,Low-Value,At Risk Customers
50771,350,1,"14,6",5,1,1,7,Mid-Value,Potential Loyalists
50772,206,2,"450,65",5,1,1,7,Mid-Value,Potential Loyalists
50773,791,1,"98,9",3,1,1,5,Low-Value,At Risk Customers
50774,776,2,"20,05",3,1,1,5,Low-Value,At Risk Customers
50775,553,7,"298,3",4,2,1,7,Mid-Value,Potential Loyalists
50776,211,5,"244,9",5,1,1,7,Mid-Value,Potential Loyalists
50777,236,3,"294,6",5,1,1,7,Mid-Value,Potential Loyalists
50778,295,2,"100,6",5,1,1,7,Mid-Value,Potential Loyalists
50782,778,1,"45,0",3,1,1,5,Low-Value,At Risk Customers
50783,416,11,"717,85",4,2,2,8,High-Value,Potential Loyalists
50784,298,2,"118,0",5,1,1,7,Mid-Value,Potential Loyalists
50785,1179,2,"88,45",2,1,1,4,Low-Value,Can't Lose
50786,844,2,"36,3",3,1,1,5,Low-Value,At Risk Customers
50788,171,4,"704,95",5,1,2,8,High-Value,Potential Loyalists
50792,266,7,"648,05",5,2,1,8,High-Value,Potential Loyalists
50793,148,17,"1024,5",5,4,2,11,High-Value,Champions
50794,222,2,"96,64999999999999",5,1,1,7,Mid-Value,Potential Loyalists
50795,1526,2,"65,55",1,1,1,3,Low-Value,Lost
50798,1322,1,"7,5",2,1,1,4,Low-Value,Can't Lose
50802,33,4,"339,2",5,1,1,7,Mid-Value,Potential Loyalists
50804,166,5,"206,8",5,1,1,7,Mid-Value,Potential Loyalists
50805,479,3,"370,59999999999997",4,1,1,6,Mid-Value,Potential Loyalists
50806,11,7,"511,0",5,2,1,8,High-Value,Potential Loyalists
50807,1326,4,"222,89999999999998",2,1,1,4,Low-Value,Can't Lose
50808,201,10,"388,1",5,2,1,8,High-Value,Potential Loyalists
50809,77,2,"114,55000000000001",5,1,1,7,Mid-Value,Potential Loyalists
50810,530,2,"181,55",4,1,1,6,Mid-Value,Potential Loyalists
50813,97,3,"71,8",5,1,1,7,Mid-Value,Potential Loyalists
50815,73,2,"219,25",5,1,1,7,Mid-Value,Potential Loyalists
50816,47,10,"363,9",5,2,1,8,High-Value,Potential Loyalists
50819,626,3,"121,14999999999999",4,1,1,6,Mid-Value,Potential Loyalists
50820,418,1,"77,8",4,1,1,6,Mid-Value,Potential Loyalists
50821,31,4,"361,45",5,1,1,7,Mid-Value,Potential Loyalists
50823,1173,1,"16,15",2,1,1,4,Low-Value,Can't Lose
50825,117,7,"577,75",5,2,1,8,High-Value,Potential Loyalists
50826,20,1,"43,0",5,1,1,7,Mid-Value,Potential Loyalists
50827,305,3,"243,3",5,1,1,7,Mid-Value,Potential Loyalists
50828,509,5,"232,55",4,1,1,6,Mid-Value,Potential Loyalists
50829,3,2,"162,0",5,1,1,7,Mid-Value,Potential Loyalists
50832,913,7,"325,1",3,2,1,6,Mid-Value,Potential Loyalists
50833,48,12,"607,25",5,3,1,9,High-Value,Champions
50834,1197,2,"164,5",2,1,1,4,Low-Value,Can't Lose
50835,800,1,"15,4",3,1,1,5,Low-Value,At Risk Customers
50836,4,1,"75,1",5,1,1,7,Mid-Value,Potential Loyalists
50838,164,4,"348,70000000000005",5,1,1,7,Mid-Value,Potential Loyalists
50839,473,11,"281,5",4,2,1,7,Mid-Value,Potential Loyalists
50842,27,2,"95,80000000000001",5,1,1,7,Mid-Value,Potential Loyalists
50845,86,5,"369,95",5,1,1,7,Mid-Value,Potential Loyalists
50846,854,2,"730,6999999999999",3,1,2,6,Mid-Value,Potential Loyalists
50847,172,1,"16,6",5,1,1,7,Mid-Value,Potential Loyalists
50851,124,2,"52,8",5,1,1,7,Mid-Value,Potential Loyalists
50854,407,7,"255,79999999999998",4,2,1,7,Mid-Value,Potential Loyalists
50859,514,8,"435,3",4,2,1,7,Mid-Value,Potential Loyalists
50860,1281,1,"184,0",2,1,1,4,Low-Value,Can't Lose
50861,1346,1,"76,3",2,1,1,4,Low-Value,Can't Lose
50863,769,1,"476,5",3,1,1,5,Low-Value,At Risk Customers
50864,74,3,"145,05",5,1,1,7,Mid-Value,Potential Loyalists
50865,841,3,"112,95",3,1,1,5,Low-Value,At Risk Customers
50868,136,5,"194,0",5,1,1,7,Mid-Value,Potential Loyalists
50872,1747,1,"34,5",1,1,1,3,Low-Value,Lost
50873,464,4,"239,45",4,1,1,6,Mid-Value,Potential Loyalists
50876,77,2,"127,50000000000001",5,1,1,7,Mid-Value,Potential Loyalists
50877,1110,1,"597,1500000000001",2,1,1,4,Low-Value,Can't Lose
50878,90,2,"55,65",5,1,1,7,Mid-Value,Potential Loyalists
50880,49,5,"303,2",5,1,1,7,Mid-Value,Potential Loyalists
50881,113,2,"48,75",5,1,1,7,Mid-Value,Potential Loyalists
50883,1140,3,"226,65",2,1,1,4,Low-Value,Can't Lose
50884,849,4,"121,45",3,1,1,5,Low-Value,At Risk Customers
50886,472,7,"461,09999999999997",4,2,1,7,Mid-Value,Potential Loyalists
50887,8,1,"17,1",5,1,1,7,Mid-Value,Potential Loyalists
50888,48,7,"408,15",5,2,1,8,High-Value,Potential Loyalists
50889,201,3,"130,35000000000002",5,1,1,7,Mid-Value,Potential Loyalists
50891,79,1,"20,7",5,1,1,7,Mid-Value,Potential Loyalists
50892,69,6,"498,59999999999997",5,1,1,7,Mid-Value,Potential Loyalists
50893,754,2,"131,8",3,1,1,5,Low-Value,At Risk Customers
50894,1327,2,"505,8",2,1,1,4,Low-Value,Can't Lose
50895,1271,2,"286,65",2,1,1,4,Low-Value,Can't Lose
50896,979,2,"188,1",3,1,1,5,Low-Value,At Risk Customers
50898,34,3,"364,8",5,1,1,7,Mid-Value,Potential Loyalists
50899,1334,1,"31,2",2,1,1,4,Low-Value,Can't Lose
50900,20,4,"505,54999999999995",5,1,1,7,Mid-Value,Potential Loyalists
50901,1056,5,"195,2",3,1,1,5,Low-Value,At Risk Customers
50902,1803,2,"57,849999999999994",1,1,1,3,Low-Value,Lost
50903,760,5,"269,95",3,1,1,5,Low-Value,At Risk Customers
50905,431,5,"505,34999999999997",4,1,1,6,Mid-Value,Potential Loyalists
50906,333,4,"155,75",5,1,1,7,Mid-Value,Potential Loyalists
50907,678,6,"98,19999999999999",4,1,1,6,Mid-Value,Potential Loyalists
50908,840,5,"159,95",3,1,1,5,Low-Value,At Risk Customers
50909,31,5,"261,65",5,1,1,7,Mid-Value,Potential Loyalists
50910,369,2,"172,5",4,1,1,6,Mid-Value,Potential Loyalists
50913,94,13,"737,25",5,3,2,10,High-Value,Champions
50914,1751,1,"45,4",1,1,1,3,Low-Value,Lost
50915,906,1,"20,3",3,1,1,5,Low-Value,At Risk Customers
50916,31,12,"433,6",5,3,1,9,High-Value,Champions
50917,451,4,"216,6",4,1,1,6,Mid-Value,Potential Loyalists
50919,809,1,"59,05",3,1,1,5,Low-Value,At Risk Customers
50923,2,2,"49,099999999999994",5,1,1,7,Mid-Value,Potential Loyalists
50924,109,4,"526,45",5,1,1,7,Mid-Value,Potential Loyalists
50926,147,2,"233,75",5,1,1,7,Mid-Value,Potential Loyalists
50927,995,2,"63,1",3,1,1,5,Low-Value,At Risk Customers
50928,104,3,"188,7",5,1,1,7,Mid-Value,Potential Loyalists
50930,106,7,"353,9",5,2,1,8,High-Value,Potential Loyalists
50931,161,2,"146,39999999999998",5,1,1,7,Mid-Value,Potential Loyalists
50935,610,1,"15,15",4,1,1,6,Mid-Value,Potential Loyalists
50936,59,3,"610,9",5,1,1,7,Mid-Value,Potential Loyalists
50937,1407,1,"10,75",2,1,1,4,Low-Value,Can't Lose
50939,945,3,"83,2",3,1,1,5,Low-Value,At Risk Customers
50940,122,4,"277,6",5,1,1,7,Mid-Value,Potential Loyalists
50941,122,3,"227,7",5,1,1,7,Mid-Value,Potential Loyalists
50942,1,3,"667,4",5,1,2,8,High-Value,Potential Loyalists
50946,324,2,"56,95",5,1,1,7,Mid-Value,Potential Loyalists
50947,6,11,"550,35",5,2,1,8,High-Value,Potential Loyalists
50948,147,3,"64,8",5,1,1,7,Mid-Value,Potential Loyalists
50950,258,3,"34,15",5,1,1,7,Mid-Value,Potential Loyalists
50951,47,4,"331,35",5,1,1,7,Mid-Value,Potential Loyalists
50953,551,1,"12,9",4,1,1,6,Mid-Value,Potential Loyalists
50954,1084,3,"206,4",3,1,1,5,Low-Value,At Risk Customers
50956,949,4,"835,1",3,1,2,6,Mid-Value,Potential Loyalists
50957,1043,1,"200,4",3,1,1,5,Low-Value,At Risk Customers
50958,996,4,"179,0",3,1,1,5,Low-Value,At Risk Customers
50962,756,1,"89,0",3,1,1,5,Low-Value,At Risk Customers
50964,838,4,"164,45000000000002",3,1,1,5,Low-Value,At Risk Customers
50966,1361,3,"77,65",2,1,1,4,Low-Value,Can't Lose
50967,679,3,"108,65",4,1,1,6,Mid-Value,Potential Loyalists
50971,39,1,"175,2",5,1,1,7,Mid-Value,Potential Loyalists
50972,744,2,"274,65",3,1,1,5,Low-Value,At Risk Customers
50973,868,3,"369,84999999999997",3,1,1,5,Low-Value,At Risk Customers
50976,27,2,"79,30000000000001",5,1,1,7,Mid-Value,Potential Loyalists
50977,1317,1,"13,9",2,1,1,4,Low-Value,Can't Lose
50978,1171,1,"34,1",2,1,1,4,Low-Value,Can't Lose
50980,572,2,"254,55",4,1,1,6,Mid-Value,Potential Loyalists
50983,488,3,"208,8",4,1,1,6,Mid-Value,Potential Loyalists
50984,486,1,"38,4",4,1,1,6,Mid-Value,Potential Loyalists
50985,768,1,"97,05",3,1,1,5,Low-Value,At Risk Customers
50987,234,2,"92,5",5,1,1,7,Mid-Value,Potential Loyalists
50989,650,1,"22,5",4,1,1,6,Mid-Value,Potential Loyalists
50991,984,2,"71,35",3,1,1,5,Low-Value,At Risk Customers
50993,1470,2,"38,5",1,1,1,3,Low-Value,Lost
50995,653,1,"11,8",4,1,1,6,Mid-Value,Potential Loyalists
50998,139,3,"158,3",5,1,1,7,Mid-Value,Potential Loyalists
51003,901,1,"143,9",3,1,1,5,Low-Value,At Risk Customers
51004,871,1,"226,5",3,1,1,5,Low-Value,At Risk Customers
51006,1563,1,"51,0",1,1,1,3,Low-Value,Lost
51007,1004,1,"41,0",3,1,1,5,Low-Value,At Risk Customers
51008,882,2,"18,1",3,1,1,5,Low-Value,At Risk Customers
51009,164,2,"102,6",5,1,1,7,Mid-Value,Potential Loyalists
51011,1148,4,"405,1",2,1,1,4,Low-Value,Can't Lose
51014,1199,3,"132,95",2,1,1,4,Low-Value,Can't Lose
51015,765,1,"17,65",3,1,1,5,Low-Value,At Risk Customers
51016,566,3,"309,7",4,1,1,6,Mid-Value,Potential Loyalists
51017,225,2,"72,7",5,1,1,7,Mid-Value,Potential Loyalists
51018,28,3,"269,95",5,1,1,7,Mid-Value,Potential Loyalists
51019,731,4,"429,3",3,1,1,5,Low-Value,At Risk Customers
51020,145,4,"110,81",5,1,1,7,Mid-Value,Potential Loyalists
51021,578,4,"299,4",4,1,1,6,Mid-Value,Potential Loyalists
51022,299,1,"38,4",5,1,1,7,Mid-Value,Potential Loyalists
51023,46,21,"1797,45",5,4,3,12,High-Value,Champions
51025,434,6,"317,84999999999997",4,1,1,6,Mid-Value,Potential Loyalists
51026,1240,2,"83,2",2,1,1,4,Low-Value,Can't Lose
51027,419,1,"10,95",4,1,1,6,Mid-Value,Potential Loyalists
51028,638,4,"47,2",4,1,1,6,Mid-Value,Potential Loyalists
51031,626,2,"65,75",4,1,1,6,Mid-Value,Potential Loyalists
51033,777,3,"272,05",3,1,1,5,Low-Value,At Risk Customers
51036,38,4,"243,14999999999998",5,1,1,7,Mid-Value,Potential Loyalists
51039,937,2,"56,3",3,1,1,5,Low-Value,At Risk Customers
51040,1627,1,"5,5",1,1,1,3,Low-Value,Lost
51041,409,5,"298,8",4,1,1,6,Mid-Value,Potential Loyalists
51042,386,2,"47,8",4,1,1,6,Mid-Value,Potential Loyalists
51043,617,1,"36,65",4,1,1,6,Mid-Value,Potential Loyalists
51044,140,9,"774,8000000000001",5,2,2,9,High-Value,Champions
51047,592,4,"113,55",4,1,1,6,Mid-Value,Potential Loyalists
51049,755,1,"15,5",3,1,1,5,Low-Value,At Risk Customers
51050,1292,1,"32,4",2,1,1,4,Low-Value,Can't Lose
51052,815,1,"8,05",3,1,1,5,Low-Value,At Risk Customers
51053,389,2,"17,15",4,1,1,6,Mid-Value,Potential Loyalists
51057,147,5,"335,45",5,1,1,7,Mid-Value,Potential Loyalists
51058,1155,4,"165,75",2,1,1,4,Low-Value,Can't Lose
51062,377,3,"364,75",4,1,1,6,Mid-Value,Potential Loyalists
51065,148,10,"604,5",5,2,1,8,High-Value,Potential Loyalists
51066,850,1,"0,8",3,1,1,5,Low-Value,At Risk Customers
51067,1196,2,"17,3",2,1,1,4,Low-Value,Can't Lose
51068,1678,1,"16,55",1,1,1,3,Low-Value,Lost
51070,55,5,"198,14999999999998",5,1,1,7,Mid-Value,Potential Loyalists
51071,411,2,"184,4",4,1,1,6,Mid-Value,Potential Loyalists
51074,570,5,"436,4",4,1,1,6,Mid-Value,Potential Loyalists
51075,739,3,"183,15",3,1,1,5,Low-Value,At Risk Customers
51076,134,3,"165,25",5,1,1,7,Mid-Value,Potential Loyalists
51077,1596,2,"81,15",1,1,1,3,Low-Value,Lost
51079,1256,1,"187,05",2,1,1,4,Low-Value,Can't Lose
51081,1548,1,"29,6",1,1,1,3,Low-Value,Lost
51082,418,2,"99,44999999999999",4,1,1,6,Mid-Value,Potential Loyalists
51083,721,3,"379,1",4,1,1,6,Mid-Value,Potential Loyalists
51084,431,4,"292,84999999999997",4,1,1,6,Mid-Value,Potential Loyalists
51086,266,7,"255,5",5,2,1,8,High-Value,Potential Loyalists
51087,291,3,"41,6",5,1,1,7,Mid-Value,Potential Loyalists
51089,9,6,"467,85",5,1,1,7,Mid-Value,Potential Loyalists
51093,1536,1,"111,0",1,1,1,3,Low-Value,Lost
51097,87,5,"368,3",5,1,1,7,Mid-Value,Potential Loyalists
51099,336,3,"222,10000000000002",5,1,1,7,Mid-Value,Potential Loyalists
51100,837,2,"49,7",3,1,1,5,Low-Value,At Risk Customers
51101,731,5,"492,1",3,1,1,5,Low-Value,At Risk Customers
51103,529,3,"295,90000000000003",4,1,1,6,Mid-Value,Potential Loyalists
51104,409,2,"197,35",4,1,1,6,Mid-Value,Potential Loyalists
51105,975,1,"28,9",3,1,1,5,Low-Value,At Risk Customers
51106,263,1,"6,4",5,1,1,7,Mid-Value,Potential Loyalists
51107,1,14,"1194,25",5,3,2,10,High-Value,Champions
51108,804,3,"579,3499999999999",3,1,1,5,Low-Value,At Risk Customers
51111,103,3,"72,4",5,1,1,7,Mid-Value,Potential Loyalists
51112,791,1,"56,35",3,1,1,5,Low-Value,At Risk Customers
51115,139,1,"9,9",5,1,1,7,Mid-Value,Potential Loyalists
51117,4,7,"424,90000000000003",5,2,1,8,High-Value,Potential Loyalists
51118,885,3,"39,2",3,1,1,5,Low-Value,At Risk Customers
51120,1719,2,"370,65000000000003",1,1,1,3,Low-Value,Lost
51122,505,4,"428,25",4,1,1,6,Mid-Value,Potential Loyalists
51124,1015,1,"160,6",3,1,1,5,Low-Value,At Risk Customers
51125,118,3,"224,45000000000002",5,1,1,7,Mid-Value,Potential Loyalists
51126,1295,2,"165,25",2,1,1,4,Low-Value,Can't Lose
51127,794,1,"125,65",3,1,1,5,Low-Value,At Risk Customers
51129,540,5,"428,7",4,1,1,6,Mid-Value,Potential Loyalists
51130,111,3,"179,2",5,1,1,7,Mid-Value,Potential Loyalists
51131,375,2,"147,95",4,1,1,6,Mid-Value,Potential Loyalists
51133,584,3,"47,4",4,1,1,6,Mid-Value,Potential Loyalists
51134,1205,4,"234,45",2,1,1,4,Low-Value,Can't Lose
51135,738,2,"75,1",3,1,1,5,Low-Value,At Risk Customers
51136,179,5,"249,15",5,1,1,7,Mid-Value,Potential Loyalists
51137,1019,1,"29,75",3,1,1,5,Low-Value,At Risk Customers
51138,1,2,"94,35",5,1,1,7,Mid-Value,Potential Loyalists
51140,838,1,"48,4",3,1,1,5,Low-Value,At Risk Customers
51141,1153,1,"160,6",2,1,1,4,Low-Value,Can't Lose
51144,561,7,"313,5",4,2,1,7,Mid-Value,Potential Loyalists
51145,1688,2,"484,6",1,1,1,3,Low-Value,Lost
51147,195,1,"71,1",5,1,1,7,Mid-Value,Potential Loyalists
51149,852,2,"116,0",3,1,1,5,Low-Value,At Risk Customers
51151,1199,4,"146,6",2,1,1,4,Low-Value,Can't Lose
51152,301,1,"47,75",5,1,1,7,Mid-Value,Potential Loyalists
51153,1659,1,"24,5",1,1,1,3,Low-Value,Lost
51154,56,5,"392,1",5,1,1,7,Mid-Value,Potential Loyalists
51155,1586,2,"46,75",1,1,1,3,Low-Value,Lost
51157,191,5,"119,60000000000001",5,1,1,7,Mid-Value,Potential Loyalists
51158,993,1,"5,75",3,1,1,5,Low-Value,At Risk Customers
51159,119,9,"588,5",5,2,1,8,High-Value,Potential Loyalists
51160,139,4,"170,7",5,1,1,7,Mid-Value,Potential Loyalists
51161,858,3,"132,2",3,1,1,5,Low-Value,At Risk Customers
51163,996,3,"151,5",3,1,1,5,Low-Value,At Risk Customers
51164,856,1,"21,5",3,1,1,5,Low-Value,At Risk Customers
51165,69,8,"184,6",5,2,1,8,High-Value,Potential Loyalists
51166,1229,2,"410,40000000000003",2,1,1,4,Low-Value,Can't Lose
51169,1225,1,"5,9",2,1,1,4,Low-Value,Can't Lose
51170,1186,2,"119,14999999999999",2,1,1,4,Low-Value,Can't Lose
51171,437,1,"134,8",4,1,1,6,Mid-Value,Potential Loyalists
51173,1697,1,"48,45",1,1,1,3,Low-Value,Lost
51174,613,2,"52,3",4,1,1,6,Mid-Value,Potential Loyalists
51175,44,3,"78,5",5,1,1,7,Mid-Value,Potential Loyalists
51178,1599,1,"17,35",1,1,1,3,Low-Value,Lost
51179,130,1,"25,2",5,1,1,7,Mid-Value,Potential Loyalists
51180,228,1,"32,25",5,1,1,7,Mid-Value,Potential Loyalists
51181,907,1,"87,9",3,1,1,5,Low-Value,At Risk Customers
51182,434,4,"195,45",4,1,1,6,Mid-Value,Potential Loyalists
51184,127,2,"158,85",5,1,1,7,Mid-Value,Potential Loyalists
51185,489,2,"51,8",4,1,1,6,Mid-Value,Potential Loyalists
51186,190,1,"55,349999999999994",5,1,1,7,Mid-Value,Potential Loyalists
51187,876,1,"35,6",3,1,1,5,Low-Value,At Risk Customers
51190,754,5,"170,7",3,1,1,5,Low-Value,At Risk Customers
51193,1731,1,"9,65",1,1,1,3,Low-Value,Lost
51196,1001,2,"25,05",3,1,1,5,Low-Value,At Risk Customers
51199,306,4,"236,99999999999997",5,1,1,7,Mid-Value,Potential Loyalists
51200,176,1,"117,2",5,1,1,7,Mid-Value,Potential Loyalists
51202,760,5,"553,1",3,1,1,5,Low-Value,At Risk Customers
51203,1139,3,"101,45",2,1,1,4,Low-Value,Can't Lose
51204,118,8,"349,25",5,2,1,8,High-Value,Potential Loyalists
51205,4,8,"295,71000000000004",5,2,1,8,High-Value,Potential Loyalists
51206,878,2,"28,0",3,1,1,5,Low-Value,At Risk Customers
51207,14,2,"283,55",5,1,1,7,Mid-Value,Potential Loyalists
51208,421,2,"169,85",4,1,1,6,Mid-Value,Potential Loyalists
51210,1625,1,"41,5",1,1,1,3,Low-Value,Lost
51211,495,5,"725,0999999999999",4,1,2,7,Mid-Value,Potential Loyalists
51214,214,1,"64,5",5,1,1,7,Mid-Value,Potential Loyalists
51220,623,2,"189,70000000000002",4,1,1,6,Mid-Value,Potential Loyalists
51221,3,6,"285,9",5,1,1,7,Mid-Value,Potential Loyalists
51223,18,5,"408,3",5,1,1,7,Mid-Value,Potential Loyalists
51224,171,9,"420,1",5,2,1,8,High-Value,Potential Loyalists
51227,1402,1,"14,45",2,1,1,4,Low-Value,Can't Lose
51228,196,2,"50,1",5,1,1,7,Mid-Value,Potential Loyalists
51231,48,3,"168,9",5,1,1,7,Mid-Value,Potential Loyalists
51232,578,2,"162,3",4,1,1,6,Mid-Value,Potential Loyalists
51233,31,6,"271,3",5,1,1,7,Mid-Value,Potential Loyalists
51234,21,4,"439,20000000000005",5,1,1,7,Mid-Value,Potential Loyalists
51235,269,1,"55,2",5,1,1,7,Mid-Value,Potential Loyalists
51236,995,6,"363,1",3,1,1,5,Low-Value,At Risk Customers
51237,633,1,"36,8",4,1,1,6,Mid-Value,Potential Loyalists
51238,508,2,"90,35000000000001",4,1,1,6,Mid-Value,Potential Loyalists
51241,372,1,"58,2",4,1,1,6,Mid-Value,Potential Loyalists
51242,170,6,"103,3",5,1,1,7,Mid-Value,Potential Loyalists
51243,802,3,"87,4",3,1,1,5,Low-Value,At Risk Customers
51244,48,3,"203,25",5,1,1,7,Mid-Value,Potential Loyalists
51245,204,4,"308,05",5,1,1,7,Mid-Value,Potential Loyalists
51246,832,2,"139,6",3,1,1,5,Low-Value,At Risk Customers
51247,8,5,"293,9",5,1,1,7,Mid-Value,Potential Loyalists
51252,539,5,"736,45",4,1,2,7,Mid-Value,Potential Loyalists
51253,1099,5,"142,85",2,1,1,4,Low-Value,Can't Lose
51255,530,3,"186,51",4,1,1,6,Mid-Value,Potential Loyalists
51256,162,3,"263,5",5,1,1,7,Mid-Value,Potential Loyalists
51257,1268,3,"88,75",2,1,1,4,Low-Value,Can't Lose
51262,4,5,"245,10000000000002",5,1,1,7,Mid-Value,Potential Loyalists
51265,927,6,"277,9",3,1,1,5,Low-Value,At Risk Customers
51266,662,2,"111,35000000000001",4,1,1,6,Mid-Value,Potential Loyalists
51267,315,3,"223,2",5,1,1,7,Mid-Value,Potential Loyalists
51269,14,6,"194,15",5,1,1,7,Mid-Value,Potential Loyalists
51270,1580,1,"11,0",1,1,1,3,Low-Value,Lost
51271,840,1,"145,6",3,1,1,5,Low-Value,At Risk Customers
51272,1269,1,"13,6",2,1,1,4,Low-Value,Can't Lose
51275,938,3,"224,85000000000002",3,1,1,5,Low-Value,At Risk Customers
51276,963,3,"601,95",3,1,1,5,Low-Value,At Risk Customers
51277,29,5,"438,84999999999997",5,1,1,7,Mid-Value,Potential Loyalists
51278,1208,3,"259,25",2,1,1,4,Low-Value,Can't Lose
51279,940,1,"191,3",3,1,1,5,Low-Value,At Risk Customers
51280,1575,2,"205,3",1,1,1,3,Low-Value,Lost
51281,293,3,"630,5999999999999",5,1,1,7,Mid-Value,Potential Loyalists
51284,373,5,"228,57999999999998",4,1,1,6,Mid-Value,Potential Loyalists
51285,493,3,"133,85",4,1,1,6,Mid-Value,Potential Loyalists
51286,773,9,"623,45",3,2,1,6,Mid-Value,Potential Loyalists
51288,1522,1,"6,2",1,1,1,3,Low-Value,Lost
51289,1067,1,"11,15",3,1,1,5,Low-Value,At Risk Customers
51290,1116,2,"64,7",2,1,1,4,Low-Value,Can't Lose
51292,1186,2,"13,6",2,1,1,4,Low-Value,Can't Lose
51293,27,6,"437,04999999999995",5,1,1,7,Mid-Value,Potential Loyalists
51294,1004,1,"62,4",3,1,1,5,Low-Value,At Risk Customers
51296,1258,2,"140,55",2,1,1,4,Low-Value,Can't Lose
51300,136,1,"22,7",5,1,1,7,Mid-Value,Potential Loyalists
51302,142,2,"64,65",5,1,1,7,Mid-Value,Potential Loyalists
51303,248,2,"27,3",5,1,1,7,Mid-Value,Potential Loyalists
51304,1793,1,"25,6",1,1,1,3,Low-Value,Lost
51306,907,1,"7,2",3,1,1,5,Low-Value,At Risk Customers
51307,46,7,"381,85",5,2,1,8,High-Value,Potential Loyalists
51310,917,3,"96,75",3,1,1,5,Low-Value,At Risk Customers
51311,1295,2,"55,65",2,1,1,4,Low-Value,Can't Lose
51312,365,2,"59,9",5,1,1,7,Mid-Value,Potential Loyalists
51315,280,8,"297,15",5,2,1,8,High-Value,Potential Loyalists
51319,8,6,"768,7",5,1,2,8,High-Value,Potential Loyalists
51320,877,9,"243,54999999999998",3,2,1,6,Mid-Value,Potential Loyalists
51321,339,7,"470,49999999999994",5,2,1,8,High-Value,Potential Loyalists
51324,599,8,"400,65",4,2,1,7,Mid-Value,Potential Loyalists
51325,742,1,"115,7",3,1,1,5,Low-Value,At Risk Customers
51326,1132,1,"42,1",2,1,1,4,Low-Value,Can't Lose
51327,1693,1,"73,6",1,1,1,3,Low-Value,Lost
51329,89,3,"338,35",5,1,1,7,Mid-Value,Potential Loyalists
51330,1,1,"39,5",5,1,1,7,Mid-Value,Potential Loyalists
51331,504,2,"153,55",4,1,1,6,Mid-Value,Potential Loyalists
51332,731,10,"907,0",3,2,2,7,Mid-Value,Potential Loyalists
51333,1593,1,"15,0",1,1,1,3,Low-Value,Lost
51335,15,5,"484,0",5,1,1,7,Mid-Value,Potential Loyalists
51336,45,6,"403,45",5,1,1,7,Mid-Value,Potential Loyalists
51340,16,7,"254,7",5,2,1,8,High-Value,Potential Loyalists
51341,1658,1,"19,7",1,1,1,3,Low-Value,Lost
51344,150,8,"679,6",5,2,2,9,High-Value,Champions
51345,94,1,"56,699999999999996",5,1,1,7,Mid-Value,Potential Loyalists
51346,1121,2,"52,449999999999996",2,1,1,4,Low-Value,Can't Lose
51347,424,5,"241,5",4,1,1,6,Mid-Value,Potential Loyalists
51348,1057,3,"168,6",3,1,1,5,Low-Value,At Risk Customers
51349,755,6,"485,9",3,1,1,5,Low-Value,At Risk Customers
51350,390,9,"290,5",4,2,1,7,Mid-Value,Potential Loyalists
51352,505,5,"271,0",4,1,1,6,Mid-Value,Potential Loyalists
51355,385,6,"274,25",4,1,1,6,Mid-Value,Potential Loyalists
51358,342,1,"14,75",5,1,1,7,Mid-Value,Potential Loyalists
51362,105,5,"240,7",5,1,1,7,Mid-Value,Potential Loyalists
51363,98,5,"165,7",5,1,1,7,Mid-Value,Potential Loyalists
51364,1076,1,"23,75",3,1,1,5,Low-Value,At Risk Customers
51365,392,6,"589,1999999999999",4,1,1,6,Mid-Value,Potential Loyalists
51366,733,5,"450,75",3,1,1,5,Low-Value,At Risk Customers
51367,586,8,"623,25",4,2,1,7,Mid-Value,Potential Loyalists
51369,39,5,"177,89999999999998",5,1,1,7,Mid-Value,Potential Loyalists
51370,314,1,"127,2",5,1,1,7,Mid-Value,Potential Loyalists
51371,874,5,"541,65",3,1,1,5,Low-Value,At Risk Customers
51373,845,1,"25,1",3,1,1,5,Low-Value,At Risk Customers
51375,73,6,"141,7",5,1,1,7,Mid-Value,Potential Loyalists
51376,116,8,"492,4",5,2,1,8,High-Value,Potential Loyalists
51377,944,1,"189,0",3,1,1,5,Low-Value,At Risk Customers
51378,361,6,"580,95",5,1,1,7,Mid-Value,Potential Loyalists
51379,745,4,"115,14999999999999",3,1,1,5,Low-Value,At Risk Customers
51383,517,3,"449,15",4,1,1,6,Mid-Value,Potential Loyalists
51384,600,4,"106,2",4,1,1,6,Mid-Value,Potential Loyalists
51386,1127,1,"18,35",2,1,1,4,Low-Value,Can't Lose
51389,542,2,"364,75",4,1,1,6,Mid-Value,Potential Loyalists
51390,504,5,"162,25",4,1,1,6,Mid-Value,Potential Loyalists
51391,483,6,"401,95000000000005",4,1,1,6,Mid-Value,Potential Loyalists
51392,644,2,"81,4",4,1,1,6,Mid-Value,Potential Loyalists
51393,835,5,"424,3",3,1,1,5,Low-Value,At Risk Customers
51394,489,1,"42,4",4,1,1,6,Mid-Value,Potential Loyalists
51396,32,1,"35,05",5,1,1,7,Mid-Value,Potential Loyalists
51398,777,1,"17,35",3,1,1,5,Low-Value,At Risk Customers
51400,273,4,"366,40000000000003",5,1,1,7,Mid-Value,Potential Loyalists
51402,193,6,"744,0",5,1,2,8,High-Value,Potential Loyalists
51403,171,5,"175,75",5,1,1,7,Mid-Value,Potential Loyalists
51404,1032,4,"207,5",3,1,1,5,Low-Value,At Risk Customers
51407,502,7,"445,55",4,2,1,7,Mid-Value,Potential Loyalists
51408,665,4,"197,25",4,1,1,6,Mid-Value,Potential Loyalists
51410,696,1,"250,7",4,1,1,6,Mid-Value,Potential Loyalists
51411,1303,1,"67,6",2,1,1,4,Low-Value,Can't Lose
51412,17,4,"183,75",5,1,1,7,Mid-Value,Potential Loyalists
51415,518,1,"19,9",4,1,1,6,Mid-Value,Potential Loyalists
51416,400,1,"9,35",4,1,1,6,Mid-Value,Potential Loyalists
51419,1739,1,"85,35",1,1,1,3,Low-Value,Lost
51420,998,1,"48,150000000000006",3,1,1,5,Low-Value,At Risk Customers
51421,645,3,"161,3",4,1,1,6,Mid-Value,Potential Loyalists
51422,11,3,"64,0",5,1,1,7,Mid-Value,Potential Loyalists
51426,983,2,"37,4",3,1,1,5,Low-Value,At Risk Customers
51434,617,1,"5,0",4,1,1,6,Mid-Value,Potential Loyalists
51435,369,2,"190,60000000000002",4,1,1,6,Mid-Value,Potential Loyalists
51436,1762,1,"54,55",1,1,1,3,Low-Value,Lost
51438,1152,1,"125,65",2,1,1,4,Low-Value,Can't Lose
51439,1445,1,"12,0",2,1,1,4,Low-Value,Can't Lose
51441,25,2,"154,8",5,1,1,7,Mid-Value,Potential Loyalists
51442,135,4,"202,04999999999998",5,1,1,7,Mid-Value,Potential Loyalists
51443,42,6,"277,4",5,1,1,7,Mid-Value,Potential Loyalists
51445,766,2,"27,3",3,1,1,5,Low-Value,At Risk Customers
51447,9,5,"373,3",5,1,1,7,Mid-Value,Potential Loyalists
51452,433,1,"69,1",4,1,1,6,Mid-Value,Potential Loyalists
51453,22,2,"505,50000000000006",5,1,1,7,Mid-Value,Potential Loyalists
51454,659,1,"60,75",4,1,1,6,Mid-Value,Potential Loyalists
51456,381,1,"67,5",4,1,1,6,Mid-Value,Potential Loyalists
51457,1085,1,"9,55",3,1,1,5,Low-Value,At Risk Customers
51458,1635,2,"76,5",1,1,1,3,Low-Value,Lost
51459,880,3,"392,04999999999995",3,1,1,5,Low-Value,At Risk Customers
51462,745,4,"275,75",3,1,1,5,Low-Value,At Risk Customers
51465,53,9,"636,55",5,2,1,8,High-Value,Potential Loyalists
51466,959,1,"163,64999999999998",3,1,1,5,Low-Value,At Risk Customers
51467,918,3,"269,7",3,1,1,5,Low-Value,At Risk Customers
51468,286,12,"444,45",5,3,1,9,High-Value,Champions
51469,1817,1,"7,6",1,1,1,3,Low-Value,Lost
51470,400,2,"60,2",4,1,1,6,Mid-Value,Potential Loyalists
51471,610,4,"225,65",4,1,1,6,Mid-Value,Potential Loyalists
51473,276,3,"175,8",5,1,1,7,Mid-Value,Potential Loyalists
51474,1742,2,"93,5",1,1,1,3,Low-Value,Lost
51475,1546,4,"74,6",1,1,1,3,Low-Value,Lost
51478,971,2,"42,5",3,1,1,5,Low-Value,At Risk Customers
51479,810,3,"60,15",3,1,1,5,Low-Value,At Risk Customers
51481,196,3,"145,9",5,1,1,7,Mid-Value,Potential Loyalists
51482,1726,2,"65,25",1,1,1,3,Low-Value,Lost
51483,44,8,"285,85",5,2,1,8,High-Value,Potential Loyalists
51484,1782,1,"39,2",1,1,1,3,Low-Value,Lost
51485,1159,1,"76,3",2,1,1,4,Low-Value,Can't Lose
51486,130,6,"609,0",5,1,1,7,Mid-Value,Potential Loyalists
51487,706,1,"34,5",4,1,1,6,Mid-Value,Potential Loyalists
51488,272,3,"128,9",5,1,1,7,Mid-Value,Potential Loyalists
51489,490,2,"177,3",4,1,1,6,Mid-Value,Potential Loyalists
51490,810,3,"282,8",3,1,1,5,Low-Value,At Risk Customers
51491,61,4,"196,85",5,1,1,7,Mid-Value,Potential Loyalists
51492,1662,1,"65,9",1,1,1,3,Low-Value,Lost
51494,1301,2,"69,80000000000001",2,1,1,4,Low-Value,Can't Lose
51495,49,5,"137,65",5,1,1,7,Mid-Value,Potential Loyalists
51496,1091,2,"257,45",3,1,1,5,Low-Value,At Risk Customers
51498,164,1,"250,3",5,1,1,7,Mid-Value,Potential Loyalists
51500,855,1,"35,6",3,1,1,5,Low-Value,At Risk Customers
51502,264,2,"501,9",5,1,1,7,Mid-Value,Potential Loyalists
51503,29,8,"338,45000000000005",5,2,1,8,High-Value,Potential Loyalists
51505,452,8,"622,25",4,2,1,7,Mid-Value,Potential Loyalists
51506,218,3,"124,7",5,1,1,7,Mid-Value,Potential Loyalists
51510,127,5,"1371,4",5,1,3,9,High-Value,Champions
51511,780,2,"92,3",3,1,1,5,Low-Value,At Risk Customers
51512,111,2,"167,05",5,1,1,7,Mid-Value,Potential Loyalists
51515,384,3,"179,45",4,1,1,6,Mid-Value,Potential Loyalists
51521,545,5,"377,4",4,1,1,6,Mid-Value,Potential Loyalists
51522,753,6,"366,45",3,1,1,5,Low-Value,At Risk Customers
51523,814,3,"275,2",3,1,1,5,Low-Value,At Risk Customers
51525,480,2,"90,7",4,1,1,6,Mid-Value,Potential Loyalists
51529,5,8,"606,75",5,2,1,8,High-Value,Potential Loyalists
51533,440,2,"97,05",4,1,1,6,Mid-Value,Potential Loyalists
51534,152,3,"66,4",5,1,1,7,Mid-Value,Potential Loyalists
51535,2,1,"17,2",5,1,1,7,Mid-Value,Potential Loyalists
51537,401,1,"57,85",4,1,1,6,Mid-Value,Potential Loyalists
51538,863,2,"42,150000000000006",3,1,1,5,Low-Value,At Risk Customers
51540,1373,3,"228,6",2,1,1,4,Low-Value,Can't Lose
51541,228,1,"32,25",5,1,1,7,Mid-Value,Potential Loyalists
51542,171,2,"79,9",5,1,1,7,Mid-Value,Potential Loyalists
51543,39,3,"96,25",5,1,1,7,Mid-Value,Potential Loyalists
51546,1090,1,"111,0",3,1,1,5,Low-Value,At Risk Customers
51547,392,2,"83,45",4,1,1,6,Mid-Value,Potential Loyalists
51551,1012,1,"48,45",3,1,1,5,Low-Value,At Risk Customers
51552,24,4,"261,65",5,1,1,7,Mid-Value,Potential Loyalists
51553,121,6,"268,35",5,1,1,7,Mid-Value,Potential Loyalists
51554,9,7,"323,0",5,2,1,8,High-Value,Potential Loyalists
51556,210,3,"36,7",5,1,1,7,Mid-Value,Potential Loyalists
51557,1042,1,"20,4",3,1,1,5,Low-Value,At Risk Customers
51558,188,5,"314,1",5,1,1,7,Mid-Value,Potential Loyalists
51559,938,1,"22,2",3,1,1,5,Low-Value,At Risk Customers
51561,26,10,"561,35",5,2,1,8,High-Value,Potential Loyalists
51562,368,4,"208,0",4,1,1,6,Mid-Value,Potential Loyalists
51564,445,8,"708,4",4,2,2,8,High-Value,Potential Loyalists
51565,1147,1,"56,15",2,1,1,4,Low-Value,Can't Lose
51568,24,2,"52,24999999999999",5,1,1,7,Mid-Value,Potential Loyalists
51572,76,5,"312,3",5,1,1,7,Mid-Value,Potential Loyalists
51573,546,3,"293,0",4,1,1,6,Mid-Value,Potential Loyalists
51574,131,2,"141,45",5,1,1,7,Mid-Value,Potential Loyalists
51576,1440,4,"145,4",2,1,1,4,Low-Value,Can't Lose
51578,849,1,"237,8",3,1,1,5,Low-Value,At Risk Customers
51579,1005,2,"108,6",3,1,1,5,Low-Value,At Risk Customers
51581,529,5,"265,90000000000003",4,1,1,6,Mid-Value,Potential Loyalists
51582,449,7,"390,45",4,2,1,7,Mid-Value,Potential Loyalists
51583,956,1,"3,0",3,1,1,5,Low-Value,At Risk Customers
51584,206,9,"559,75",5,2,1,8,High-Value,Potential Loyalists
51585,59,2,"174,8",5,1,1,7,Mid-Value,Potential Loyalists
51586,66,3,"37,15",5,1,1,7,Mid-Value,Potential Loyalists
51587,52,3,"161,55",5,1,1,7,Mid-Value,Potential Loyalists
51588,1113,3,"326,85",2,1,1,4,Low-Value,Can't Lose
51591,438,4,"327,05",4,1,1,6,Mid-Value,Potential Loyalists
51592,812,2,"126,10000000000001",3,1,1,5,Low-Value,At Risk Customers
51593,1399,1,"16,2",2,1,1,4,Low-Value,Can't Lose
51594,122,3,"108,0",5,1,1,7,Mid-Value,Potential Loyalists
51595,276,1,"135,4",5,1,1,7,Mid-Value,Potential Loyalists
51596,784,1,"15,8",3,1,1,5,Low-Value,At Risk Customers
51599,151,3,"131,65",5,1,1,7,Mid-Value,Potential Loyalists
51600,686,2,"102,5",4,1,1,6,Mid-Value,Potential Loyalists
51603,164,1,"119,6",5,1,1,7,Mid-Value,Potential Loyalists
51607,21,2,"131,7",5,1,1,7,Mid-Value,Potential Loyalists
51608,274,15,"777,4",5,3,2,10,High-Value,Champions
51609,3,4,"184,4",5,1,1,7,Mid-Value,Potential Loyalists
51610,1092,2,"76,05",3,1,1,5,Low-Value,At Risk Customers
51612,49,2,"112,94999999999999",5,1,1,7,Mid-Value,Potential Loyalists
51613,699,1,"13,75",4,1,1,6,Mid-Value,Potential Loyalists
51614,939,6,"199,25",3,1,1,5,Low-Value,At Risk Customers
51615,795,2,"41,75",3,1,1,5,Low-Value,At Risk Customers
51619,17,3,"131,95",5,1,1,7,Mid-Value,Potential Loyalists
51620,538,1,"36,9",4,1,1,6,Mid-Value,Potential Loyalists
51622,146,2,"245,9",5,1,1,7,Mid-Value,Potential Loyalists
51625,13,5,"273,4",5,1,1,7,Mid-Value,Potential Loyalists
51628,340,3,"86,4",5,1,1,7,Mid-Value,Potential Loyalists
51629,90,4,"117,89999999999999",5,1,1,7,Mid-Value,Potential Loyalists
51631,163,2,"399,0",5,1,1,7,Mid-Value,Potential Loyalists
51632,1179,3,"286,25",2,1,1,4,Low-Value,Can't Lose
51636,887,2,"254,2",3,1,1,5,Low-Value,At Risk Customers
51637,1011,1,"27,65",3,1,1,5,Low-Value,At Risk Customers
51638,91,1,"98,35",5,1,1,7,Mid-Value,Potential Loyalists
51640,1474,2,"43,800000000000004",1,1,1,3,Low-Value,Lost
51641,4,6,"168,14999999999998",5,1,1,7,Mid-Value,Potential Loyalists
51642,613,2,"136,7",4,1,1,6,Mid-Value,Potential Loyalists
51644,37,4,"266,6",5,1,1,7,Mid-Value,Potential Loyalists
51645,964,2,"133,65",3,1,1,5,Low-Value,At Risk Customers
51646,493,2,"218,8",4,1,1,6,Mid-Value,Potential Loyalists
51649,1606,2,"14,3",1,1,1,3,Low-Value,Lost
51650,969,1,"21,85",3,1,1,5,Low-Value,At Risk Customers
51651,110,4,"143,1",5,1,1,7,Mid-Value,Potential Loyalists
51652,537,1,"19,8",4,1,1,6,Mid-Value,Potential Loyalists
51653,107,1,"37,4",5,1,1,7,Mid-Value,Potential Loyalists
51655,1118,11,"338,61",2,2,1,5,Low-Value,At Risk Customers
51656,771,2,"156,4",3,1,1,5,Low-Value,At Risk Customers
51658,1319,1,"40,45",2,1,1,4,Low-Value,Can't Lose
51659,173,1,"38,0",5,1,1,7,Mid-Value,Potential Loyalists
51661,1201,2,"576,95",2,1,1,4,Low-Value,Can't Lose
51663,80,6,"280,25",5,1,1,7,Mid-Value,Potential Loyalists
51664,1071,3,"167,0",3,1,1,5,Low-Value,At Risk Customers
51668,9,11,"710,9000000000001",5,2,2,9,High-Value,Champions
51669,956,4,"66,4",3,1,1,5,Low-Value,At Risk Customers
51670,251,5,"212,1",5,1,1,7,Mid-Value,Potential Loyalists
51671,962,3,"162,45",3,1,1,5,Low-Value,At Risk Customers
51673,670,3,"104,5",4,1,1,6,Mid-Value,Potential Loyalists
51674,375,4,"173,8",4,1,1,6,Mid-Value,Potential Loyalists
51678,385,1,"49,2",4,1,1,6,Mid-Value,Potential Loyalists
51681,397,5,"74,7",4,1,1,6,Mid-Value,Potential Loyalists
51682,693,1,"9,25",4,1,1,6,Mid-Value,Potential Loyalists
51683,358,4,"710,1999999999999",5,1,2,8,High-Value,Potential Loyalists
51684,96,2,"257,9",5,1,1,7,Mid-Value,Potential Loyalists
51685,482,4,"608,4",4,1,1,6,Mid-Value,Potential Loyalists
51686,1245,1,"11,9",2,1,1,4,Low-Value,Can't Lose
51688,1130,2,"77,7",2,1,1,4,Low-Value,Can't Lose
51691,253,1,"13,2",5,1,1,7,Mid-Value,Potential Loyalists
51692,20,1,"42,6",5,1,1,7,Mid-Value,Potential Loyalists
51695,96,2,"238,0",5,1,1,7,Mid-Value,Potential Loyalists
51696,1021,2,"98,69999999999999",3,1,1,5,Low-Value,At Risk Customers
51697,437,5,"264,85",4,1,1,6,Mid-Value,Potential Loyalists
51698,536,2,"207,4",4,1,1,6,Mid-Value,Potential Loyalists
51700,724,4,"232,7",4,1,1,6,Mid-Value,Potential Loyalists
51701,11,4,"900,1",5,1,2,8,High-Value,Potential Loyalists
51702,645,4,"216,05",4,1,1,6,Mid-Value,Potential Loyalists
51705,365,3,"144,85",5,1,1,7,Mid-Value,Potential Loyalists
51707,635,2,"28,35",4,1,1,6,Mid-Value,Potential Loyalists
51710,104,3,"519,15",5,1,1,7,Mid-Value,Potential Loyalists
51711,618,1,"36,05",4,1,1,6,Mid-Value,Potential Loyalists
51713,1587,2,"45,9",1,1,1,3,Low-Value,Lost
51714,21,5,"327,65",5,1,1,7,Mid-Value,Potential Loyalists
51715,741,3,"133,1",3,1,1,5,Low-Value,At Risk Customers
51717,63,4,"519,95",5,1,1,7,Mid-Value,Potential Loyalists
51718,422,7,"393,2",4,2,1,7,Mid-Value,Potential Loyalists
51721,594,1,"2,95",4,1,1,6,Mid-Value,Potential Loyalists
51722,203,1,"11,0",5,1,1,7,Mid-Value,Potential Loyalists
51724,13,4,"582,0",5,1,1,7,Mid-Value,Potential Loyalists
51725,167,5,"303,25",5,1,1,7,Mid-Value,Potential Loyalists
51727,1430,1,"70,85",2,1,1,4,Low-Value,Can't Lose
51729,518,2,"60,3",4,1,1,6,Mid-Value,Potential Loyalists
51730,255,2,"95,69999999999999",5,1,1,7,Mid-Value,Potential Loyalists
51734,867,1,"88,8",3,1,1,5,Low-Value,At Risk Customers
51735,796,2,"29,1",3,1,1,5,Low-Value,At Risk Customers
51736,1595,1,"118,75",1,1,1,3,Low-Value,Lost
51737,861,3,"103,0",3,1,1,5,Low-Value,At Risk Customers
51738,148,1,"24,1",5,1,1,7,Mid-Value,Potential Loyalists
51739,11,4,"407,0",5,1,1,7,Mid-Value,Potential Loyalists
51740,20,12,"770,55",5,3,2,10,High-Value,Champions
51743,1208,1,"103,35000000000001",2,1,1,4,Low-Value,Can't Lose
51744,711,4,"195,55",4,1,1,6,Mid-Value,Potential Loyalists
51745,306,5,"428,09999999999997",5,1,1,7,Mid-Value,Potential Loyalists
51746,405,5,"372,95",4,1,1,6,Mid-Value,Potential Loyalists
51750,1632,1,"22,2",1,1,1,3,Low-Value,Lost
51751,724,2,"81,85",4,1,1,6,Mid-Value,Potential Loyalists
51752,641,3,"120,3",4,1,1,6,Mid-Value,Potential Loyalists
51754,738,1,"110,95",3,1,1,5,Low-Value,At Risk Customers
51755,328,5,"249,4",5,1,1,7,Mid-Value,Potential Loyalists
51758,1067,1,"4,15",3,1,1,5,Low-Value,At Risk Customers
51759,719,3,"171,55",4,1,1,6,Mid-Value,Potential Loyalists
51761,76,7,"477,00000000000006",5,2,1,8,High-Value,Potential Loyalists
51762,1221,1,"15,899999999999999",2,1,1,4,Low-Value,Can't Lose
51764,57,2,"603,9999999999999",5,1,1,7,Mid-Value,Potential Loyalists
51765,693,3,"147,1",4,1,1,6,Mid-Value,Potential Loyalists
51767,32,4,"289,75",5,1,1,7,Mid-Value,Potential Loyalists
51769,60,3,"120,15",5,1,1,7,Mid-Value,Potential Loyalists
51770,913,3,"406,0",3,1,1,5,Low-Value,At Risk Customers
51771,389,2,"344,34999999999997",4,1,1,6,Mid-Value,Potential Loyalists
51773,208,2,"137,45000000000002",5,1,1,7,Mid-Value,Potential Loyalists
51775,816,3,"159,25",3,1,1,5,Low-Value,At Risk Customers
51777,34,6,"216,4",5,1,1,7,Mid-Value,Potential Loyalists
51780,3,4,"303,1",5,1,1,7,Mid-Value,Potential Loyalists
51782,257,3,"96,15",5,1,1,7,Mid-Value,Potential Loyalists
51784,267,7,"528,5",5,2,1,8,High-Value,Potential Loyalists
51785,1132,1,"54,5",2,1,1,4,Low-Value,Can't Lose
51787,24,5,"216,35",5,1,1,7,Mid-Value,Potential Loyalists
51790,1,3,"115,2",5,1,1,7,Mid-Value,Potential Loyalists
51792,1621,1,"34,2",1,1,1,3,Low-Value,Lost
51793,255,3,"100,8",5,1,1,7,Mid-Value,Potential Loyalists
51794,869,1,"84,9",3,1,1,5,Low-Value,At Risk Customers
51797,804,3,"139,3",3,1,1,5,Low-Value,At Risk Customers
51799,36,4,"403,8",5,1,1,7,Mid-Value,Potential Loyalists
51803,567,3,"45,6",4,1,1,6,Mid-Value,Potential Loyalists
51805,218,3,"260,5",5,1,1,7,Mid-Value,Potential Loyalists
51806,334,3,"195,10000000000002",5,1,1,7,Mid-Value,Potential Loyalists
51808,1073,2,"34,25",3,1,1,5,Low-Value,At Risk Customers
51809,278,4,"287,3",5,1,1,7,Mid-Value,Potential Loyalists
51810,4,1,"108,14999999999999",5,1,1,7,Mid-Value,Potential Loyalists
51811,821,1,"19,45",3,1,1,5,Low-Value,At Risk Customers
51812,1630,2,"131,25",1,1,1,3,Low-Value,Lost
51815,889,6,"250,85",3,1,1,5,Low-Value,At Risk Customers
51817,390,1,"59,0",4,1,1,6,Mid-Value,Potential Loyalists
51818,186,4,"561,65",5,1,1,7,Mid-Value,Potential Loyalists
51821,1417,4,"361,75",2,1,1,4,Low-Value,Can't Lose
51825,293,2,"178,8",5,1,1,7,Mid-Value,Potential Loyalists
51830,940,2,"176,0",3,1,1,5,Low-Value,At Risk Customers
51831,1060,1,"113,45",3,1,1,5,Low-Value,At Risk Customers
51832,127,1,"34,5",5,1,1,7,Mid-Value,Potential Loyalists
51833,370,3,"275,2",4,1,1,6,Mid-Value,Potential Loyalists
51834,547,1,"57,1",4,1,1,6,Mid-Value,Potential Loyalists
51837,87,1,"1,9",5,1,1,7,Mid-Value,Potential Loyalists
51839,161,5,"300,29999999999995",5,1,1,7,Mid-Value,Potential Loyalists
51840,329,2,"18,4",5,1,1,7,Mid-Value,Potential Loyalists
51841,464,1,"21,85",4,1,1,6,Mid-Value,Potential Loyalists
51842,489,2,"107,29999999999998",4,1,1,6,Mid-Value,Potential Loyalists
51843,417,5,"639,45",4,1,1,6,Mid-Value,Potential Loyalists
51844,116,5,"147,95",5,1,1,7,Mid-Value,Potential Loyalists
51846,695,5,"326,6",4,1,1,6,Mid-Value,Potential Loyalists
51847,4,2,"36,8",5,1,1,7,Mid-Value,Potential Loyalists
51848,458,4,"316,29999999999995",4,1,1,6,Mid-Value,Potential Loyalists
51849,464,2,"41,5",4,1,1,6,Mid-Value,Potential Loyalists
51852,431,4,"157,15",4,1,1,6,Mid-Value,Potential Loyalists
51853,1182,1,"16,95",2,1,1,4,Low-Value,Can't Lose
51854,456,5,"205,15",4,1,1,6,Mid-Value,Potential Loyalists
51857,1519,1,"62,3",1,1,1,3,Low-Value,Lost
51858,151,1,"31,0",5,1,1,7,Mid-Value,Potential Loyalists
51860,568,3,"187,9",4,1,1,6,Mid-Value,Potential Loyalists
51861,1138,3,"581,8",2,1,1,4,Low-Value,Can't Lose
51866,35,7,"565,95",5,2,1,8,High-Value,Potential Loyalists
51870,925,1,"20,1",3,1,1,5,Low-Value,At Risk Customers
51871,162,4,"222,55",5,1,1,7,Mid-Value,Potential Loyalists
51873,522,5,"1045,2500000000002",4,1,2,7,Mid-Value,Potential Loyalists
51874,73,2,"24,849999999999998",5,1,1,7,Mid-Value,Potential Loyalists
51877,751,2,"67,60000000000001",3,1,1,5,Low-Value,At Risk Customers
51885,1,1,"64,1",5,1,1,7,Mid-Value,Potential Loyalists
51886,10,2,"39,6",5,1,1,7,Mid-Value,Potential Loyalists
51887,780,2,"104,64999999999999",3,1,1,5,Low-Value,At Risk Customers
51888,724,2,"279,5",4,1,1,6,Mid-Value,Potential Loyalists
51889,739,1,"19,3",3,1,1,5,Low-Value,At Risk Customers
51890,755,6,"659,4499999999999",3,1,1,5,Low-Value,At Risk Customers
51892,441,3,"112,0",4,1,1,6,Mid-Value,Potential Loyalists
51894,390,3,"260,2",4,1,1,6,Mid-Value,Potential Loyalists
51895,245,3,"262,2",5,1,1,7,Mid-Value,Potential Loyalists
51896,509,2,"78,6",4,1,1,6,Mid-Value,Potential Loyalists
51897,24,7,"441,3",5,2,1,8,High-Value,Potential Loyalists
51901,1175,7,"242,9",2,2,1,5,Low-Value,At Risk Customers
51902,305,12,"325,2",5,3,1,9,High-Value,Champions
51904,167,2,"290,7",5,1,1,7,Mid-Value,Potential Loyalists
51907,366,1,"59,1",4,1,1,6,Mid-Value,Potential Loyalists
51908,786,3,"158,55",3,1,1,5,Low-Value,At Risk Customers
51909,152,4,"583,1",5,1,1,7,Mid-Value,Potential Loyalists
51912,403,3,"159,25",4,1,1,6,Mid-Value,Potential Loyalists
51916,458,2,"40,95",4,1,1,6,Mid-Value,Potential Loyalists
51918,313,5,"296,6",5,1,1,7,Mid-Value,Potential Loyalists
51919,794,2,"89,0",3,1,1,5,Low-Value,At Risk Customers
51922,140,7,"304,09999999999997",5,2,1,8,High-Value,Potential Loyalists
51923,1077,1,"16,4",3,1,1,5,Low-Value,At Risk Customers
51924,39,2,"92,3",5,1,1,7,Mid-Value,Potential Loyalists
51926,536,5,"243,85",4,1,1,6,Mid-Value,Potential Loyalists
51927,363,2,"33,4",5,1,1,7,Mid-Value,Potential Loyalists
51928,146,1,"238,3",5,1,1,7,Mid-Value,Potential Loyalists
51930,84,5,"316,55",5,1,1,7,Mid-Value,Potential Loyalists
51931,159,2,"214,90000000000003",5,1,1,7,Mid-Value,Potential Loyalists
51932,949,2,"88,9",3,1,1,5,Low-Value,At Risk Customers
51934,862,2,"110,65",3,1,1,5,Low-Value,At Risk Customers
51935,174,4,"207,35",5,1,1,7,Mid-Value,Potential Loyalists
51937,450,3,"252,95",4,1,1,6,Mid-Value,Potential Loyalists
51939,1586,1,"91,05000000000001",1,1,1,3,Low-Value,Lost
51940,1287,2,"115,5",2,1,1,4,Low-Value,Can't Lose
51942,21,8,"775,8",5,2,2,9,High-Value,Champions
51943,139,3,"56,0",5,1,1,7,Mid-Value,Potential Loyalists
51944,861,3,"149,95",3,1,1,5,Low-Value,At Risk Customers
51945,33,4,"110,45",5,1,1,7,Mid-Value,Potential Loyalists
51946,167,2,"207,65",5,1,1,7,Mid-Value,Potential Loyalists
51949,98,4,"41,15",5,1,1,7,Mid-Value,Potential Loyalists
51953,934,3,"154,5",3,1,1,5,Low-Value,At Risk Customers
51955,731,6,"159,79999999999998",3,1,1,5,Low-Value,At Risk Customers
51956,557,3,"156,6",4,1,1,6,Mid-Value,Potential Loyalists
51958,1133,3,"115,75",2,1,1,4,Low-Value,Can't Lose
51959,187,4,"173,0",5,1,1,7,Mid-Value,Potential Loyalists
51960,98,6,"431,3",5,1,1,7,Mid-Value,Potential Loyalists
51963,648,1,"7,85",4,1,1,6,Mid-Value,Potential Loyalists
51964,920,2,"30,8",3,1,1,5,Low-Value,At Risk Customers
51965,1443,3,"152,55",2,1,1,4,Low-Value,Can't Lose
51967,1716,1,"1,35",1,1,1,3,Low-Value,Lost
51970,1306,1,"17,4",2,1,1,4,Low-Value,Can't Lose
51971,1518,2,"162,5",1,1,1,3,Low-Value,Lost
51972,732,5,"400,45",3,1,1,5,Low-Value,At Risk Customers
51973,7,2,"236,10000000000002",5,1,1,7,Mid-Value,Potential Loyalists
51974,142,2,"1057,85",5,1,2,8,High-Value,Potential Loyalists
51975,32,1,"31,7",5,1,1,7,Mid-Value,Potential Loyalists
51978,200,1,"194,85000000000002",5,1,1,7,Mid-Value,Potential Loyalists
51980,260,6,"771,0999999999999",5,1,2,8,High-Value,Potential Loyalists
51982,489,1,"249,8",4,1,1,6,Mid-Value,Potential Loyalists
51983,925,3,"319,79999999999995",3,1,1,5,Low-Value,At Risk Customers
51984,677,1,"48,1",4,1,1,6,Mid-Value,Potential Loyalists
51988,1583,1,"18,6",1,1,1,3,Low-Value,Lost
51989,194,10,"537,75",5,2,1,8,High-Value,Potential Loyalists
51990,621,1,"23,75",4,1,1,6,Mid-Value,Potential Loyalists
51992,1468,2,"62,65",1,1,1,3,Low-Value,Lost
51994,405,13,"490,8",4,3,1,8,High-Value,Potential Loyalists
51996,176,8,"263,5",5,2,1,8,High-Value,Potential Loyalists
51998,505,3,"154,7",4,1,1,6,Mid-Value,Potential Loyalists
51999,1816,1,"77,0",1,1,1,3,Low-Value,Lost
52000,421,12,"685,45",4,3,2,9,High-Value,Champions
52001,120,2,"67,3",5,1,1,7,Mid-Value,Potential Loyalists
52008,63,5,"288,45000000000005",5,1,1,7,Mid-Value,Potential Loyalists
52009,1223,3,"133,45",2,1,1,4,Low-Value,Can't Lose
52011,26,1,"81,8",5,1,1,7,Mid-Value,Potential Loyalists
52012,147,2,"88,19999999999999",5,1,1,7,Mid-Value,Potential Loyalists
52013,1490,1,"36,6",1,1,1,3,Low-Value,Lost
52015,490,3,"949,1999999999999",4,1,2,7,Mid-Value,Potential Loyalists
52016,451,3,"93,5",4,1,1,6,Mid-Value,Potential Loyalists
52017,384,3,"129,2",4,1,1,6,Mid-Value,Potential Loyalists
52019,340,1,"43,85",5,1,1,7,Mid-Value,Potential Loyalists
52020,346,3,"155,89999999999998",5,1,1,7,Mid-Value,Potential Loyalists
52021,978,1,"16,3",3,1,1,5,Low-Value,At Risk Customers
52022,1163,3,"158,65",2,1,1,4,Low-Value,Can't Lose
52024,1048,1,"239,3",3,1,1,5,Low-Value,At Risk Customers
52025,194,3,"234,39999999999998",5,1,1,7,Mid-Value,Potential Loyalists
52026,187,7,"251,2",5,2,1,8,High-Value,Potential Loyalists
52027,113,1,"47,1",5,1,1,7,Mid-Value,Potential Loyalists
52029,1308,1,"8,1",2,1,1,4,Low-Value,Can't Lose
52030,82,2,"74,3",5,1,1,7,Mid-Value,Potential Loyalists
52032,938,4,"114,70000000000002",3,1,1,5,Low-Value,At Risk Customers
52033,1093,1,"2,95",3,1,1,5,Low-Value,At Risk Customers
52037,39,2,"80,35",5,1,1,7,Mid-Value,Potential Loyalists
52039,410,12,"436,25",4,3,1,8,High-Value,Potential Loyalists
52040,854,4,"249,25",3,1,1,5,Low-Value,At Risk Customers
52041,461,1,"59,3",4,1,1,6,Mid-Value,Potential Loyalists
52042,81,10,"1168,7",5,2,2,9,High-Value,Champions
52043,1484,3,"216,5",1,1,1,3,Low-Value,Lost
52044,533,2,"97,85",4,1,1,6,Mid-Value,Potential Loyalists
52045,830,2,"32,7",3,1,1,5,Low-Value,At Risk Customers
52046,40,1,"22,8",5,1,1,7,Mid-Value,Potential Loyalists
52047,18,5,"378,85",5,1,1,7,Mid-Value,Potential Loyalists
52048,195,17,"866,35",5,4,2,11,High-Value,Champions
52049,451,2,"113,5",4,1,1,6,Mid-Value,Potential Loyalists
52050,372,4,"376,69999999999993",4,1,1,6,Mid-Value,Potential Loyalists
52051,149,5,"320,6",5,1,1,7,Mid-Value,Potential Loyalists
52052,231,6,"159,46",5,1,1,7,Mid-Value,Potential Loyalists
52055,494,2,"414,4",4,1,1,6,Mid-Value,Potential Loyalists
52056,1536,1,"15,6",1,1,1,3,Low-Value,Lost
52057,816,2,"144,45",3,1,1,5,Low-Value,At Risk Customers
52058,81,2,"208,0",5,1,1,7,Mid-Value,Potential Loyalists
52059,1175,1,"135,0",2,1,1,4,Low-Value,Can't Lose
52061,20,4,"161,85000000000002",5,1,1,7,Mid-Value,Potential Loyalists
52064,978,2,"165,55",3,1,1,5,Low-Value,At Risk Customers
52065,575,6,"349,5",4,1,1,6,Mid-Value,Potential Loyalists
52066,182,7,"203,1",5,2,1,8,High-Value,Potential Loyalists
52067,74,5,"491,09999999999997",5,1,1,7,Mid-Value,Potential Loyalists
52068,736,1,"53,2",3,1,1,5,Low-Value,At Risk Customers
52069,1581,1,"19,1",1,1,1,3,Low-Value,Lost
52072,12,12,"670,45",5,3,2,10,High-Value,Champions
52074,34,2,"90,75",5,1,1,7,Mid-Value,Potential Loyalists
52075,421,6,"245,4",4,1,1,6,Mid-Value,Potential Loyalists
52076,117,3,"430,85",5,1,1,7,Mid-Value,Potential Loyalists
52077,583,1,"13,4",4,1,1,6,Mid-Value,Potential Loyalists
52078,1722,2,"30,1",1,1,1,3,Low-Value,Lost
52079,207,3,"156,95",5,1,1,7,Mid-Value,Potential Loyalists
52080,563,1,"50,5",4,1,1,6,Mid-Value,Potential Loyalists
52082,329,4,"741,5",5,1,2,8,High-Value,Potential Loyalists
52083,671,2,"101,03",4,1,1,6,Mid-Value,Potential Loyalists
52084,1491,1,"49,4",1,1,1,3,Low-Value,Lost
52085,1438,1,"20,7",2,1,1,4,Low-Value,Can't Lose
52087,106,5,"256,75",5,1,1,7,Mid-Value,Potential Loyalists
52088,263,5,"588,1",5,1,1,7,Mid-Value,Potential Loyalists
52089,701,4,"83,55",4,1,1,6,Mid-Value,Potential Loyalists
52090,435,2,"30,200000000000003",4,1,1,6,Mid-Value,Potential Loyalists
52092,747,1,"398,3",3,1,1,5,Low-Value,At Risk Customers
52096,1411,1,"33,75",2,1,1,4,Low-Value,Can't Lose
52098,110,3,"180,25",5,1,1,7,Mid-Value,Potential Loyalists
52100,221,3,"47,599999999999994",5,1,1,7,Mid-Value,Potential Loyalists
52101,91,6,"314,6",5,1,1,7,Mid-Value,Potential Loyalists
52102,222,5,"428,8",5,1,1,7,Mid-Value,Potential Loyalists
52103,71,4,"193,7",5,1,1,7,Mid-Value,Potential Loyalists
52104,913,3,"109,45",3,1,1,5,Low-Value,At Risk Customers
52105,72,6,"532,5",5,1,1,7,Mid-Value,Potential Loyalists
52106,1546,2,"225,04999999999998",1,1,1,3,Low-Value,Lost
52108,262,1,"56,25",5,1,1,7,Mid-Value,Potential Loyalists
52109,27,6,"445,3",5,1,1,7,Mid-Value,Potential Loyalists
52111,1340,2,"26,65",2,1,1,4,Low-Value,Can't Lose
52112,13,4,"129,15",5,1,1,7,Mid-Value,Potential Loyalists
52114,540,1,"17,2",4,1,1,6,Mid-Value,Potential Loyalists
52115,1249,1,"13,95",2,1,1,4,Low-Value,Can't Lose
52116,81,7,"504,0",5,2,1,8,High-Value,Potential Loyalists
52117,284,2,"38,45",5,1,1,7,Mid-Value,Potential Loyalists
52118,1619,2,"117,4",1,1,1,3,Low-Value,Lost
52119,771,3,"385,65",3,1,1,5,Low-Value,At Risk Customers
52120,863,9,"409,03",3,2,1,6,Mid-Value,Potential Loyalists
52121,468,4,"184,05",4,1,1,6,Mid-Value,Potential Loyalists
52122,1518,1,"5,95",1,1,1,3,Low-Value,Lost
52124,558,7,"718,3",4,2,2,8,High-Value,Potential Loyalists
52125,10,1,"147,7",5,1,1,7,Mid-Value,Potential Loyalists
52126,1090,3,"161,5",3,1,1,5,Low-Value,At Risk Customers
52128,657,1,"42,15",4,1,1,6,Mid-Value,Potential Loyalists
52129,1438,1,"298,2",2,1,1,4,Low-Value,Can't Lose
52130,11,7,"248,15",5,2,1,8,High-Value,Potential Loyalists
52131,1271,1,"77,2",2,1,1,4,Low-Value,Can't Lose
52133,41,4,"510,1",5,1,1,7,Mid-Value,Potential Loyalists
52135,935,5,"372,15",3,1,1,5,Low-Value,At Risk Customers
52136,28,3,"222,1",5,1,1,7,Mid-Value,Potential Loyalists
52138,754,2,"44,099999999999994",3,1,1,5,Low-Value,At Risk Customers
52139,75,4,"263,4",5,1,1,7,Mid-Value,Potential Loyalists
52142,175,4,"76,4",5,1,1,7,Mid-Value,Potential Loyalists
52144,917,3,"435,3",3,1,1,5,Low-Value,At Risk Customers
52146,453,4,"85,95",4,1,1,6,Mid-Value,Potential Loyalists
52148,911,2,"60,4",3,1,1,5,Low-Value,At Risk Customers
52150,1395,2,"212,1",2,1,1,4,Low-Value,Can't Lose
52152,29,6,"1194,6",5,1,2,8,High-Value,Potential Loyalists
52154,969,3,"127,5",3,1,1,5,Low-Value,At Risk Customers
52158,1368,2,"156,35000000000002",2,1,1,4,Low-Value,Can't Lose
52160,249,3,"111,6",5,1,1,7,Mid-Value,Potential Loyalists
52161,41,7,"609,15",5,2,1,8,High-Value,Potential Loyalists
52163,376,4,"159,0",4,1,1,6,Mid-Value,Potential Loyalists
52164,1307,3,"296,65",2,1,1,4,Low-Value,Can't Lose
52166,463,3,"75,2",4,1,1,6,Mid-Value,Potential Loyalists
52168,752,3,"110,5",3,1,1,5,Low-Value,At Risk Customers
52170,402,4,"285,25",4,1,1,6,Mid-Value,Potential Loyalists
52171,336,1,"17,5",5,1,1,7,Mid-Value,Potential Loyalists
52172,740,6,"222,92000000000002",3,1,1,5,Low-Value,At Risk Customers
52174,767,1,"9,75",3,1,1,5,Low-Value,At Risk Customers
52175,1250,3,"126,95",2,1,1,4,Low-Value,Can't Lose
52177,15,2,"55,75",5,1,1,7,Mid-Value,Potential Loyalists
52178,434,1,"66,5",4,1,1,6,Mid-Value,Potential Loyalists
52180,4,3,"62,05",5,1,1,7,Mid-Value,Potential Loyalists
52181,492,1,"166,8",4,1,1,6,Mid-Value,Potential Loyalists
52182,1359,2,"208,2",2,1,1,4,Low-Value,Can't Lose
52183,1204,5,"415,45",2,1,1,4,Low-Value,Can't Lose
52187,665,1,"135,0",4,1,1,6,Mid-Value,Potential Loyalists
52189,530,4,"168,2",4,1,1,6,Mid-Value,Potential Loyalists
52191,348,6,"726,05",5,1,2,8,High-Value,Potential Loyalists
52193,1077,1,"51,35",3,1,1,5,Low-Value,At Risk Customers
52194,486,4,"292,05",4,1,1,6,Mid-Value,Potential Loyalists
52195,83,2,"51,0",5,1,1,7,Mid-Value,Potential Loyalists
52196,100,3,"85,8",5,1,1,7,Mid-Value,Potential Loyalists
52197,346,3,"201,64999999999998",5,1,1,7,Mid-Value,Potential Loyalists
52198,283,2,"51,5",5,1,1,7,Mid-Value,Potential Loyalists
52199,9,1,"180,14999999999998",5,1,1,7,Mid-Value,Potential Loyalists
52200,563,1,"83,3",4,1,1,6,Mid-Value,Potential Loyalists
52201,313,5,"300,84999999999997",5,1,1,7,Mid-Value,Potential Loyalists
52202,117,3,"92,0",5,1,1,7,Mid-Value,Potential Loyalists
52206,1509,5,"130,9",1,1,1,3,Low-Value,Lost
52207,541,2,"112,6",4,1,1,6,Mid-Value,Potential Loyalists
52208,512,1,"411,8",4,1,1,6,Mid-Value,Potential Loyalists
52209,366,3,"139,64999999999998",4,1,1,6,Mid-Value,Potential Loyalists
52211,17,3,"263,6",5,1,1,7,Mid-Value,Potential Loyalists
52212,1000,1,"49,55",3,1,1,5,Low-Value,At Risk Customers
52213,387,7,"305,95",4,2,1,7,Mid-Value,Potential Loyalists
52214,689,1,"16,7",4,1,1,6,Mid-Value,Potential Loyalists
52217,1115,2,"101,7",2,1,1,4,Low-Value,Can't Lose
52219,1018,1,"4,3",3,1,1,5,Low-Value,At Risk Customers
52220,823,4,"45,3",3,1,1,5,Low-Value,At Risk Customers
52221,24,4,"206,9",5,1,1,7,Mid-Value,Potential Loyalists
52222,5,4,"215,55",5,1,1,7,Mid-Value,Potential Loyalists
52226,306,5,"325,5",5,1,1,7,Mid-Value,Potential Loyalists
52229,156,7,"614,1",5,2,1,8,High-Value,Potential Loyalists
52230,824,2,"34,55",3,1,1,5,Low-Value,At Risk Customers
52232,833,2,"88,25",3,1,1,5,Low-Value,At Risk Customers
52233,130,2,"54,1",5,1,1,7,Mid-Value,Potential Loyalists
52234,176,5,"266,9",5,1,1,7,Mid-Value,Potential Loyalists
52236,1698,2,"434,75",1,1,1,3,Low-Value,Lost
52238,451,1,"4,85",4,1,1,6,Mid-Value,Potential Loyalists
52239,1594,1,"82,0",1,1,1,3,Low-Value,Lost
52240,29,3,"303,0",5,1,1,7,Mid-Value,Potential Loyalists
52241,582,4,"510,1",4,1,1,6,Mid-Value,Potential Loyalists
52242,102,10,"555,3",5,2,1,8,High-Value,Potential Loyalists
52244,739,8,"421,09999999999997",3,2,1,6,Mid-Value,Potential Loyalists
52246,608,1,"66,35",4,1,1,6,Mid-Value,Potential Loyalists
52249,1021,1,"22,0",3,1,1,5,Low-Value,At Risk Customers
52254,266,2,"153,15",5,1,1,7,Mid-Value,Potential Loyalists
52255,1584,2,"446,25",1,1,1,3,Low-Value,Lost
52257,601,3,"210,15",4,1,1,6,Mid-Value,Potential Loyalists
52259,375,4,"236,05",4,1,1,6,Mid-Value,Potential Loyalists
52260,780,3,"254,29999999999998",3,1,1,5,Low-Value,At Risk Customers
52261,63,6,"415,35",5,1,1,7,Mid-Value,Potential Loyalists
52264,336,3,"299,85",5,1,1,7,Mid-Value,Potential Loyalists
52266,168,1,"75,9",5,1,1,7,Mid-Value,Potential Loyalists
52267,55,6,"675,3",5,1,2,8,High-Value,Potential Loyalists
52270,514,4,"219,14999999999998",4,1,1,6,Mid-Value,Potential Loyalists
52271,186,6,"348,40000000000003",5,1,1,7,Mid-Value,Potential Loyalists
52272,235,4,"98,4",5,1,1,7,Mid-Value,Potential Loyalists
52275,373,2,"316,0",4,1,1,6,Mid-Value,Potential Loyalists
52276,1337,1,"10,6",2,1,1,4,Low-Value,Can't Lose
52277,839,4,"108,19999999999999",3,1,1,5,Low-Value,At Risk Customers
52279,904,2,"83,3",3,1,1,5,Low-Value,At Risk Customers
52281,181,4,"283,5",5,1,1,7,Mid-Value,Potential Loyalists
52285,395,4,"240,54999999999998",4,1,1,6,Mid-Value,Potential Loyalists
52286,387,2,"167,35",4,1,1,6,Mid-Value,Potential Loyalists
52287,698,1,"7,7",4,1,1,6,Mid-Value,Potential Loyalists
52288,992,2,"62,7",3,1,1,5,Low-Value,At Risk Customers
52289,330,4,"182,75",5,1,1,7,Mid-Value,Potential Loyalists
52290,1423,3,"184,45",2,1,1,4,Low-Value,Can't Lose
52291,15,8,"384,3",5,2,1,8,High-Value,Potential Loyalists
52292,210,5,"516,1",5,1,1,7,Mid-Value,Potential Loyalists
52294,143,4,"140,3",5,1,1,7,Mid-Value,Potential Loyalists
52295,918,3,"131,7",3,1,1,5,Low-Value,At Risk Customers
52297,59,7,"201,9",5,2,1,8,High-Value,Potential Loyalists
52299,822,2,"82,95",3,1,1,5,Low-Value,At Risk Customers
52300,563,3,"79,8",4,1,1,6,Mid-Value,Potential Loyalists
52302,29,1,"134,7",5,1,1,7,Mid-Value,Potential Loyalists
52303,143,2,"126,44999999999999",5,1,1,7,Mid-Value,Potential Loyalists
52304,445,7,"443,4",4,2,1,7,Mid-Value,Potential Loyalists
52305,1289,1,"267,0",2,1,1,4,Low-Value,Can't Lose
52306,192,1,"250,5",5,1,1,7,Mid-Value,Potential Loyalists
52307,396,2,"42,55",4,1,1,6,Mid-Value,Potential Loyalists
52308,458,1,"146,35",4,1,1,6,Mid-Value,Potential Loyalists
52310,84,3,"184,1",5,1,1,7,Mid-Value,Potential Loyalists
52311,836,5,"734,9",3,1,2,6,Mid-Value,Potential Loyalists
52313,164,3,"306,0",5,1,1,7,Mid-Value,Potential Loyalists
52314,369,3,"79,0",4,1,1,6,Mid-Value,Potential Loyalists
52315,124,2,"69,19999999999999",5,1,1,7,Mid-Value,Potential Loyalists
52318,819,6,"567,15",3,1,1,5,Low-Value,At Risk Customers
52321,20,5,"229,25",5,1,1,7,Mid-Value,Potential Loyalists
52322,476,5,"374,90000000000003",4,1,1,6,Mid-Value,Potential Loyalists
52323,286,4,"207,65",5,1,1,7,Mid-Value,Potential Loyalists
52324,42,2,"65,64999999999999",5,1,1,7,Mid-Value,Potential Loyalists
52325,1360,1,"12,45",2,1,1,4,Low-Value,Can't Lose
52326,67,1,"13,9",5,1,1,7,Mid-Value,Potential Loyalists
52328,413,4,"63,9",4,1,1,6,Mid-Value,Potential Loyalists
52329,972,2,"60,05",3,1,1,5,Low-Value,At Risk Customers
52330,801,1,"5,75",3,1,1,5,Low-Value,At Risk Customers
52332,165,4,"70,45",5,1,1,7,Mid-Value,Potential Loyalists
52335,64,2,"21,0",5,1,1,7,Mid-Value,Potential Loyalists
52336,899,1,"167,6",3,1,1,5,Low-Value,At Risk Customers
52337,1522,1,"28,35",1,1,1,3,Low-Value,Lost
52338,455,9,"652,25",4,2,1,7,Mid-Value,Potential Loyalists
52339,290,4,"506,15",5,1,1,7,Mid-Value,Potential Loyalists
52340,15,2,"112,4",5,1,1,7,Mid-Value,Potential Loyalists
52341,191,4,"106,5",5,1,1,7,Mid-Value,Potential Loyalists
52342,756,5,"356,90000000000003",3,1,1,5,Low-Value,At Risk Customers
52343,151,7,"358,0",5,2,1,8,High-Value,Potential Loyalists
52344,210,4,"161,65",5,1,1,7,Mid-Value,Potential Loyalists
52345,791,1,"5,7",3,1,1,5,Low-Value,At Risk Customers
52347,1545,1,"77,7",1,1,1,3,Low-Value,Lost
52348,392,4,"770,95",4,1,2,7,Mid-Value,Potential Loyalists
52349,469,1,"84,4",4,1,1,6,Mid-Value,Potential Loyalists
52350,249,5,"206,45",5,1,1,7,Mid-Value,Potential Loyalists
52351,1674,1,"44,0",1,1,1,3,Low-Value,Lost
52352,950,1,"57,6",3,1,1,5,Low-Value,At Risk Customers
52354,14,4,"280,4",5,1,1,7,Mid-Value,Potential Loyalists
52355,5,4,"154,05",5,1,1,7,Mid-Value,Potential Loyalists
52357,123,3,"215,5",5,1,1,7,Mid-Value,Potential Loyalists
52358,92,3,"121,65",5,1,1,7,Mid-Value,Potential Loyalists
52361,303,2,"105,15",5,1,1,7,Mid-Value,Potential Loyalists
52363,792,5,"413,1",3,1,1,5,Low-Value,At Risk Customers
52365,34,6,"385,4",5,1,1,7,Mid-Value,Potential Loyalists
52367,805,3,"125,65",3,1,1,5,Low-Value,At Risk Customers
52368,767,3,"100,55",3,1,1,5,Low-Value,At Risk Customers
52369,645,1,"25,1",4,1,1,6,Mid-Value,Potential Loyalists
52370,46,3,"138,4",5,1,1,7,Mid-Value,Potential Loyalists
52371,1188,1,"88,5",2,1,1,4,Low-Value,Can't Lose
52372,876,1,"52,2",3,1,1,5,Low-Value,At Risk Customers
52373,832,5,"245,45000000000002",3,1,1,5,Low-Value,At Risk Customers
52375,1093,1,"24,0",3,1,1,5,Low-Value,At Risk Customers
52379,207,1,"82,25",5,1,1,7,Mid-Value,Potential Loyalists
52380,568,5,"294,35",4,1,1,6,Mid-Value,Potential Loyalists
52382,259,1,"126,44999999999999",5,1,1,7,Mid-Value,Potential Loyalists
52384,403,4,"136,2",4,1,1,6,Mid-Value,Potential Loyalists
52385,427,4,"746,6",4,1,2,7,Mid-Value,Potential Loyalists
52386,557,5,"451,0",4,1,1,6,Mid-Value,Potential Loyalists
52387,723,1,"310,6",4,1,1,6,Mid-Value,Potential Loyalists
52388,627,2,"65,8",4,1,1,6,Mid-Value,Potential Loyalists
52389,1033,2,"144,25",3,1,1,5,Low-Value,At Risk Customers
52390,1162,2,"15,65",2,1,1,4,Low-Value,Can't Lose
52391,1053,1,"128,3",3,1,1,5,Low-Value,At Risk Customers
52392,370,1,"36,9",4,1,1,6,Mid-Value,Potential Loyalists
52395,578,2,"34,85",4,1,1,6,Mid-Value,Potential Loyalists
52396,735,3,"180,8",3,1,1,5,Low-Value,At Risk Customers
52398,235,3,"279,95",5,1,1,7,Mid-Value,Potential Loyalists
52399,1188,2,"145,15",2,1,1,4,Low-Value,Can't Lose
52400,305,3,"112,69999999999999",5,1,1,7,Mid-Value,Potential Loyalists
52402,651,3,"62,2",4,1,1,6,Mid-Value,Potential Loyalists
52403,377,5,"436,1",4,1,1,6,Mid-Value,Potential Loyalists
52404,1319,1,"44,849999999999994",2,1,1,4,Low-Value,Can't Lose
52405,291,4,"397,7",5,1,1,7,Mid-Value,Potential Loyalists
52406,550,2,"106,39999999999999",4,1,1,6,Mid-Value,Potential Loyalists
52407,202,5,"628,6",5,1,1,7,Mid-Value,Potential Loyalists
52408,1279,1,"14,549999999999999",2,1,1,4,Low-Value,Can't Lose
52409,32,3,"156,45",5,1,1,7,Mid-Value,Potential Loyalists
52410,1301,3,"366,05",2,1,1,4,Low-Value,Can't Lose
52412,211,1,"11,75",5,1,1,7,Mid-Value,Potential Loyalists
52414,1270,2,"50,9",2,1,1,4,Low-Value,Can't Lose
52416,5,6,"159,55",5,1,1,7,Mid-Value,Potential Loyalists
52417,256,3,"471,75",5,1,1,7,Mid-Value,Potential Loyalists
52419,361,6,"117,55",5,1,1,7,Mid-Value,Potential Loyalists
52421,723,1,"256,3",4,1,1,6,Mid-Value,Potential Loyalists
52423,24,4,"401,95000000000005",5,1,1,7,Mid-Value,Potential Loyalists
52425,1750,1,"44,8",1,1,1,3,Low-Value,Lost
52430,979,3,"90,45",3,1,1,5,Low-Value,At Risk Customers
52431,389,5,"141,6",4,1,1,6,Mid-Value,Potential Loyalists
52432,828,2,"37,099999999999994",3,1,1,5,Low-Value,At Risk Customers
52434,806,4,"205,2",3,1,1,5,Low-Value,At Risk Customers
52435,1117,3,"112,0",2,1,1,4,Low-Value,Can't Lose
52437,490,4,"230,60000000000002",4,1,1,6,Mid-Value,Potential Loyalists
52438,1306,1,"46,2",2,1,1,4,Low-Value,Can't Lose
52441,404,6,"257,05",4,1,1,6,Mid-Value,Potential Loyalists
52444,491,3,"307,9",4,1,1,6,Mid-Value,Potential Loyalists
52445,824,4,"426,35",3,1,1,5,Low-Value,At Risk Customers
52446,899,1,"17,6",3,1,1,5,Low-Value,At Risk Customers
52450,929,1,"156,8",3,1,1,5,Low-Value,At Risk Customers
52451,64,4,"181,1",5,1,1,7,Mid-Value,Potential Loyalists
52452,164,6,"226,05",5,1,1,7,Mid-Value,Potential Loyalists
52453,266,4,"54,75",5,1,1,7,Mid-Value,Potential Loyalists
52454,439,5,"516,1",4,1,1,6,Mid-Value,Potential Loyalists
52455,864,7,"466,3",3,2,1,6,Mid-Value,Potential Loyalists
52457,374,3,"103,85000000000001",4,1,1,6,Mid-Value,Potential Loyalists
52458,864,4,"114,66",3,1,1,5,Low-Value,At Risk Customers
52460,136,5,"266,0",5,1,1,7,Mid-Value,Potential Loyalists
52465,94,11,"932,75",5,2,2,9,High-Value,Champions
52468,412,10,"920,9499999999999",4,2,2,8,High-Value,Potential Loyalists
52471,762,4,"359,95000000000005",3,1,1,5,Low-Value,At Risk Customers
52473,500,4,"215,8",4,1,1,6,Mid-Value,Potential Loyalists
52474,45,3,"163,9",5,1,1,7,Mid-Value,Potential Loyalists
52478,54,5,"415,85",5,1,1,7,Mid-Value,Potential Loyalists
52480,1074,3,"725,6",3,1,2,6,Mid-Value,Potential Loyalists
52481,2,1,"4,4",5,1,1,7,Mid-Value,Potential Loyalists
52484,235,2,"158,1",5,1,1,7,Mid-Value,Potential Loyalists
52486,45,3,"92,3",5,1,1,7,Mid-Value,Potential Loyalists
52487,780,2,"43,699999999999996",3,1,1,5,Low-Value,At Risk Customers
52489,921,3,"186,3",3,1,1,5,Low-Value,At Risk Customers
52490,414,2,"45,8",4,1,1,6,Mid-Value,Potential Loyalists
52493,490,1,"117,1",4,1,1,6,Mid-Value,Potential Loyalists
52494,57,4,"141,0",5,1,1,7,Mid-Value,Potential Loyalists
52495,0,5,"249,35000000000002",5,1,1,7,Mid-Value,Potential Loyalists
52497,276,1,"30,35",5,1,1,7,Mid-Value,Potential Loyalists
52498,181,9,"408,05",5,2,1,8,High-Value,Potential Loyalists
52501,552,2,"39,1",4,1,1,6,Mid-Value,Potential Loyalists
52502,634,7,"392,15",4,2,1,7,Mid-Value,Potential Loyalists
52504,638,3,"78,1",4,1,1,6,Mid-Value,Potential Loyalists
52505,32,6,"141,95",5,1,1,7,Mid-Value,Potential Loyalists
52507,1076,1,"146,2",3,1,1,5,Low-Value,At Risk Customers
52508,759,1,"42,1",3,1,1,5,Low-Value,At Risk Customers
52509,258,5,"102,3",5,1,1,7,Mid-Value,Potential Loyalists
52510,82,5,"61,75",5,1,1,7,Mid-Value,Potential Loyalists
52511,132,3,"200,65",5,1,1,7,Mid-Value,Potential Loyalists
52512,830,1,"196,7",3,1,1,5,Low-Value,At Risk Customers
52513,185,2,"33,0",5,1,1,7,Mid-Value,Potential Loyalists
52514,521,3,"49,6",4,1,1,6,Mid-Value,Potential Loyalists
52518,1584,1,"27,299999999999997",1,1,1,3,Low-Value,Lost
52522,784,5,"1147,8",3,1,2,6,Mid-Value,Potential Loyalists
52523,596,3,"86,05",4,1,1,6,Mid-Value,Potential Loyalists
52525,83,10,"476,09999999999997",5,2,1,8,High-Value,Potential Loyalists
52528,274,3,"39,45",5,1,1,7,Mid-Value,Potential Loyalists
52529,242,1,"5,35",5,1,1,7,Mid-Value,Potential Loyalists
52532,1621,1,"8,8",1,1,1,3,Low-Value,Lost
52533,520,5,"315,55",4,1,1,6,Mid-Value,Potential Loyalists
52534,407,1,"47,0",4,1,1,6,Mid-Value,Potential Loyalists
52537,2,19,"1013,9",5,4,2,11,High-Value,Champions
52542,1250,4,"84,35",2,1,1,4,Low-Value,Can't Lose
52543,349,5,"367,2",5,1,1,7,Mid-Value,Potential Loyalists
52544,122,11,"408,45",5,2,1,8,High-Value,Potential Loyalists
52545,152,8,"654,65",5,2,1,8,High-Value,Potential Loyalists
52546,257,1,"16,9",5,1,1,7,Mid-Value,Potential Loyalists
52548,46,11,"870,05",5,2,2,9,High-Value,Champions
52549,144,6,"291,9",5,1,1,7,Mid-Value,Potential Loyalists
52551,575,2,"28,45",4,1,1,6,Mid-Value,Potential Loyalists
52553,1114,1,"131,6",2,1,1,4,Low-Value,Can't Lose
52554,397,2,"37,45",4,1,1,6,Mid-Value,Potential Loyalists
52557,9,8,"1311,35",5,2,2,9,High-Value,Champions
52560,131,5,"269,7",5,1,1,7,Mid-Value,Potential Loyalists
52561,419,2,"55,849999999999994",4,1,1,6,Mid-Value,Potential Loyalists
52564,706,1,"15,95",4,1,1,6,Mid-Value,Potential Loyalists
52565,487,4,"312,90000000000003",4,1,1,6,Mid-Value,Potential Loyalists
52566,411,3,"122,1",4,1,1,6,Mid-Value,Potential Loyalists
52567,33,7,"470,3",5,2,1,8,High-Value,Potential Loyalists
52570,435,1,"20,65",4,1,1,6,Mid-Value,Potential Loyalists
52572,465,8,"306,85",4,2,1,7,Mid-Value,Potential Loyalists
52573,1695,1,"81,8",1,1,1,3,Low-Value,Lost
52574,1407,1,"17,35",2,1,1,4,Low-Value,Can't Lose
52575,372,4,"369,79999999999995",4,1,1,6,Mid-Value,Potential Loyalists
52577,85,1,"12,4",5,1,1,7,Mid-Value,Potential Loyalists
52578,568,3,"290,85",4,1,1,6,Mid-Value,Potential Loyalists
52580,89,7,"158,05",5,2,1,8,High-Value,Potential Loyalists
52581,521,4,"345,3",4,1,1,6,Mid-Value,Potential Loyalists
52584,108,6,"423,2",5,1,1,7,Mid-Value,Potential Loyalists
52585,1680,1,"37,85",1,1,1,3,Low-Value,Lost
52587,0,6,"232,45",5,1,1,7,Mid-Value,Potential Loyalists
52590,171,2,"34,349999999999994",5,1,1,7,Mid-Value,Potential Loyalists
52592,742,1,"5,8",3,1,1,5,Low-Value,At Risk Customers
52593,297,5,"225,0",5,1,1,7,Mid-Value,Potential Loyalists
52594,105,4,"475,45",5,1,1,7,Mid-Value,Potential Loyalists
52595,203,4,"932,6499999999999",5,1,2,8,High-Value,Potential Loyalists
52596,991,1,"16,4",3,1,1,5,Low-Value,At Risk Customers
52598,206,10,"408,3",5,2,1,8,High-Value,Potential Loyalists
52600,642,2,"46,0",4,1,1,6,Mid-Value,Potential Loyalists
52603,1140,1,"35,55",2,1,1,4,Low-Value,Can't Lose
52604,158,5,"624,3",5,1,1,7,Mid-Value,Potential Loyalists
52607,21,11,"498,5",5,2,1,8,High-Value,Potential Loyalists
52608,33,5,"287,0",5,1,1,7,Mid-Value,Potential Loyalists
52609,410,3,"114,05",4,1,1,6,Mid-Value,Potential Loyalists
52611,914,1,"146,3",3,1,1,5,Low-Value,At Risk Customers
52615,108,3,"86,94999999999999",5,1,1,7,Mid-Value,Potential Loyalists
52616,358,1,"25,0",5,1,1,7,Mid-Value,Potential Loyalists
52617,525,4,"790,8",4,1,2,7,Mid-Value,Potential Loyalists
52618,98,3,"97,5",5,1,1,7,Mid-Value,Potential Loyalists
52620,354,1,"30,35",5,1,1,7,Mid-Value,Potential Loyalists
52621,214,3,"44,95",5,1,1,7,Mid-Value,Potential Loyalists
52622,516,6,"356,79999999999995",4,1,1,6,Mid-Value,Potential Loyalists
52623,44,9,"388,8",5,2,1,8,High-Value,Potential Loyalists
52624,416,4,"81,85",4,1,1,6,Mid-Value,Potential Loyalists
52625,70,2,"76,89999999999999",5,1,1,7,Mid-Value,Potential Loyalists
52626,1087,3,"65,3",3,1,1,5,Low-Value,At Risk Customers
52627,192,3,"96,85",5,1,1,7,Mid-Value,Potential Loyalists
52629,1155,3,"186,14999999999998",2,1,1,4,Low-Value,Can't Lose
52630,1393,1,"18,75",2,1,1,4,Low-Value,Can't Lose
52631,122,2,"121,19999999999999",5,1,1,7,Mid-Value,Potential Loyalists
52633,624,3,"288,15",4,1,1,6,Mid-Value,Potential Loyalists
52634,1123,2,"380,7",2,1,1,4,Low-Value,Can't Lose
52638,134,4,"168,25",5,1,1,7,Mid-Value,Potential Loyalists
52639,161,2,"217,75",5,1,1,7,Mid-Value,Potential Loyalists
52642,711,3,"145,79999999999998",4,1,1,6,Mid-Value,Potential Loyalists
52643,605,2,"292,7",4,1,1,6,Mid-Value,Potential Loyalists
52644,1578,1,"13,45",1,1,1,3,Low-Value,Lost
52645,1156,5,"224,15",2,1,1,4,Low-Value,Can't Lose
52647,929,1,"136,15",3,1,1,5,Low-Value,At Risk Customers
52649,403,5,"283,85",4,1,1,6,Mid-Value,Potential Loyalists
52650,1272,1,"111,75",2,1,1,4,Low-Value,Can't Lose
52651,603,4,"145,70000000000002",4,1,1,6,Mid-Value,Potential Loyalists
52652,1191,1,"17,7",2,1,1,4,Low-Value,Can't Lose
52653,1599,1,"156,7",1,1,1,3,Low-Value,Lost
52654,651,3,"927,85",4,1,2,7,Mid-Value,Potential Loyalists
52655,536,5,"144,8",4,1,1,6,Mid-Value,Potential Loyalists
52656,1821,1,"2,85",1,1,1,3,Low-Value,Lost
52657,760,4,"139,65",3,1,1,5,Low-Value,At Risk Customers
52658,25,7,"320,75",5,2,1,8,High-Value,Potential Loyalists
52659,1520,1,"9,45",1,1,1,3,Low-Value,Lost
52663,1617,1,"129,9",1,1,1,3,Low-Value,Lost
52666,1178,1,"478,6",2,1,1,4,Low-Value,Can't Lose
52667,1740,1,"76,7",1,1,1,3,Low-Value,Lost
52668,1495,1,"7,75",1,1,1,3,Low-Value,Lost
52669,1748,1,"71,5",1,1,1,3,Low-Value,Lost
52670,395,2,"120,2",4,1,1,6,Mid-Value,Potential Loyalists
52673,372,7,"253,5",4,2,1,7,Mid-Value,Potential Loyalists
52674,59,6,"624,4499999999999",5,1,1,7,Mid-Value,Potential Loyalists
52675,250,4,"157,0",5,1,1,7,Mid-Value,Potential Loyalists
52676,891,1,"28,9",3,1,1,5,Low-Value,At Risk Customers
52677,685,2,"38,75",4,1,1,6,Mid-Value,Potential Loyalists
52678,1077,1,"7,7",3,1,1,5,Low-Value,At Risk Customers
52679,71,3,"113,19999999999999",5,1,1,7,Mid-Value,Potential Loyalists
52680,933,2,"185,9",3,1,1,5,Low-Value,At Risk Customers
52683,1490,2,"111,30000000000001",1,1,1,3,Low-Value,Lost
52685,19,8,"758,05",5,2,2,9,High-Value,Champions
52686,83,5,"135,65",5,1,1,7,Mid-Value,Potential Loyalists
52688,589,3,"146,54999999999998",4,1,1,6,Mid-Value,Potential Loyalists
52689,164,3,"65,3",5,1,1,7,Mid-Value,Potential Loyalists
52690,654,4,"273,6",4,1,1,6,Mid-Value,Potential Loyalists
52693,243,12,"446,8",5,3,1,9,High-Value,Champions
52694,246,3,"273,95",5,1,1,7,Mid-Value,Potential Loyalists
52695,1441,1,"126,2",2,1,1,4,Low-Value,Can't Lose
52696,304,1,"17,35",5,1,1,7,Mid-Value,Potential Loyalists
52697,150,2,"234,5",5,1,1,7,Mid-Value,Potential Loyalists
52698,337,1,"6,25",5,1,1,7,Mid-Value,Potential Loyalists
52699,1189,2,"319,40000000000003",2,1,1,4,Low-Value,Can't Lose
52700,35,4,"104,35",5,1,1,7,Mid-Value,Potential Loyalists
52701,1289,1,"96,9",2,1,1,4,Low-Value,Can't Lose
52702,251,2,"50,5",5,1,1,7,Mid-Value,Potential Loyalists
52703,547,1,"31,4",4,1,1,6,Mid-Value,Potential Loyalists
52707,600,1,"25,25",4,1,1,6,Mid-Value,Potential Loyalists
52709,185,6,"408,7",5,1,1,7,Mid-Value,Potential Loyalists
52710,372,2,"185,25",4,1,1,6,Mid-Value,Potential Loyalists
52711,867,2,"41,35",3,1,1,5,Low-Value,At Risk Customers
52712,321,2,"56,1",5,1,1,7,Mid-Value,Potential Loyalists
52713,570,2,"744,4",4,1,2,7,Mid-Value,Potential Loyalists
52714,361,5,"249,3",5,1,1,7,Mid-Value,Potential Loyalists
52715,599,4,"308,3",4,1,1,6,Mid-Value,Potential Loyalists
52717,890,2,"155,35",3,1,1,5,Low-Value,At Risk Customers
52719,53,12,"521,1",5,3,1,9,High-Value,Champions
52721,1177,1,"43,4",2,1,1,4,Low-Value,Can't Lose
52722,527,2,"245,79999999999998",4,1,1,6,Mid-Value,Potential Loyalists
52724,328,1,"38,6",5,1,1,7,Mid-Value,Potential Loyalists
52725,201,1,"348,8",5,1,1,7,Mid-Value,Potential Loyalists
52726,138,6,"583,4",5,1,1,7,Mid-Value,Potential Loyalists
52727,866,2,"319,25",3,1,1,5,Low-Value,At Risk Customers
52730,40,2,"891,0999999999999",5,1,2,8,High-Value,Potential Loyalists
52731,132,4,"241,15",5,1,1,7,Mid-Value,Potential Loyalists
52734,567,2,"58,89999999999999",4,1,1,6,Mid-Value,Potential Loyalists
52735,70,5,"238,8",5,1,1,7,Mid-Value,Potential Loyalists
52736,1244,1,"6,0",2,1,1,4,Low-Value,Can't Lose
52737,1347,2,"205,6",2,1,1,4,Low-Value,Can't Lose
52739,1186,1,"56,0",2,1,1,4,Low-Value,Can't Lose
52740,637,6,"142,29999999999998",4,1,1,6,Mid-Value,Potential Loyalists
52741,84,5,"421,1",5,1,1,7,Mid-Value,Potential Loyalists
52742,584,1,"40,2",4,1,1,6,Mid-Value,Potential Loyalists
52744,195,8,"582,45",5,2,1,8,High-Value,Potential Loyalists
52745,17,3,"244,75",5,1,1,7,Mid-Value,Potential Loyalists
52746,658,5,"210,9",4,1,1,6,Mid-Value,Potential Loyalists
52747,521,6,"359,90000000000003",4,1,1,6,Mid-Value,Potential Loyalists
52748,884,6,"421,59999999999997",3,1,1,5,Low-Value,At Risk Customers
52749,399,9,"728,8",4,2,2,8,High-Value,Potential Loyalists
52751,231,3,"175,4",5,1,1,7,Mid-Value,Potential Loyalists
52753,6,3,"102,14999999999999",5,1,1,7,Mid-Value,Potential Loyalists
52754,274,2,"76,2",5,1,1,7,Mid-Value,Potential Loyalists
52756,71,9,"1193,3500000000001",5,2,2,9,High-Value,Champions
52758,1083,1,"49,1",3,1,1,5,Low-Value,At Risk Customers
52761,1002,1,"22,0",3,1,1,5,Low-Value,At Risk Customers
52763,46,1,"55,25",5,1,1,7,Mid-Value,Potential Loyalists
52764,538,6,"390,45",4,1,1,6,Mid-Value,Potential Loyalists
52766,850,1,"87,5",3,1,1,5,Low-Value,At Risk Customers
52769,826,1,"22,1",3,1,1,5,Low-Value,At Risk Customers
52770,693,1,"27,35",4,1,1,6,Mid-Value,Potential Loyalists
52771,1179,4,"58,08",2,1,1,4,Low-Value,Can't Lose
52772,2,1,"121,5",5,1,1,7,Mid-Value,Potential Loyalists
52773,132,3,"176,0",5,1,1,7,Mid-Value,Potential Loyalists
52776,1620,1,"11,65",1,1,1,3,Low-Value,Lost
52779,195,3,"642,0999999999999",5,1,1,7,Mid-Value,Potential Loyalists
52780,187,9,"654,75",5,2,1,8,High-Value,Potential Loyalists
52781,480,6,"666,3",4,1,2,7,Mid-Value,Potential Loyalists
52782,1040,1,"14,8",3,1,1,5,Low-Value,At Risk Customers
52783,1573,2,"61,2",1,1,1,3,Low-Value,Lost
52784,229,3,"214,14999999999998",5,1,1,7,Mid-Value,Potential Loyalists
52787,651,1,"86,1",4,1,1,6,Mid-Value,Potential Loyalists
52788,65,8,"675,0500000000001",5,2,2,9,High-Value,Champions
52789,98,3,"156,35",5,1,1,7,Mid-Value,Potential Loyalists
52791,217,2,"63,75",5,1,1,7,Mid-Value,Potential Loyalists
52792,249,2,"104,89999999999999",5,1,1,7,Mid-Value,Potential Loyalists
52793,245,3,"153,85",5,1,1,7,Mid-Value,Potential Loyalists
52794,767,4,"432,00000000000006",3,1,1,5,Low-Value,At Risk Customers
52795,743,5,"712,75",3,1,2,6,Mid-Value,Potential Loyalists
52796,631,2,"64,85",4,1,1,6,Mid-Value,Potential Loyalists
52798,56,1,"23,45",5,1,1,7,Mid-Value,Potential Loyalists
52799,1208,2,"333,79999999999995",2,1,1,4,Low-Value,Can't Lose
52801,101,2,"89,55",5,1,1,7,Mid-Value,Potential Loyalists
52802,75,3,"228,5",5,1,1,7,Mid-Value,Potential Loyalists
52803,671,9,"506,75",4,2,1,7,Mid-Value,Potential Loyalists
52805,271,2,"88,4",5,1,1,7,Mid-Value,Potential Loyalists
52807,584,3,"104,75",4,1,1,6,Mid-Value,Potential Loyalists
52808,1007,1,"12,95",3,1,1,5,Low-Value,At Risk Customers
52809,872,3,"142,76",3,1,1,5,Low-Value,At Risk Customers
52810,1267,2,"41,199999999999996",2,1,1,4,Low-Value,Can't Lose
52811,1330,1,"155,7",2,1,1,4,Low-Value,Can't Lose
52812,363,1,"235,6",5,1,1,7,Mid-Value,Potential Loyalists
52813,214,1,"22,25",5,1,1,7,Mid-Value,Potential Loyalists
52814,754,4,"1637,3",3,1,3,7,Mid-Value,Potential Loyalists
52815,756,2,"151,95",3,1,1,5,Low-Value,At Risk Customers
52816,733,3,"82,7",3,1,1,5,Low-Value,At Risk Customers
52817,186,4,"119,0",5,1,1,7,Mid-Value,Potential Loyalists
52819,710,5,"199,95",4,1,1,6,Mid-Value,Potential Loyalists
52821,1293,1,"34,4",2,1,1,4,Low-Value,Can't Lose
52822,1716,1,"40,65",1,1,1,3,Low-Value,Lost
52823,1507,2,"268,55",1,1,1,3,Low-Value,Lost
52824,853,1,"57,4",3,1,1,5,Low-Value,At Risk Customers
52825,348,3,"70,0",5,1,1,7,Mid-Value,Potential Loyalists
52826,978,2,"191,64999999999998",3,1,1,5,Low-Value,At Risk Customers
52827,136,1,"60,5",5,1,1,7,Mid-Value,Potential Loyalists
52829,654,5,"161,5",4,1,1,6,Mid-Value,Potential Loyalists
52830,457,5,"299,95",4,1,1,6,Mid-Value,Potential Loyalists
52831,1287,1,"94,8",2,1,1,4,Low-Value,Can't Lose
52832,537,8,"280,35",4,2,1,7,Mid-Value,Potential Loyalists
52834,1788,1,"32,15",1,1,1,3,Low-Value,Lost
52835,45,7,"525,4",5,2,1,8,High-Value,Potential Loyalists
52839,145,6,"200,35",5,1,1,7,Mid-Value,Potential Loyalists
52840,1013,4,"176,65",3,1,1,5,Low-Value,At Risk Customers
52841,550,1,"53,5",4,1,1,6,Mid-Value,Potential Loyalists
52842,35,4,"277,7",5,1,1,7,Mid-Value,Potential Loyalists
52843,213,4,"246,85",5,1,1,7,Mid-Value,Potential Loyalists
52845,374,3,"84,65",4,1,1,6,Mid-Value,Potential Loyalists
52846,19,4,"213,25",5,1,1,7,Mid-Value,Potential Loyalists
52847,855,1,"24,2",3,1,1,5,Low-Value,At Risk Customers
52848,515,4,"586,9",4,1,1,6,Mid-Value,Potential Loyalists
52850,1099,3,"115,49999999999999",2,1,1,4,Low-Value,Can't Lose
52853,739,4,"887,3",3,1,2,6,Mid-Value,Potential Loyalists
52854,4,6,"262,75",5,1,1,7,Mid-Value,Potential Loyalists
52857,1123,2,"32,300000000000004",2,1,1,4,Low-Value,Can't Lose
52858,179,5,"112,14999999999999",5,1,1,7,Mid-Value,Potential Loyalists
52859,702,1,"0,6",4,1,1,6,Mid-Value,Potential Loyalists
52860,7,5,"397,15",5,1,1,7,Mid-Value,Potential Loyalists
52861,322,4,"254,0",5,1,1,7,Mid-Value,Potential Loyalists
52862,68,5,"222,95000000000002",5,1,1,7,Mid-Value,Potential Loyalists
52863,144,9,"500,79999999999995",5,2,1,8,High-Value,Potential Loyalists
52864,11,4,"102,2",5,1,1,7,Mid-Value,Potential Loyalists
52867,28,9,"1441,6",5,2,3,10,High-Value,Champions
52868,1124,6,"670,55",2,1,2,5,Low-Value,At Risk Customers
52869,108,7,"375,70000000000005",5,2,1,8,High-Value,Potential Loyalists
52870,12,2,"133,5",5,1,1,7,Mid-Value,Potential Loyalists
52872,1305,1,"15,4",2,1,1,4,Low-Value,Can't Lose
52874,314,5,"348,35",5,1,1,7,Mid-Value,Potential Loyalists
52876,610,1,"39,9",4,1,1,6,Mid-Value,Potential Loyalists
52878,825,1,"249,8",3,1,1,5,Low-Value,At Risk Customers
52879,1053,2,"111,14999999999999",3,1,1,5,Low-Value,At Risk Customers
52881,7,4,"131,35",5,1,1,7,Mid-Value,Potential Loyalists
52883,41,4,"278,1",5,1,1,7,Mid-Value,Potential Loyalists
52884,370,2,"109,0",4,1,1,6,Mid-Value,Potential Loyalists
52885,1810,1,"135,4",1,1,1,3,Low-Value,Lost
52887,1135,3,"127,81",2,1,1,4,Low-Value,Can't Lose
52889,1355,1,"77,25",2,1,1,4,Low-Value,Can't Lose
52893,188,6,"190,2",5,1,1,7,Mid-Value,Potential Loyalists
52894,256,2,"203,64999999999998",5,1,1,7,Mid-Value,Potential Loyalists
52896,397,3,"117,2",4,1,1,6,Mid-Value,Potential Loyalists
52897,1824,1,"50,55",1,1,1,3,Low-Value,Lost
52899,193,2,"165,64999999999998",5,1,1,7,Mid-Value,Potential Loyalists
52900,103,3,"51,0",5,1,1,7,Mid-Value,Potential Loyalists
52901,1107,3,"117,15",2,1,1,4,Low-Value,Can't Lose
52903,235,6,"353,95",5,1,1,7,Mid-Value,Potential Loyalists
52905,17,6,"202,1",5,1,1,7,Mid-Value,Potential Loyalists
52907,835,1,"41,6",3,1,1,5,Low-Value,At Risk Customers
52909,550,1,"76,3",4,1,1,6,Mid-Value,Potential Loyalists
52911,47,11,"450,0",5,2,1,8,High-Value,Potential Loyalists
52912,569,7,"311,7",4,2,1,7,Mid-Value,Potential Loyalists
52914,35,2,"35,6",5,1,1,7,Mid-Value,Potential Loyalists
52916,386,1,"68,7",4,1,1,6,Mid-Value,Potential Loyalists
52919,45,5,"193,5",5,1,1,7,Mid-Value,Potential Loyalists
52920,424,4,"321,55",4,1,1,6,Mid-Value,Potential Loyalists
52921,526,1,"122,25",4,1,1,6,Mid-Value,Potential Loyalists
52922,172,2,"97,65",5,1,1,7,Mid-Value,Potential Loyalists
52923,381,4,"303,84999999999997",4,1,1,6,Mid-Value,Potential Loyalists
52924,840,4,"57,4",3,1,1,5,Low-Value,At Risk Customers
52925,1209,1,"7,7",2,1,1,4,Low-Value,Can't Lose
52927,154,5,"302,55",5,1,1,7,Mid-Value,Potential Loyalists
52928,269,4,"186,85",5,1,1,7,Mid-Value,Potential Loyalists
52929,1248,2,"76,7",2,1,1,4,Low-Value,Can't Lose
52931,21,5,"410,9",5,1,1,7,Mid-Value,Potential Loyalists
52933,380,2,"431,2",4,1,1,6,Mid-Value,Potential Loyalists
52934,93,2,"192,95000000000002",5,1,1,7,Mid-Value,Potential Loyalists
52935,43,5,"398,9",5,1,1,7,Mid-Value,Potential Loyalists
52936,441,5,"85,45",4,1,1,6,Mid-Value,Potential Loyalists
52937,3,10,"519,0",5,2,1,8,High-Value,Potential Loyalists
52938,1123,3,"640,3",2,1,1,4,Low-Value,Can't Lose
52940,924,1,"215,85000000000002",3,1,1,5,Low-Value,At Risk Customers
52941,94,2,"36,15",5,1,1,7,Mid-Value,Potential Loyalists
52942,161,4,"164,4",5,1,1,7,Mid-Value,Potential Loyalists
52943,886,2,"103,0",3,1,1,5,Low-Value,At Risk Customers
52945,852,1,"24,5",3,1,1,5,Low-Value,At Risk Customers
52946,1229,3,"225,45000000000002",2,1,1,4,Low-Value,Can't Lose
52947,732,2,"334,45",3,1,1,5,Low-Value,At Risk Customers
52949,122,1,"20,6",5,1,1,7,Mid-Value,Potential Loyalists
52951,777,5,"209,4",3,1,1,5,Low-Value,At Risk Customers
52953,180,6,"114,35",5,1,1,7,Mid-Value,Potential Loyalists
52958,1125,2,"135,05",2,1,1,4,Low-Value,Can't Lose
52960,561,5,"229,25",4,1,1,6,Mid-Value,Potential Loyalists
52961,172,1,"19,5",5,1,1,7,Mid-Value,Potential Loyalists
52962,5,1,"19,35",5,1,1,7,Mid-Value,Potential Loyalists
52966,190,10,"1182,95",5,2,2,9,High-Value,Champions
52968,601,5,"277,09999999999997",4,1,1,6,Mid-Value,Potential Loyalists
52970,995,2,"126,6",3,1,1,5,Low-Value,At Risk Customers
52972,772,4,"71,25",3,1,1,5,Low-Value,At Risk Customers
52973,268,3,"187,35000000000002",5,1,1,7,Mid-Value,Potential Loyalists
52974,769,8,"1064,55",3,2,2,7,Mid-Value,Potential Loyalists
52975,185,3,"81,65",5,1,1,7,Mid-Value,Potential Loyalists
52976,591,1,"4,15",4,1,1,6,Mid-Value,Potential Loyalists
52977,339,6,"183,95",5,1,1,7,Mid-Value,Potential Loyalists
52978,59,7,"330,25",5,2,1,8,High-Value,Potential Loyalists
52979,154,3,"199,95",5,1,1,7,Mid-Value,Potential Loyalists
52980,64,6,"284,4",5,1,1,7,Mid-Value,Potential Loyalists
52981,1379,1,"83,4",2,1,1,4,Low-Value,Can't Lose
52982,187,2,"356,05",5,1,1,7,Mid-Value,Potential Loyalists
52983,1593,1,"103,0",1,1,1,3,Low-Value,Lost
52984,766,4,"212,95",3,1,1,5,Low-Value,At Risk Customers
52986,473,5,"480,95",4,1,1,6,Mid-Value,Potential Loyalists
52987,261,4,"36,58",5,1,1,7,Mid-Value,Potential Loyalists
52988,179,2,"156,0",5,1,1,7,Mid-Value,Potential Loyalists
52992,309,1,"68,6",5,1,1,7,Mid-Value,Potential Loyalists
52993,692,4,"152,7",4,1,1,6,Mid-Value,Potential Loyalists
52994,546,2,"168,55",4,1,1,6,Mid-Value,Potential Loyalists
52995,1021,1,"16,8",3,1,1,5,Low-Value,At Risk Customers
52997,1653,1,"92,1",1,1,1,3,Low-Value,Lost
53000,1496,2,"109,94999999999999",1,1,1,3,Low-Value,Lost
53004,15,2,"31,9",5,1,1,7,Mid-Value,Potential Loyalists
53005,141,2,"81,7",5,1,1,7,Mid-Value,Potential Loyalists
53006,48,6,"233,7",5,1,1,7,Mid-Value,Potential Loyalists
53007,934,4,"173,75",3,1,1,5,Low-Value,At Risk Customers
53008,190,7,"602,15",5,2,1,8,High-Value,Potential Loyalists
53010,202,4,"91,05",5,1,1,7,Mid-Value,Potential Loyalists
53011,316,3,"228,55",5,1,1,7,Mid-Value,Potential Loyalists
53014,1010,1,"103,25",3,1,1,5,Low-Value,At Risk Customers
53017,256,5,"590,85",5,1,1,7,Mid-Value,Potential Loyalists
53018,487,2,"135,7",4,1,1,6,Mid-Value,Potential Loyalists
53019,1457,1,"38,35",2,1,1,4,Low-Value,Can't Lose
53020,140,1,"99,6",5,1,1,7,Mid-Value,Potential Loyalists
53021,1629,2,"51,849999999999994",1,1,1,3,Low-Value,Lost
53022,19,2,"105,0",5,1,1,7,Mid-Value,Potential Loyalists
53023,1669,2,"384,45",1,1,1,3,Low-Value,Lost
53024,427,4,"81,1",4,1,1,6,Mid-Value,Potential Loyalists
53025,1450,2,"34,65",2,1,1,4,Low-Value,Can't Lose
53026,1119,1,"139,8",2,1,1,4,Low-Value,Can't Lose
53027,102,1,"38,7",5,1,1,7,Mid-Value,Potential Loyalists
53028,83,5,"239,25",5,1,1,7,Mid-Value,Potential Loyalists
53030,760,2,"541,1999999999999",3,1,1,5,Low-Value,At Risk Customers
53031,25,2,"135,4",5,1,1,7,Mid-Value,Potential Loyalists
53032,1010,2,"74,05",3,1,1,5,Low-Value,At Risk Customers
53034,1005,3,"131,5",3,1,1,5,Low-Value,At Risk Customers
53035,1148,1,"9,95",2,1,1,4,Low-Value,Can't Lose
53038,74,3,"138,6",5,1,1,7,Mid-Value,Potential Loyalists
53039,1349,1,"15,4",2,1,1,4,Low-Value,Can't Lose
53040,239,9,"1131,8999999999999",5,2,2,9,High-Value,Champions
53042,1213,1,"58,6",2,1,1,4,Low-Value,Can't Lose
53043,1538,1,"20,5",1,1,1,3,Low-Value,Lost
53044,824,6,"247,5",3,1,1,5,Low-Value,At Risk Customers
53047,1480,1,"14,45",1,1,1,3,Low-Value,Lost
53049,716,3,"458,9",4,1,1,6,Mid-Value,Potential Loyalists
53057,31,5,"987,3000000000001",5,1,2,8,High-Value,Potential Loyalists
53058,549,1,"55,050000000000004",4,1,1,6,Mid-Value,Potential Loyalists
53059,1637,1,"17,0",1,1,1,3,Low-Value,Lost
53060,559,1,"34,9",4,1,1,6,Mid-Value,Potential Loyalists
53061,1347,1,"109,1",2,1,1,4,Low-Value,Can't Lose
53063,211,2,"89,15",5,1,1,7,Mid-Value,Potential Loyalists
53064,997,1,"24,0",3,1,1,5,Low-Value,At Risk Customers
53065,164,2,"133,45",5,1,1,7,Mid-Value,Potential Loyalists
53067,217,4,"139,05",5,1,1,7,Mid-Value,Potential Loyalists
53068,195,1,"90,7",5,1,1,7,Mid-Value,Potential Loyalists
53069,635,2,"68,45",4,1,1,6,Mid-Value,Potential Loyalists
53070,1624,1,"13,15",1,1,1,3,Low-Value,Lost
53072,1486,1,"59,4",1,1,1,3,Low-Value,Lost
53073,1029,1,"79,0",3,1,1,5,Low-Value,At Risk Customers
53076,199,5,"610,1500000000001",5,1,1,7,Mid-Value,Potential Loyalists
53077,515,6,"280,35",4,1,1,6,Mid-Value,Potential Loyalists
53078,395,17,"2420,5",4,4,4,12,High-Value,Champions
53079,25,7,"315,05",5,2,1,8,High-Value,Potential Loyalists
53080,634,1,"16,85",4,1,1,6,Mid-Value,Potential Loyalists
53083,604,2,"285,5",4,1,1,6,Mid-Value,Potential Loyalists
53084,706,6,"732,45",4,1,2,7,Mid-Value,Potential Loyalists
53086,236,1,"16,75",5,1,1,7,Mid-Value,Potential Loyalists
53087,757,2,"308,0",3,1,1,5,Low-Value,At Risk Customers
53088,507,3,"95,3",4,1,1,6,Mid-Value,Potential Loyalists
53093,1508,1,"15,0",1,1,1,3,Low-Value,Lost
53095,1021,2,"79,4",3,1,1,5,Low-Value,At Risk Customers
53096,517,2,"108,5",4,1,1,6,Mid-Value,Potential Loyalists
53097,87,2,"148,15",5,1,1,7,Mid-Value,Potential Loyalists
53098,1167,6,"169,75",2,1,1,4,Low-Value,Can't Lose
53100,19,2,"59,7",5,1,1,7,Mid-Value,Potential Loyalists
53102,1032,2,"76,2",3,1,1,5,Low-Value,At Risk Customers
53104,110,5,"551,85",5,1,1,7,Mid-Value,Potential Loyalists
53105,252,7,"435,75",5,2,1,8,High-Value,Potential Loyalists
53106,1348,2,"75,44999999999999",2,1,1,4,Low-Value,Can't Lose
53110,986,1,"84,6",3,1,1,5,Low-Value,At Risk Customers
53111,1054,1,"13,35",3,1,1,5,Low-Value,At Risk Customers
53112,1245,3,"53,900000000000006",2,1,1,4,Low-Value,Can't Lose
53114,460,3,"331,3",4,1,1,6,Mid-Value,Potential Loyalists
53116,486,3,"82,35",4,1,1,6,Mid-Value,Potential Loyalists
53117,527,2,"61,5",4,1,1,6,Mid-Value,Potential Loyalists
53118,76,5,"233,64999999999998",5,1,1,7,Mid-Value,Potential Loyalists
53120,1278,1,"49,199999999999996",2,1,1,4,Low-Value,Can't Lose
53124,366,10,"522,25",4,2,1,7,Mid-Value,Potential Loyalists
53125,501,4,"700,75",4,1,2,7,Mid-Value,Potential Loyalists
53127,392,1,"63,5",4,1,1,6,Mid-Value,Potential Loyalists
53128,663,3,"245,10000000000002",4,1,1,6,Mid-Value,Potential Loyalists
53129,113,3,"53,8",5,1,1,7,Mid-Value,Potential Loyalists
53130,21,14,"713,8",5,3,2,10,High-Value,Champions
53133,214,4,"327,55",5,1,1,7,Mid-Value,Potential Loyalists
53134,749,3,"201,55",3,1,1,5,Low-Value,At Risk Customers
53136,93,4,"99,2",5,1,1,7,Mid-Value,Potential Loyalists
53138,1334,1,"9,35",2,1,1,4,Low-Value,Can't Lose
53140,141,3,"357,65",5,1,1,7,Mid-Value,Potential Loyalists
53142,1106,2,"76,7",2,1,1,4,Low-Value,Can't Lose
53143,1553,2,"59,1",1,1,1,3,Low-Value,Lost
53145,1268,1,"19,0",2,1,1,4,Low-Value,Can't Lose
53146,0,1,"177,0",5,1,1,7,Mid-Value,Potential Loyalists
53149,767,7,"216,00000000000003",3,2,1,6,Mid-Value,Potential Loyalists
53151,766,3,"112,0",3,1,1,5,Low-Value,At Risk Customers
53152,622,3,"39,0",4,1,1,6,Mid-Value,Potential Loyalists
53153,993,2,"182,95",3,1,1,5,Low-Value,At Risk Customers
53154,11,4,"306,65",5,1,1,7,Mid-Value,Potential Loyalists
53155,983,1,"42,15",3,1,1,5,Low-Value,At Risk Customers
53156,689,1,"16,0",4,1,1,6,Mid-Value,Potential Loyalists
53157,214,1,"9,85",5,1,1,7,Mid-Value,Potential Loyalists
53158,10,1,"20,0",5,1,1,7,Mid-Value,Potential Loyalists
53160,40,4,"125,19999999999999",5,1,1,7,Mid-Value,Potential Loyalists
53161,273,4,"235,4",5,1,1,7,Mid-Value,Potential Loyalists
53162,402,2,"67,55000000000001",4,1,1,6,Mid-Value,Potential Loyalists
53164,365,4,"176,45000000000002",5,1,1,7,Mid-Value,Potential Loyalists
53167,3,3,"649,4",5,1,1,7,Mid-Value,Potential Loyalists
53168,1648,1,"37,5",1,1,1,3,Low-Value,Lost
53169,556,2,"11,350000000000001",4,1,1,6,Mid-Value,Potential Loyalists
53170,1627,1,"147,2",1,1,1,3,Low-Value,Lost
53171,527,2,"384,75",4,1,1,6,Mid-Value,Potential Loyalists
53172,737,1,"60,2",3,1,1,5,Low-Value,At Risk Customers
53174,1447,1,"22,45",2,1,1,4,Low-Value,Can't Lose
53175,184,1,"108,89999999999999",5,1,1,7,Mid-Value,Potential Loyalists
53176,1097,2,"514,5",2,1,1,4,Low-Value,Can't Lose
53178,1138,4,"159,5",2,1,1,4,Low-Value,Can't Lose
53179,187,1,"245,2",5,1,1,7,Mid-Value,Potential Loyalists
53180,567,1,"364,5",4,1,1,6,Mid-Value,Potential Loyalists
53183,341,1,"17,25",5,1,1,7,Mid-Value,Potential Loyalists
53184,56,1,"33,7",5,1,1,7,Mid-Value,Potential Loyalists
53185,860,1,"67,8",3,1,1,5,Low-Value,At Risk Customers
53188,1056,1,"87,1",3,1,1,5,Low-Value,At Risk Customers
53190,224,2,"148,54999999999998",5,1,1,7,Mid-Value,Potential Loyalists
53191,777,3,"113,55",3,1,1,5,Low-Value,At Risk Customers
53194,61,7,"440,7",5,2,1,8,High-Value,Potential Loyalists
53196,841,4,"214,75",3,1,1,5,Low-Value,At Risk Customers
53197,71,7,"672,8",5,2,2,9,High-Value,Champions
53198,60,4,"286,54999999999995",5,1,1,7,Mid-Value,Potential Loyalists
53199,450,3,"186,45",4,1,1,6,Mid-Value,Potential Loyalists
53200,579,3,"498,9",4,1,1,6,Mid-Value,Potential Loyalists
53203,230,1,"31,950000000000003",5,1,1,7,Mid-Value,Potential Loyalists
53204,223,2,"223,64999999999998",5,1,1,7,Mid-Value,Potential Loyalists
53205,92,4,"142,1",5,1,1,7,Mid-Value,Potential Loyalists
53206,746,1,"102,8",3,1,1,5,Low-Value,At Risk Customers
53207,21,5,"153,29999999999998",5,1,1,7,Mid-Value,Potential Loyalists
53208,1694,1,"6,6",1,1,1,3,Low-Value,Lost
53211,609,3,"190,35",4,1,1,6,Mid-Value,Potential Loyalists
53212,87,3,"104,55",5,1,1,7,Mid-Value,Potential Loyalists
53214,149,2,"235,6",5,1,1,7,Mid-Value,Potential Loyalists
53217,1527,2,"120,30000000000001",1,1,1,3,Low-Value,Lost
53218,9,4,"231,45",5,1,1,7,Mid-Value,Potential Loyalists
53219,246,1,"31,2",5,1,1,7,Mid-Value,Potential Loyalists
53220,326,2,"332,9",5,1,1,7,Mid-Value,Potential Loyalists
53221,524,2,"168,95000000000002",4,1,1,6,Mid-Value,Potential Loyalists
53222,44,9,"1132,05",5,2,2,9,High-Value,Champions
53224,22,3,"155,95",5,1,1,7,Mid-Value,Potential Loyalists
53225,22,2,"101,4",5,1,1,7,Mid-Value,Potential Loyalists
53226,1520,2,"162,7",1,1,1,3,Low-Value,Lost
53228,1595,1,"136,0",1,1,1,3,Low-Value,Lost
53229,472,2,"101,0",4,1,1,6,Mid-Value,Potential Loyalists
53230,1224,3,"34,5",2,1,1,4,Low-Value,Can't Lose
53232,614,2,"81,6",4,1,1,6,Mid-Value,Potential Loyalists
53233,1153,2,"43,5",2,1,1,4,Low-Value,Can't Lose
53235,276,1,"79,0",5,1,1,7,Mid-Value,Potential Loyalists
53236,1415,3,"272,35",2,1,1,4,Low-Value,Can't Lose
53237,260,1,"15,8",5,1,1,7,Mid-Value,Potential Loyalists
53239,19,5,"625,3",5,1,1,7,Mid-Value,Potential Loyalists
53241,1141,1,"20,4",2,1,1,4,Low-Value,Can't Lose
53245,1139,2,"46,85",2,1,1,4,Low-Value,Can't Lose
53247,367,4,"159,9",4,1,1,6,Mid-Value,Potential Loyalists
53248,427,2,"169,75",4,1,1,6,Mid-Value,Potential Loyalists
53249,113,5,"177,4",5,1,1,7,Mid-Value,Potential Loyalists
53251,145,1,"134,85000000000002",5,1,1,7,Mid-Value,Potential Loyalists
53253,584,9,"341,0",4,2,1,7,Mid-Value,Potential Loyalists
53254,22,4,"300,15",5,1,1,7,Mid-Value,Potential Loyalists
53255,1589,1,"30,2",1,1,1,3,Low-Value,Lost
53256,24,3,"76,5",5,1,1,7,Mid-Value,Potential Loyalists
53257,340,11,"621,4499999999999",5,2,1,8,High-Value,Potential Loyalists
53259,1123,1,"276,8",2,1,1,4,Low-Value,Can't Lose
53260,664,3,"199,7",4,1,1,6,Mid-Value,Potential Loyalists
53261,188,4,"84,30000000000001",5,1,1,7,Mid-Value,Potential Loyalists
53262,74,8,"199,3",5,2,1,8,High-Value,Potential Loyalists
53264,257,3,"131,7",5,1,1,7,Mid-Value,Potential Loyalists
53266,249,2,"112,24999999999999",5,1,1,7,Mid-Value,Potential Loyalists
53267,114,4,"207,6",5,1,1,7,Mid-Value,Potential Loyalists
53268,52,4,"383,6",5,1,1,7,Mid-Value,Potential Loyalists
53269,921,3,"141,14999999999998",3,1,1,5,Low-Value,At Risk Customers
53271,1306,2,"59,0",2,1,1,4,Low-Value,Can't Lose
53272,747,7,"147,6",3,2,1,6,Mid-Value,Potential Loyalists
53273,12,9,"430,15000000000003",5,2,1,8,High-Value,Potential Loyalists
53275,334,3,"104,3",5,1,1,7,Mid-Value,Potential Loyalists
53276,403,11,"428,15",4,2,1,7,Mid-Value,Potential Loyalists
53277,1141,2,"115,55",2,1,1,4,Low-Value,Can't Lose
53278,94,5,"209,1",5,1,1,7,Mid-Value,Potential Loyalists
53279,96,6,"414,0",5,1,1,7,Mid-Value,Potential Loyalists
53280,59,2,"179,85",5,1,1,7,Mid-Value,Potential Loyalists
53282,26,3,"243,3",5,1,1,7,Mid-Value,Potential Loyalists
53285,1359,1,"35,0",2,1,1,4,Low-Value,Can't Lose
53286,187,3,"61,95",5,1,1,7,Mid-Value,Potential Loyalists
53288,16,11,"880,15",5,2,2,9,High-Value,Champions
53290,700,2,"154,2",4,1,1,6,Mid-Value,Potential Loyalists
53292,213,4,"133,7",5,1,1,7,Mid-Value,Potential Loyalists
53294,748,4,"247,35",3,1,1,5,Low-Value,At Risk Customers
53295,40,2,"203,2",5,1,1,7,Mid-Value,Potential Loyalists
53296,498,1,"227,3",4,1,1,6,Mid-Value,Potential Loyalists
53298,733,4,"232,0",3,1,1,5,Low-Value,At Risk Customers
53299,595,3,"204,15",4,1,1,6,Mid-Value,Potential Loyalists
53300,248,3,"86,2",5,1,1,7,Mid-Value,Potential Loyalists
53301,452,2,"44,3",4,1,1,6,Mid-Value,Potential Loyalists
53302,1127,3,"52,5",2,1,1,4,Low-Value,Can't Lose
53303,14,3,"148,35",5,1,1,7,Mid-Value,Potential Loyalists
53304,49,4,"80,7",5,1,1,7,Mid-Value,Potential Loyalists
53305,307,3,"43,25",5,1,1,7,Mid-Value,Potential Loyalists
53306,21,7,"710,7",5,2,2,9,High-Value,Champions
53307,36,8,"479,8",5,2,1,8,High-Value,Potential Loyalists
53309,436,2,"12,2",4,1,1,6,Mid-Value,Potential Loyalists
53310,253,6,"512,65",5,1,1,7,Mid-Value,Potential Loyalists
53312,28,5,"197,8",5,1,1,7,Mid-Value,Potential Loyalists
53316,738,5,"262,7",3,1,1,5,Low-Value,At Risk Customers
53317,1244,2,"165,2",2,1,1,4,Low-Value,Can't Lose
53318,213,7,"450,75",5,2,1,8,High-Value,Potential Loyalists
53319,1163,3,"109,7",2,1,1,4,Low-Value,Can't Lose
53320,718,1,"4,6",4,1,1,6,Mid-Value,Potential Loyalists
53322,393,2,"243,54999999999998",4,1,1,6,Mid-Value,Potential Loyalists
53323,1706,1,"57,6",1,1,1,3,Low-Value,Lost
53324,1,3,"151,15",5,1,1,7,Mid-Value,Potential Loyalists
53326,994,1,"28,8",3,1,1,5,Low-Value,At Risk Customers
53328,627,3,"49,4",4,1,1,6,Mid-Value,Potential Loyalists
53330,80,9,"288,90000000000003",5,2,1,8,High-Value,Potential Loyalists
53331,1000,1,"15,7",3,1,1,5,Low-Value,At Risk Customers
53333,856,4,"229,45",3,1,1,5,Low-Value,At Risk Customers
53334,361,1,"57,7",5,1,1,7,Mid-Value,Potential Loyalists
53336,97,2,"164,35000000000002",5,1,1,7,Mid-Value,Potential Loyalists
53337,851,1,"7,25",3,1,1,5,Low-Value,At Risk Customers
53338,350,2,"163,39999999999998",5,1,1,7,Mid-Value,Potential Loyalists
53340,406,3,"96,45",4,1,1,6,Mid-Value,Potential Loyalists
53342,585,6,"260,7",4,1,1,6,Mid-Value,Potential Loyalists
53343,360,3,"81,94999999999999",5,1,1,7,Mid-Value,Potential Loyalists
53344,87,7,"211,95",5,2,1,8,High-Value,Potential Loyalists
53345,188,6,"780,5",5,1,2,8,High-Value,Potential Loyalists
53346,863,2,"194,5",3,1,1,5,Low-Value,At Risk Customers
53348,602,5,"285,7",4,1,1,6,Mid-Value,Potential Loyalists
53349,46,5,"262,95",5,1,1,7,Mid-Value,Potential Loyalists
53352,13,16,"1678,9",5,3,3,11,High-Value,Champions
53357,441,4,"238,45000000000002",4,1,1,6,Mid-Value,Potential Loyalists
53359,147,1,"93,3",5,1,1,7,Mid-Value,Potential Loyalists
53360,68,1,"63,05",5,1,1,7,Mid-Value,Potential Loyalists
53362,242,6,"192,2",5,1,1,7,Mid-Value,Potential Loyalists
53365,422,3,"80,45",4,1,1,6,Mid-Value,Potential Loyalists
53366,312,4,"277,4",5,1,1,7,Mid-Value,Potential Loyalists
53367,22,4,"237,7",5,1,1,7,Mid-Value,Potential Loyalists
53369,188,1,"75,75",5,1,1,7,Mid-Value,Potential Loyalists
53370,71,1,"50,9",5,1,1,7,Mid-Value,Potential Loyalists
53373,129,4,"675,65",5,1,2,8,High-Value,Potential Loyalists
53378,507,1,"230,9",4,1,1,6,Mid-Value,Potential Loyalists
53380,427,3,"92,3",4,1,1,6,Mid-Value,Potential Loyalists
53382,136,3,"87,8",5,1,1,7,Mid-Value,Potential Loyalists
53383,1351,1,"9,3",2,1,1,4,Low-Value,Can't Lose
53384,245,3,"368,35",5,1,1,7,Mid-Value,Potential Loyalists
53387,77,12,"1315,3",5,3,2,10,High-Value,Champions
53390,840,7,"268,85",3,2,1,6,Mid-Value,Potential Loyalists
53392,713,9,"557,7",4,2,1,7,Mid-Value,Potential Loyalists
53393,1086,1,"68,0",3,1,1,5,Low-Value,At Risk Customers
53394,1014,1,"112,85",3,1,1,5,Low-Value,At Risk Customers
53395,195,3,"256,3",5,1,1,7,Mid-Value,Potential Loyalists
53397,1098,4,"447,75",2,1,1,4,Low-Value,Can't Lose
53398,119,3,"64,45",5,1,1,7,Mid-Value,Potential Loyalists
53399,523,3,"320,1",4,1,1,6,Mid-Value,Potential Loyalists
53400,1169,3,"77,3",2,1,1,4,Low-Value,Can't Lose
53401,1586,2,"87,8",1,1,1,3,Low-Value,Lost
53402,1140,1,"60,9",2,1,1,4,Low-Value,Can't Lose
53403,410,1,"21,95",4,1,1,6,Mid-Value,Potential Loyalists
53404,1528,1,"38,6",1,1,1,3,Low-Value,Lost
53408,124,2,"49,2",5,1,1,7,Mid-Value,Potential Loyalists
53411,700,1,"6,35",4,1,1,6,Mid-Value,Potential Loyalists
53413,641,1,"84,85",4,1,1,6,Mid-Value,Potential Loyalists
53414,876,3,"396,8",3,1,1,5,Low-Value,At Risk Customers
53416,452,2,"50,4",4,1,1,6,Mid-Value,Potential Loyalists
53418,1571,2,"57,300000000000004",1,1,1,3,Low-Value,Lost
53419,632,2,"82,55",4,1,1,6,Mid-Value,Potential Loyalists
53422,525,8,"481,75",4,2,1,7,Mid-Value,Potential Loyalists
53424,399,2,"61,55",4,1,1,6,Mid-Value,Potential Loyalists
53426,603,3,"296,4",4,1,1,6,Mid-Value,Potential Loyalists
53428,283,2,"100,25",5,1,1,7,Mid-Value,Potential Loyalists
53429,391,3,"314,65",4,1,1,6,Mid-Value,Potential Loyalists
53433,136,14,"1259,3",5,3,2,10,High-Value,Champions
53434,1054,5,"472,30000000000007",3,1,1,5,Low-Value,At Risk Customers
53435,1663,4,"328,15",1,1,1,3,Low-Value,Lost
53437,32,1,"11,0",5,1,1,7,Mid-Value,Potential Loyalists
53438,296,4,"280,25",5,1,1,7,Mid-Value,Potential Loyalists
53439,519,3,"104,0",4,1,1,6,Mid-Value,Potential Loyalists
53440,829,2,"13,6",3,1,1,5,Low-Value,At Risk Customers
53441,1642,1,"63,7",1,1,1,3,Low-Value,Lost
53443,112,6,"286,3",5,1,1,7,Mid-Value,Potential Loyalists
53444,11,2,"28,0",5,1,1,7,Mid-Value,Potential Loyalists
53446,1287,1,"46,5",2,1,1,4,Low-Value,Can't Lose
53447,530,2,"32,65",4,1,1,6,Mid-Value,Potential Loyalists
53449,783,1,"88,8",3,1,1,5,Low-Value,At Risk Customers
53450,201,7,"218,9",5,2,1,8,High-Value,Potential Loyalists
53452,235,3,"150,7",5,1,1,7,Mid-Value,Potential Loyalists
53453,768,2,"79,45",3,1,1,5,Low-Value,At Risk Customers
53455,1244,2,"145,04999999999998",2,1,1,4,Low-Value,Can't Lose
53456,1253,3,"107,85",2,1,1,4,Low-Value,Can't Lose
53457,1235,4,"144,55",2,1,1,4,Low-Value,Can't Lose
53459,67,7,"306,3",5,2,1,8,High-Value,Potential Loyalists
53460,1180,1,"4,5",2,1,1,4,Low-Value,Can't Lose
53461,1782,1,"296,1",1,1,1,3,Low-Value,Lost
53462,145,2,"25,5",5,1,1,7,Mid-Value,Potential Loyalists
53464,333,1,"659,75",5,1,1,7,Mid-Value,Potential Loyalists
53465,641,3,"22,799999999999997",4,1,1,6,Mid-Value,Potential Loyalists
53466,143,1,"228,89999999999998",5,1,1,7,Mid-Value,Potential Loyalists
53468,851,4,"108,7",3,1,1,5,Low-Value,At Risk Customers
53469,301,5,"131,35",5,1,1,7,Mid-Value,Potential Loyalists
53471,404,1,"131,65",4,1,1,6,Mid-Value,Potential Loyalists
53473,367,13,"777,55",4,3,2,9,High-Value,Champions
53475,1711,1,"59,95",1,1,1,3,Low-Value,Lost
53476,1405,1,"32,15",2,1,1,4,Low-Value,Can't Lose
53478,466,6,"437,95000000000005",4,1,1,6,Mid-Value,Potential Loyalists
53479,1630,1,"31,2",1,1,1,3,Low-Value,Lost
53482,644,3,"211,20000000000002",4,1,1,6,Mid-Value,Potential Loyalists
53483,542,1,"52,4",4,1,1,6,Mid-Value,Potential Loyalists
53484,32,7,"444,95000000000005",5,2,1,8,High-Value,Potential Loyalists
53486,27,4,"160,7",5,1,1,7,Mid-Value,Potential Loyalists
53487,32,3,"80,5",5,1,1,7,Mid-Value,Potential Loyalists
53489,522,2,"161,4",4,1,1,6,Mid-Value,Potential Loyalists
53490,541,1,"81,5",4,1,1,6,Mid-Value,Potential Loyalists
53491,286,3,"346,95",5,1,1,7,Mid-Value,Potential Loyalists
53492,12,6,"189,65",5,1,1,7,Mid-Value,Potential Loyalists
53493,720,1,"6,2",4,1,1,6,Mid-Value,Potential Loyalists
53494,874,4,"181,1",3,1,1,5,Low-Value,At Risk Customers
53495,29,1,"82,8",5,1,1,7,Mid-Value,Potential Loyalists
53496,1167,3,"77,95",2,1,1,4,Low-Value,Can't Lose
53497,955,1,"34,3",3,1,1,5,Low-Value,At Risk Customers
53498,105,6,"888,15",5,1,2,8,High-Value,Potential Loyalists
53501,509,2,"142,5",4,1,1,6,Mid-Value,Potential Loyalists
53502,22,3,"353,7",5,1,1,7,Mid-Value,Potential Loyalists
53504,905,1,"160,9",3,1,1,5,Low-Value,At Risk Customers
53506,259,1,"30,299999999999997",5,1,1,7,Mid-Value,Potential Loyalists
53507,54,4,"96,65",5,1,1,7,Mid-Value,Potential Loyalists
53508,1378,1,"24,05",2,1,1,4,Low-Value,Can't Lose
53510,661,1,"57,6",4,1,1,6,Mid-Value,Potential Loyalists
53512,82,8,"243,95",5,2,1,8,High-Value,Potential Loyalists
53513,771,9,"405,6",3,2,1,6,Mid-Value,Potential Loyalists
53519,46,4,"141,45",5,1,1,7,Mid-Value,Potential Loyalists
53521,43,1,"40,5",5,1,1,7,Mid-Value,Potential Loyalists
53522,1414,1,"109,55",2,1,1,4,Low-Value,Can't Lose
53524,316,5,"284,95",5,1,1,7,Mid-Value,Potential Loyalists
53525,315,1,"0,9",5,1,1,7,Mid-Value,Potential Loyalists
53526,886,2,"175,9",3,1,1,5,Low-Value,At Risk Customers
53528,21,6,"414,59999999999997",5,1,1,7,Mid-Value,Potential Loyalists
53529,272,3,"113,7",5,1,1,7,Mid-Value,Potential Loyalists
53534,437,2,"57,6",4,1,1,6,Mid-Value,Potential Loyalists
53536,64,5,"347,4",5,1,1,7,Mid-Value,Potential Loyalists
53537,768,2,"70,25",3,1,1,5,Low-Value,At Risk Customers
53538,26,1,"7,9",5,1,1,7,Mid-Value,Potential Loyalists
53540,995,2,"82,8",3,1,1,5,Low-Value,At Risk Customers
53541,399,4,"169,3",4,1,1,6,Mid-Value,Potential Loyalists
53542,405,2,"105,89999999999999",4,1,1,6,Mid-Value,Potential Loyalists
53543,21,11,"792,5",5,2,2,9,High-Value,Champions
53544,393,1,"148,35000000000002",4,1,1,6,Mid-Value,Potential Loyalists
53546,113,3,"338,5",5,1,1,7,Mid-Value,Potential Loyalists
53549,370,2,"24,4",4,1,1,6,Mid-Value,Potential Loyalists
53550,70,4,"172,65",5,1,1,7,Mid-Value,Potential Loyalists
53551,11,4,"135,6",5,1,1,7,Mid-Value,Potential Loyalists
53553,34,6,"203,8",5,1,1,7,Mid-Value,Potential Loyalists
53554,468,1,"7,5",4,1,1,6,Mid-Value,Potential Loyalists
53555,35,5,"184,60000000000002",5,1,1,7,Mid-Value,Potential Loyalists
53556,966,2,"140,85",3,1,1,5,Low-Value,At Risk Customers
53557,3,2,"27,949999999999996",5,1,1,7,Mid-Value,Potential Loyalists
53560,576,3,"283,1",4,1,1,6,Mid-Value,Potential Loyalists
53561,153,3,"137,4",5,1,1,7,Mid-Value,Potential Loyalists
53562,10,5,"453,35",5,1,1,7,Mid-Value,Potential Loyalists
53563,90,8,"980,0",5,2,2,9,High-Value,Champions
53566,490,2,"155,25",4,1,1,6,Mid-Value,Potential Loyalists
53567,165,4,"101,8",5,1,1,7,Mid-Value,Potential Loyalists
53568,41,3,"237,7",5,1,1,7,Mid-Value,Potential Loyalists
53569,684,1,"10,85",4,1,1,6,Mid-Value,Potential Loyalists
53570,28,2,"62,0",5,1,1,7,Mid-Value,Potential Loyalists
53571,15,9,"566,05",5,2,1,8,High-Value,Potential Loyalists
53573,913,4,"114,94999999999999",3,1,1,5,Low-Value,At Risk Customers
53574,9,9,"1131,45",5,2,2,9,High-Value,Champions
53577,1485,3,"121,39999999999999",1,1,1,3,Low-Value,Lost
53583,663,2,"43,85",4,1,1,6,Mid-Value,Potential Loyalists
53584,531,1,"100,1",4,1,1,6,Mid-Value,Potential Loyalists
53586,1600,1,"84,3",1,1,1,3,Low-Value,Lost
53588,756,2,"196,14999999999998",3,1,1,5,Low-Value,At Risk Customers
53589,189,2,"311,40000000000003",5,1,1,7,Mid-Value,Potential Loyalists
53590,1381,4,"60,35",2,1,1,4,Low-Value,Can't Lose
53591,646,1,"116,0",4,1,1,6,Mid-Value,Potential Loyalists
53592,32,5,"195,9",5,1,1,7,Mid-Value,Potential Loyalists
53593,351,1,"544,6",5,1,1,7,Mid-Value,Potential Loyalists
53595,742,4,"488,35",3,1,1,5,Low-Value,At Risk Customers
53598,12,5,"347,6",5,1,1,7,Mid-Value,Potential Loyalists
53599,59,4,"192,55",5,1,1,7,Mid-Value,Potential Loyalists
53600,662,1,"21,7",4,1,1,6,Mid-Value,Potential Loyalists
53601,892,2,"436,7",3,1,1,5,Low-Value,At Risk Customers
53602,1252,1,"12,3",2,1,1,4,Low-Value,Can't Lose
53603,1695,1,"17,05",1,1,1,3,Low-Value,Lost
53604,899,7,"410,90000000000003",3,2,1,6,Mid-Value,Potential Loyalists
53606,444,10,"482,0",4,2,1,7,Mid-Value,Potential Loyalists
53607,386,2,"90,95",4,1,1,6,Mid-Value,Potential Loyalists
53609,59,4,"96,5",5,1,1,7,Mid-Value,Potential Loyalists
53611,894,4,"447,25",3,1,1,5,Low-Value,At Risk Customers
53613,242,7,"462,25",5,2,1,8,High-Value,Potential Loyalists
53614,1123,5,"193,75",2,1,1,4,Low-Value,Can't Lose
53616,4,6,"568,35",5,1,1,7,Mid-Value,Potential Loyalists
53617,194,9,"1716,85",5,2,3,10,High-Value,Champions
53618,88,1,"11,35",5,1,1,7,Mid-Value,Potential Loyalists
53620,1128,4,"199,65",2,1,1,4,Low-Value,Can't Lose
53621,1159,1,"4,85",2,1,1,4,Low-Value,Can't Lose
53622,227,4,"145,25",5,1,1,7,Mid-Value,Potential Loyalists
53624,1810,1,"109,94999999999999",1,1,1,3,Low-Value,Lost
53627,1061,1,"19,0",3,1,1,5,Low-Value,At Risk Customers
53628,566,1,"31,650000000000002",4,1,1,6,Mid-Value,Potential Loyalists
53629,495,7,"383,34999999999997",4,2,1,7,Mid-Value,Potential Loyalists
53630,68,5,"211,45",5,1,1,7,Mid-Value,Potential Loyalists
53632,541,1,"234,4",4,1,1,6,Mid-Value,Potential Loyalists
53633,738,2,"90,9",3,1,1,5,Low-Value,At Risk Customers
53634,752,8,"337,6",3,2,1,6,Mid-Value,Potential Loyalists
53635,1779,1,"11,45",1,1,1,3,Low-Value,Lost
53640,253,5,"124,69999999999999",5,1,1,7,Mid-Value,Potential Loyalists
53641,1082,1,"23,3",3,1,1,5,Low-Value,At Risk Customers
53644,1268,1,"70,15",2,1,1,4,Low-Value,Can't Lose
53646,1020,3,"1554,3999999999999",3,1,3,7,Mid-Value,Potential Loyalists
53647,133,1,"81,4",5,1,1,7,Mid-Value,Potential Loyalists
53648,62,8,"595,65",5,2,1,8,High-Value,Potential Loyalists
53649,354,2,"63,5",5,1,1,7,Mid-Value,Potential Loyalists
53650,887,2,"746,8",3,1,2,6,Mid-Value,Potential Loyalists
53652,66,3,"192,20000000000002",5,1,1,7,Mid-Value,Potential Loyalists
53654,386,4,"294,65",4,1,1,6,Mid-Value,Potential Loyalists
53655,1182,2,"80,30000000000001",2,1,1,4,Low-Value,Can't Lose
53656,659,5,"307,05",4,1,1,6,Mid-Value,Potential Loyalists
53658,748,1,"23,45",3,1,1,5,Low-Value,At Risk Customers
53659,565,5,"155,75",4,1,1,6,Mid-Value,Potential Loyalists
53661,361,1,"2,9",5,1,1,7,Mid-Value,Potential Loyalists
53662,69,10,"1104,95",5,2,2,9,High-Value,Champions
53663,1643,1,"34,5",1,1,1,3,Low-Value,Lost
53665,999,1,"31,0",3,1,1,5,Low-Value,At Risk Customers
53666,269,5,"334,45",5,1,1,7,Mid-Value,Potential Loyalists
53667,195,1,"51,1",5,1,1,7,Mid-Value,Potential Loyalists
53668,232,1,"36,599999999999994",5,1,1,7,Mid-Value,Potential Loyalists
53669,209,5,"86,6",5,1,1,7,Mid-Value,Potential Loyalists
53670,73,5,"131,85",5,1,1,7,Mid-Value,Potential Loyalists
53672,37,5,"326,6",5,1,1,7,Mid-Value,Potential Loyalists
53674,116,2,"16,450000000000003",5,1,1,7,Mid-Value,Potential Loyalists
53678,336,3,"218,79999999999998",5,1,1,7,Mid-Value,Potential Loyalists
53680,577,2,"59,55",4,1,1,6,Mid-Value,Potential Loyalists
53681,300,1,"167,9",5,1,1,7,Mid-Value,Potential Loyalists
53685,1072,2,"391,9",3,1,1,5,Low-Value,At Risk Customers
53686,1109,4,"496,90000000000003",2,1,1,4,Low-Value,Can't Lose
53687,1805,1,"2,75",1,1,1,3,Low-Value,Lost
53688,540,2,"46,1",4,1,1,6,Mid-Value,Potential Loyalists
53689,67,1,"29,45",5,1,1,7,Mid-Value,Potential Loyalists
53691,111,3,"169,1",5,1,1,7,Mid-Value,Potential Loyalists
53694,755,2,"35,9",3,1,1,5,Low-Value,At Risk Customers
53696,1729,1,"151,95",1,1,1,3,Low-Value,Lost
53697,1512,1,"18,75",1,1,1,3,Low-Value,Lost
53699,1573,2,"100,1",1,1,1,3,Low-Value,Lost
53700,1547,1,"17,85",1,1,1,3,Low-Value,Lost
53701,209,3,"159,5",5,1,1,7,Mid-Value,Potential Loyalists
53703,1397,1,"140,0",2,1,1,4,Low-Value,Can't Lose
53704,445,5,"198,79999999999998",4,1,1,6,Mid-Value,Potential Loyalists
53705,502,7,"401,15",4,2,1,7,Mid-Value,Potential Loyalists
53707,367,2,"204,20000000000002",4,1,1,6,Mid-Value,Potential Loyalists
53708,1329,2,"31,45",2,1,1,4,Low-Value,Can't Lose
53709,129,2,"106,2",5,1,1,7,Mid-Value,Potential Loyalists
53710,1603,3,"107,5",1,1,1,3,Low-Value,Lost
53711,787,3,"64,2",3,1,1,5,Low-Value,At Risk Customers
53712,459,6,"424,15",4,1,1,6,Mid-Value,Potential Loyalists
53713,1015,3,"93,15",3,1,1,5,Low-Value,At Risk Customers
53715,29,5,"233,7",5,1,1,7,Mid-Value,Potential Loyalists
53718,1633,2,"64,2",1,1,1,3,Low-Value,Lost
53719,460,9,"467,95",4,2,1,7,Mid-Value,Potential Loyalists
53721,747,3,"317,75",3,1,1,5,Low-Value,At Risk Customers
53726,1288,1,"85,5",2,1,1,4,Low-Value,Can't Lose
53732,392,1,"127,35000000000001",4,1,1,6,Mid-Value,Potential Loyalists
53734,150,8,"275,0",5,2,1,8,High-Value,Potential Loyalists
53735,530,1,"51,8",4,1,1,6,Mid-Value,Potential Loyalists
53736,1345,2,"47,650000000000006",2,1,1,4,Low-Value,Can't Lose
53737,146,3,"56,25",5,1,1,7,Mid-Value,Potential Loyalists
53738,578,2,"43,9",4,1,1,6,Mid-Value,Potential Loyalists
53740,238,1,"40,75",5,1,1,7,Mid-Value,Potential Loyalists
53741,136,4,"193,2",5,1,1,7,Mid-Value,Potential Loyalists
53742,1125,4,"218,1",2,1,1,4,Low-Value,Can't Lose
53743,1434,1,"30,5",2,1,1,4,Low-Value,Can't Lose
53744,1573,2,"70,05000000000001",1,1,1,3,Low-Value,Lost
53745,1299,1,"252,2",2,1,1,4,Low-Value,Can't Lose
53746,45,9,"336,2",5,2,1,8,High-Value,Potential Loyalists
53747,711,2,"369,5",4,1,1,6,Mid-Value,Potential Loyalists
53748,513,3,"232,15",4,1,1,6,Mid-Value,Potential Loyalists
53750,235,3,"39,0",5,1,1,7,Mid-Value,Potential Loyalists
53753,941,5,"350,35",3,1,1,5,Low-Value,At Risk Customers
53754,1276,1,"15,7",2,1,1,4,Low-Value,Can't Lose
53758,237,8,"430,29999999999995",5,2,1,8,High-Value,Potential Loyalists
53759,896,1,"77,85",3,1,1,5,Low-Value,At Risk Customers
53760,367,5,"232,0",4,1,1,6,Mid-Value,Potential Loyalists
53762,855,3,"194,75",3,1,1,5,Low-Value,At Risk Customers
53763,480,5,"197,9",4,1,1,6,Mid-Value,Potential Loyalists
53764,1142,4,"139,05",2,1,1,4,Low-Value,Can't Lose
53765,381,3,"198,85",4,1,1,6,Mid-Value,Potential Loyalists
53766,131,2,"207,0",5,1,1,7,Mid-Value,Potential Loyalists
53767,284,4,"224,2",5,1,1,7,Mid-Value,Potential Loyalists
53769,92,3,"166,65",5,1,1,7,Mid-Value,Potential Loyalists
53770,1685,1,"6,55",1,1,1,3,Low-Value,Lost
53771,335,3,"27,35",5,1,1,7,Mid-Value,Potential Loyalists
53773,3,4,"485,55000000000007",5,1,1,7,Mid-Value,Potential Loyalists
53775,917,2,"186,8",3,1,1,5,Low-Value,At Risk Customers
53776,1553,1,"9,8",1,1,1,3,Low-Value,Lost
53777,758,2,"55,25",3,1,1,5,Low-Value,At Risk Customers
53782,822,3,"160,35",3,1,1,5,Low-Value,At Risk Customers
53783,1287,2,"125,15",2,1,1,4,Low-Value,Can't Lose
53784,1638,1,"15,0",1,1,1,3,Low-Value,Lost
53786,292,3,"167,4",5,1,1,7,Mid-Value,Potential Loyalists
53787,15,8,"819,2",5,2,2,9,High-Value,Champions
53789,277,2,"71,2",5,1,1,7,Mid-Value,Potential Loyalists
53790,749,5,"305,55",3,1,1,5,Low-Value,At Risk Customers
53793,790,1,"28,35",3,1,1,5,Low-Value,At Risk Customers
53794,649,6,"328,55",4,1,1,6,Mid-Value,Potential Loyalists
53796,217,4,"146,3",5,1,1,7,Mid-Value,Potential Loyalists
53797,622,2,"124,85",4,1,1,6,Mid-Value,Potential Loyalists
53800,1385,1,"70,75",2,1,1,4,Low-Value,Can't Lose
53802,1215,4,"198,0",2,1,1,4,Low-Value,Can't Lose
53803,230,3,"95,25",5,1,1,7,Mid-Value,Potential Loyalists
53804,48,7,"283,35",5,2,1,8,High-Value,Potential Loyalists
53805,288,1,"51,4",5,1,1,7,Mid-Value,Potential Loyalists
53806,1247,1,"87,1",2,1,1,4,Low-Value,Can't Lose
53808,191,4,"91,7",5,1,1,7,Mid-Value,Potential Loyalists
53809,52,2,"224,1",5,1,1,7,Mid-Value,Potential Loyalists
53810,1632,2,"51,2",1,1,1,3,Low-Value,Lost
53813,217,4,"118,45",5,1,1,7,Mid-Value,Potential Loyalists
53814,830,6,"165,95",3,1,1,5,Low-Value,At Risk Customers
53816,751,2,"373,95",3,1,1,5,Low-Value,At Risk Customers
53817,278,4,"325,25",5,1,1,7,Mid-Value,Potential Loyalists
53821,379,7,"384,35",4,2,1,7,Mid-Value,Potential Loyalists
53822,1459,2,"94,65",2,1,1,4,Low-Value,Can't Lose
53823,823,1,"165,95",3,1,1,5,Low-Value,At Risk Customers
53824,78,3,"37,900000000000006",5,1,1,7,Mid-Value,Potential Loyalists
53825,121,3,"169,10000000000002",5,1,1,7,Mid-Value,Potential Loyalists
53826,810,6,"180,8",3,1,1,5,Low-Value,At Risk Customers
53827,55,2,"43,55",5,1,1,7,Mid-Value,Potential Loyalists
53830,1400,1,"42,45",2,1,1,4,Low-Value,Can't Lose
53834,1448,1,"10,8",2,1,1,4,Low-Value,Can't Lose
53836,151,3,"91,8",5,1,1,7,Mid-Value,Potential Loyalists
53843,21,7,"420,9",5,2,1,8,High-Value,Potential Loyalists
53844,582,1,"145,35000000000002",4,1,1,6,Mid-Value,Potential Loyalists
53846,1,3,"134,3",5,1,1,7,Mid-Value,Potential Loyalists
53847,338,1,"26,95",5,1,1,7,Mid-Value,Potential Loyalists
53848,809,5,"104,0",3,1,1,5,Low-Value,At Risk Customers
53850,296,2,"35,15",5,1,1,7,Mid-Value,Potential Loyalists
53851,141,7,"872,9499999999999",5,2,2,9,High-Value,Champions
53852,731,3,"99,85",3,1,1,5,Low-Value,At Risk Customers
53853,251,3,"59,6",5,1,1,7,Mid-Value,Potential Loyalists
53854,877,1,"16,65",3,1,1,5,Low-Value,At Risk Customers
53855,614,2,"59,599999999999994",4,1,1,6,Mid-Value,Potential Loyalists
53857,368,2,"91,55000000000001",4,1,1,6,Mid-Value,Potential Loyalists
53861,760,5,"472,04999999999995",3,1,1,5,Low-Value,At Risk Customers
53862,1476,2,"50,650000000000006",1,1,1,3,Low-Value,Lost
53863,381,2,"59,849999999999994",4,1,1,6,Mid-Value,Potential Loyalists
53864,790,2,"239,45000000000002",3,1,1,5,Low-Value,At Risk Customers
53865,145,6,"393,25",5,1,1,7,Mid-Value,Potential Loyalists
53866,236,5,"149,91",5,1,1,7,Mid-Value,Potential Loyalists
53867,376,5,"325,0",4,1,1,6,Mid-Value,Potential Loyalists
53868,447,4,"209,9",4,1,1,6,Mid-Value,Potential Loyalists
53869,151,2,"50,949999999999996",5,1,1,7,Mid-Value,Potential Loyalists
53871,739,8,"333,5",3,2,1,6,Mid-Value,Potential Loyalists
53872,318,2,"465,4",5,1,1,7,Mid-Value,Potential Loyalists
53873,388,3,"189,35000000000002",4,1,1,6,Mid-Value,Potential Loyalists
53874,1585,1,"133,0",1,1,1,3,Low-Value,Lost
53876,50,4,"65,85",5,1,1,7,Mid-Value,Potential Loyalists
53877,96,3,"64,09",5,1,1,7,Mid-Value,Potential Loyalists
53878,452,6,"450,5",4,1,1,6,Mid-Value,Potential Loyalists
53881,111,6,"148,75",5,1,1,7,Mid-Value,Potential Loyalists
53882,1345,2,"58,1",2,1,1,4,Low-Value,Can't Lose
53883,755,1,"91,2",3,1,1,5,Low-Value,At Risk Customers
53884,180,2,"215,65",5,1,1,7,Mid-Value,Potential Loyalists
53885,476,5,"401,95",4,1,1,6,Mid-Value,Potential Loyalists
53886,169,4,"246,05",5,1,1,7,Mid-Value,Potential Loyalists
53889,85,9,"296,75",5,2,1,8,High-Value,Potential Loyalists
53891,1498,1,"168,05",1,1,1,3,Low-Value,Lost
53893,38,4,"205,0",5,1,1,7,Mid-Value,Potential Loyalists
53894,1009,2,"162,35",3,1,1,5,Low-Value,At Risk Customers
53897,419,3,"52,5",4,1,1,6,Mid-Value,Potential Loyalists
53898,218,3,"126,75",5,1,1,7,Mid-Value,Potential Loyalists
53900,406,3,"153,95",4,1,1,6,Mid-Value,Potential Loyalists
53903,1483,1,"64,6",1,1,1,3,Low-Value,Lost
53904,1596,2,"94,05",1,1,1,3,Low-Value,Lost
53905,136,2,"198,39999999999998",5,1,1,7,Mid-Value,Potential Loyalists
53908,771,2,"67,65",3,1,1,5,Low-Value,At Risk Customers
53909,1270,1,"53,7",2,1,1,4,Low-Value,Can't Lose
53910,206,1,"40,349999999999994",5,1,1,7,Mid-Value,Potential Loyalists
53913,817,2,"78,0",3,1,1,5,Low-Value,At Risk Customers
53915,1485,5,"213,95000000000002",1,1,1,3,Low-Value,Lost
53916,1015,1,"33,4",3,1,1,5,Low-Value,At Risk Customers
53917,1263,4,"418,2",2,1,1,4,Low-Value,Can't Lose
53918,567,3,"339,45",4,1,1,6,Mid-Value,Potential Loyalists
53919,405,3,"183,25",4,1,1,6,Mid-Value,Potential Loyalists
53921,533,4,"213,8",4,1,1,6,Mid-Value,Potential Loyalists
53924,297,5,"83,45",5,1,1,7,Mid-Value,Potential Loyalists
53925,1143,4,"148,5",2,1,1,4,Low-Value,Can't Lose
53927,681,2,"46,25",4,1,1,6,Mid-Value,Potential Loyalists
53928,182,1,"46,1",5,1,1,7,Mid-Value,Potential Loyalists
53929,1674,1,"6,0",1,1,1,3,Low-Value,Lost
53931,51,6,"72,65",5,1,1,7,Mid-Value,Potential Loyalists
53934,319,9,"119,4",5,2,1,8,High-Value,Potential Loyalists
53935,66,3,"995,5999999999999",5,1,2,8,High-Value,Potential Loyalists
53936,202,3,"68,5",5,1,1,7,Mid-Value,Potential Loyalists
53937,480,1,"48,2",4,1,1,6,Mid-Value,Potential Loyalists
53938,398,1,"50,4",4,1,1,6,Mid-Value,Potential Loyalists
53940,116,9,"218,85",5,2,1,8,High-Value,Potential Loyalists
53941,1051,2,"40,6",3,1,1,5,Low-Value,At Risk Customers
53945,854,1,"94,2",3,1,1,5,Low-Value,At Risk Customers
53947,166,3,"415,8",5,1,1,7,Mid-Value,Potential Loyalists
53952,248,1,"11,4",5,1,1,7,Mid-Value,Potential Loyalists
53954,7,8,"536,3",5,2,1,8,High-Value,Potential Loyalists
53955,186,5,"198,2",5,1,1,7,Mid-Value,Potential Loyalists
53957,570,3,"191,45000000000002",4,1,1,6,Mid-Value,Potential Loyalists
53958,554,3,"214,59999999999997",4,1,1,6,Mid-Value,Potential Loyalists
53959,859,1,"205,79999999999998",3,1,1,5,Low-Value,At Risk Customers
53960,917,2,"136,25",3,1,1,5,Low-Value,At Risk Customers
53962,400,3,"164,1",4,1,1,6,Mid-Value,Potential Loyalists
53963,808,1,"165,75",3,1,1,5,Low-Value,At Risk Customers
53964,637,6,"344,40000000000003",4,1,1,6,Mid-Value,Potential Loyalists
53965,507,4,"114,1",4,1,1,6,Mid-Value,Potential Loyalists
53967,181,4,"137,7",5,1,1,7,Mid-Value,Potential Loyalists
53968,214,1,"25,45",5,1,1,7,Mid-Value,Potential Loyalists
53969,18,8,"468,75",5,2,1,8,High-Value,Potential Loyalists
53976,1655,1,"46,6",1,1,1,3,Low-Value,Lost
53979,384,2,"229,70000000000002",4,1,1,6,Mid-Value,Potential Loyalists
53980,1364,1,"60,6",2,1,1,4,Low-Value,Can't Lose
53981,106,7,"719,65",5,2,2,9,High-Value,Champions
53982,1396,1,"21,05",2,1,1,4,Low-Value,Can't Lose
53983,1397,1,"11,8",2,1,1,4,Low-Value,Can't Lose
53985,1310,3,"388,95000000000005",2,1,1,4,Low-Value,Can't Lose
53986,1501,1,"55,85",1,1,1,3,Low-Value,Lost
53989,1351,1,"43,25",2,1,1,4,Low-Value,Can't Lose
53990,777,2,"86,9",3,1,1,5,Low-Value,At Risk Customers
53992,79,5,"122,15",5,1,1,7,Mid-Value,Potential Loyalists
53993,852,3,"215,6",3,1,1,5,Low-Value,At Risk Customers
53994,206,9,"608,35",5,2,1,8,High-Value,Potential Loyalists
53995,59,3,"196,65",5,1,1,7,Mid-Value,Potential Loyalists
53996,541,1,"8,1",4,1,1,6,Mid-Value,Potential Loyalists
53998,1063,1,"41,75",3,1,1,5,Low-Value,At Risk Customers
53999,133,2,"324,1",5,1,1,7,Mid-Value,Potential Loyalists
54002,1540,1,"58,6",1,1,1,3,Low-Value,Lost
54003,252,6,"644,6",5,1,1,7,Mid-Value,Potential Loyalists
54007,222,6,"248,0",5,1,1,7,Mid-Value,Potential Loyalists
54008,1351,2,"62,800000000000004",2,1,1,4,Low-Value,Can't Lose
54009,159,2,"172,75",5,1,1,7,Mid-Value,Potential Loyalists
54010,10,2,"80,69999999999999",5,1,1,7,Mid-Value,Potential Loyalists
54012,343,1,"25,45",5,1,1,7,Mid-Value,Potential Loyalists
54013,878,1,"7,9",3,1,1,5,Low-Value,At Risk Customers
54014,108,9,"432,85",5,2,1,8,High-Value,Potential Loyalists
54015,243,2,"166,1",5,1,1,7,Mid-Value,Potential Loyalists
54017,993,2,"64,6",3,1,1,5,Low-Value,At Risk Customers
54020,320,1,"10,75",5,1,1,7,Mid-Value,Potential Loyalists
54021,348,2,"85,05",5,1,1,7,Mid-Value,Potential Loyalists
54022,683,2,"122,19999999999999",4,1,1,6,Mid-Value,Potential Loyalists
54023,888,1,"63,9",3,1,1,5,Low-Value,At Risk Customers
54025,373,4,"143,65",4,1,1,6,Mid-Value,Potential Loyalists
54027,577,5,"911,95",4,1,2,7,Mid-Value,Potential Loyalists
54028,63,6,"380,55",5,1,1,7,Mid-Value,Potential Loyalists
54029,56,6,"443,75",5,1,1,7,Mid-Value,Potential Loyalists
54031,402,4,"120,05",4,1,1,6,Mid-Value,Potential Loyalists
54033,121,5,"477,1",5,1,1,7,Mid-Value,Potential Loyalists
54034,832,3,"111,1",3,1,1,5,Low-Value,At Risk Customers
54037,523,3,"126,55",4,1,1,6,Mid-Value,Potential Loyalists
54038,616,6,"272,7",4,1,1,6,Mid-Value,Potential Loyalists
54039,35,2,"35,25",5,1,1,7,Mid-Value,Potential Loyalists
54041,1718,1,"95,5",1,1,1,3,Low-Value,Lost
54043,437,1,"12,4",4,1,1,6,Mid-Value,Potential Loyalists
54045,391,11,"266,2",4,2,1,7,Mid-Value,Potential Loyalists
54046,414,4,"134,4",4,1,1,6,Mid-Value,Potential Loyalists
54050,1060,1,"454,5",3,1,1,5,Low-Value,At Risk Customers
54053,623,6,"328,59999999999997",4,1,1,6,Mid-Value,Potential Loyalists
54055,712,1,"15,4",4,1,1,6,Mid-Value,Potential Loyalists
54057,807,5,"182,45",3,1,1,5,Low-Value,At Risk Customers
54058,16,4,"326,2",5,1,1,7,Mid-Value,Potential Loyalists
54059,439,7,"391,0",4,2,1,7,Mid-Value,Potential Loyalists
54060,7,1,"112,6",5,1,1,7,Mid-Value,Potential Loyalists
54061,1180,3,"90,0",2,1,1,4,Low-Value,Can't Lose
54062,1047,1,"89,2",3,1,1,5,Low-Value,At Risk Customers
54063,1739,2,"170,55",1,1,1,3,Low-Value,Lost
54064,695,9,"326,35",4,2,1,7,Mid-Value,Potential Loyalists
54065,1489,1,"77,69999999999999",1,1,1,3,Low-Value,Lost
54066,299,5,"325,54999999999995",5,1,1,7,Mid-Value,Potential Loyalists
54068,368,1,"11,8",4,1,1,6,Mid-Value,Potential Loyalists
54069,163,1,"87,1",5,1,1,7,Mid-Value,Potential Loyalists
54070,1595,2,"55,5",1,1,1,3,Low-Value,Lost
54071,504,2,"157,25",4,1,1,6,Mid-Value,Potential Loyalists
54073,1137,1,"5,45",2,1,1,4,Low-Value,Can't Lose
54077,613,2,"85,2",4,1,1,6,Mid-Value,Potential Loyalists
54078,178,5,"297,13",5,1,1,7,Mid-Value,Potential Loyalists
54080,775,3,"152,9",3,1,1,5,Low-Value,At Risk Customers
54081,291,3,"204,65",5,1,1,7,Mid-Value,Potential Loyalists
54082,428,4,"124,45",4,1,1,6,Mid-Value,Potential Loyalists
54083,705,1,"22,25",4,1,1,6,Mid-Value,Potential Loyalists
54084,388,3,"251,35000000000002",4,1,1,6,Mid-Value,Potential Loyalists
54086,562,2,"132,3",4,1,1,6,Mid-Value,Potential Loyalists
54087,978,1,"237,1",3,1,1,5,Low-Value,At Risk Customers
54088,738,2,"82,85",3,1,1,5,Low-Value,At Risk Customers
54090,616,4,"235,45",4,1,1,6,Mid-Value,Potential Loyalists
54092,349,1,"100,94999999999999",5,1,1,7,Mid-Value,Potential Loyalists
54093,1405,1,"16,8",2,1,1,4,Low-Value,Can't Lose
54094,424,7,"348,75",4,2,1,7,Mid-Value,Potential Loyalists
54095,574,4,"266,4",4,1,1,6,Mid-Value,Potential Loyalists
54099,1086,3,"69,2",3,1,1,5,Low-Value,At Risk Customers
54101,123,2,"37,6",5,1,1,7,Mid-Value,Potential Loyalists
54102,308,1,"58,6",5,1,1,7,Mid-Value,Potential Loyalists
54104,1445,1,"24,8",2,1,1,4,Low-Value,Can't Lose
54105,384,1,"117,2",4,1,1,6,Mid-Value,Potential Loyalists
54106,1135,2,"90,9",2,1,1,4,Low-Value,Can't Lose
54107,1127,1,"39,25",2,1,1,4,Low-Value,Can't Lose
54108,327,5,"180,95000000000002",5,1,1,7,Mid-Value,Potential Loyalists
54109,1033,2,"53,2",3,1,1,5,Low-Value,At Risk Customers
54110,605,7,"381,35",4,2,1,7,Mid-Value,Potential Loyalists
54112,637,4,"156,5",4,1,1,6,Mid-Value,Potential Loyalists
54114,1751,1,"86,65",1,1,1,3,Low-Value,Lost
54117,1507,1,"102,89999999999999",1,1,1,3,Low-Value,Lost
54118,1134,1,"27,5",2,1,1,4,Low-Value,Can't Lose
54119,1737,1,"25,25",1,1,1,3,Low-Value,Lost
54120,657,6,"283,7",4,1,1,6,Mid-Value,Potential Loyalists
54123,669,1,"40,75",4,1,1,6,Mid-Value,Potential Loyalists
54126,42,5,"225,6",5,1,1,7,Mid-Value,Potential Loyalists
54128,224,2,"97,05",5,1,1,7,Mid-Value,Potential Loyalists
54129,406,1,"67,8",4,1,1,6,Mid-Value,Potential Loyalists
54130,506,5,"210,79999999999998",4,1,1,6,Mid-Value,Potential Loyalists
54131,443,1,"2,9",4,1,1,6,Mid-Value,Potential Loyalists
54134,106,1,"24,35",5,1,1,7,Mid-Value,Potential Loyalists
54136,206,3,"193,85",5,1,1,7,Mid-Value,Potential Loyalists
54137,36,1,"73,85",5,1,1,7,Mid-Value,Potential Loyalists
54141,610,3,"239,60000000000002",4,1,1,6,Mid-Value,Potential Loyalists
54142,33,4,"106,30000000000001",5,1,1,7,Mid-Value,Potential Loyalists
54144,494,2,"108,4",4,1,1,6,Mid-Value,Potential Loyalists
54145,1462,1,"22,35",1,1,1,3,Low-Value,Lost
54148,505,1,"158,0",4,1,1,6,Mid-Value,Potential Loyalists
54149,118,12,"791,5",5,3,2,10,High-Value,Champions
54151,489,3,"28,25",4,1,1,6,Mid-Value,Potential Loyalists
54152,132,6,"479,5",5,1,1,7,Mid-Value,Potential Loyalists
54153,744,2,"138,0",3,1,1,5,Low-Value,At Risk Customers
54155,298,4,"314,0",5,1,1,7,Mid-Value,Potential Loyalists
54158,985,1,"19,35",3,1,1,5,Low-Value,At Risk Customers
54159,160,4,"118,05",5,1,1,7,Mid-Value,Potential Loyalists
54160,65,2,"51,45",5,1,1,7,Mid-Value,Potential Loyalists
54161,741,2,"266,2",3,1,1,5,Low-Value,At Risk Customers
54162,214,2,"59,15",5,1,1,7,Mid-Value,Potential Loyalists
54163,75,12,"797,0",5,3,2,10,High-Value,Champions
54165,1278,1,"24,4",2,1,1,4,Low-Value,Can't Lose
54166,229,7,"896,55",5,2,2,9,High-Value,Champions
54167,75,7,"435,7",5,2,1,8,High-Value,Potential Loyalists
54170,75,4,"168,1",5,1,1,7,Mid-Value,Potential Loyalists
54171,388,4,"169,2",4,1,1,6,Mid-Value,Potential Loyalists
54172,935,1,"134,8",3,1,1,5,Low-Value,At Risk Customers
54173,432,2,"113,6",4,1,1,6,Mid-Value,Potential Loyalists
54175,170,2,"315,6",5,1,1,7,Mid-Value,Potential Loyalists
54176,77,2,"400,45",5,1,1,7,Mid-Value,Potential Loyalists
54177,1334,2,"44,099999999999994",2,1,1,4,Low-Value,Can't Lose
54178,322,5,"335,85",5,1,1,7,Mid-Value,Potential Loyalists
54179,24,2,"74,6",5,1,1,7,Mid-Value,Potential Loyalists
54180,907,3,"75,0",3,1,1,5,Low-Value,At Risk Customers
54183,155,8,"501,4",5,2,1,8,High-Value,Potential Loyalists
54186,109,3,"115,95",5,1,1,7,Mid-Value,Potential Loyalists
54187,1231,1,"46,5",2,1,1,4,Low-Value,Can't Lose
54188,38,3,"268,4",5,1,1,7,Mid-Value,Potential Loyalists
54189,1347,1,"50,4",2,1,1,4,Low-Value,Can't Lose
54190,46,3,"299,4",5,1,1,7,Mid-Value,Potential Loyalists
54191,3,3,"79,81",5,1,1,7,Mid-Value,Potential Loyalists
54193,5,3,"43,75",5,1,1,7,Mid-Value,Potential Loyalists
54194,750,3,"164,35000000000002",3,1,1,5,Low-Value,At Risk Customers
54198,1119,3,"142,05",2,1,1,4,Low-Value,Can't Lose
54203,705,5,"507,6",4,1,1,6,Mid-Value,Potential Loyalists
54204,131,15,"1055,45",5,3,2,10,High-Value,Champions
54205,13,4,"147,65",5,1,1,7,Mid-Value,Potential Loyalists
54207,685,3,"73,95",4,1,1,6,Mid-Value,Potential Loyalists
54209,47,5,"410,2",5,1,1,7,Mid-Value,Potential Loyalists
54211,1453,1,"1,75",2,1,1,4,Low-Value,Can't Lose
54213,108,4,"149,95",5,1,1,7,Mid-Value,Potential Loyalists
54214,402,6,"198,68",4,1,1,6,Mid-Value,Potential Loyalists
54215,459,1,"45,85",4,1,1,6,Mid-Value,Potential Loyalists
54216,1306,1,"0,4",2,1,1,4,Low-Value,Can't Lose
54218,209,2,"780,8999999999999",5,1,2,8,High-Value,Potential Loyalists
54219,1333,1,"28,25",2,1,1,4,Low-Value,Can't Lose
54220,421,4,"98,15",4,1,1,6,Mid-Value,Potential Loyalists
54223,541,2,"78,55",4,1,1,6,Mid-Value,Potential Loyalists
54224,130,2,"225,89999999999998",5,1,1,7,Mid-Value,Potential Loyalists
54225,693,2,"123,4",4,1,1,6,Mid-Value,Potential Loyalists
54226,572,8,"526,05",4,2,1,7,Mid-Value,Potential Loyalists
54229,62,2,"61,85",5,1,1,7,Mid-Value,Potential Loyalists
54230,199,1,"125,8",5,1,1,7,Mid-Value,Potential Loyalists
54231,335,3,"303,45000000000005",5,1,1,7,Mid-Value,Potential Loyalists
54232,512,2,"95,3",4,1,1,6,Mid-Value,Potential Loyalists
54235,367,5,"304,53",4,1,1,6,Mid-Value,Potential Loyalists
54236,1203,2,"72,05",2,1,1,4,Low-Value,Can't Lose
54237,437,3,"123,25",4,1,1,6,Mid-Value,Potential Loyalists
54238,1235,4,"520,45",2,1,1,4,Low-Value,Can't Lose
54239,353,5,"699,75",5,1,2,8,High-Value,Potential Loyalists
54240,38,4,"57,8",5,1,1,7,Mid-Value,Potential Loyalists
54241,1529,1,"11,7",1,1,1,3,Low-Value,Lost
54242,60,2,"71,4",5,1,1,7,Mid-Value,Potential Loyalists
54243,115,2,"59,0",5,1,1,7,Mid-Value,Potential Loyalists
54244,312,6,"280,6",5,1,1,7,Mid-Value,Potential Loyalists
54245,346,4,"221,39999999999998",5,1,1,7,Mid-Value,Potential Loyalists
54247,435,2,"93,39999999999999",4,1,1,6,Mid-Value,Potential Loyalists
54248,91,8,"195,45",5,2,1,8,High-Value,Potential Loyalists
54250,882,3,"129,75",3,1,1,5,Low-Value,At Risk Customers
54252,458,2,"74,19999999999999",4,1,1,6,Mid-Value,Potential Loyalists
54253,753,1,"33,6",3,1,1,5,Low-Value,At Risk Customers
54255,3,3,"122,2",5,1,1,7,Mid-Value,Potential Loyalists
54256,1544,2,"42,25",1,1,1,3,Low-Value,Lost
54257,872,4,"324,90000000000003",3,1,1,5,Low-Value,At Risk Customers
54259,1634,1,"69,6",1,1,1,3,Low-Value,Lost
54260,1127,4,"223,1",2,1,1,4,Low-Value,Can't Lose
54262,1099,2,"45,75",2,1,1,4,Low-Value,Can't Lose
54263,155,4,"325,6",5,1,1,7,Mid-Value,Potential Loyalists
54264,942,3,"161,8",3,1,1,5,Low-Value,At Risk Customers
54265,132,1,"51,75",5,1,1,7,Mid-Value,Potential Loyalists
54266,25,5,"186,79999999999998",5,1,1,7,Mid-Value,Potential Loyalists
54267,760,2,"86,05",3,1,1,5,Low-Value,At Risk Customers
54268,248,6,"429,25",5,1,1,7,Mid-Value,Potential Loyalists
54270,217,1,"9,3",5,1,1,7,Mid-Value,Potential Loyalists
54271,386,8,"301,2",4,2,1,7,Mid-Value,Potential Loyalists
54273,56,5,"128,0",5,1,1,7,Mid-Value,Potential Loyalists
54275,183,1,"84,3",5,1,1,7,Mid-Value,Potential Loyalists
54277,367,1,"47,55",4,1,1,6,Mid-Value,Potential Loyalists
54278,1103,1,"98,0",2,1,1,4,Low-Value,Can't Lose
54279,771,1,"72,75",3,1,1,5,Low-Value,At Risk Customers
54280,63,3,"84,80000000000001",5,1,1,7,Mid-Value,Potential Loyalists
54281,754,2,"58,65",3,1,1,5,Low-Value,At Risk Customers
54282,657,3,"74,1",4,1,1,6,Mid-Value,Potential Loyalists
54285,51,2,"136,75",5,1,1,7,Mid-Value,Potential Loyalists
54286,27,1,"72,75",5,1,1,7,Mid-Value,Potential Loyalists
54288,214,3,"206,49999999999997",5,1,1,7,Mid-Value,Potential Loyalists
54289,1138,1,"17,8",2,1,1,4,Low-Value,Can't Lose
54290,367,1,"3167,2",4,1,5,10,High-Value,Champions
54293,203,2,"50,45",5,1,1,7,Mid-Value,Potential Loyalists
54294,165,7,"311,15",5,2,1,8,High-Value,Potential Loyalists
54296,195,6,"1274,3",5,1,2,8,High-Value,Potential Loyalists
54298,45,3,"47,75",5,1,1,7,Mid-Value,Potential Loyalists
54299,864,2,"285,1",3,1,1,5,Low-Value,At Risk Customers
54300,168,3,"218,2",5,1,1,7,Mid-Value,Potential Loyalists
54301,774,5,"214,3",3,1,1,5,Low-Value,At Risk Customers
54303,259,4,"107,95",5,1,1,7,Mid-Value,Potential Loyalists
54304,741,13,"731,15",3,3,2,8,High-Value,Potential Loyalists
54305,73,3,"76,7",5,1,1,7,Mid-Value,Potential Loyalists
54306,118,2,"187,6",5,1,1,7,Mid-Value,Potential Loyalists
54307,258,1,"135,0",5,1,1,7,Mid-Value,Potential Loyalists
54308,250,2,"261,3",5,1,1,7,Mid-Value,Potential Loyalists
54309,405,3,"230,1",4,1,1,6,Mid-Value,Potential Loyalists
54311,658,5,"396,2",4,1,1,6,Mid-Value,Potential Loyalists
54313,1266,1,"16,45",2,1,1,4,Low-Value,Can't Lose
54315,10,5,"967,1499999999999",5,1,2,8,High-Value,Potential Loyalists
54318,261,3,"195,3",5,1,1,7,Mid-Value,Potential Loyalists
54319,966,2,"105,25",3,1,1,5,Low-Value,At Risk Customers
54320,1638,1,"3,5",1,1,1,3,Low-Value,Lost
54323,655,1,"46,65",4,1,1,6,Mid-Value,Potential Loyalists
54326,195,4,"440,29999999999995",5,1,1,7,Mid-Value,Potential Loyalists
54329,325,6,"339,8",5,1,1,7,Mid-Value,Potential Loyalists
54331,32,4,"254,15",5,1,1,7,Mid-Value,Potential Loyalists
54333,77,2,"14,8",5,1,1,7,Mid-Value,Potential Loyalists
54335,818,4,"227,85",3,1,1,5,Low-Value,At Risk Customers
54336,998,2,"28,5",3,1,1,5,Low-Value,At Risk Customers
54337,1476,3,"260,8",1,1,1,3,Low-Value,Lost
54338,1536,1,"206,15",1,1,1,3,Low-Value,Lost
54341,1,4,"115,1",5,1,1,7,Mid-Value,Potential Loyalists
54342,240,5,"204,5",5,1,1,7,Mid-Value,Potential Loyalists
54346,542,13,"808,8",4,3,2,9,High-Value,Champions
54348,147,4,"128,2",5,1,1,7,Mid-Value,Potential Loyalists
54351,468,3,"64,8",4,1,1,6,Mid-Value,Potential Loyalists
54352,283,1,"102,3",5,1,1,7,Mid-Value,Potential Loyalists
54353,3,2,"252,95",5,1,1,7,Mid-Value,Potential Loyalists
54356,394,5,"238,55",4,1,1,6,Mid-Value,Potential Loyalists
54359,560,1,"157,0",4,1,1,6,Mid-Value,Potential Loyalists
54360,1268,1,"81,3",2,1,1,4,Low-Value,Can't Lose
54361,34,2,"32,25",5,1,1,7,Mid-Value,Potential Loyalists
54362,293,2,"352,2",5,1,1,7,Mid-Value,Potential Loyalists
54363,107,3,"113,45",5,1,1,7,Mid-Value,Potential Loyalists
54364,873,4,"305,9",3,1,1,5,Low-Value,At Risk Customers
54366,64,6,"157,05",5,1,1,7,Mid-Value,Potential Loyalists
54369,48,5,"155,95",5,1,1,7,Mid-Value,Potential Loyalists
54370,63,3,"120,75",5,1,1,7,Mid-Value,Potential Loyalists
54371,664,1,"71,6",4,1,1,6,Mid-Value,Potential Loyalists
54372,65,3,"68,05000000000001",5,1,1,7,Mid-Value,Potential Loyalists
54375,378,2,"620,1999999999999",4,1,1,6,Mid-Value,Potential Loyalists
54376,55,3,"275,6",5,1,1,7,Mid-Value,Potential Loyalists
54377,109,2,"55,7",5,1,1,7,Mid-Value,Potential Loyalists
54378,957,2,"88,05000000000001",3,1,1,5,Low-Value,At Risk Customers
54379,49,7,"189,3",5,2,1,8,High-Value,Potential Loyalists
54382,395,1,"102,6",4,1,1,6,Mid-Value,Potential Loyalists
54384,598,2,"40,4",4,1,1,6,Mid-Value,Potential Loyalists
54385,846,3,"179,75",3,1,1,5,Low-Value,At Risk Customers
54387,13,7,"908,9",5,2,2,9,High-Value,Champions
54388,68,1,"22,9",5,1,1,7,Mid-Value,Potential Loyalists
54389,214,3,"333,45",5,1,1,7,Mid-Value,Potential Loyalists
54391,24,4,"359,45",5,1,1,7,Mid-Value,Potential Loyalists
54392,379,2,"169,85",4,1,1,6,Mid-Value,Potential Loyalists
54393,15,12,"1033,9",5,3,2,10,High-Value,Champions
54394,36,2,"39,9",5,1,1,7,Mid-Value,Potential Loyalists
54398,651,2,"70,65",4,1,1,6,Mid-Value,Potential Loyalists
54400,34,9,"285,65",5,2,1,8,High-Value,Potential Loyalists
54401,1700,1,"50,9",1,1,1,3,Low-Value,Lost
54402,587,3,"293,40000000000003",4,1,1,6,Mid-Value,Potential Loyalists
54403,233,2,"57,599999999999994",5,1,1,7,Mid-Value,Potential Loyalists
54404,975,1,"199,04999999999998",3,1,1,5,Low-Value,At Risk Customers
54405,997,2,"92,45",3,1,1,5,Low-Value,At Risk Customers
54406,994,2,"192,45000000000002",3,1,1,5,Low-Value,At Risk Customers
54407,368,7,"285,6",4,2,1,7,Mid-Value,Potential Loyalists
54408,1118,2,"127,35",2,1,1,4,Low-Value,Can't Lose
54410,1389,1,"51,15",2,1,1,4,Low-Value,Can't Lose
54411,442,3,"243,4",4,1,1,6,Mid-Value,Potential Loyalists
54413,3,6,"320,40000000000003",5,1,1,7,Mid-Value,Potential Loyalists
54414,1762,1,"0,6",1,1,1,3,Low-Value,Lost
54415,445,3,"174,75",4,1,1,6,Mid-Value,Potential Loyalists
54418,360,5,"309,4",5,1,1,7,Mid-Value,Potential Loyalists
54419,388,2,"112,25",4,1,1,6,Mid-Value,Potential Loyalists
54424,475,3,"530,45",4,1,1,6,Mid-Value,Potential Loyalists
54425,1071,4,"335,25",3,1,1,5,Low-Value,At Risk Customers
54427,161,15,"1056,9",5,3,2,10,High-Value,Champions
54429,628,6,"327,65",4,1,1,6,Mid-Value,Potential Loyalists
54432,51,4,"281,65",5,1,1,7,Mid-Value,Potential Loyalists
54433,8,1,"28,7",5,1,1,7,Mid-Value,Potential Loyalists
54435,257,6,"207,2",5,1,1,7,Mid-Value,Potential Loyalists
54436,797,2,"43,2",3,1,1,5,Low-Value,At Risk Customers
54437,619,4,"119,05000000000001",4,1,1,6,Mid-Value,Potential Loyalists
54439,245,10,"496,35",5,2,1,8,High-Value,Potential Loyalists
54443,500,3,"61,5",4,1,1,6,Mid-Value,Potential Loyalists
54445,673,2,"78,85",4,1,1,6,Mid-Value,Potential Loyalists
54446,370,3,"118,75",4,1,1,6,Mid-Value,Potential Loyalists
54447,1235,1,"19,4",2,1,1,4,Low-Value,Can't Lose
54448,741,2,"382,29999999999995",3,1,1,5,Low-Value,At Risk Customers
54449,325,1,"30,9",5,1,1,7,Mid-Value,Potential Loyalists
54450,157,12,"681,9",5,3,2,10,High-Value,Champions
54451,153,6,"193,4",5,1,1,7,Mid-Value,Potential Loyalists
54453,1179,1,"42,15",2,1,1,4,Low-Value,Can't Lose
54454,766,5,"215,15",3,1,1,5,Low-Value,At Risk Customers
54455,381,2,"62,5",4,1,1,6,Mid-Value,Potential Loyalists
54457,1445,1,"81,4",2,1,1,4,Low-Value,Can't Lose
54459,17,3,"109,7",5,1,1,7,Mid-Value,Potential Loyalists
54460,385,2,"75,60000000000001",4,1,1,6,Mid-Value,Potential Loyalists
54462,1513,4,"359,05",1,1,1,3,Low-Value,Lost
54464,250,1,"85,5",5,1,1,7,Mid-Value,Potential Loyalists
54465,134,4,"295,35",5,1,1,7,Mid-Value,Potential Loyalists
54466,812,2,"26,099999999999998",3,1,1,5,Low-Value,At Risk Customers
54468,595,4,"445,49999999999994",4,1,1,6,Mid-Value,Potential Loyalists
54469,1,7,"250,90000000000003",5,2,1,8,High-Value,Potential Loyalists
54470,1484,5,"81,1",1,1,1,3,Low-Value,Lost
54472,133,2,"273,0",5,1,1,7,Mid-Value,Potential Loyalists
54473,53,3,"117,0",5,1,1,7,Mid-Value,Potential Loyalists
54475,668,4,"133,64999999999998",4,1,1,6,Mid-Value,Potential Loyalists
54476,599,1,"81,1",4,1,1,6,Mid-Value,Potential Loyalists
54477,436,10,"638,75",4,2,1,7,Mid-Value,Potential Loyalists
54478,218,4,"397,65",5,1,1,7,Mid-Value,Potential Loyalists
54479,895,2,"220,4",3,1,1,5,Low-Value,At Risk Customers
54481,146,3,"192,0",5,1,1,7,Mid-Value,Potential Loyalists
54482,1658,1,"101,5",1,1,1,3,Low-Value,Lost
54485,930,2,"182,4",3,1,1,5,Low-Value,At Risk Customers
54486,1149,5,"235,2",2,1,1,4,Low-Value,Can't Lose
54488,939,2,"339,0",3,1,1,5,Low-Value,At Risk Customers
54489,49,3,"123,55",5,1,1,7,Mid-Value,Potential Loyalists
54490,494,3,"552,4",4,1,1,6,Mid-Value,Potential Loyalists
54493,738,4,"208,45",3,1,1,5,Low-Value,At Risk Customers
54494,448,6,"345,9",4,1,1,6,Mid-Value,Potential Loyalists
54495,119,11,"871,7",5,2,2,9,High-Value,Champions
54496,163,5,"206,39999999999998",5,1,1,7,Mid-Value,Potential Loyalists
54497,1062,3,"76,69999999999999",3,1,1,5,Low-Value,At Risk Customers
54499,431,2,"59,349999999999994",4,1,1,6,Mid-Value,Potential Loyalists
54501,99,3,"134,7",5,1,1,7,Mid-Value,Potential Loyalists
54503,81,3,"163,95",5,1,1,7,Mid-Value,Potential Loyalists
54504,809,7,"282,85",3,2,1,6,Mid-Value,Potential Loyalists
54505,312,3,"185,5",5,1,1,7,Mid-Value,Potential Loyalists
54507,30,5,"310,55",5,1,1,7,Mid-Value,Potential Loyalists
54510,1461,2,"266,7",1,1,1,3,Low-Value,Lost
54511,771,3,"66,1",3,1,1,5,Low-Value,At Risk Customers
54513,1037,1,"341,9",3,1,1,5,Low-Value,At Risk Customers
54514,1120,2,"359,95",2,1,1,4,Low-Value,Can't Lose
54515,69,3,"296,59999999999997",5,1,1,7,Mid-Value,Potential Loyalists
54518,382,3,"325,85",4,1,1,6,Mid-Value,Potential Loyalists
54519,1054,1,"261,45000000000005",3,1,1,5,Low-Value,At Risk Customers
54521,408,3,"80,85",4,1,1,6,Mid-Value,Potential Loyalists
54524,1394,1,"33,5",2,1,1,4,Low-Value,Can't Lose
54526,175,1,"31,95",5,1,1,7,Mid-Value,Potential Loyalists
54527,5,2,"124,7",5,1,1,7,Mid-Value,Potential Loyalists
54528,1383,1,"33,4",2,1,1,4,Low-Value,Can't Lose
54530,1048,1,"12,85",3,1,1,5,Low-Value,At Risk Customers
54531,1417,1,"122,25",2,1,1,4,Low-Value,Can't Lose
54532,403,2,"77,3",4,1,1,6,Mid-Value,Potential Loyalists
54533,1274,2,"100,0",2,1,1,4,Low-Value,Can't Lose
54534,1132,2,"35,5",2,1,1,4,Low-Value,Can't Lose
54536,248,2,"549,95",5,1,1,7,Mid-Value,Potential Loyalists
54537,555,6,"219,05",4,1,1,6,Mid-Value,Potential Loyalists
54538,1307,1,"22,8",2,1,1,4,Low-Value,Can't Lose
54539,98,2,"80,95",5,1,1,7,Mid-Value,Potential Loyalists
54540,124,1,"24,4",5,1,1,7,Mid-Value,Potential Loyalists
54541,452,13,"676,45",4,3,2,9,High-Value,Champions
54542,1519,4,"1113,35",1,1,2,4,Low-Value,Can't Lose
54543,226,4,"81,9",5,1,1,7,Mid-Value,Potential Loyalists
54545,119,4,"227,55",5,1,1,7,Mid-Value,Potential Loyalists
54546,196,1,"42,4",5,1,1,7,Mid-Value,Potential Loyalists
54548,57,1,"66,1",5,1,1,7,Mid-Value,Potential Loyalists
54549,584,2,"46,5",4,1,1,6,Mid-Value,Potential Loyalists
54550,11,10,"589,6",5,2,1,8,High-Value,Potential Loyalists
54551,1444,1,"14,65",2,1,1,4,Low-Value,Can't Lose
54554,703,1,"35,9",4,1,1,6,Mid-Value,Potential Loyalists
54555,815,5,"251,95",3,1,1,5,Low-Value,At Risk Customers
54556,205,3,"128,4",5,1,1,7,Mid-Value,Potential Loyalists
54557,413,9,"344,9",4,2,1,7,Mid-Value,Potential Loyalists
54558,379,2,"891,9499999999999",4,1,2,7,Mid-Value,Potential Loyalists
54559,500,1,"36,7",4,1,1,6,Mid-Value,Potential Loyalists
54561,1489,2,"36,75",1,1,1,3,Low-Value,Lost
54562,104,1,"67,8",5,1,1,7,Mid-Value,Potential Loyalists
54565,117,3,"201,25",5,1,1,7,Mid-Value,Potential Loyalists
54566,118,3,"116,44999999999999",5,1,1,7,Mid-Value,Potential Loyalists
54567,1549,1,"113,65",1,1,1,3,Low-Value,Lost
54569,662,1,"219,1",4,1,1,6,Mid-Value,Potential Loyalists
54570,300,1,"34,2",5,1,1,7,Mid-Value,Potential Loyalists
54571,529,3,"20,5",4,1,1,6,Mid-Value,Potential Loyalists
54575,237,3,"339,35",5,1,1,7,Mid-Value,Potential Loyalists
54576,738,1,"267,0",3,1,1,5,Low-Value,At Risk Customers
54577,1491,2,"32,150000000000006",1,1,1,3,Low-Value,Lost
54578,46,4,"220,7",5,1,1,7,Mid-Value,Potential Loyalists
54580,63,3,"89,15",5,1,1,7,Mid-Value,Potential Loyalists
54583,422,1,"25,4",4,1,1,6,Mid-Value,Potential Loyalists
54585,27,4,"175,8",5,1,1,7,Mid-Value,Potential Loyalists
54586,1140,1,"25,65",2,1,1,4,Low-Value,Can't Lose
54588,167,4,"195,10000000000002",5,1,1,7,Mid-Value,Potential Loyalists
54589,506,1,"86,1",4,1,1,6,Mid-Value,Potential Loyalists
54591,1065,1,"56,35",3,1,1,5,Low-Value,At Risk Customers
54592,1577,1,"38,6",1,1,1,3,Low-Value,Lost
54593,208,2,"298,34999999999997",5,1,1,7,Mid-Value,Potential Loyalists
54596,1243,1,"63,4",2,1,1,4,Low-Value,Can't Lose
54597,672,1,"17,25",4,1,1,6,Mid-Value,Potential Loyalists
54598,620,7,"221,64999999999998",4,2,1,7,Mid-Value,Potential Loyalists
54600,342,3,"276,9",5,1,1,7,Mid-Value,Potential Loyalists
54601,199,2,"212,79999999999998",5,1,1,7,Mid-Value,Potential Loyalists
54602,688,1,"46,05",4,1,1,6,Mid-Value,Potential Loyalists
54603,1034,2,"23,549999999999997",3,1,1,5,Low-Value,At Risk Customers
54605,1269,2,"34,349999999999994",2,1,1,4,Low-Value,Can't Lose
54606,1163,2,"68,6",2,1,1,4,Low-Value,Can't Lose
54607,717,1,"19,75",4,1,1,6,Mid-Value,Potential Loyalists
54608,12,5,"510,15",5,1,1,7,Mid-Value,Potential Loyalists
54610,921,5,"238,35",3,1,1,5,Low-Value,At Risk Customers
54611,501,5,"206,15",4,1,1,6,Mid-Value,Potential Loyalists
54613,379,7,"339,90999999999997",4,2,1,7,Mid-Value,Potential Loyalists
54614,14,2,"99,7",5,1,1,7,Mid-Value,Potential Loyalists
54615,925,1,"31,7",3,1,1,5,Low-Value,At Risk Customers
54616,437,8,"597,5",4,2,1,7,Mid-Value,Potential Loyalists
54617,367,2,"266,55",4,1,1,6,Mid-Value,Potential Loyalists
54618,201,4,"124,4",5,1,1,7,Mid-Value,Potential Loyalists
54619,378,1,"124,2",4,1,1,6,Mid-Value,Potential Loyalists
54620,654,1,"28,25",4,1,1,6,Mid-Value,Potential Loyalists
54621,111,3,"203,65",5,1,1,7,Mid-Value,Potential Loyalists
54622,49,6,"318,15",5,1,1,7,Mid-Value,Potential Loyalists
54625,155,11,"620,2",5,2,1,8,High-Value,Potential Loyalists
54626,590,4,"223,04999999999998",4,1,1,6,Mid-Value,Potential Loyalists
54627,111,4,"215,75",5,1,1,7,Mid-Value,Potential Loyalists
54628,28,6,"251,75",5,1,1,7,Mid-Value,Potential Loyalists
54629,126,1,"67,3",5,1,1,7,Mid-Value,Potential Loyalists
54630,1179,1,"10,0",2,1,1,4,Low-Value,Can't Lose
54631,542,2,"30,049999999999997",4,1,1,6,Mid-Value,Potential Loyalists
54632,764,2,"68,1",3,1,1,5,Low-Value,At Risk Customers
54633,823,1,"7,0",3,1,1,5,Low-Value,At Risk Customers
54634,538,4,"398,85",4,1,1,6,Mid-Value,Potential Loyalists
54635,987,2,"58,95",3,1,1,5,Low-Value,At Risk Customers
54636,334,1,"22,5",5,1,1,7,Mid-Value,Potential Loyalists
54637,106,2,"139,5",5,1,1,7,Mid-Value,Potential Loyalists
54638,77,9,"246,6",5,2,1,8,High-Value,Potential Loyalists
54639,95,1,"2,9",5,1,1,7,Mid-Value,Potential Loyalists
54640,32,2,"127,7",5,1,1,7,Mid-Value,Potential Loyalists
54641,785,4,"433,15",3,1,1,5,Low-Value,At Risk Customers
54642,267,1,"8,35",5,1,1,7,Mid-Value,Potential Loyalists
54643,14,4,"183,9",5,1,1,7,Mid-Value,Potential Loyalists
54645,1152,2,"29,95",2,1,1,4,Low-Value,Can't Lose
54648,832,3,"53,2",3,1,1,5,Low-Value,At Risk Customers
54649,105,6,"359,9",5,1,1,7,Mid-Value,Potential Loyalists
54650,883,8,"398,3",3,2,1,6,Mid-Value,Potential Loyalists
54654,109,6,"416,55",5,1,1,7,Mid-Value,Potential Loyalists
54656,1380,1,"5,4",2,1,1,4,Low-Value,Can't Lose
54657,511,2,"230,4",4,1,1,6,Mid-Value,Potential Loyalists
54658,518,2,"67,2",4,1,1,6,Mid-Value,Potential Loyalists
54659,11,5,"179,6",5,1,1,7,Mid-Value,Potential Loyalists
54660,18,5,"213,25",5,1,1,7,Mid-Value,Potential Loyalists
54665,178,3,"280,9",5,1,1,7,Mid-Value,Potential Loyalists
54667,1658,1,"17,6",1,1,1,3,Low-Value,Lost
54669,638,1,"49,05",4,1,1,6,Mid-Value,Potential Loyalists
54672,869,4,"281,3",3,1,1,5,Low-Value,At Risk Customers
54673,689,6,"330,5",4,1,1,6,Mid-Value,Potential Loyalists
54674,393,6,"305,0",4,1,1,6,Mid-Value,Potential Loyalists
54675,327,8,"170,95",5,2,1,8,High-Value,Potential Loyalists
54676,274,2,"122,3",5,1,1,7,Mid-Value,Potential Loyalists
54678,1172,1,"78,35",2,1,1,4,Low-Value,Can't Lose
54679,10,16,"1151,9",5,3,2,10,High-Value,Champions
54681,755,3,"56,5",3,1,1,5,Low-Value,At Risk Customers
54682,4,3,"205,24999999999997",5,1,1,7,Mid-Value,Potential Loyalists
54684,376,2,"197,89999999999998",4,1,1,6,Mid-Value,Potential Loyalists
54685,580,3,"192,85",4,1,1,6,Mid-Value,Potential Loyalists
54686,753,4,"364,35",3,1,1,5,Low-Value,At Risk Customers
54687,421,3,"84,2",4,1,1,6,Mid-Value,Potential Loyalists
54689,17,7,"117,0",5,2,1,8,High-Value,Potential Loyalists
54690,988,2,"154,5",3,1,1,5,Low-Value,At Risk Customers
54695,53,7,"640,9499999999999",5,2,1,8,High-Value,Potential Loyalists
54697,780,2,"25,0",3,1,1,5,Low-Value,At Risk Customers
54698,208,2,"66,9",5,1,1,7,Mid-Value,Potential Loyalists
54699,262,4,"50,900000000000006",5,1,1,7,Mid-Value,Potential Loyalists
54701,758,1,"128,2",3,1,1,5,Low-Value,At Risk Customers
54702,366,5,"225,25",4,1,1,6,Mid-Value,Potential Loyalists
54703,136,1,"34,0",5,1,1,7,Mid-Value,Potential Loyalists
54704,344,7,"612,55",5,2,1,8,High-Value,Potential Loyalists
54706,638,1,"13,75",4,1,1,6,Mid-Value,Potential Loyalists
54707,906,1,"21,9",3,1,1,5,Low-Value,At Risk Customers
54708,110,4,"244,60000000000002",5,1,1,7,Mid-Value,Potential Loyalists
54709,86,10,"716,55",5,2,2,9,High-Value,Champions
54710,714,1,"190,8",4,1,1,6,Mid-Value,Potential Loyalists
54712,8,6,"367,95",5,1,1,7,Mid-Value,Potential Loyalists
54713,860,1,"158,0",3,1,1,5,Low-Value,At Risk Customers
54714,255,1,"87,4",5,1,1,7,Mid-Value,Potential Loyalists
54715,206,3,"149,05",5,1,1,7,Mid-Value,Potential Loyalists
54718,445,5,"146,0",4,1,1,6,Mid-Value,Potential Loyalists
54719,273,3,"172,10000000000002",5,1,1,7,Mid-Value,Potential Loyalists
54721,194,4,"508,35",5,1,1,7,Mid-Value,Potential Loyalists
54722,1155,1,"34,9",2,1,1,4,Low-Value,Can't Lose
54723,21,7,"105,95",5,2,1,8,High-Value,Potential Loyalists
54724,237,4,"263,05",5,1,1,7,Mid-Value,Potential Loyalists
54725,147,17,"601,8",5,4,1,10,High-Value,Champions
54726,550,3,"403,40000000000003",4,1,1,6,Mid-Value,Potential Loyalists
54727,790,2,"618,8000000000001",3,1,1,5,Low-Value,At Risk Customers
54728,1618,1,"21,7",1,1,1,3,Low-Value,Lost
54729,27,1,"19,3",5,1,1,7,Mid-Value,Potential Loyalists
54730,214,6,"282,15",5,1,1,7,Mid-Value,Potential Loyalists
54731,2,2,"42,9",5,1,1,7,Mid-Value,Potential Loyalists
54733,652,8,"118,8",4,2,1,7,Mid-Value,Potential Loyalists
54734,834,4,"164,0",3,1,1,5,Low-Value,At Risk Customers
54738,1711,1,"20,2",1,1,1,3,Low-Value,Lost
54739,259,1,"11,5",5,1,1,7,Mid-Value,Potential Loyalists
54740,29,6,"365,55",5,1,1,7,Mid-Value,Potential Loyalists
54741,73,11,"728,1",5,2,2,9,High-Value,Champions
54742,1655,1,"6,95",1,1,1,3,Low-Value,Lost
54743,449,3,"751,3999999999999",4,1,2,7,Mid-Value,Potential Loyalists
54744,6,3,"140,2",5,1,1,7,Mid-Value,Potential Loyalists
54745,1605,2,"369,30000000000007",1,1,1,3,Low-Value,Lost
54746,57,4,"104,2",5,1,1,7,Mid-Value,Potential Loyalists
54747,60,3,"18,2",5,1,1,7,Mid-Value,Potential Loyalists
54749,69,5,"97,6",5,1,1,7,Mid-Value,Potential Loyalists
54750,4,7,"307,9",5,2,1,8,High-Value,Potential Loyalists
54752,652,6,"248,85",4,1,1,6,Mid-Value,Potential Loyalists
54753,122,11,"660,1999999999999",5,2,1,8,High-Value,Potential Loyalists
54754,28,8,"943,05",5,2,2,9,High-Value,Champions
54756,923,1,"49,1",3,1,1,5,Low-Value,At Risk Customers
54757,483,3,"67,2",4,1,1,6,Mid-Value,Potential Loyalists
54758,1788,1,"4,6",1,1,1,3,Low-Value,Lost
54761,276,4,"132,0",5,1,1,7,Mid-Value,Potential Loyalists
54764,260,1,"94,19999999999999",5,1,1,7,Mid-Value,Potential Loyalists
54765,791,4,"200,6",3,1,1,5,Low-Value,At Risk Customers
54767,990,2,"201,35000000000002",3,1,1,5,Low-Value,At Risk Customers
54769,115,5,"309,9",5,1,1,7,Mid-Value,Potential Loyalists
54770,1123,2,"398,6",2,1,1,4,Low-Value,Can't Lose
54771,22,6,"321,55",5,1,1,7,Mid-Value,Potential Loyalists
54772,770,1,"74,7",3,1,1,5,Low-Value,At Risk Customers
54774,566,3,"96,65",4,1,1,6,Mid-Value,Potential Loyalists
54777,1,3,"254,65",5,1,1,7,Mid-Value,Potential Loyalists
54778,212,4,"271,29999999999995",5,1,1,7,Mid-Value,Potential Loyalists
54780,60,8,"197,35",5,2,1,8,High-Value,Potential Loyalists
54781,1186,2,"28,549999999999997",2,1,1,4,Low-Value,Can't Lose
54782,192,3,"120,69999999999999",5,1,1,7,Mid-Value,Potential Loyalists
54783,74,2,"334,99999999999994",5,1,1,7,Mid-Value,Potential Loyalists
54784,386,1,"43,9",4,1,1,6,Mid-Value,Potential Loyalists
54786,124,4,"234,3",5,1,1,7,Mid-Value,Potential Loyalists
54787,270,5,"515,95",5,1,1,7,Mid-Value,Potential Loyalists
54788,298,6,"298,0",5,1,1,7,Mid-Value,Potential Loyalists
54790,1113,2,"50,629999999999995",2,1,1,4,Low-Value,Can't Lose
54791,49,5,"205,55",5,1,1,7,Mid-Value,Potential Loyalists
54792,803,2,"82,15",3,1,1,5,Low-Value,At Risk Customers
54793,1225,2,"28,35",2,1,1,4,Low-Value,Can't Lose
54795,290,2,"14,799999999999999",5,1,1,7,Mid-Value,Potential Loyalists
54796,247,1,"15,9",5,1,1,7,Mid-Value,Potential Loyalists
54798,390,1,"8,3",4,1,1,6,Mid-Value,Potential Loyalists
54799,313,3,"59,55",5,1,1,7,Mid-Value,Potential Loyalists
54801,479,6,"376,09999999999997",4,1,1,6,Mid-Value,Potential Loyalists
54802,346,2,"65,75",5,1,1,7,Mid-Value,Potential Loyalists
54804,841,6,"480,7",3,1,1,5,Low-Value,At Risk Customers
54805,313,1,"506,4",5,1,1,7,Mid-Value,Potential Loyalists
54806,805,1,"19,5",3,1,1,5,Low-Value,At Risk Customers
54808,11,1,"171,6",5,1,1,7,Mid-Value,Potential Loyalists
54809,869,2,"145,8",3,1,1,5,Low-Value,At Risk Customers
54810,86,4,"85,95",5,1,1,7,Mid-Value,Potential Loyalists
54811,249,1,"8,25",5,1,1,7,Mid-Value,Potential Loyalists
54813,1398,1,"89,6",2,1,1,4,Low-Value,Can't Lose
54815,1220,2,"226,10000000000002",2,1,1,4,Low-Value,Can't Lose
54816,412,2,"9,85",4,1,1,6,Mid-Value,Potential Loyalists
54821,34,1,"47,05",5,1,1,7,Mid-Value,Potential Loyalists
54826,24,4,"269,90000000000003",5,1,1,7,Mid-Value,Potential Loyalists
54830,377,8,"877,6999999999999",4,2,2,8,High-Value,Potential Loyalists
54831,969,2,"415,15",3,1,1,5,Low-Value,At Risk Customers
54832,1114,2,"174,55",2,1,1,4,Low-Value,Can't Lose
54833,749,3,"124,15",3,1,1,5,Low-Value,At Risk Customers
54834,1012,5,"374,8",3,1,1,5,Low-Value,At Risk Customers
54835,260,8,"464,1",5,2,1,8,High-Value,Potential Loyalists
54836,394,6,"288,65",4,1,1,6,Mid-Value,Potential Loyalists
54839,381,6,"496,7",4,1,1,6,Mid-Value,Potential Loyalists
54845,388,4,"145,7",4,1,1,6,Mid-Value,Potential Loyalists
54846,733,2,"112,95",3,1,1,5,Low-Value,At Risk Customers
54847,1760,1,"61,7",1,1,1,3,Low-Value,Lost
54848,151,3,"221,45",5,1,1,7,Mid-Value,Potential Loyalists
54852,1641,1,"74,55",1,1,1,3,Low-Value,Lost
54853,1158,3,"126,21000000000001",2,1,1,4,Low-Value,Can't Lose
54857,33,3,"44,300000000000004",5,1,1,7,Mid-Value,Potential Loyalists
54858,532,1,"82,05000000000001",4,1,1,6,Mid-Value,Potential Loyalists
54859,1106,3,"197,89999999999998",2,1,1,4,Low-Value,Can't Lose
54860,530,3,"363,2",4,1,1,6,Mid-Value,Potential Loyalists
54863,866,2,"50,199999999999996",3,1,1,5,Low-Value,At Risk Customers
54864,1300,1,"66,3",2,1,1,4,Low-Value,Can't Lose
54865,1291,1,"107,0",2,1,1,4,Low-Value,Can't Lose
54870,915,3,"241,15",3,1,1,5,Low-Value,At Risk Customers
54871,67,6,"444,5",5,1,1,7,Mid-Value,Potential Loyalists
54873,14,1,"105,6",5,1,1,7,Mid-Value,Potential Loyalists
54874,237,1,"50,9",5,1,1,7,Mid-Value,Potential Loyalists
54876,13,3,"241,5",5,1,1,7,Mid-Value,Potential Loyalists
54877,340,5,"150,35",5,1,1,7,Mid-Value,Potential Loyalists
54879,746,1,"56,1",3,1,1,5,Low-Value,At Risk Customers
54880,77,2,"67,35",5,1,1,7,Mid-Value,Potential Loyalists
54888,463,2,"124,5",4,1,1,6,Mid-Value,Potential Loyalists
54890,1126,2,"136,8",2,1,1,4,Low-Value,Can't Lose
54891,983,1,"57,05",3,1,1,5,Low-Value,At Risk Customers
54892,444,5,"282,15",4,1,1,6,Mid-Value,Potential Loyalists
54893,201,4,"163,39999999999998",5,1,1,7,Mid-Value,Potential Loyalists
54894,165,9,"342,1",5,2,1,8,High-Value,Potential Loyalists
54895,73,6,"679,65",5,1,2,8,High-Value,Potential Loyalists
54896,396,4,"931,0999999999999",4,1,2,7,Mid-Value,Potential Loyalists
54897,230,3,"54,45",5,1,1,7,Mid-Value,Potential Loyalists
54899,828,1,"29,25",3,1,1,5,Low-Value,At Risk Customers
54900,81,3,"114,80000000000001",5,1,1,7,Mid-Value,Potential Loyalists
54906,12,2,"77,65",5,1,1,7,Mid-Value,Potential Loyalists
54907,1106,5,"92,65",2,1,1,4,Low-Value,Can't Lose
54912,980,3,"27,950000000000003",3,1,1,5,Low-Value,At Risk Customers
54913,517,2,"104,1",4,1,1,6,Mid-Value,Potential Loyalists
54914,586,5,"264,05",4,1,1,6,Mid-Value,Potential Loyalists
54916,827,2,"446,1",3,1,1,5,Low-Value,At Risk Customers
54920,135,3,"420,25",5,1,1,7,Mid-Value,Potential Loyalists
54921,1720,1,"15,45",1,1,1,3,Low-Value,Lost
54922,1106,3,"188,0",2,1,1,4,Low-Value,Can't Lose
54923,1737,1,"37,65",1,1,1,3,Low-Value,Lost
54924,19,1,"15,5",5,1,1,7,Mid-Value,Potential Loyalists
54925,62,14,"966,75",5,3,2,10,High-Value,Champions
54926,84,21,"1834,0",5,4,3,12,High-Value,Champions
54927,34,3,"181,8",5,1,1,7,Mid-Value,Potential Loyalists
54929,36,2,"80,85",5,1,1,7,Mid-Value,Potential Loyalists
54931,1802,1,"28,5",1,1,1,3,Low-Value,Lost
54932,680,1,"91,15",4,1,1,6,Mid-Value,Potential Loyalists
54933,24,5,"144,5",5,1,1,7,Mid-Value,Potential Loyalists
54935,854,6,"331,65",3,1,1,5,Low-Value,At Risk Customers
54936,441,1,"25,85",4,1,1,6,Mid-Value,Potential Loyalists
54937,145,8,"498,7",5,2,1,8,High-Value,Potential Loyalists
54939,234,2,"81,6",5,1,1,7,Mid-Value,Potential Loyalists
54940,1109,1,"57,1",2,1,1,4,Low-Value,Can't Lose
54941,783,8,"294,15",3,2,1,6,Mid-Value,Potential Loyalists
54945,60,6,"210,35",5,1,1,7,Mid-Value,Potential Loyalists
54947,1347,5,"154,55",2,1,1,4,Low-Value,Can't Lose
54948,303,8,"334,35",5,2,1,8,High-Value,Potential Loyalists
54950,251,4,"444,75",5,1,1,7,Mid-Value,Potential Loyalists
54951,553,3,"118,7",4,1,1,6,Mid-Value,Potential Loyalists
54952,171,3,"316,6",5,1,1,7,Mid-Value,Potential Loyalists
54953,119,2,"60,7",5,1,1,7,Mid-Value,Potential Loyalists
54954,771,1,"28,35",3,1,1,5,Low-Value,At Risk Customers
54955,737,4,"138,85",3,1,1,5,Low-Value,At Risk Customers
54956,964,1,"242,25",3,1,1,5,Low-Value,At Risk Customers
54958,43,11,"880,25",5,2,2,9,High-Value,Champions
54959,1369,1,"173,3",2,1,1,4,Low-Value,Can't Lose
54961,757,1,"129,9",3,1,1,5,Low-Value,At Risk Customers
54962,749,1,"41,0",3,1,1,5,Low-Value,At Risk Customers
54963,732,4,"232,70000000000002",3,1,1,5,Low-Value,At Risk Customers
54966,861,1,"141,6",3,1,1,5,Low-Value,At Risk Customers
54968,210,4,"359,54999999999995",5,1,1,7,Mid-Value,Potential Loyalists
54970,64,7,"295,3",5,2,1,8,High-Value,Potential Loyalists
54972,270,3,"179,5",5,1,1,7,Mid-Value,Potential Loyalists
54973,1621,1,"411,8",1,1,1,3,Low-Value,Lost
54974,216,2,"76,55",5,1,1,7,Mid-Value,Potential Loyalists
54977,395,6,"264,1",4,1,1,6,Mid-Value,Potential Loyalists
54979,243,3,"116,4",5,1,1,7,Mid-Value,Potential Loyalists
54980,440,5,"287,45000000000005",4,1,1,6,Mid-Value,Potential Loyalists
54983,1303,1,"89,35",2,1,1,4,Low-Value,Can't Lose
54986,1222,1,"21,7",2,1,1,4,Low-Value,Can't Lose
54987,16,5,"208,95",5,1,1,7,Mid-Value,Potential Loyalists
54990,70,6,"514,85",5,1,1,7,Mid-Value,Potential Loyalists
54992,376,4,"164,75",4,1,1,6,Mid-Value,Potential Loyalists
54993,175,12,"603,75",5,3,1,9,High-Value,Champions
54995,54,1,"37,6",5,1,1,7,Mid-Value,Potential Loyalists
54997,577,1,"38,8",4,1,1,6,Mid-Value,Potential Loyalists
55001,1487,2,"327,25",1,1,1,3,Low-Value,Lost
55003,96,2,"34,95",5,1,1,7,Mid-Value,Potential Loyalists
55004,938,4,"335,5",3,1,1,5,Low-Value,At Risk Customers
55005,1251,1,"196,9",2,1,1,4,Low-Value,Can't Lose
55007,226,4,"162,0",5,1,1,7,Mid-Value,Potential Loyalists
55008,216,2,"227,9",5,1,1,7,Mid-Value,Potential Loyalists
55009,1159,1,"13,15",2,1,1,4,Low-Value,Can't Lose
55010,1159,2,"198,0",2,1,1,4,Low-Value,Can't Lose
55011,755,3,"115,39999999999999",3,1,1,5,Low-Value,At Risk Customers
55012,726,1,"316,35",4,1,1,6,Mid-Value,Potential Loyalists
55016,109,7,"474,79999999999995",5,2,1,8,High-Value,Potential Loyalists
55017,661,2,"85,55",4,1,1,6,Mid-Value,Potential Loyalists
55018,35,3,"179,25",5,1,1,7,Mid-Value,Potential Loyalists
55023,368,1,"230,6",4,1,1,6,Mid-Value,Potential Loyalists
55024,1275,1,"73,1",2,1,1,4,Low-Value,Can't Lose
55025,19,7,"562,9499999999999",5,2,1,8,High-Value,Potential Loyalists
55026,1037,2,"145,9",3,1,1,5,Low-Value,At Risk Customers
55027,556,5,"576,05",4,1,1,6,Mid-Value,Potential Loyalists
55028,89,5,"160,6",5,1,1,7,Mid-Value,Potential Loyalists
55030,951,2,"53,0",3,1,1,5,Low-Value,At Risk Customers
55031,678,1,"29,65",4,1,1,6,Mid-Value,Potential Loyalists
55032,203,3,"107,5",5,1,1,7,Mid-Value,Potential Loyalists
55033,296,6,"266,45",5,1,1,7,Mid-Value,Potential Loyalists
55038,253,9,"279,85",5,2,1,8,High-Value,Potential Loyalists
55039,1209,2,"65,55",2,1,1,4,Low-Value,Can't Lose
55040,15,8,"267,45",5,2,1,8,High-Value,Potential Loyalists
55041,86,1,"319,9",5,1,1,7,Mid-Value,Potential Loyalists
55042,454,1,"95,65",4,1,1,6,Mid-Value,Potential Loyalists
55043,1402,3,"276,75",2,1,1,4,Low-Value,Can't Lose
55044,1343,1,"43,05",2,1,1,4,Low-Value,Can't Lose
55045,529,4,"194,0",4,1,1,6,Mid-Value,Potential Loyalists
55046,4,7,"1003,45",5,2,2,9,High-Value,Champions
55048,437,4,"372,95",4,1,1,6,Mid-Value,Potential Loyalists
55049,90,1,"355,6",5,1,1,7,Mid-Value,Potential Loyalists
55050,55,1,"13,4",5,1,1,7,Mid-Value,Potential Loyalists
55051,823,1,"17,1",3,1,1,5,Low-Value,At Risk Customers
55052,54,3,"282,0",5,1,1,7,Mid-Value,Potential Loyalists
55053,1072,1,"4,75",3,1,1,5,Low-Value,At Risk Customers
55054,369,5,"354,85",4,1,1,6,Mid-Value,Potential Loyalists
55055,595,6,"328,25",4,1,1,6,Mid-Value,Potential Loyalists
55056,694,1,"62,85",4,1,1,6,Mid-Value,Potential Loyalists
55059,811,1,"35,95",3,1,1,5,Low-Value,At Risk Customers
55060,44,2,"219,45000000000002",5,1,1,7,Mid-Value,Potential Loyalists
55061,423,7,"516,65",4,2,1,7,Mid-Value,Potential Loyalists
55062,1370,1,"31,2",2,1,1,4,Low-Value,Can't Lose
55063,139,4,"444,4",5,1,1,7,Mid-Value,Potential Loyalists
55064,231,2,"59,949999999999996",5,1,1,7,Mid-Value,Potential Loyalists
55065,1112,1,"82,2",2,1,1,4,Low-Value,Can't Lose
55066,273,3,"292,35",5,1,1,7,Mid-Value,Potential Loyalists
55067,63,9,"611,3",5,2,1,8,High-Value,Potential Loyalists
55068,223,5,"143,7",5,1,1,7,Mid-Value,Potential Loyalists
55071,7,6,"572,8",5,1,1,7,Mid-Value,Potential Loyalists
55074,158,8,"1055,2",5,2,2,9,High-Value,Champions
55075,33,4,"214,65",5,1,1,7,Mid-Value,Potential Loyalists
55078,928,1,"270,0",3,1,1,5,Low-Value,At Risk Customers
55079,999,3,"121,5",3,1,1,5,Low-Value,At Risk Customers
55080,395,3,"346,65",4,1,1,6,Mid-Value,Potential Loyalists
55081,1419,1,"9,85",2,1,1,4,Low-Value,Can't Lose
55082,769,14,"740,45",3,3,2,8,High-Value,Potential Loyalists
55084,111,1,"6,1",5,1,1,7,Mid-Value,Potential Loyalists
55087,370,2,"249,45000000000005",4,1,1,6,Mid-Value,Potential Loyalists
55089,722,1,"5,4",4,1,1,6,Mid-Value,Potential Loyalists
55090,251,2,"56,55",5,1,1,7,Mid-Value,Potential Loyalists
55091,1438,4,"114,35",2,1,1,4,Low-Value,Can't Lose
55092,434,1,"124,15",4,1,1,6,Mid-Value,Potential Loyalists
55093,60,7,"376,2",5,2,1,8,High-Value,Potential Loyalists
55097,973,2,"142,6",3,1,1,5,Low-Value,At Risk Customers
55100,818,3,"174,6",3,1,1,5,Low-Value,At Risk Customers
55101,1186,2,"97,0",2,1,1,4,Low-Value,Can't Lose
55104,201,1,"117,8",5,1,1,7,Mid-Value,Potential Loyalists
55106,282,1,"20,4",5,1,1,7,Mid-Value,Potential Loyalists
55108,524,4,"191,2",4,1,1,6,Mid-Value,Potential Loyalists
55110,5,7,"253,6",5,2,1,8,High-Value,Potential Loyalists
55111,433,4,"133,9",4,1,1,6,Mid-Value,Potential Loyalists
55112,43,3,"268,6",5,1,1,7,Mid-Value,Potential Loyalists
55114,1713,2,"87,7",1,1,1,3,Low-Value,Lost
55117,1530,2,"110,1",1,1,1,3,Low-Value,Lost
55118,1059,2,"30,0",3,1,1,5,Low-Value,At Risk Customers
55119,17,3,"117,70000000000002",5,1,1,7,Mid-Value,Potential Loyalists
55121,326,1,"50,3",5,1,1,7,Mid-Value,Potential Loyalists
55122,120,9,"430,95",5,2,1,8,High-Value,Potential Loyalists
55123,152,8,"488,4",5,2,1,8,High-Value,Potential Loyalists
55124,533,4,"195,8",4,1,1,6,Mid-Value,Potential Loyalists
55125,229,2,"159,8",5,1,1,7,Mid-Value,Potential Loyalists
55128,99,3,"243,55",5,1,1,7,Mid-Value,Potential Loyalists
55130,622,6,"310,4",4,1,1,6,Mid-Value,Potential Loyalists
55131,1480,1,"153,0",1,1,1,3,Low-Value,Lost
55132,115,8,"216,6",5,2,1,8,High-Value,Potential Loyalists
55134,267,5,"830,9000000000001",5,1,2,8,High-Value,Potential Loyalists
55136,2,7,"413,95",5,2,1,8,High-Value,Potential Loyalists
55138,434,1,"150,0",4,1,1,6,Mid-Value,Potential Loyalists
55142,775,3,"106,39999999999999",3,1,1,5,Low-Value,At Risk Customers
55143,545,7,"428,5",4,2,1,7,Mid-Value,Potential Loyalists
55144,382,1,"32,4",4,1,1,6,Mid-Value,Potential Loyalists
55146,129,1,"28,1",5,1,1,7,Mid-Value,Potential Loyalists
55147,11,2,"924,15",5,1,2,8,High-Value,Potential Loyalists
55149,106,2,"47,4",5,1,1,7,Mid-Value,Potential Loyalists
55150,161,4,"221,4",5,1,1,7,Mid-Value,Potential Loyalists
55152,136,3,"147,2",5,1,1,7,Mid-Value,Potential Loyalists
55153,5,1,"43,9",5,1,1,7,Mid-Value,Potential Loyalists
55154,759,2,"386,5",3,1,1,5,Low-Value,At Risk Customers
55157,913,3,"154,0",3,1,1,5,Low-Value,At Risk Customers
55158,1671,1,"9,95",1,1,1,3,Low-Value,Lost
55159,610,1,"3,4",4,1,1,6,Mid-Value,Potential Loyalists
55161,11,5,"372,1",5,1,1,7,Mid-Value,Potential Loyalists
55162,529,1,"89,2",4,1,1,6,Mid-Value,Potential Loyalists
55164,790,3,"300,3",3,1,1,5,Low-Value,At Risk Customers
55170,21,3,"169,60000000000002",5,1,1,7,Mid-Value,Potential Loyalists
55171,75,7,"207,85",5,2,1,8,High-Value,Potential Loyalists
55173,751,1,"84,85",3,1,1,5,Low-Value,At Risk Customers
55174,672,7,"272,0",4,2,1,7,Mid-Value,Potential Loyalists
55175,221,1,"35,05",5,1,1,7,Mid-Value,Potential Loyalists
55177,59,6,"263,55",5,1,1,7,Mid-Value,Potential Loyalists
55178,142,1,"160,9",5,1,1,7,Mid-Value,Potential Loyalists
55179,194,4,"147,6",5,1,1,7,Mid-Value,Potential Loyalists
55180,714,3,"298,95",4,1,1,6,Mid-Value,Potential Loyalists
55181,559,1,"88,9",4,1,1,6,Mid-Value,Potential Loyalists
55182,619,1,"19,3",4,1,1,6,Mid-Value,Potential Loyalists
55185,767,3,"118,55000000000001",3,1,1,5,Low-Value,At Risk Customers
55187,29,14,"439,0",5,3,1,9,High-Value,Champions
55188,162,3,"19,950000000000003",5,1,1,7,Mid-Value,Potential Loyalists
55189,1694,1,"23,85",1,1,1,3,Low-Value,Lost
55191,518,7,"588,45",4,2,1,7,Mid-Value,Potential Loyalists
55192,1054,3,"328,45",3,1,1,5,Low-Value,At Risk Customers
55193,336,1,"98,9",5,1,1,7,Mid-Value,Potential Loyalists
55195,1238,1,"71,25",2,1,1,4,Low-Value,Can't Lose
55196,464,3,"86,64999999999999",4,1,1,6,Mid-Value,Potential Loyalists
55198,928,2,"175,60000000000002",3,1,1,5,Low-Value,At Risk Customers
55199,678,5,"110,55",4,1,1,6,Mid-Value,Potential Loyalists
55200,808,2,"34,9",3,1,1,5,Low-Value,At Risk Customers
55203,557,3,"441,9",4,1,1,6,Mid-Value,Potential Loyalists
55204,46,11,"629,95",5,2,1,8,High-Value,Potential Loyalists
55206,635,1,"116,85",4,1,1,6,Mid-Value,Potential Loyalists
55208,651,1,"35,1",4,1,1,6,Mid-Value,Potential Loyalists
55209,211,4,"294,4",5,1,1,7,Mid-Value,Potential Loyalists
55210,571,4,"285,6",4,1,1,6,Mid-Value,Potential Loyalists
55213,405,6,"494,85",4,1,1,6,Mid-Value,Potential Loyalists
55214,83,5,"364,75",5,1,1,7,Mid-Value,Potential Loyalists
55215,1118,2,"201,8",2,1,1,4,Low-Value,Can't Lose
55216,1566,1,"122,8",1,1,1,3,Low-Value,Lost
55217,553,1,"60,5",4,1,1,6,Mid-Value,Potential Loyalists
55218,1123,2,"139,85",2,1,1,4,Low-Value,Can't Lose
55219,27,5,"215,5",5,1,1,7,Mid-Value,Potential Loyalists
55220,381,5,"417,9",4,1,1,6,Mid-Value,Potential Loyalists
55221,204,3,"43,1",5,1,1,7,Mid-Value,Potential Loyalists
55224,3,7,"180,2",5,2,1,8,High-Value,Potential Loyalists
55225,792,1,"8,85",3,1,1,5,Low-Value,At Risk Customers
55227,203,3,"226,45",5,1,1,7,Mid-Value,Potential Loyalists
55228,127,2,"38,25",5,1,1,7,Mid-Value,Potential Loyalists
55230,817,3,"128,35000000000002",3,1,1,5,Low-Value,At Risk Customers
55232,774,2,"105,35",3,1,1,5,Low-Value,At Risk Customers
55233,1110,5,"340,7",2,1,1,4,Low-Value,Can't Lose
55234,25,4,"251,2",5,1,1,7,Mid-Value,Potential Loyalists
55235,413,2,"169,0",4,1,1,6,Mid-Value,Potential Loyalists
55236,904,4,"208,0",3,1,1,5,Low-Value,At Risk Customers
55237,152,3,"190,04999999999998",5,1,1,7,Mid-Value,Potential Loyalists
55239,914,2,"57,45",3,1,1,5,Low-Value,At Risk Customers
55240,15,12,"632,9000000000001",5,3,1,9,High-Value,Champions
55241,624,2,"107,15",4,1,1,6,Mid-Value,Potential Loyalists
55243,39,1,"48,65",5,1,1,7,Mid-Value,Potential Loyalists
55244,29,6,"278,2",5,1,1,7,Mid-Value,Potential Loyalists
55246,735,7,"396,55",3,2,1,6,Mid-Value,Potential Loyalists
55247,1461,1,"24,6",1,1,1,3,Low-Value,Lost
55248,1236,1,"64,6",2,1,1,4,Low-Value,Can't Lose
55250,127,1,"87,15",5,1,1,7,Mid-Value,Potential Loyalists
55251,535,1,"158,0",4,1,1,6,Mid-Value,Potential Loyalists
55252,159,2,"192,05",5,1,1,7,Mid-Value,Potential Loyalists
55253,561,1,"61,3",4,1,1,6,Mid-Value,Potential Loyalists
55254,151,4,"147,35",5,1,1,7,Mid-Value,Potential Loyalists
55255,157,1,"118,8",5,1,1,7,Mid-Value,Potential Loyalists
55256,265,4,"139,25",5,1,1,7,Mid-Value,Potential Loyalists
55257,1531,2,"59,2",1,1,1,3,Low-Value,Lost
55261,1183,1,"90,45",2,1,1,4,Low-Value,Can't Lose
55262,43,12,"416,65",5,3,1,9,High-Value,Champions
55263,1487,1,"54,2",1,1,1,3,Low-Value,Lost
55264,313,6,"272,2",5,1,1,7,Mid-Value,Potential Loyalists
55265,4,3,"164,5",5,1,1,7,Mid-Value,Potential Loyalists
55266,500,2,"141,70000000000002",4,1,1,6,Mid-Value,Potential Loyalists
55267,207,3,"290,9",5,1,1,7,Mid-Value,Potential Loyalists
55269,15,3,"62,3",5,1,1,7,Mid-Value,Potential Loyalists
55273,115,2,"57,8",5,1,1,7,Mid-Value,Potential Loyalists
55274,867,2,"83,45",3,1,1,5,Low-Value,At Risk Customers
55275,113,8,"362,45",5,2,1,8,High-Value,Potential Loyalists
55276,94,8,"916,75",5,2,2,9,High-Value,Champions
55280,52,4,"118,35",5,1,1,7,Mid-Value,Potential Loyalists
55282,547,5,"225,40000000000003",4,1,1,6,Mid-Value,Potential Loyalists
55283,1106,4,"190,1",2,1,1,4,Low-Value,Can't Lose
55284,97,10,"479,75",5,2,1,8,High-Value,Potential Loyalists
55285,1378,2,"99,19999999999999",2,1,1,4,Low-Value,Can't Lose
55288,1015,1,"8,3",3,1,1,5,Low-Value,At Risk Customers
55289,732,5,"296,45",3,1,1,5,Low-Value,At Risk Customers
55290,574,3,"235,55",4,1,1,6,Mid-Value,Potential Loyalists
55291,197,6,"310,7",5,1,1,7,Mid-Value,Potential Loyalists
55292,330,5,"86,5",5,1,1,7,Mid-Value,Potential Loyalists
55295,900,1,"47,5",3,1,1,5,Low-Value,At Risk Customers
55296,109,1,"66,1",5,1,1,7,Mid-Value,Potential Loyalists
55297,343,5,"149,25",5,1,1,7,Mid-Value,Potential Loyalists
55298,847,3,"118,45",3,1,1,5,Low-Value,At Risk Customers
55299,682,2,"78,75",4,1,1,6,Mid-Value,Potential Loyalists
55300,755,4,"539,7",3,1,1,5,Low-Value,At Risk Customers
55301,536,5,"179,6",4,1,1,6,Mid-Value,Potential Loyalists
55304,1291,3,"797,3499999999999",2,1,2,5,Low-Value,At Risk Customers
55305,1810,1,"8,8",1,1,1,3,Low-Value,Lost
55306,10,3,"205,65",5,1,1,7,Mid-Value,Potential Loyalists
55307,634,1,"6,1",4,1,1,6,Mid-Value,Potential Loyalists
55308,984,4,"161,75",3,1,1,5,Low-Value,At Risk Customers
55310,1278,4,"174,3",2,1,1,4,Low-Value,Can't Lose
55311,490,2,"51,5",4,1,1,6,Mid-Value,Potential Loyalists
55312,1537,2,"20,55",1,1,1,3,Low-Value,Lost
55314,412,2,"166,6",4,1,1,6,Mid-Value,Potential Loyalists
55317,49,12,"672,35",5,3,2,10,High-Value,Champions
55318,39,6,"425,3",5,1,1,7,Mid-Value,Potential Loyalists
55319,1313,1,"187,5",2,1,1,4,Low-Value,Can't Lose
55320,49,5,"81,15",5,1,1,7,Mid-Value,Potential Loyalists
55321,335,3,"99,15",5,1,1,7,Mid-Value,Potential Loyalists
55322,1150,3,"142,85",2,1,1,4,Low-Value,Can't Lose
55323,225,8,"290,55",5,2,1,8,High-Value,Potential Loyalists
55326,577,7,"376,5",4,2,1,7,Mid-Value,Potential Loyalists
55327,338,1,"62,1",5,1,1,7,Mid-Value,Potential Loyalists
55328,5,13,"718,2",5,3,2,10,High-Value,Champions
55333,854,5,"373,0",3,1,1,5,Low-Value,At Risk Customers
55335,403,8,"480,35",4,2,1,7,Mid-Value,Potential Loyalists
55336,259,1,"51,85",5,1,1,7,Mid-Value,Potential Loyalists
55338,533,2,"63,8",4,1,1,6,Mid-Value,Potential Loyalists
55339,1022,1,"49,5",3,1,1,5,Low-Value,At Risk Customers
55340,416,1,"7,25",4,1,1,6,Mid-Value,Potential Loyalists
55344,1494,3,"171,9",1,1,1,3,Low-Value,Lost
55345,326,3,"57,85",5,1,1,7,Mid-Value,Potential Loyalists
55346,158,2,"102,60000000000001",5,1,1,7,Mid-Value,Potential Loyalists
55348,1275,1,"8,25",2,1,1,4,Low-Value,Can't Lose
55350,164,11,"476,65",5,2,1,8,High-Value,Potential Loyalists
55352,1345,2,"58,9",2,1,1,4,Low-Value,Can't Lose
55355,68,3,"474,95",5,1,1,7,Mid-Value,Potential Loyalists
55357,606,7,"341,4",4,2,1,7,Mid-Value,Potential Loyalists
55358,199,4,"357,5",5,1,1,7,Mid-Value,Potential Loyalists
55360,277,1,"74,6",5,1,1,7,Mid-Value,Potential Loyalists
55361,657,2,"115,35",4,1,1,6,Mid-Value,Potential Loyalists
55363,101,3,"121,6",5,1,1,7,Mid-Value,Potential Loyalists
55365,851,6,"517,4",3,1,1,5,Low-Value,At Risk Customers
55366,1373,1,"18,5",2,1,1,4,Low-Value,Can't Lose
55367,412,3,"135,9",4,1,1,6,Mid-Value,Potential Loyalists
55369,461,2,"66,75",4,1,1,6,Mid-Value,Potential Loyalists
55370,1337,2,"109,05",2,1,1,4,Low-Value,Can't Lose
55371,485,4,"232,39999999999998",4,1,1,6,Mid-Value,Potential Loyalists
55372,39,1,"12,3",5,1,1,7,Mid-Value,Potential Loyalists
55374,97,4,"309,59999999999997",5,1,1,7,Mid-Value,Potential Loyalists
55375,839,3,"42,900000000000006",3,1,1,5,Low-Value,At Risk Customers
55377,968,2,"68,35000000000001",3,1,1,5,Low-Value,At Risk Customers
55378,438,7,"420,09999999999997",4,2,1,7,Mid-Value,Potential Loyalists
55379,817,7,"374,55",3,2,1,6,Mid-Value,Potential Loyalists
55380,1118,2,"76,14999999999999",2,1,1,4,Low-Value,Can't Lose
55381,921,5,"221,75",3,1,1,5,Low-Value,At Risk Customers
55382,1243,1,"30,5",2,1,1,4,Low-Value,Can't Lose
55383,435,3,"115,5",4,1,1,6,Mid-Value,Potential Loyalists
55384,907,1,"109,0",3,1,1,5,Low-Value,At Risk Customers
55385,578,2,"130,75",4,1,1,6,Mid-Value,Potential Loyalists
55386,630,4,"198,35000000000002",4,1,1,6,Mid-Value,Potential Loyalists
55387,641,2,"63,75",4,1,1,6,Mid-Value,Potential Loyalists
55388,376,2,"160,0",4,1,1,6,Mid-Value,Potential Loyalists
55390,458,5,"193,05",4,1,1,6,Mid-Value,Potential Loyalists
55391,1580,3,"143,8",1,1,1,3,Low-Value,Lost
55393,398,1,"12,85",4,1,1,6,Mid-Value,Potential Loyalists
55396,1719,1,"145,35000000000002",1,1,1,3,Low-Value,Lost
55397,171,5,"477,0",5,1,1,7,Mid-Value,Potential Loyalists
55398,357,3,"140,55",5,1,1,7,Mid-Value,Potential Loyalists
55399,171,2,"42,8",5,1,1,7,Mid-Value,Potential Loyalists
55400,363,2,"127,94999999999999",5,1,1,7,Mid-Value,Potential Loyalists
55401,1216,2,"42,4",2,1,1,4,Low-Value,Can't Lose
55402,1222,4,"252,4",2,1,1,4,Low-Value,Can't Lose
55403,327,4,"299,7",5,1,1,7,Mid-Value,Potential Loyalists
55406,29,7,"351,0",5,2,1,8,High-Value,Potential Loyalists
55407,1383,3,"205,54999999999998",2,1,1,4,Low-Value,Can't Lose
55409,10,1,"100,4",5,1,1,7,Mid-Value,Potential Loyalists
55411,1393,1,"104,6",2,1,1,4,Low-Value,Can't Lose
55412,476,9,"570,6",4,2,1,7,Mid-Value,Potential Loyalists
55414,1354,1,"3,5",2,1,1,4,Low-Value,Can't Lose
55416,93,4,"71,85",5,1,1,7,Mid-Value,Potential Loyalists
55418,730,1,"49,0",4,1,1,6,Mid-Value,Potential Loyalists
55419,409,5,"405,08",4,1,1,6,Mid-Value,Potential Loyalists
55420,526,6,"306,75",4,1,1,6,Mid-Value,Potential Loyalists
55421,821,1,"42,45",3,1,1,5,Low-Value,At Risk Customers
55422,274,5,"302,05",5,1,1,7,Mid-Value,Potential Loyalists
55423,69,15,"1239,45",5,3,2,10,High-Value,Champions
55425,558,1,"68,2",4,1,1,6,Mid-Value,Potential Loyalists
55426,206,1,"97,80000000000001",5,1,1,7,Mid-Value,Potential Loyalists
55427,49,7,"425,75",5,2,1,8,High-Value,Potential Loyalists
55428,476,1,"182,4",4,1,1,6,Mid-Value,Potential Loyalists
55430,1704,1,"44,85",1,1,1,3,Low-Value,Lost
55431,362,1,"21,5",5,1,1,7,Mid-Value,Potential Loyalists
55432,428,8,"475,9",4,2,1,7,Mid-Value,Potential Loyalists
55433,910,3,"1077,5",3,1,2,6,Mid-Value,Potential Loyalists
55434,70,8,"444,4",5,2,1,8,High-Value,Potential Loyalists
55435,67,7,"680,3",5,2,2,9,High-Value,Champions
55436,1455,2,"99,75",2,1,1,4,Low-Value,Can't Lose
55439,339,2,"144,0",5,1,1,7,Mid-Value,Potential Loyalists
55441,34,3,"54,0",5,1,1,7,Mid-Value,Potential Loyalists
55442,68,7,"1087,3999999999999",5,2,2,9,High-Value,Champions
55444,571,3,"475,25",4,1,1,6,Mid-Value,Potential Loyalists
55446,619,2,"266,3",4,1,1,6,Mid-Value,Potential Loyalists
55447,158,6,"324,15",5,1,1,7,Mid-Value,Potential Loyalists
55450,232,6,"216,8",5,1,1,7,Mid-Value,Potential Loyalists
55452,1065,2,"89,35",3,1,1,5,Low-Value,At Risk Customers
55454,25,2,"143,65",5,1,1,7,Mid-Value,Potential Loyalists
55455,437,1,"10,65",4,1,1,6,Mid-Value,Potential Loyalists
55459,101,7,"1128,65",5,2,2,9,High-Value,Champions
55460,654,1,"71,8",4,1,1,6,Mid-Value,Potential Loyalists
55461,40,4,"249,2",5,1,1,7,Mid-Value,Potential Loyalists
55462,826,2,"114,95",3,1,1,5,Low-Value,At Risk Customers
55463,376,1,"16,6",4,1,1,6,Mid-Value,Potential Loyalists
55464,48,11,"326,05",5,2,1,8,High-Value,Potential Loyalists
55465,1126,2,"232,39999999999998",2,1,1,4,Low-Value,Can't Lose
55466,70,1,"55,75",5,1,1,7,Mid-Value,Potential Loyalists
55469,1160,2,"65,3",2,1,1,4,Low-Value,Can't Lose
55470,265,5,"98,65",5,1,1,7,Mid-Value,Potential Loyalists
55471,421,4,"218,35000000000002",4,1,1,6,Mid-Value,Potential Loyalists
55473,380,5,"261,15",4,1,1,6,Mid-Value,Potential Loyalists
55474,323,3,"20,95",5,1,1,7,Mid-Value,Potential Loyalists
55476,57,3,"158,9",5,1,1,7,Mid-Value,Potential Loyalists
55477,26,7,"488,5",5,2,1,8,High-Value,Potential Loyalists
55479,281,1,"85,8",5,1,1,7,Mid-Value,Potential Loyalists
55480,31,8,"501,45",5,2,1,8,High-Value,Potential Loyalists
55481,1265,3,"147,2",2,1,1,4,Low-Value,Can't Lose
55482,377,2,"145,65",4,1,1,6,Mid-Value,Potential Loyalists
55483,88,4,"199,4",5,1,1,7,Mid-Value,Potential Loyalists
55487,48,2,"38,550000000000004",5,1,1,7,Mid-Value,Potential Loyalists
55489,1110,1,"60,3",2,1,1,4,Low-Value,Can't Lose
55492,779,4,"235,65",3,1,1,5,Low-Value,At Risk Customers
55493,929,1,"63,9",3,1,1,5,Low-Value,At Risk Customers
55495,1016,1,"31,2",3,1,1,5,Low-Value,At Risk Customers
55496,1423,1,"6,35",2,1,1,4,Low-Value,Can't Lose
55497,767,4,"193,64999999999998",3,1,1,5,Low-Value,At Risk Customers
55499,280,1,"51,4",5,1,1,7,Mid-Value,Potential Loyalists
55500,1449,2,"34,25",2,1,1,4,Low-Value,Can't Lose
55502,1050,2,"78,94999999999999",3,1,1,5,Low-Value,At Risk Customers
55503,698,1,"49,05",4,1,1,6,Mid-Value,Potential Loyalists
55504,936,1,"41,5",3,1,1,5,Low-Value,At Risk Customers
55506,52,5,"480,9",5,1,1,7,Mid-Value,Potential Loyalists
55507,15,5,"287,45000000000005",5,1,1,7,Mid-Value,Potential Loyalists
55509,1389,3,"215,20000000000002",2,1,1,4,Low-Value,Can't Lose
55510,353,1,"17,55",5,1,1,7,Mid-Value,Potential Loyalists
55511,708,7,"388,30000000000007",4,2,1,7,Mid-Value,Potential Loyalists
55512,1170,2,"91,30000000000001",2,1,1,4,Low-Value,Can't Lose
55514,691,3,"145,65",4,1,1,6,Mid-Value,Potential Loyalists
55515,185,7,"301,79999999999995",5,2,1,8,High-Value,Potential Loyalists
55517,1760,1,"6,55",1,1,1,3,Low-Value,Lost
55518,912,4,"215,75",3,1,1,5,Low-Value,At Risk Customers
55519,417,6,"308,05",4,1,1,6,Mid-Value,Potential Loyalists
55520,14,5,"330,55",5,1,1,7,Mid-Value,Potential Loyalists
55521,893,3,"360,4",3,1,1,5,Low-Value,At Risk Customers
55522,579,5,"579,65",4,1,1,6,Mid-Value,Potential Loyalists
55523,383,2,"80,0",4,1,1,6,Mid-Value,Potential Loyalists
55524,535,2,"64,55",4,1,1,6,Mid-Value,Potential Loyalists
55526,328,2,"135,5",5,1,1,7,Mid-Value,Potential Loyalists
55527,916,6,"518,2",3,1,1,5,Low-Value,At Risk Customers
55529,101,8,"344,79999999999995",5,2,1,8,High-Value,Potential Loyalists
55531,724,1,"1,15",4,1,1,6,Mid-Value,Potential Loyalists
55535,1496,2,"198,9",1,1,1,3,Low-Value,Lost
55536,80,7,"245,05",5,2,1,8,High-Value,Potential Loyalists
55538,894,1,"49,8",3,1,1,5,Low-Value,At Risk Customers
55539,1009,1,"42,15",3,1,1,5,Low-Value,At Risk Customers
55541,1035,1,"14,5",3,1,1,5,Low-Value,At Risk Customers
55542,46,5,"257,1",5,1,1,7,Mid-Value,Potential Loyalists
55543,865,1,"10,2",3,1,1,5,Low-Value,At Risk Customers
55546,265,3,"92,6",5,1,1,7,Mid-Value,Potential Loyalists
55547,490,7,"631,1999999999999",4,2,1,7,Mid-Value,Potential Loyalists
55549,1114,2,"61,550000000000004",2,1,1,4,Low-Value,Can't Lose
55552,234,6,"405,04999999999995",5,1,1,7,Mid-Value,Potential Loyalists
55554,136,3,"213,4",5,1,1,7,Mid-Value,Potential Loyalists
55556,297,2,"60,6",5,1,1,7,Mid-Value,Potential Loyalists
55561,40,2,"27,400000000000002",5,1,1,7,Mid-Value,Potential Loyalists
55563,1126,1,"17,6",2,1,1,4,Low-Value,Can't Lose
55564,436,1,"30,9",4,1,1,6,Mid-Value,Potential Loyalists
55565,1272,2,"56,35",2,1,1,4,Low-Value,Can't Lose
55566,145,8,"646,35",5,2,1,8,High-Value,Potential Loyalists
55568,1069,1,"34,2",3,1,1,5,Low-Value,At Risk Customers
55570,403,2,"66,5",4,1,1,6,Mid-Value,Potential Loyalists
55571,1145,3,"51,35",2,1,1,4,Low-Value,Can't Lose
55573,158,5,"104,5",5,1,1,7,Mid-Value,Potential Loyalists
55574,9,2,"60,3",5,1,1,7,Mid-Value,Potential Loyalists
55575,413,1,"2,2",4,1,1,6,Mid-Value,Potential Loyalists
55576,548,2,"523,4",4,1,1,6,Mid-Value,Potential Loyalists
55577,74,3,"167,95",5,1,1,7,Mid-Value,Potential Loyalists
55578,939,4,"133,5",3,1,1,5,Low-Value,At Risk Customers
55579,164,4,"1253,1",5,1,2,8,High-Value,Potential Loyalists
55580,159,4,"1164,25",5,1,2,8,High-Value,Potential Loyalists
55581,90,12,"771,35",5,3,2,10,High-Value,Champions
55582,329,3,"240,7",5,1,1,7,Mid-Value,Potential Loyalists
55584,236,1,"42,9",5,1,1,7,Mid-Value,Potential Loyalists
55590,677,1,"18,0",4,1,1,6,Mid-Value,Potential Loyalists
55591,17,3,"253,55",5,1,1,7,Mid-Value,Potential Loyalists
55593,865,3,"179,5",3,1,1,5,Low-Value,At Risk Customers
55594,596,2,"163,1",4,1,1,6,Mid-Value,Potential Loyalists
55595,1152,4,"141,75",2,1,1,4,Low-Value,Can't Lose
55597,24,1,"50,4",5,1,1,7,Mid-Value,Potential Loyalists
55598,894,7,"285,55",3,2,1,6,Mid-Value,Potential Loyalists
55599,1,6,"362,2",5,1,1,7,Mid-Value,Potential Loyalists
55600,322,5,"264,9",5,1,1,7,Mid-Value,Potential Loyalists
55601,590,4,"64,8",4,1,1,6,Mid-Value,Potential Loyalists
55603,1140,6,"636,3",2,1,1,4,Low-Value,Can't Lose
55605,91,3,"626,6",5,1,1,7,Mid-Value,Potential Loyalists
55606,805,3,"124,3",3,1,1,5,Low-Value,At Risk Customers
55609,131,4,"155,65",5,1,1,7,Mid-Value,Potential Loyalists
55610,1281,2,"35,2",2,1,1,4,Low-Value,Can't Lose
55611,504,1,"103,94999999999999",4,1,1,6,Mid-Value,Potential Loyalists
55612,671,3,"112,55",4,1,1,6,Mid-Value,Potential Loyalists
55615,909,2,"182,14999999999998",3,1,1,5,Low-Value,At Risk Customers
55617,1138,2,"88,15",2,1,1,4,Low-Value,Can't Lose
55618,250,5,"217,4",5,1,1,7,Mid-Value,Potential Loyalists
55619,1061,1,"39,95",3,1,1,5,Low-Value,At Risk Customers
55624,404,1,"54,7",4,1,1,6,Mid-Value,Potential Loyalists
55625,20,6,"212,45000000000002",5,1,1,7,Mid-Value,Potential Loyalists
55626,228,4,"116,05",5,1,1,7,Mid-Value,Potential Loyalists
55627,193,2,"131,89999999999998",5,1,1,7,Mid-Value,Potential Loyalists
55628,499,1,"12,1",4,1,1,6,Mid-Value,Potential Loyalists
55629,40,2,"50,849999999999994",5,1,1,7,Mid-Value,Potential Loyalists
55630,368,10,"523,2",4,2,1,7,Mid-Value,Potential Loyalists
55631,500,3,"429,8",4,1,1,6,Mid-Value,Potential Loyalists
55632,54,8,"459,45",5,2,1,8,High-Value,Potential Loyalists
55633,1104,2,"282,6",2,1,1,4,Low-Value,Can't Lose
55634,739,1,"57,95",3,1,1,5,Low-Value,At Risk Customers
55637,696,2,"31,1",4,1,1,6,Mid-Value,Potential Loyalists
55641,1635,1,"38,5",1,1,1,3,Low-Value,Lost
55642,1565,1,"2,75",1,1,1,3,Low-Value,Lost
55645,1029,2,"130,6",3,1,1,5,Low-Value,At Risk Customers
55646,329,1,"52,2",5,1,1,7,Mid-Value,Potential Loyalists
55647,36,2,"17,4",5,1,1,7,Mid-Value,Potential Loyalists
55650,760,2,"26,35",3,1,1,5,Low-Value,At Risk Customers
55653,762,1,"24,65",3,1,1,5,Low-Value,At Risk Customers
55655,39,6,"333,95",5,1,1,7,Mid-Value,Potential Loyalists
55656,788,5,"139,75",3,1,1,5,Low-Value,At Risk Customers
55657,62,1,"122,8",5,1,1,7,Mid-Value,Potential Loyalists
55661,1580,2,"50,25",1,1,1,3,Low-Value,Lost
55662,255,10,"549,25",5,2,1,8,High-Value,Potential Loyalists
55664,1731,1,"21,0",1,1,1,3,Low-Value,Lost
55666,383,2,"118,3",4,1,1,6,Mid-Value,Potential Loyalists
55668,1214,1,"49,15",2,1,1,4,Low-Value,Can't Lose
55669,35,3,"109,19999999999999",5,1,1,7,Mid-Value,Potential Loyalists
55670,700,2,"111,95",4,1,1,6,Mid-Value,Potential Loyalists
55671,1708,1,"30,69",1,1,1,3,Low-Value,Lost
55672,38,4,"315,1",5,1,1,7,Mid-Value,Potential Loyalists
55674,21,3,"102,85000000000001",5,1,1,7,Mid-Value,Potential Loyalists
55676,1141,3,"374,29999999999995",2,1,1,4,Low-Value,Can't Lose
55677,1471,2,"30,35",1,1,1,3,Low-Value,Lost
55678,384,1,"76,8",4,1,1,6,Mid-Value,Potential Loyalists
55679,1600,1,"17,6",1,1,1,3,Low-Value,Lost
55680,10,5,"675,85",5,1,2,8,High-Value,Potential Loyalists
55681,1236,2,"127,5",2,1,1,4,Low-Value,Can't Lose
55683,1142,3,"102,68",2,1,1,4,Low-Value,Can't Lose
55684,970,1,"72,6",3,1,1,5,Low-Value,At Risk Customers
55685,389,3,"214,85",4,1,1,6,Mid-Value,Potential Loyalists
55686,176,3,"483,4",5,1,1,7,Mid-Value,Potential Loyalists
55687,178,6,"503,34999999999997",5,1,1,7,Mid-Value,Potential Loyalists
55688,437,7,"395,65",4,2,1,7,Mid-Value,Potential Loyalists
55691,393,2,"513,5",4,1,1,6,Mid-Value,Potential Loyalists
55692,18,8,"439,65",5,2,1,8,High-Value,Potential Loyalists
55695,1534,2,"49,7",1,1,1,3,Low-Value,Lost
55696,570,5,"410,95000000000005",4,1,1,6,Mid-Value,Potential Loyalists
55698,1027,2,"108,75",3,1,1,5,Low-Value,At Risk Customers
55699,1637,2,"172,95",1,1,1,3,Low-Value,Lost
55700,1364,2,"35,4",2,1,1,4,Low-Value,Can't Lose
55702,593,2,"44,0",4,1,1,6,Mid-Value,Potential Loyalists
55703,150,2,"133,45",5,1,1,7,Mid-Value,Potential Loyalists
55704,8,8,"309,5",5,2,1,8,High-Value,Potential Loyalists
55709,614,1,"96,44999999999999",4,1,1,6,Mid-Value,Potential Loyalists
55710,1638,2,"167,3",1,1,1,3,Low-Value,Lost
55712,67,1,"2,25",5,1,1,7,Mid-Value,Potential Loyalists
55714,204,7,"488,70000000000005",5,2,1,8,High-Value,Potential Loyalists
55715,807,2,"14,05",3,1,1,5,Low-Value,At Risk Customers
55717,8,5,"217,85",5,1,1,7,Mid-Value,Potential Loyalists
55719,1376,1,"9,3",2,1,1,4,Low-Value,Can't Lose
55720,147,5,"496,54999999999995",5,1,1,7,Mid-Value,Potential Loyalists
55721,1779,1,"56,6",1,1,1,3,Low-Value,Lost
55722,1300,1,"140,8",2,1,1,4,Low-Value,Can't Lose
55723,732,3,"444,45000000000005",3,1,1,5,Low-Value,At Risk Customers
55724,667,1,"53,0",4,1,1,6,Mid-Value,Potential Loyalists
55725,1354,3,"91,75",2,1,1,4,Low-Value,Can't Lose
55727,379,5,"639,65",4,1,1,6,Mid-Value,Potential Loyalists
55728,1544,1,"44,0",1,1,1,3,Low-Value,Lost
55730,346,2,"74,7",5,1,1,7,Mid-Value,Potential Loyalists
55731,508,3,"170,15",4,1,1,6,Mid-Value,Potential Loyalists
55734,1818,1,"174,7",1,1,1,3,Low-Value,Lost
55735,1319,2,"52,7",2,1,1,4,Low-Value,Can't Lose
55738,314,2,"58,75",5,1,1,7,Mid-Value,Potential Loyalists
55740,601,3,"241,65000000000003",4,1,1,6,Mid-Value,Potential Loyalists
55741,1252,1,"41,400000000000006",2,1,1,4,Low-Value,Can't Lose
55742,549,2,"38,4",4,1,1,6,Mid-Value,Potential Loyalists
55743,443,4,"254,8",4,1,1,6,Mid-Value,Potential Loyalists
55744,31,4,"265,35",5,1,1,7,Mid-Value,Potential Loyalists
55745,166,6,"133,3",5,1,1,7,Mid-Value,Potential Loyalists
55746,610,3,"93,5",4,1,1,6,Mid-Value,Potential Loyalists
55747,966,7,"213,75",3,2,1,6,Mid-Value,Potential Loyalists
55749,1070,3,"201,75",3,1,1,5,Low-Value,At Risk Customers
55751,829,2,"265,5",3,1,1,5,Low-Value,At Risk Customers
55752,164,1,"67,4",5,1,1,7,Mid-Value,Potential Loyalists
55753,788,3,"180,9",3,1,1,5,Low-Value,At Risk Customers
55754,541,2,"158,7",4,1,1,6,Mid-Value,Potential Loyalists
55755,856,4,"304,75",3,1,1,5,Low-Value,At Risk Customers
55756,297,3,"35,8",5,1,1,7,Mid-Value,Potential Loyalists
55758,12,4,"119,64999999999999",5,1,1,7,Mid-Value,Potential Loyalists
55759,54,8,"768,95",5,2,2,9,High-Value,Champions
55760,269,3,"269,0",5,1,1,7,Mid-Value,Potential Loyalists
55761,413,3,"233,89999999999998",4,1,1,6,Mid-Value,Potential Loyalists
55762,239,1,"95,65",5,1,1,7,Mid-Value,Potential Loyalists
55763,25,7,"376,95",5,2,1,8,High-Value,Potential Loyalists
55764,414,1,"19,3",4,1,1,6,Mid-Value,Potential Loyalists
55766,419,6,"254,10000000000002",4,1,1,6,Mid-Value,Potential Loyalists
55767,283,1,"80,9",5,1,1,7,Mid-Value,Potential Loyalists
55768,2,5,"190,0",5,1,1,7,Mid-Value,Potential Loyalists
55769,459,5,"225,35",4,1,1,6,Mid-Value,Potential Loyalists
55770,733,2,"24,65",3,1,1,5,Low-Value,At Risk Customers
55773,456,2,"252,25000000000003",4,1,1,6,Mid-Value,Potential Loyalists
55774,1665,2,"58,150000000000006",1,1,1,3,Low-Value,Lost
55777,722,2,"59,85",4,1,1,6,Mid-Value,Potential Loyalists
55778,191,6,"385,35",5,1,1,7,Mid-Value,Potential Loyalists
55779,346,1,"31,95",5,1,1,7,Mid-Value,Potential Loyalists
55784,259,2,"83,4",5,1,1,7,Mid-Value,Potential Loyalists
55786,1,6,"279,25",5,1,1,7,Mid-Value,Potential Loyalists
55787,505,7,"480,1",4,2,1,7,Mid-Value,Potential Loyalists
55788,1561,1,"35,15",1,1,1,3,Low-Value,Lost
55792,363,6,"444,65000000000003",5,1,1,7,Mid-Value,Potential Loyalists
55793,235,1,"159,95",5,1,1,7,Mid-Value,Potential Loyalists
55798,891,5,"402,5",3,1,1,5,Low-Value,At Risk Customers
55799,369,6,"151,2",4,1,1,6,Mid-Value,Potential Loyalists
55800,724,1,"42,0",4,1,1,6,Mid-Value,Potential Loyalists
55801,41,2,"50,25",5,1,1,7,Mid-Value,Potential Loyalists
55805,668,3,"242,6",4,1,1,6,Mid-Value,Potential Loyalists
55806,389,4,"177,6",4,1,1,6,Mid-Value,Potential Loyalists
55808,1659,1,"27,1",1,1,1,3,Low-Value,Lost
55809,903,1,"18,15",3,1,1,5,Low-Value,At Risk Customers
55810,119,8,"744,5",5,2,2,9,High-Value,Champions
55811,136,4,"168,2",5,1,1,7,Mid-Value,Potential Loyalists
55813,187,6,"436,65",5,1,1,7,Mid-Value,Potential Loyalists
55814,26,7,"968,8499999999999",5,2,2,9,High-Value,Champions
55815,652,9,"332,95",4,2,1,7,Mid-Value,Potential Loyalists
55816,38,7,"491,5",5,2,1,8,High-Value,Potential Loyalists
55817,1461,2,"41,349999999999994",1,1,1,3,Low-Value,Lost
55819,380,2,"33,1",4,1,1,6,Mid-Value,Potential Loyalists
55820,1546,1,"20,75",1,1,1,3,Low-Value,Lost
55821,521,4,"166,15",4,1,1,6,Mid-Value,Potential Loyalists
55822,912,1,"117,1",3,1,1,5,Low-Value,At Risk Customers
55825,400,1,"128,3",4,1,1,6,Mid-Value,Potential Loyalists
55826,787,7,"707,2",3,2,2,7,Mid-Value,Potential Loyalists
55829,1224,2,"74,65",2,1,1,4,Low-Value,Can't Lose
55832,108,9,"848,9",5,2,2,9,High-Value,Champions
55833,164,2,"146,7",5,1,1,7,Mid-Value,Potential Loyalists
55835,938,2,"133,35000000000002",3,1,1,5,Low-Value,At Risk Customers
55837,277,2,"33,2",5,1,1,7,Mid-Value,Potential Loyalists
55839,533,6,"175,55",4,1,1,6,Mid-Value,Potential Loyalists
55840,858,3,"194,65",3,1,1,5,Low-Value,At Risk Customers
55841,190,3,"292,25",5,1,1,7,Mid-Value,Potential Loyalists
55844,103,2,"144,85000000000002",5,1,1,7,Mid-Value,Potential Loyalists
55847,607,4,"421,20000000000005",4,1,1,6,Mid-Value,Potential Loyalists
55848,66,5,"209,6",5,1,1,7,Mid-Value,Potential Loyalists
55852,129,2,"184,65",5,1,1,7,Mid-Value,Potential Loyalists
55854,980,2,"35,35",3,1,1,5,Low-Value,At Risk Customers
55855,504,3,"313,1",4,1,1,6,Mid-Value,Potential Loyalists
55856,236,5,"354,09999999999997",5,1,1,7,Mid-Value,Potential Loyalists
55858,588,3,"264,65",4,1,1,6,Mid-Value,Potential Loyalists
55859,1273,3,"349,79999999999995",2,1,1,4,Low-Value,Can't Lose
55860,870,1,"14,7",3,1,1,5,Low-Value,At Risk Customers
55861,1130,4,"168,35000000000002",2,1,1,4,Low-Value,Can't Lose
55863,21,2,"94,94999999999999",5,1,1,7,Mid-Value,Potential Loyalists
55865,164,5,"291,90000000000003",5,1,1,7,Mid-Value,Potential Loyalists
55867,424,4,"311,4",4,1,1,6,Mid-Value,Potential Loyalists
55870,613,3,"254,5",4,1,1,6,Mid-Value,Potential Loyalists
55871,118,4,"294,65",5,1,1,7,Mid-Value,Potential Loyalists
55872,739,3,"132,65",3,1,1,5,Low-Value,At Risk Customers
55875,452,3,"53,95",4,1,1,6,Mid-Value,Potential Loyalists
55877,1286,1,"20,46",2,1,1,4,Low-Value,Can't Lose
55878,133,2,"221,25000000000003",5,1,1,7,Mid-Value,Potential Loyalists
55879,734,3,"212,35",3,1,1,5,Low-Value,At Risk Customers
55881,102,6,"389,90000000000003",5,1,1,7,Mid-Value,Potential Loyalists
55882,132,2,"49,1",5,1,1,7,Mid-Value,Potential Loyalists
55883,501,7,"356,1",4,2,1,7,Mid-Value,Potential Loyalists
55884,1112,1,"221,10000000000002",2,1,1,4,Low-Value,Can't Lose
55885,778,4,"143,35",3,1,1,5,Low-Value,At Risk Customers
55887,1579,2,"72,0",1,1,1,3,Low-Value,Lost
55894,17,5,"260,7",5,1,1,7,Mid-Value,Potential Loyalists
55895,100,3,"273,25",5,1,1,7,Mid-Value,Potential Loyalists
55896,1784,1,"412,3",1,1,1,3,Low-Value,Lost
55897,801,1,"14,2",3,1,1,5,Low-Value,At Risk Customers
55898,915,3,"168,9",3,1,1,5,Low-Value,At Risk Customers
55899,846,3,"238,7",3,1,1,5,Low-Value,At Risk Customers
55900,103,6,"610,85",5,1,1,7,Mid-Value,Potential Loyalists
55901,659,1,"140,0",4,1,1,6,Mid-Value,Potential Loyalists
55902,305,4,"292,1",5,1,1,7,Mid-Value,Potential Loyalists
55903,1048,1,"12,25",3,1,1,5,Low-Value,At Risk Customers
55904,211,2,"19,6",5,1,1,7,Mid-Value,Potential Loyalists
55906,164,1,"27,900000000000002",5,1,1,7,Mid-Value,Potential Loyalists
55907,379,3,"113,15",4,1,1,6,Mid-Value,Potential Loyalists
55909,734,2,"170,8",3,1,1,5,Low-Value,At Risk Customers
55910,1506,2,"46,1",1,1,1,3,Low-Value,Lost
55912,978,1,"55,9",3,1,1,5,Low-Value,At Risk Customers
55913,675,1,"28,05",4,1,1,6,Mid-Value,Potential Loyalists
55914,939,1,"12,2",3,1,1,5,Low-Value,At Risk Customers
55915,1111,2,"140,35",2,1,1,4,Low-Value,Can't Lose
55916,13,3,"518,9",5,1,1,7,Mid-Value,Potential Loyalists
55918,222,2,"99,75",5,1,1,7,Mid-Value,Potential Loyalists
55919,78,11,"2222,65",5,2,4,11,High-Value,Champions
55920,209,19,"1268,4",5,4,2,11,High-Value,Champions
55921,1369,5,"212,6",2,1,1,4,Low-Value,Can't Lose
55922,13,3,"287,8",5,1,1,7,Mid-Value,Potential Loyalists
55923,152,4,"426,7",5,1,1,7,Mid-Value,Potential Loyalists
55924,29,6,"352,0",5,1,1,7,Mid-Value,Potential Loyalists
55925,13,8,"822,35",5,2,2,9,High-Value,Champions
55927,1169,5,"289,51",2,1,1,4,Low-Value,Can't Lose
55929,984,1,"27,150000000000002",3,1,1,5,Low-Value,At Risk Customers
55930,1330,1,"376,95000000000005",2,1,1,4,Low-Value,Can't Lose
55931,1469,1,"5,9",1,1,1,3,Low-Value,Lost
55932,1629,1,"349,4",1,1,1,3,Low-Value,Lost
55933,1494,6,"162,5",1,1,1,3,Low-Value,Lost
55934,27,4,"209,70000000000002",5,1,1,7,Mid-Value,Potential Loyalists
55935,123,8,"445,25",5,2,1,8,High-Value,Potential Loyalists
55936,1189,2,"31,6",2,1,1,4,Low-Value,Can't Lose
55937,1046,1,"31,4",3,1,1,5,Low-Value,At Risk Customers
55939,134,8,"195,55",5,2,1,8,High-Value,Potential Loyalists
55940,943,3,"97,44999999999999",3,1,1,5,Low-Value,At Risk Customers
55941,459,3,"111,3",4,1,1,6,Mid-Value,Potential Loyalists
55942,1176,1,"28,0",2,1,1,4,Low-Value,Can't Lose
55943,1503,2,"194,2",1,1,1,3,Low-Value,Lost
55944,57,6,"198,79999999999998",5,1,1,7,Mid-Value,Potential Loyalists
55945,244,4,"268,85",5,1,1,7,Mid-Value,Potential Loyalists
55946,1088,1,"12,85",3,1,1,5,Low-Value,At Risk Customers
55950,794,2,"59,8",3,1,1,5,Low-Value,At Risk Customers
55951,207,2,"102,65",5,1,1,7,Mid-Value,Potential Loyalists
55954,1283,2,"77,95",2,1,1,4,Low-Value,Can't Lose
55956,206,3,"172,14999999999998",5,1,1,7,Mid-Value,Potential Loyalists
55958,1789,1,"30,0",1,1,1,3,Low-Value,Lost
55959,741,2,"547,35",3,1,1,5,Low-Value,At Risk Customers
55960,1132,1,"12,25",2,1,1,4,Low-Value,Can't Lose
55961,1019,1,"1,1",3,1,1,5,Low-Value,At Risk Customers
55963,964,3,"146,95000000000002",3,1,1,5,Low-Value,At Risk Customers
55964,42,5,"544,05",5,1,1,7,Mid-Value,Potential Loyalists
55965,234,2,"131,4",5,1,1,7,Mid-Value,Potential Loyalists
55971,934,2,"89,1",3,1,1,5,Low-Value,At Risk Customers
55972,905,3,"93,80000000000001",3,1,1,5,Low-Value,At Risk Customers
55973,79,2,"38,400000000000006",5,1,1,7,Mid-Value,Potential Loyalists
55976,103,2,"168,89999999999998",5,1,1,7,Mid-Value,Potential Loyalists
55977,19,5,"118,5",5,1,1,7,Mid-Value,Potential Loyalists
55979,236,10,"1740,1000000000001",5,2,3,10,High-Value,Champions
55980,496,4,"165,1",4,1,1,6,Mid-Value,Potential Loyalists
55982,1070,4,"541,25",3,1,1,5,Low-Value,At Risk Customers
55984,482,1,"29,3",4,1,1,6,Mid-Value,Potential Loyalists
55985,267,4,"194,9",5,1,1,7,Mid-Value,Potential Loyalists
55986,369,6,"137,4",4,1,1,6,Mid-Value,Potential Loyalists
55987,186,10,"690,45",5,2,2,9,High-Value,Champions
55989,817,2,"58,55",3,1,1,5,Low-Value,At Risk Customers
55992,746,2,"154,9",3,1,1,5,Low-Value,At Risk Customers
55993,785,2,"56,900000000000006",3,1,1,5,Low-Value,At Risk Customers
55994,431,7,"627,55",4,2,1,7,Mid-Value,Potential Loyalists
56000,389,4,"250,75",4,1,1,6,Mid-Value,Potential Loyalists
56002,1609,1,"383,85",1,1,1,3,Low-Value,Lost
56003,18,4,"259,95",5,1,1,7,Mid-Value,Potential Loyalists
56004,157,2,"100,4",5,1,1,7,Mid-Value,Potential Loyalists
56009,161,6,"443,2",5,1,1,7,Mid-Value,Potential Loyalists
56011,676,2,"265,6",4,1,1,6,Mid-Value,Potential Loyalists
56014,1709,2,"69,4",1,1,1,3,Low-Value,Lost
56015,285,8,"256,45",5,2,1,8,High-Value,Potential Loyalists
56016,439,2,"39,2",4,1,1,6,Mid-Value,Potential Loyalists
56017,153,10,"662,85",5,2,1,8,High-Value,Potential Loyalists
56018,147,11,"1560,8999999999999",5,2,3,10,High-Value,Champions
56019,207,7,"515,45",5,2,1,8,High-Value,Potential Loyalists
56020,469,4,"201,5",4,1,1,6,Mid-Value,Potential Loyalists
56022,1119,4,"403,85",2,1,1,4,Low-Value,Can't Lose
56023,40,8,"222,45000000000002",5,2,1,8,High-Value,Potential Loyalists
56024,1246,1,"40,0",2,1,1,4,Low-Value,Can't Lose
56026,0,3,"237,55",5,1,1,7,Mid-Value,Potential Loyalists
56029,1112,5,"331,35",2,1,1,4,Low-Value,Can't Lose
56030,46,1,"58,85",5,1,1,7,Mid-Value,Potential Loyalists
56033,1260,1,"20,9",2,1,1,4,Low-Value,Can't Lose
56036,3,3,"149,25",5,1,1,7,Mid-Value,Potential Loyalists
56037,531,1,"108,0",4,1,1,6,Mid-Value,Potential Loyalists
56038,1114,1,"105,7",2,1,1,4,Low-Value,Can't Lose
56039,1241,6,"500,54999999999995",2,1,1,4,Low-Value,Can't Lose
56040,1212,2,"21,15",2,1,1,4,Low-Value,Can't Lose
56041,146,3,"194,05",5,1,1,7,Mid-Value,Potential Loyalists
56043,741,5,"263,65",3,1,1,5,Low-Value,At Risk Customers
56044,493,3,"47,4",4,1,1,6,Mid-Value,Potential Loyalists
56046,1359,1,"42,8",2,1,1,4,Low-Value,Can't Lose
56047,41,4,"176,2",5,1,1,7,Mid-Value,Potential Loyalists
56048,30,6,"581,95",5,1,1,7,Mid-Value,Potential Loyalists
56050,144,4,"278,2",5,1,1,7,Mid-Value,Potential Loyalists
56051,138,5,"286,55",5,1,1,7,Mid-Value,Potential Loyalists
56053,188,2,"233,7",5,1,1,7,Mid-Value,Potential Loyalists
56054,269,1,"24,150000000000002",5,1,1,7,Mid-Value,Potential Loyalists
56057,1409,2,"27,700000000000003",2,1,1,4,Low-Value,Can't Lose
56060,17,4,"299,66",5,1,1,7,Mid-Value,Potential Loyalists
56061,235,2,"601,5",5,1,1,7,Mid-Value,Potential Loyalists
56065,558,3,"345,55",4,1,1,6,Mid-Value,Potential Loyalists
56066,52,15,"354,65",5,3,1,9,High-Value,Champions
56067,47,4,"137,9",5,1,1,7,Mid-Value,Potential Loyalists
56068,775,2,"37,1",3,1,1,5,Low-Value,At Risk Customers
56069,220,4,"244,65",5,1,1,7,Mid-Value,Potential Loyalists
56070,188,6,"218,55",5,1,1,7,Mid-Value,Potential Loyalists
56071,596,3,"274,4",4,1,1,6,Mid-Value,Potential Loyalists
56073,1494,2,"94,19999999999999",1,1,1,3,Low-Value,Lost
56074,571,1,"12,1",4,1,1,6,Mid-Value,Potential Loyalists
56076,566,1,"223,4",4,1,1,6,Mid-Value,Potential Loyalists
56077,46,9,"846,85",5,2,2,9,High-Value,Champions
56080,28,5,"399,95",5,1,1,7,Mid-Value,Potential Loyalists
56081,872,8,"484,7",3,2,1,6,Mid-Value,Potential Loyalists
56082,673,1,"10,3",4,1,1,6,Mid-Value,Potential Loyalists
56084,1007,3,"128,9",3,1,1,5,Low-Value,At Risk Customers
56085,1368,1,"44,6",2,1,1,4,Low-Value,Can't Lose
56087,331,3,"254,95",5,1,1,7,Mid-Value,Potential Loyalists
56088,973,2,"125,65",3,1,1,5,Low-Value,At Risk Customers
56089,1328,2,"204,0",2,1,1,4,Low-Value,Can't Lose
56090,320,1,"88,2",5,1,1,7,Mid-Value,Potential Loyalists
56091,259,4,"69,03",5,1,1,7,Mid-Value,Potential Loyalists
56092,1348,3,"190,6",2,1,1,4,Low-Value,Can't Lose
56093,146,7,"306,2",5,2,1,8,High-Value,Potential Loyalists
56094,293,6,"428,75",5,1,1,7,Mid-Value,Potential Loyalists
56095,453,5,"318,65000000000003",4,1,1,6,Mid-Value,Potential Loyalists
56096,1575,4,"322,75",1,1,1,3,Low-Value,Lost
56097,167,2,"162,8",5,1,1,7,Mid-Value,Potential Loyalists
56099,59,3,"295,9",5,1,1,7,Mid-Value,Potential Loyalists
56101,196,3,"494,75",5,1,1,7,Mid-Value,Potential Loyalists
56102,167,1,"48,1",5,1,1,7,Mid-Value,Potential Loyalists
56103,109,5,"110,3",5,1,1,7,Mid-Value,Potential Loyalists
56105,696,1,"5,6",4,1,1,6,Mid-Value,Potential Loyalists
56106,42,3,"292,75",5,1,1,7,Mid-Value,Potential Loyalists
56109,3,8,"466,1",5,2,1,8,High-Value,Potential Loyalists
56110,1280,2,"251,7",2,1,1,4,Low-Value,Can't Lose
56111,58,4,"219,4",5,1,1,7,Mid-Value,Potential Loyalists
56112,750,1,"311,2",3,1,1,5,Low-Value,At Risk Customers
56113,940,1,"65,6",3,1,1,5,Low-Value,At Risk Customers
56114,66,2,"568,3000000000001",5,1,1,7,Mid-Value,Potential Loyalists
56115,645,1,"42,45",4,1,1,6,Mid-Value,Potential Loyalists
56116,21,2,"616,6",5,1,1,7,Mid-Value,Potential Loyalists
56117,85,10,"577,8",5,2,1,8,High-Value,Potential Loyalists
56118,1116,2,"134,25",2,1,1,4,Low-Value,Can't Lose
56119,784,1,"19,7",3,1,1,5,Low-Value,At Risk Customers
56122,1099,1,"618,45",2,1,1,4,Low-Value,Can't Lose
56123,163,3,"140,4",5,1,1,7,Mid-Value,Potential Loyalists
56124,1568,1,"122,8",1,1,1,3,Low-Value,Lost
56126,131,8,"845,7",5,2,2,9,High-Value,Champions
56127,567,4,"169,55",4,1,1,6,Mid-Value,Potential Loyalists
56128,18,8,"403,2",5,2,1,8,High-Value,Potential Loyalists
56129,1378,1,"19,45",2,1,1,4,Low-Value,Can't Lose
56132,405,7,"291,05",4,2,1,7,Mid-Value,Potential Loyalists
56135,183,1,"68,1",5,1,1,7,Mid-Value,Potential Loyalists
56137,1477,1,"40,4",1,1,1,3,Low-Value,Lost
56138,513,1,"7,6499999999999995",4,1,1,6,Mid-Value,Potential Loyalists
56139,1578,1,"50,4",1,1,1,3,Low-Value,Lost
56142,567,3,"384,20000000000005",4,1,1,6,Mid-Value,Potential Loyalists
56143,67,7,"392,4",5,2,1,8,High-Value,Potential Loyalists
56144,13,1,"12,2",5,1,1,7,Mid-Value,Potential Loyalists
56145,90,1,"32,65",5,1,1,7,Mid-Value,Potential Loyalists
56146,85,4,"197,1",5,1,1,7,Mid-Value,Potential Loyalists
56147,13,1,"39,95",5,1,1,7,Mid-Value,Potential Loyalists
56149,1096,1,"78,3",2,1,1,4,Low-Value,Can't Lose
56152,1159,3,"80,4",2,1,1,4,Low-Value,Can't Lose
56153,83,10,"641,0",5,2,1,8,High-Value,Potential Loyalists
56155,24,2,"97,8",5,1,1,7,Mid-Value,Potential Loyalists
56157,416,1,"5,45",4,1,1,6,Mid-Value,Potential Loyalists
56158,1306,1,"129,05",2,1,1,4,Low-Value,Can't Lose
56159,374,1,"4,4",4,1,1,6,Mid-Value,Potential Loyalists
56161,848,4,"311,45",3,1,1,5,Low-Value,At Risk Customers
56162,262,4,"608,75",5,1,1,7,Mid-Value,Potential Loyalists
56163,1808,2,"142,8",1,1,1,3,Low-Value,Lost
56165,82,7,"729,85",5,2,2,9,High-Value,Champions
56166,531,3,"185,5",4,1,1,6,Mid-Value,Potential Loyalists
56168,826,1,"47,7",3,1,1,5,Low-Value,At Risk Customers
56169,1238,2,"186,0",2,1,1,4,Low-Value,Can't Lose
56171,1308,1,"74,25",2,1,1,4,Low-Value,Can't Lose
56176,12,2,"103,2",5,1,1,7,Mid-Value,Potential Loyalists
56178,646,5,"576,0",4,1,1,6,Mid-Value,Potential Loyalists
56180,919,4,"69,55",3,1,1,5,Low-Value,At Risk Customers
56182,115,9,"340,8",5,2,1,8,High-Value,Potential Loyalists
56184,1147,1,"27,6",2,1,1,4,Low-Value,Can't Lose
56185,619,7,"978,0",4,2,2,8,High-Value,Potential Loyalists
56186,530,6,"593,75",4,1,1,6,Mid-Value,Potential Loyalists
56188,20,3,"175,4",5,1,1,7,Mid-Value,Potential Loyalists
56192,803,1,"97,3",3,1,1,5,Low-Value,At Risk Customers
56193,298,1,"47,7",5,1,1,7,Mid-Value,Potential Loyalists
56196,424,2,"38,15",4,1,1,6,Mid-Value,Potential Loyalists
56197,507,3,"94,85",4,1,1,6,Mid-Value,Potential Loyalists
56200,493,1,"213,75",4,1,1,6,Mid-Value,Potential Loyalists
56201,903,3,"296,65",3,1,1,5,Low-Value,At Risk Customers
56202,368,2,"43,699999999999996",4,1,1,6,Mid-Value,Potential Loyalists
56208,946,3,"210,95000000000002",3,1,1,5,Low-Value,At Risk Customers
56209,416,8,"381,3",4,2,1,7,Mid-Value,Potential Loyalists
56210,169,5,"104,45",5,1,1,7,Mid-Value,Potential Loyalists
56211,1,8,"374,0",5,2,1,8,High-Value,Potential Loyalists
56212,41,7,"743,5",5,2,2,9,High-Value,Champions
56213,1596,2,"151,2",1,1,1,3,Low-Value,Lost
56214,26,6,"355,90000000000003",5,1,1,7,Mid-Value,Potential Loyalists
56216,210,1,"144,0",5,1,1,7,Mid-Value,Potential Loyalists
56218,20,7,"793,75",5,2,2,9,High-Value,Champions
56220,386,4,"441,75",4,1,1,6,Mid-Value,Potential Loyalists
56221,682,1,"29,1",4,1,1,6,Mid-Value,Potential Loyalists
56222,1247,2,"382,40000000000003",2,1,1,4,Low-Value,Can't Lose
56223,809,5,"133,15",3,1,1,5,Low-Value,At Risk Customers
56227,656,1,"42,0",4,1,1,6,Mid-Value,Potential Loyalists
56228,43,6,"311,05",5,1,1,7,Mid-Value,Potential Loyalists
56229,1702,1,"177,75",1,1,1,3,Low-Value,Lost
56231,181,5,"199,1",5,1,1,7,Mid-Value,Potential Loyalists
56233,388,2,"335,59999999999997",4,1,1,6,Mid-Value,Potential Loyalists
56234,74,2,"74,1",5,1,1,7,Mid-Value,Potential Loyalists
56235,138,4,"300,34999999999997",5,1,1,7,Mid-Value,Potential Loyalists
56237,1287,1,"270,8",2,1,1,4,Low-Value,Can't Lose
56238,34,5,"180,35",5,1,1,7,Mid-Value,Potential Loyalists
56239,1275,2,"27,9",2,1,1,4,Low-Value,Can't Lose
56243,1723,1,"3,8",1,1,1,3,Low-Value,Lost
56245,282,1,"38,6",5,1,1,7,Mid-Value,Potential Loyalists
56246,26,6,"324,85",5,1,1,7,Mid-Value,Potential Loyalists
56247,1000,1,"38,95",3,1,1,5,Low-Value,At Risk Customers
56248,68,5,"185,7",5,1,1,7,Mid-Value,Potential Loyalists
56250,515,2,"203,8",4,1,1,6,Mid-Value,Potential Loyalists
56252,33,3,"139,05",5,1,1,7,Mid-Value,Potential Loyalists
56256,270,6,"448,15",5,1,1,7,Mid-Value,Potential Loyalists
56257,967,2,"553,2",3,1,1,5,Low-Value,At Risk Customers
56259,1666,4,"147,79999999999998",1,1,1,3,Low-Value,Lost
56261,1580,1,"152,1",1,1,1,3,Low-Value,Lost
56262,654,4,"81,55",4,1,1,6,Mid-Value,Potential Loyalists
56265,1211,1,"56,1",2,1,1,4,Low-Value,Can't Lose
56266,5,3,"160,6",5,1,1,7,Mid-Value,Potential Loyalists
56267,1,5,"298,55",5,1,1,7,Mid-Value,Potential Loyalists
56269,945,4,"126,65",3,1,1,5,Low-Value,At Risk Customers
56270,883,3,"115,75",3,1,1,5,Low-Value,At Risk Customers
56273,160,3,"81,15",5,1,1,7,Mid-Value,Potential Loyalists
56274,52,6,"639,3000000000001",5,1,1,7,Mid-Value,Potential Loyalists
56275,401,1,"15,4",4,1,1,6,Mid-Value,Potential Loyalists
56277,857,3,"244,7",3,1,1,5,Low-Value,At Risk Customers
56278,327,1,"93,4",5,1,1,7,Mid-Value,Potential Loyalists
56280,158,9,"578,4",5,2,1,8,High-Value,Potential Loyalists
56281,1224,2,"50,900000000000006",2,1,1,4,Low-Value,Can't Lose
56283,380,1,"365,25",4,1,1,6,Mid-Value,Potential Loyalists
56284,45,7,"808,55",5,2,2,9,High-Value,Champions
56285,694,2,"130,25",4,1,1,6,Mid-Value,Potential Loyalists
56286,295,5,"200,58",5,1,1,7,Mid-Value,Potential Loyalists
56288,45,4,"233,7",5,1,1,7,Mid-Value,Potential Loyalists
56289,1301,1,"94,80000000000001",2,1,1,4,Low-Value,Can't Lose
56290,776,3,"90,25",3,1,1,5,Low-Value,At Risk Customers
56292,168,5,"326,34999999999997",5,1,1,7,Mid-Value,Potential Loyalists
56295,430,13,"548,0",4,3,1,8,High-Value,Potential Loyalists
56297,1208,1,"69,2",2,1,1,4,Low-Value,Can't Lose
56298,1160,1,"67,45",2,1,1,4,Low-Value,Can't Lose
56299,350,5,"456,4",5,1,1,7,Mid-Value,Potential Loyalists
56302,1207,2,"206,75",2,1,1,4,Low-Value,Can't Lose
56303,362,4,"433,3",5,1,1,7,Mid-Value,Potential Loyalists
56304,392,2,"62,05",4,1,1,6,Mid-Value,Potential Loyalists
56307,544,4,"73,4",4,1,1,6,Mid-Value,Potential Loyalists
56308,13,6,"294,90000000000003",5,1,1,7,Mid-Value,Potential Loyalists
56309,1111,1,"79,6",2,1,1,4,Low-Value,Can't Lose
56311,113,6,"205,75",5,1,1,7,Mid-Value,Potential Loyalists
56312,304,1,"10,35",5,1,1,7,Mid-Value,Potential Loyalists
56313,283,2,"46,25",5,1,1,7,Mid-Value,Potential Loyalists
56314,10,5,"732,45",5,1,2,8,High-Value,Potential Loyalists
56317,795,2,"54,699999999999996",3,1,1,5,Low-Value,At Risk Customers
56318,257,6,"592,0",5,1,1,7,Mid-Value,Potential Loyalists
56321,1437,1,"14,35",2,1,1,4,Low-Value,Can't Lose
56324,1192,1,"84,3",2,1,1,4,Low-Value,Can't Lose
56326,1034,1,"47,6",3,1,1,5,Low-Value,At Risk Customers
56327,833,2,"22,049999999999997",3,1,1,5,Low-Value,At Risk Customers
56329,1369,1,"51,9",2,1,1,4,Low-Value,Can't Lose
56331,27,4,"137,55",5,1,1,7,Mid-Value,Potential Loyalists
56332,608,2,"85,9",4,1,1,6,Mid-Value,Potential Loyalists
56334,496,2,"113,19999999999999",4,1,1,6,Mid-Value,Potential Loyalists
56336,230,5,"275,05",5,1,1,7,Mid-Value,Potential Loyalists
56338,122,5,"244,04999999999998",5,1,1,7,Mid-Value,Potential Loyalists
56341,40,4,"184,45",5,1,1,7,Mid-Value,Potential Loyalists
56342,500,6,"469,6",4,1,1,6,Mid-Value,Potential Loyalists
56343,87,9,"522,9",5,2,1,8,High-Value,Potential Loyalists
56345,134,7,"698,9",5,2,2,9,High-Value,Champions
56346,1531,1,"195,0",1,1,1,3,Low-Value,Lost
56348,454,7,"382,95",4,2,1,7,Mid-Value,Potential Loyalists
56349,703,2,"186,1",4,1,1,6,Mid-Value,Potential Loyalists
56353,435,1,"41,85",4,1,1,6,Mid-Value,Potential Loyalists
56355,1125,3,"313,0",2,1,1,4,Low-Value,Can't Lose
56356,433,5,"269,65",4,1,1,6,Mid-Value,Potential Loyalists
56357,47,2,"49,099999999999994",5,1,1,7,Mid-Value,Potential Loyalists
56358,216,3,"145,9",5,1,1,7,Mid-Value,Potential Loyalists
56361,1564,5,"177,2",1,1,1,3,Low-Value,Lost
56362,543,1,"506,4",4,1,1,6,Mid-Value,Potential Loyalists
56363,59,12,"680,25",5,3,2,10,High-Value,Champions
56364,379,6,"274,25",4,1,1,6,Mid-Value,Potential Loyalists
56366,21,1,"63,2",5,1,1,7,Mid-Value,Potential Loyalists
56367,1280,2,"147,55",2,1,1,4,Low-Value,Can't Lose
56370,1406,4,"159,5",2,1,1,4,Low-Value,Can't Lose
56373,182,5,"971,3500000000001",5,1,2,8,High-Value,Potential Loyalists
56374,1316,3,"346,45000000000005",2,1,1,4,Low-Value,Can't Lose
56375,187,3,"358,4",5,1,1,7,Mid-Value,Potential Loyalists
56377,77,2,"67,1",5,1,1,7,Mid-Value,Potential Loyalists
56378,72,4,"104,43",5,1,1,7,Mid-Value,Potential Loyalists
56379,572,3,"210,75",4,1,1,6,Mid-Value,Potential Loyalists
56380,544,1,"42,6",4,1,1,6,Mid-Value,Potential Loyalists
56382,5,7,"257,6",5,2,1,8,High-Value,Potential Loyalists
56384,382,1,"69,7",4,1,1,6,Mid-Value,Potential Loyalists
56385,832,6,"901,9000000000001",3,1,2,6,Mid-Value,Potential Loyalists
56387,830,4,"734,6499999999999",3,1,2,6,Mid-Value,Potential Loyalists
56388,1548,1,"11,2",1,1,1,3,Low-Value,Lost
56389,144,3,"242,95",5,1,1,7,Mid-Value,Potential Loyalists
56390,329,1,"35,2",5,1,1,7,Mid-Value,Potential Loyalists
56393,410,4,"803,15",4,1,2,7,Mid-Value,Potential Loyalists
56394,46,11,"341,95",5,2,1,8,High-Value,Potential Loyalists
56396,1242,1,"134,9",2,1,1,4,Low-Value,Can't Lose
56397,664,2,"229,25",4,1,1,6,Mid-Value,Potential Loyalists
56400,1262,1,"117,1",2,1,1,4,Low-Value,Can't Lose
56401,428,5,"188,10999999999999",4,1,1,6,Mid-Value,Potential Loyalists
56404,1084,1,"25,15",3,1,1,5,Low-Value,At Risk Customers
56405,386,6,"394,1",4,1,1,6,Mid-Value,Potential Loyalists
56406,59,8,"515,2",5,2,1,8,High-Value,Potential Loyalists
56407,19,10,"623,9",5,2,1,8,High-Value,Potential Loyalists
56408,20,5,"1035,6",5,1,2,8,High-Value,Potential Loyalists
56409,88,8,"454,55",5,2,1,8,High-Value,Potential Loyalists
56410,1270,1,"50,5",2,1,1,4,Low-Value,Can't Lose
56411,70,7,"252,55",5,2,1,8,High-Value,Potential Loyalists
56412,605,1,"82,8",4,1,1,6,Mid-Value,Potential Loyalists
56414,297,3,"60,85",5,1,1,7,Mid-Value,Potential Loyalists
56415,26,8,"417,45",5,2,1,8,High-Value,Potential Loyalists
56416,66,1,"27,35",5,1,1,7,Mid-Value,Potential Loyalists
56418,724,2,"125,19999999999999",4,1,1,6,Mid-Value,Potential Loyalists
56419,547,6,"301,85",4,1,1,6,Mid-Value,Potential Loyalists
56420,258,2,"104,60000000000001",5,1,1,7,Mid-Value,Potential Loyalists
56423,416,2,"129,85",4,1,1,6,Mid-Value,Potential Loyalists
56427,78,3,"39,45",5,1,1,7,Mid-Value,Potential Loyalists
56430,508,2,"75,2",4,1,1,6,Mid-Value,Potential Loyalists
56431,224,5,"295,3",5,1,1,7,Mid-Value,Potential Loyalists
56433,494,3,"178,45",4,1,1,6,Mid-Value,Potential Loyalists
56434,164,2,"61,9",5,1,1,7,Mid-Value,Potential Loyalists
56437,1592,2,"65,80000000000001",1,1,1,3,Low-Value,Lost
56438,1115,1,"110,4",2,1,1,4,Low-Value,Can't Lose
56439,965,3,"109,8",3,1,1,5,Low-Value,At Risk Customers
56440,126,2,"116,69999999999999",5,1,1,7,Mid-Value,Potential Loyalists
56441,1733,1,"73,65",1,1,1,3,Low-Value,Lost
56442,524,1,"21,1",4,1,1,6,Mid-Value,Potential Loyalists
56443,1438,1,"6,05",2,1,1,4,Low-Value,Can't Lose
56444,548,3,"166,64999999999998",4,1,1,6,Mid-Value,Potential Loyalists
56446,1399,1,"17,25",2,1,1,4,Low-Value,Can't Lose
56447,377,5,"184,65",4,1,1,6,Mid-Value,Potential Loyalists
56448,459,5,"195,85",4,1,1,6,Mid-Value,Potential Loyalists
56449,839,1,"48,45",3,1,1,5,Low-Value,At Risk Customers
56451,466,10,"829,9499999999999",4,2,2,8,High-Value,Potential Loyalists
56452,746,4,"116,73",3,1,1,5,Low-Value,At Risk Customers
56454,706,5,"256,4",4,1,1,6,Mid-Value,Potential Loyalists
56457,410,2,"88,55",4,1,1,6,Mid-Value,Potential Loyalists
56458,169,4,"437,05",5,1,1,7,Mid-Value,Potential Loyalists
56459,460,1,"11,0",4,1,1,6,Mid-Value,Potential Loyalists
56460,416,3,"146,2",4,1,1,6,Mid-Value,Potential Loyalists
56461,77,8,"316,45",5,2,1,8,High-Value,Potential Loyalists
56462,774,2,"67,65",3,1,1,5,Low-Value,At Risk Customers
56463,1511,1,"14,8",1,1,1,3,Low-Value,Lost
56465,79,4,"144,95",5,1,1,7,Mid-Value,Potential Loyalists
56466,395,3,"201,85",4,1,1,6,Mid-Value,Potential Loyalists
56467,325,1,"51,3",5,1,1,7,Mid-Value,Potential Loyalists
56468,5,3,"89,2",5,1,1,7,Mid-Value,Potential Loyalists
56471,82,6,"572,6",5,1,1,7,Mid-Value,Potential Loyalists
56473,164,8,"340,2",5,2,1,8,High-Value,Potential Loyalists
56474,2,2,"67,3",5,1,1,7,Mid-Value,Potential Loyalists
56476,1210,1,"18,95",2,1,1,4,Low-Value,Can't Lose
56478,151,8,"534,05",5,2,1,8,High-Value,Potential Loyalists
56479,174,10,"714,85",5,2,2,9,High-Value,Champions
56480,635,1,"58,6",4,1,1,6,Mid-Value,Potential Loyalists
56484,137,1,"34,5",5,1,1,7,Mid-Value,Potential Loyalists
56485,62,9,"656,7",5,2,1,8,High-Value,Potential Loyalists
56486,1751,1,"27,1",1,1,1,3,Low-Value,Lost
56487,30,1,"67,4",5,1,1,7,Mid-Value,Potential Loyalists
56488,404,6,"315,0",4,1,1,6,Mid-Value,Potential Loyalists
56490,1786,1,"51,45",1,1,1,3,Low-Value,Lost
56491,144,1,"100,8",5,1,1,7,Mid-Value,Potential Loyalists
56494,44,4,"169,7",5,1,1,7,Mid-Value,Potential Loyalists
56496,995,3,"114,35000000000001",3,1,1,5,Low-Value,At Risk Customers
56497,35,4,"272,8",5,1,1,7,Mid-Value,Potential Loyalists
56500,390,6,"491,29999999999995",4,1,1,6,Mid-Value,Potential Loyalists
56501,820,3,"83,75",3,1,1,5,Low-Value,At Risk Customers
56502,20,2,"21,4",5,1,1,7,Mid-Value,Potential Loyalists
56503,787,10,"1152,1",3,2,2,7,Mid-Value,Potential Loyalists
56505,517,2,"64,9",4,1,1,6,Mid-Value,Potential Loyalists
56506,334,1,"14,65",5,1,1,7,Mid-Value,Potential Loyalists
56507,578,2,"495,95",4,1,1,6,Mid-Value,Potential Loyalists
56508,157,4,"302,85",5,1,1,7,Mid-Value,Potential Loyalists
56510,1147,4,"236,35",2,1,1,4,Low-Value,Can't Lose
56511,1579,1,"11,1",1,1,1,3,Low-Value,Lost
56514,526,4,"119,7",4,1,1,6,Mid-Value,Potential Loyalists
56516,431,3,"111,1",4,1,1,6,Mid-Value,Potential Loyalists
56517,745,5,"203,95",3,1,1,5,Low-Value,At Risk Customers
56520,797,2,"27,200000000000003",3,1,1,5,Low-Value,At Risk Customers
56521,207,3,"389,75",5,1,1,7,Mid-Value,Potential Loyalists
56522,1338,2,"285,96",2,1,1,4,Low-Value,Can't Lose
56524,446,3,"138,65",4,1,1,6,Mid-Value,Potential Loyalists
56525,201,4,"284,75",5,1,1,7,Mid-Value,Potential Loyalists
56526,78,2,"44,2",5,1,1,7,Mid-Value,Potential Loyalists
56527,847,1,"46,7",3,1,1,5,Low-Value,At Risk Customers
56528,139,1,"418,9",5,1,1,7,Mid-Value,Potential Loyalists
56529,1371,1,"52,35",2,1,1,4,Low-Value,Can't Lose
56530,1246,1,"78,4",2,1,1,4,Low-Value,Can't Lose
56533,810,3,"224,05",3,1,1,5,Low-Value,At Risk Customers
56534,1358,1,"5,25",2,1,1,4,Low-Value,Can't Lose
56541,1649,2,"104,15",1,1,1,3,Low-Value,Lost
56543,721,3,"237,6",4,1,1,6,Mid-Value,Potential Loyalists
56544,1587,1,"66,1",1,1,1,3,Low-Value,Lost
56546,150,1,"40,7",5,1,1,7,Mid-Value,Potential Loyalists
56547,750,2,"53,050000000000004",3,1,1,5,Low-Value,At Risk Customers
56549,522,3,"93,0",4,1,1,6,Mid-Value,Potential Loyalists
56550,1289,3,"270,95",2,1,1,4,Low-Value,Can't Lose
56552,761,4,"116,60000000000001",3,1,1,5,Low-Value,At Risk Customers
56553,1499,4,"190,8",1,1,1,3,Low-Value,Lost
56555,1681,1,"63,150000000000006",1,1,1,3,Low-Value,Lost
56556,4,9,"480,5",5,2,1,8,High-Value,Potential Loyalists
56557,1356,1,"45,6",2,1,1,4,Low-Value,Can't Lose
56558,828,1,"58,4",3,1,1,5,Low-Value,At Risk Customers
56559,1390,1,"4,4",2,1,1,4,Low-Value,Can't Lose
56560,1117,2,"273,29999999999995",2,1,1,4,Low-Value,Can't Lose
56561,18,6,"389,8",5,1,1,7,Mid-Value,Potential Loyalists
56565,414,1,"22,8",4,1,1,6,Mid-Value,Potential Loyalists
56569,171,2,"76,8",5,1,1,7,Mid-Value,Potential Loyalists
56571,541,2,"42,75",4,1,1,6,Mid-Value,Potential Loyalists
56572,439,3,"77,95",4,1,1,6,Mid-Value,Potential Loyalists
56573,1111,2,"74,9",2,1,1,4,Low-Value,Can't Lose
56575,801,3,"32,95",3,1,1,5,Low-Value,At Risk Customers
56577,1324,3,"121,64999999999999",2,1,1,4,Low-Value,Can't Lose
56579,1286,1,"82,5",2,1,1,4,Low-Value,Can't Lose
56580,211,7,"492,7",5,2,1,8,High-Value,Potential Loyalists
56581,464,1,"35,0",4,1,1,6,Mid-Value,Potential Loyalists
56585,379,2,"352,8",4,1,1,6,Mid-Value,Potential Loyalists
56588,187,3,"147,65",5,1,1,7,Mid-Value,Potential Loyalists
56589,878,3,"92,25",3,1,1,5,Low-Value,At Risk Customers
56591,33,1,"58,6",5,1,1,7,Mid-Value,Potential Loyalists
56592,571,4,"416,8",4,1,1,6,Mid-Value,Potential Loyalists
56594,1572,1,"100,9",1,1,1,3,Low-Value,Lost
56595,59,6,"203,05",5,1,1,7,Mid-Value,Potential Loyalists
56597,908,2,"209,85000000000002",3,1,1,5,Low-Value,At Risk Customers
56598,626,2,"21,25",4,1,1,6,Mid-Value,Potential Loyalists
56599,16,2,"586,35",5,1,1,7,Mid-Value,Potential Loyalists
56601,1526,4,"195,45",1,1,1,3,Low-Value,Lost
56604,339,7,"480,2",5,2,1,8,High-Value,Potential Loyalists
56605,927,1,"130,2",3,1,1,5,Low-Value,At Risk Customers
56607,218,4,"247,0",5,1,1,7,Mid-Value,Potential Loyalists
56608,77,5,"460,35",5,1,1,7,Mid-Value,Potential Loyalists
56609,617,3,"91,95",4,1,1,6,Mid-Value,Potential Loyalists
56610,24,7,"443,34999999999997",5,2,1,8,High-Value,Potential Loyalists
56611,379,2,"168,95",4,1,1,6,Mid-Value,Potential Loyalists
56613,104,4,"202,5",5,1,1,7,Mid-Value,Potential Loyalists
56614,270,4,"202,55",5,1,1,7,Mid-Value,Potential Loyalists
56615,972,2,"66,89999999999999",3,1,1,5,Low-Value,At Risk Customers
56616,139,7,"278,25",5,2,1,8,High-Value,Potential Loyalists
56617,1146,6,"537,0999999999999",2,1,1,4,Low-Value,Can't Lose
56618,493,5,"1199,9499999999998",4,1,2,7,Mid-Value,Potential Loyalists
56619,73,11,"978,25",5,2,2,9,High-Value,Champions
56620,379,2,"26,85",4,1,1,6,Mid-Value,Potential Loyalists
56623,20,4,"403,84999999999997",5,1,1,7,Mid-Value,Potential Loyalists
56625,797,4,"175,3",3,1,1,5,Low-Value,At Risk Customers
56626,686,2,"69,4",4,1,1,6,Mid-Value,Potential Loyalists
56627,890,1,"114,9",3,1,1,5,Low-Value,At Risk Customers
56628,719,2,"85,3",4,1,1,6,Mid-Value,Potential Loyalists
56629,45,8,"328,1",5,2,1,8,High-Value,Potential Loyalists
56631,1134,2,"111,3",2,1,1,4,Low-Value,Can't Lose
56632,399,3,"376,95",4,1,1,6,Mid-Value,Potential Loyalists
56633,966,2,"259,8",3,1,1,5,Low-Value,At Risk Customers
56636,1527,1,"12,1",1,1,1,3,Low-Value,Lost
56637,1456,1,"10,23",2,1,1,4,Low-Value,Can't Lose
56638,740,3,"220,5",3,1,1,5,Low-Value,At Risk Customers
56640,187,1,"105,6",5,1,1,7,Mid-Value,Potential Loyalists
56641,589,3,"173,4",4,1,1,6,Mid-Value,Potential Loyalists
56642,855,1,"398,0",3,1,1,5,Low-Value,At Risk Customers
56643,498,5,"362,0",4,1,1,6,Mid-Value,Potential Loyalists
56644,368,4,"724,3499999999999",4,1,2,7,Mid-Value,Potential Loyalists
56645,1209,1,"22,8",2,1,1,4,Low-Value,Can't Lose
56646,63,4,"216,54999999999998",5,1,1,7,Mid-Value,Potential Loyalists
56647,1663,2,"79,45",1,1,1,3,Low-Value,Lost
56648,920,2,"143,5",3,1,1,5,Low-Value,At Risk Customers
56649,23,10,"571,6999999999999",5,2,1,8,High-Value,Potential Loyalists
56650,701,1,"17,85",4,1,1,6,Mid-Value,Potential Loyalists
56651,867,4,"254,09999999999997",3,1,1,5,Low-Value,At Risk Customers
56652,539,1,"8,3",4,1,1,6,Mid-Value,Potential Loyalists
56653,46,7,"409,35",5,2,1,8,High-Value,Potential Loyalists
56655,1534,1,"10,85",1,1,1,3,Low-Value,Lost
56656,11,3,"317,65",5,1,1,7,Mid-Value,Potential Loyalists
56657,1501,1,"108,15",1,1,1,3,Low-Value,Lost
56658,1714,1,"124,80000000000001",1,1,1,3,Low-Value,Lost
56659,1520,3,"490,15",1,1,1,3,Low-Value,Lost
56664,1368,1,"152,0",2,1,1,4,Low-Value,Can't Lose
56665,428,3,"148,54999999999998",4,1,1,6,Mid-Value,Potential Loyalists
56668,249,4,"425,25",5,1,1,7,Mid-Value,Potential Loyalists
56669,1528,1,"10,85",1,1,1,3,Low-Value,Lost
56670,360,6,"580,65",5,1,1,7,Mid-Value,Potential Loyalists
56671,656,1,"88,2",4,1,1,6,Mid-Value,Potential Loyalists
56672,62,6,"126,69999999999999",5,1,1,7,Mid-Value,Potential Loyalists
56673,111,6,"192,35000000000002",5,1,1,7,Mid-Value,Potential Loyalists
56674,228,4,"349,29999999999995",5,1,1,7,Mid-Value,Potential Loyalists
56675,41,5,"249,55",5,1,1,7,Mid-Value,Potential Loyalists
56676,1506,1,"11,7",1,1,1,3,Low-Value,Lost
56678,47,3,"127,35000000000001",5,1,1,7,Mid-Value,Potential Loyalists
56679,775,6,"186,85",3,1,1,5,Low-Value,At Risk Customers
56680,171,6,"301,7",5,1,1,7,Mid-Value,Potential Loyalists
56681,1207,4,"153,3",2,1,1,4,Low-Value,Can't Lose
56682,748,4,"88,7",3,1,1,5,Low-Value,At Risk Customers
56683,64,3,"125,55",5,1,1,7,Mid-Value,Potential Loyalists
56685,1300,2,"35,45",2,1,1,4,Low-Value,Can't Lose
56686,31,2,"39,300000000000004",5,1,1,7,Mid-Value,Potential Loyalists
56688,1023,3,"108,10000000000001",3,1,1,5,Low-Value,At Risk Customers
56690,1382,2,"79,05",2,1,1,4,Low-Value,Can't Lose
56691,15,2,"203,0",5,1,1,7,Mid-Value,Potential Loyalists
56692,1466,1,"74,1",1,1,1,3,Low-Value,Lost
56694,207,3,"48,4",5,1,1,7,Mid-Value,Potential Loyalists
56695,1160,2,"198,2",2,1,1,4,Low-Value,Can't Lose
56696,522,4,"459,25",4,1,1,6,Mid-Value,Potential Loyalists
56697,77,3,"130,2",5,1,1,7,Mid-Value,Potential Loyalists
56698,1191,1,"41,0",2,1,1,4,Low-Value,Can't Lose
56703,1080,1,"13,5",3,1,1,5,Low-Value,At Risk Customers
56704,583,2,"529,15",4,1,1,6,Mid-Value,Potential Loyalists
56705,368,5,"387,8",4,1,1,6,Mid-Value,Potential Loyalists
56706,1480,1,"42,1",1,1,1,3,Low-Value,Lost
56707,128,9,"520,7",5,2,1,8,High-Value,Potential Loyalists
56711,970,1,"19,5",3,1,1,5,Low-Value,At Risk Customers
56712,984,2,"49,699999999999996",3,1,1,5,Low-Value,At Risk Customers
56714,972,3,"64,6",3,1,1,5,Low-Value,At Risk Customers
56715,955,3,"135,6",3,1,1,5,Low-Value,At Risk Customers
56716,119,4,"198,64999999999998",5,1,1,7,Mid-Value,Potential Loyalists
56719,700,1,"78,9",4,1,1,6,Mid-Value,Potential Loyalists
56720,857,3,"208,7",3,1,1,5,Low-Value,At Risk Customers
56724,362,2,"29,1",5,1,1,7,Mid-Value,Potential Loyalists
56726,785,6,"388,5",3,1,1,5,Low-Value,At Risk Customers
56727,1023,4,"332,95",3,1,1,5,Low-Value,At Risk Customers
56729,528,2,"139,65",4,1,1,6,Mid-Value,Potential Loyalists
56730,777,2,"115,5",3,1,1,5,Low-Value,At Risk Customers
56731,424,1,"48,45",4,1,1,6,Mid-Value,Potential Loyalists
56732,780,7,"225,7",3,2,1,6,Mid-Value,Potential Loyalists
56733,1265,1,"118,8",2,1,1,4,Low-Value,Can't Lose
56734,570,3,"331,45000000000005",4,1,1,6,Mid-Value,Potential Loyalists
56737,1407,1,"113,6",2,1,1,4,Low-Value,Can't Lose
56738,1259,6,"481,74999999999994",2,1,1,4,Low-Value,Can't Lose
56741,143,6,"2056,3",5,1,4,10,High-Value,Champions
56742,435,4,"173,50000000000003",4,1,1,6,Mid-Value,Potential Loyalists
56743,807,2,"111,8",3,1,1,5,Low-Value,At Risk Customers
56747,651,2,"48,699999999999996",4,1,1,6,Mid-Value,Potential Loyalists
56748,1276,1,"13,15",2,1,1,4,Low-Value,Can't Lose
56750,45,7,"439,0",5,2,1,8,High-Value,Potential Loyalists
56752,105,2,"15,8",5,1,1,7,Mid-Value,Potential Loyalists
56753,166,3,"217,54999999999998",5,1,1,7,Mid-Value,Potential Loyalists
56754,585,1,"202,5",4,1,1,6,Mid-Value,Potential Loyalists
56755,270,1,"30,900000000000002",5,1,1,7,Mid-Value,Potential Loyalists
56757,1073,3,"74,55",3,1,1,5,Low-Value,At Risk Customers
56758,1371,1,"148,3",2,1,1,4,Low-Value,Can't Lose
56759,218,2,"94,89999999999999",5,1,1,7,Mid-Value,Potential Loyalists
56761,814,2,"101,85",3,1,1,5,Low-Value,At Risk Customers
56762,529,1,"27,599999999999998",4,1,1,6,Mid-Value,Potential Loyalists
56763,171,6,"167,8",5,1,1,7,Mid-Value,Potential Loyalists
56768,1192,2,"134,55",2,1,1,4,Low-Value,Can't Lose
56769,746,1,"53,3",3,1,1,5,Low-Value,At Risk Customers
56771,209,1,"20,6",5,1,1,7,Mid-Value,Potential Loyalists
56775,859,1,"23,4",3,1,1,5,Low-Value,At Risk Customers
56777,266,3,"81,2",5,1,1,7,Mid-Value,Potential Loyalists
56778,66,2,"44,5",5,1,1,7,Mid-Value,Potential Loyalists
56779,156,4,"139,8",5,1,1,7,Mid-Value,Potential Loyalists
56780,1030,2,"35,6",3,1,1,5,Low-Value,At Risk Customers
56781,499,6,"99,3",4,1,1,6,Mid-Value,Potential Loyalists
56782,174,6,"619,05",5,1,1,7,Mid-Value,Potential Loyalists
56783,886,2,"90,65",3,1,1,5,Low-Value,At Risk Customers
56785,520,4,"187,15",4,1,1,6,Mid-Value,Potential Loyalists
56787,28,5,"197,6",5,1,1,7,Mid-Value,Potential Loyalists
56788,420,7,"186,25",4,2,1,7,Mid-Value,Potential Loyalists
56789,1439,1,"46,5",2,1,1,4,Low-Value,Can't Lose
56790,383,3,"177,60000000000002",4,1,1,6,Mid-Value,Potential Loyalists
56791,8,2,"69,15",5,1,1,7,Mid-Value,Potential Loyalists
56792,1492,1,"18,0",1,1,1,3,Low-Value,Lost
56795,627,1,"8,1",4,1,1,6,Mid-Value,Potential Loyalists
56796,1355,4,"238,05",2,1,1,4,Low-Value,Can't Lose
56797,332,3,"454,65",5,1,1,7,Mid-Value,Potential Loyalists
56799,21,5,"374,65",5,1,1,7,Mid-Value,Potential Loyalists
56800,141,6,"424,09999999999997",5,1,1,7,Mid-Value,Potential Loyalists
56801,572,2,"156,5",4,1,1,6,Mid-Value,Potential Loyalists
56802,757,2,"208,0",3,1,1,5,Low-Value,At Risk Customers
56803,733,6,"352,8",3,1,1,5,Low-Value,At Risk Customers
56806,1123,1,"19,1",2,1,1,4,Low-Value,Can't Lose
56807,438,4,"287,8",4,1,1,6,Mid-Value,Potential Loyalists
56809,532,7,"275,85",4,2,1,7,Mid-Value,Potential Loyalists
56810,621,3,"499,54999999999995",4,1,1,6,Mid-Value,Potential Loyalists
56812,195,8,"404,5",5,2,1,8,High-Value,Potential Loyalists
56813,706,1,"29,1",4,1,1,6,Mid-Value,Potential Loyalists
56816,94,5,"293,75",5,1,1,7,Mid-Value,Potential Loyalists
56817,200,2,"260,5",5,1,1,7,Mid-Value,Potential Loyalists
56822,1294,4,"431,3",2,1,1,4,Low-Value,Can't Lose
56824,52,6,"491,05",5,1,1,7,Mid-Value,Potential Loyalists
56826,564,4,"202,85000000000002",4,1,1,6,Mid-Value,Potential Loyalists
56827,111,4,"414,59999999999997",5,1,1,7,Mid-Value,Potential Loyalists
56828,421,1,"41,7",4,1,1,6,Mid-Value,Potential Loyalists
56831,62,4,"217,5",5,1,1,7,Mid-Value,Potential Loyalists
56836,1193,5,"298,0",2,1,1,4,Low-Value,Can't Lose
56837,394,2,"116,10000000000001",4,1,1,6,Mid-Value,Potential Loyalists
56840,28,4,"364,0",5,1,1,7,Mid-Value,Potential Loyalists
56843,1256,2,"115,55",2,1,1,4,Low-Value,Can't Lose
56844,1532,1,"19,4",1,1,1,3,Low-Value,Lost
56847,160,3,"68,78",5,1,1,7,Mid-Value,Potential Loyalists
56848,269,2,"384,15",5,1,1,7,Mid-Value,Potential Loyalists
56849,155,2,"222,79999999999998",5,1,1,7,Mid-Value,Potential Loyalists
56851,705,1,"54,599999999999994",4,1,1,6,Mid-Value,Potential Loyalists
56854,883,1,"48,4",3,1,1,5,Low-Value,At Risk Customers
56856,1677,1,"36,7",1,1,1,3,Low-Value,Lost
56858,757,6,"482,95000000000005",3,1,1,5,Low-Value,At Risk Customers
56859,42,6,"969,4",5,1,2,8,High-Value,Potential Loyalists
56860,1595,1,"11,65",1,1,1,3,Low-Value,Lost
56861,106,5,"318,70000000000005",5,1,1,7,Mid-Value,Potential Loyalists
56862,208,4,"314,95000000000005",5,1,1,7,Mid-Value,Potential Loyalists
56867,396,4,"101,25",4,1,1,6,Mid-Value,Potential Loyalists
56868,595,3,"135,54999999999998",4,1,1,6,Mid-Value,Potential Loyalists
56870,1775,1,"39,3",1,1,1,3,Low-Value,Lost
56871,200,5,"111,75",5,1,1,7,Mid-Value,Potential Loyalists
56872,607,2,"135,2",4,1,1,6,Mid-Value,Potential Loyalists
56873,1604,3,"292,5",1,1,1,3,Low-Value,Lost
56874,436,6,"239,7",4,1,1,6,Mid-Value,Potential Loyalists
56875,617,1,"8,05",4,1,1,6,Mid-Value,Potential Loyalists
56876,220,4,"197,3",5,1,1,7,Mid-Value,Potential Loyalists
56880,124,13,"1441,2",5,3,3,11,High-Value,Champions
56881,523,3,"190,45",4,1,1,6,Mid-Value,Potential Loyalists
56882,31,11,"652,6999999999999",5,2,1,8,High-Value,Potential Loyalists
56883,10,2,"188,85",5,1,1,7,Mid-Value,Potential Loyalists
56884,98,4,"188,60000000000002",5,1,1,7,Mid-Value,Potential Loyalists
56885,11,9,"689,45",5,2,2,9,High-Value,Champions
56886,206,3,"296,9",5,1,1,7,Mid-Value,Potential Loyalists
56887,332,8,"386,8",5,2,1,8,High-Value,Potential Loyalists
56890,1157,1,"15,8",2,1,1,4,Low-Value,Can't Lose
56892,119,4,"53,8",5,1,1,7,Mid-Value,Potential Loyalists
56893,672,4,"256,6",4,1,1,6,Mid-Value,Potential Loyalists
56896,189,1,"304,2",5,1,1,7,Mid-Value,Potential Loyalists
56898,61,4,"111,75",5,1,1,7,Mid-Value,Potential Loyalists
56899,286,4,"331,9",5,1,1,7,Mid-Value,Potential Loyalists
56900,0,2,"124,55",5,1,1,7,Mid-Value,Potential Loyalists
56901,306,9,"639,4",5,2,1,8,High-Value,Potential Loyalists
56903,609,2,"54,050000000000004",4,1,1,6,Mid-Value,Potential Loyalists
56906,32,6,"674,55",5,1,2,8,High-Value,Potential Loyalists
56907,706,1,"25,5",4,1,1,6,Mid-Value,Potential Loyalists
56909,741,2,"255,8",3,1,1,5,Low-Value,At Risk Customers
56910,409,6,"680,25",4,1,2,7,Mid-Value,Potential Loyalists
56911,1568,1,"46,95",1,1,1,3,Low-Value,Lost
56912,1176,2,"190,70000000000002",2,1,1,4,Low-Value,Can't Lose
56913,426,1,"14,549999999999999",4,1,1,6,Mid-Value,Potential Loyalists
56919,935,4,"184,7",3,1,1,5,Low-Value,At Risk Customers
56920,570,4,"403,1",4,1,1,6,Mid-Value,Potential Loyalists
56921,465,1,"40,2",4,1,1,6,Mid-Value,Potential Loyalists
56922,175,2,"157,25",5,1,1,7,Mid-Value,Potential Loyalists
56924,1351,1,"78,15",2,1,1,4,Low-Value,Can't Lose
56926,59,6,"298,75",5,1,1,7,Mid-Value,Potential Loyalists
56928,430,6,"283,15",4,1,1,6,Mid-Value,Potential Loyalists
56930,43,3,"82,19999999999999",5,1,1,7,Mid-Value,Potential Loyalists
56931,514,2,"98,3",4,1,1,6,Mid-Value,Potential Loyalists
56933,27,4,"86,5",5,1,1,7,Mid-Value,Potential Loyalists
56934,109,3,"82,5",5,1,1,7,Mid-Value,Potential Loyalists
56936,131,1,"192,29999999999998",5,1,1,7,Mid-Value,Potential Loyalists
56937,87,5,"241,6",5,1,1,7,Mid-Value,Potential Loyalists
56939,1263,3,"85,35",2,1,1,4,Low-Value,Can't Lose
56940,1792,1,"165,9",1,1,1,3,Low-Value,Lost
56942,726,2,"46,0",4,1,1,6,Mid-Value,Potential Loyalists
56943,1056,1,"10,25",3,1,1,5,Low-Value,At Risk Customers
56944,466,7,"386,65",4,2,1,7,Mid-Value,Potential Loyalists
56945,1361,1,"4,25",2,1,1,4,Low-Value,Can't Lose
56947,561,4,"463,3",4,1,1,6,Mid-Value,Potential Loyalists
56948,602,3,"379,09999999999997",4,1,1,6,Mid-Value,Potential Loyalists
56949,223,2,"165,3",5,1,1,7,Mid-Value,Potential Loyalists
56953,1128,2,"109,4",2,1,1,4,Low-Value,Can't Lose
56954,1497,1,"12,1",1,1,1,3,Low-Value,Lost
56958,228,3,"98,2",5,1,1,7,Mid-Value,Potential Loyalists
56959,27,6,"581,2",5,1,1,7,Mid-Value,Potential Loyalists
56960,1203,2,"55,9",2,1,1,4,Low-Value,Can't Lose
56961,58,1,"12,25",5,1,1,7,Mid-Value,Potential Loyalists
56962,424,1,"17,25",4,1,1,6,Mid-Value,Potential Loyalists
56963,449,4,"154,35000000000002",4,1,1,6,Mid-Value,Potential Loyalists
56964,135,4,"287,4",5,1,1,7,Mid-Value,Potential Loyalists
56965,14,7,"320,3",5,2,1,8,High-Value,Potential Loyalists
56966,159,4,"1176,35",5,1,2,8,High-Value,Potential Loyalists
56967,976,2,"142,3",3,1,1,5,Low-Value,At Risk Customers
56968,991,2,"264,5",3,1,1,5,Low-Value,At Risk Customers
56970,5,6,"324,74999999999994",5,1,1,7,Mid-Value,Potential Loyalists
56971,621,6,"834,9499999999999",4,1,2,7,Mid-Value,Potential Loyalists
56972,782,1,"30,9",3,1,1,5,Low-Value,At Risk Customers
56973,752,2,"105,4",3,1,1,5,Low-Value,At Risk Customers
56976,1026,1,"104,2",3,1,1,5,Low-Value,At Risk Customers
56977,897,2,"53,85",3,1,1,5,Low-Value,At Risk Customers
56978,160,4,"359,2",5,1,1,7,Mid-Value,Potential Loyalists
56982,582,2,"84,44999999999999",4,1,1,6,Mid-Value,Potential Loyalists
56985,997,2,"32,05",3,1,1,5,Low-Value,At Risk Customers
56986,468,3,"234,6",4,1,1,6,Mid-Value,Potential Loyalists
56987,550,1,"39,8",4,1,1,6,Mid-Value,Potential Loyalists
56988,641,3,"170,75",4,1,1,6,Mid-Value,Potential Loyalists
56989,395,5,"526,45",4,1,1,6,Mid-Value,Potential Loyalists
56990,858,1,"243,89999999999998",3,1,1,5,Low-Value,At Risk Customers
56991,515,1,"76,8",4,1,1,6,Mid-Value,Potential Loyalists
56992,1018,2,"75,9",3,1,1,5,Low-Value,At Risk Customers
56994,311,4,"661,8",5,1,1,7,Mid-Value,Potential Loyalists
56997,446,1,"45,75",4,1,1,6,Mid-Value,Potential Loyalists
56998,46,6,"431,15",5,1,1,7,Mid-Value,Potential Loyalists
56999,122,3,"164,5",5,1,1,7,Mid-Value,Potential Loyalists
57003,54,1,"28,35",5,1,1,7,Mid-Value,Potential Loyalists
57008,814,1,"50,15",3,1,1,5,Low-Value,At Risk Customers
57009,33,6,"481,4",5,1,1,7,Mid-Value,Potential Loyalists
57011,467,1,"25,25",4,1,1,6,Mid-Value,Potential Loyalists
57012,686,1,"43,3",4,1,1,6,Mid-Value,Potential Loyalists
57013,1771,1,"6,2",1,1,1,3,Low-Value,Lost
57014,1068,1,"101,4",3,1,1,5,Low-Value,At Risk Customers
57015,413,6,"219,3",4,1,1,6,Mid-Value,Potential Loyalists
57017,1064,2,"309,15",3,1,1,5,Low-Value,At Risk Customers
57018,478,2,"65,35",4,1,1,6,Mid-Value,Potential Loyalists
57020,1790,1,"58,6",1,1,1,3,Low-Value,Lost
57021,1520,1,"17,55",1,1,1,3,Low-Value,Lost
57022,902,3,"109,10000000000001",3,1,1,5,Low-Value,At Risk Customers
57023,223,6,"478,90000000000003",5,1,1,7,Mid-Value,Potential Loyalists
57025,18,5,"659,3000000000001",5,1,1,7,Mid-Value,Potential Loyalists
57026,411,3,"133,4",4,1,1,6,Mid-Value,Potential Loyalists
57027,63,4,"70,2",5,1,1,7,Mid-Value,Potential Loyalists
57028,930,1,"69,1",3,1,1,5,Low-Value,At Risk Customers
57030,920,1,"202,8",3,1,1,5,Low-Value,At Risk Customers
57032,145,2,"249,1",5,1,1,7,Mid-Value,Potential Loyalists
57033,678,6,"165,89999999999998",4,1,1,6,Mid-Value,Potential Loyalists
57034,1120,3,"96,6",2,1,1,4,Low-Value,Can't Lose
57035,862,2,"45,89999999999999",3,1,1,5,Low-Value,At Risk Customers
57038,1151,1,"11,5",2,1,1,4,Low-Value,Can't Lose
57039,195,6,"266,15",5,1,1,7,Mid-Value,Potential Loyalists
57041,1543,1,"50,4",1,1,1,3,Low-Value,Lost
57043,758,2,"63,35",3,1,1,5,Low-Value,At Risk Customers
57046,1118,3,"106,19999999999999",2,1,1,4,Low-Value,Can't Lose
57047,27,4,"172,14999999999998",5,1,1,7,Mid-Value,Potential Loyalists
57049,255,5,"338,35",5,1,1,7,Mid-Value,Potential Loyalists
57051,0,2,"101,85000000000001",5,1,1,7,Mid-Value,Potential Loyalists
57052,1264,3,"59,45",2,1,1,4,Low-Value,Can't Lose
57056,1520,1,"116,05",1,1,1,3,Low-Value,Lost
57057,696,5,"256,3",4,1,1,6,Mid-Value,Potential Loyalists
57058,440,1,"21,3",4,1,1,6,Mid-Value,Potential Loyalists
57059,549,2,"272,4",4,1,1,6,Mid-Value,Potential Loyalists
57060,187,2,"188,8",5,1,1,7,Mid-Value,Potential Loyalists
57061,777,2,"23,18",3,1,1,5,Low-Value,At Risk Customers
57062,171,4,"342,9",5,1,1,7,Mid-Value,Potential Loyalists
57064,456,3,"143,0",4,1,1,6,Mid-Value,Potential Loyalists
57065,652,1,"42,15",4,1,1,6,Mid-Value,Potential Loyalists
57066,788,2,"184,75",3,1,1,5,Low-Value,At Risk Customers
57070,12,7,"427,95000000000005",5,2,1,8,High-Value,Potential Loyalists
57071,110,2,"138,7",5,1,1,7,Mid-Value,Potential Loyalists
57073,205,2,"77,9",5,1,1,7,Mid-Value,Potential Loyalists
57074,1104,1,"66,35",2,1,1,4,Low-Value,Can't Lose
57075,733,3,"220,25",3,1,1,5,Low-Value,At Risk Customers
57078,116,4,"289,84999999999997",5,1,1,7,Mid-Value,Potential Loyalists
57081,193,5,"477,15",5,1,1,7,Mid-Value,Potential Loyalists
57082,380,2,"33,3",4,1,1,6,Mid-Value,Potential Loyalists
57083,1355,2,"18,9",2,1,1,4,Low-Value,Can't Lose
57085,157,2,"23,55",5,1,1,7,Mid-Value,Potential Loyalists
57087,1530,1,"165,95",1,1,1,3,Low-Value,Lost
57088,1658,1,"207,9",1,1,1,3,Low-Value,Lost
57090,108,4,"76,2",5,1,1,7,Mid-Value,Potential Loyalists
57091,188,3,"134,7",5,1,1,7,Mid-Value,Potential Loyalists
57094,80,2,"238,35000000000002",5,1,1,7,Mid-Value,Potential Loyalists
57095,1677,1,"14,7",1,1,1,3,Low-Value,Lost
57096,394,1,"2,2",4,1,1,6,Mid-Value,Potential Loyalists
57097,351,7,"332,5",5,2,1,8,High-Value,Potential Loyalists
57098,1817,1,"16,4",1,1,1,3,Low-Value,Lost
57100,762,1,"32,75",3,1,1,5,Low-Value,At Risk Customers
57102,44,1,"165,3",5,1,1,7,Mid-Value,Potential Loyalists
57103,9,9,"368,1",5,2,1,8,High-Value,Potential Loyalists
57105,1257,7,"671,7",2,2,2,6,Mid-Value,Potential Loyalists
57106,19,6,"607,4",5,1,1,7,Mid-Value,Potential Loyalists
57107,753,5,"286,05",3,1,1,5,Low-Value,At Risk Customers
57108,123,4,"231,35000000000002",5,1,1,7,Mid-Value,Potential Loyalists
57109,154,4,"175,55",5,1,1,7,Mid-Value,Potential Loyalists
57110,283,9,"554,95",5,2,1,8,High-Value,Potential Loyalists
57112,336,1,"8,85",5,1,1,7,Mid-Value,Potential Loyalists
57113,537,5,"362,85",4,1,1,6,Mid-Value,Potential Loyalists
57114,236,8,"569,05",5,2,1,8,High-Value,Potential Loyalists
57115,714,1,"66,8",4,1,1,6,Mid-Value,Potential Loyalists
57116,1649,3,"133,79999999999998",1,1,1,3,Low-Value,Lost
57118,428,1,"25,25",4,1,1,6,Mid-Value,Potential Loyalists
57119,15,3,"387,4",5,1,1,7,Mid-Value,Potential Loyalists
57120,204,3,"245,2",5,1,1,7,Mid-Value,Potential Loyalists
57122,543,6,"948,4000000000001",4,1,2,7,Mid-Value,Potential Loyalists
57123,1741,1,"9,5",1,1,1,3,Low-Value,Lost
57124,1320,1,"100,0",2,1,1,4,Low-Value,Can't Lose
57125,781,3,"87,2",3,1,1,5,Low-Value,At Risk Customers
57126,409,2,"38,3",4,1,1,6,Mid-Value,Potential Loyalists
57128,166,6,"444,25",5,1,1,7,Mid-Value,Potential Loyalists
57129,1118,3,"153,2",2,1,1,4,Low-Value,Can't Lose
57130,234,1,"105,3",5,1,1,7,Mid-Value,Potential Loyalists
57131,1757,2,"95,75",1,1,1,3,Low-Value,Lost
57132,53,3,"657,7",5,1,1,7,Mid-Value,Potential Loyalists
57134,410,2,"99,8",4,1,1,6,Mid-Value,Potential Loyalists
57135,789,3,"194,1",3,1,1,5,Low-Value,At Risk Customers
57136,202,5,"210,95",5,1,1,7,Mid-Value,Potential Loyalists
57137,11,5,"394,5",5,1,1,7,Mid-Value,Potential Loyalists
57139,1179,1,"12,9",2,1,1,4,Low-Value,Can't Lose
57140,1034,1,"5,95",3,1,1,5,Low-Value,At Risk Customers
57141,429,1,"7,25",4,1,1,6,Mid-Value,Potential Loyalists
57142,658,2,"85,05",4,1,1,6,Mid-Value,Potential Loyalists
57143,929,2,"186,4",3,1,1,5,Low-Value,At Risk Customers
57146,936,3,"404,70000000000005",3,1,1,5,Low-Value,At Risk Customers
57147,797,2,"617,0",3,1,1,5,Low-Value,At Risk Customers
57149,1290,1,"124,80000000000001",2,1,1,4,Low-Value,Can't Lose
57150,403,2,"29,0",4,1,1,6,Mid-Value,Potential Loyalists
57153,1303,1,"50,5",2,1,1,4,Low-Value,Can't Lose
57154,144,2,"279,1",5,1,1,7,Mid-Value,Potential Loyalists
57155,77,5,"266,15",5,1,1,7,Mid-Value,Potential Loyalists
57157,30,6,"513,0",5,1,1,7,Mid-Value,Potential Loyalists
57158,1030,2,"92,3",3,1,1,5,Low-Value,At Risk Customers
57159,263,4,"453,45",5,1,1,7,Mid-Value,Potential Loyalists
57161,1403,1,"127,25",2,1,1,4,Low-Value,Can't Lose
57162,1571,1,"27,95",1,1,1,3,Low-Value,Lost
57163,214,5,"367,7",5,1,1,7,Mid-Value,Potential Loyalists
57164,864,2,"300,6",3,1,1,5,Low-Value,At Risk Customers
57166,580,3,"151,7",4,1,1,6,Mid-Value,Potential Loyalists
57167,1530,1,"22,25",1,1,1,3,Low-Value,Lost
57168,368,3,"239,0",4,1,1,6,Mid-Value,Potential Loyalists
57171,1536,1,"67,35",1,1,1,3,Low-Value,Lost
57172,1129,1,"29,6",2,1,1,4,Low-Value,Can't Lose
57175,514,1,"66,2",4,1,1,6,Mid-Value,Potential Loyalists
57176,42,4,"123,54999999999998",5,1,1,7,Mid-Value,Potential Loyalists
57181,834,3,"163,3",3,1,1,5,Low-Value,At Risk Customers
57183,39,1,"110,15",5,1,1,7,Mid-Value,Potential Loyalists
57184,1137,1,"192,35",2,1,1,4,Low-Value,Can't Lose
57186,857,1,"206,15",3,1,1,5,Low-Value,At Risk Customers
57188,279,2,"183,4",5,1,1,7,Mid-Value,Potential Loyalists
57189,626,5,"112,19999999999999",4,1,1,6,Mid-Value,Potential Loyalists
57190,509,4,"142,4",4,1,1,6,Mid-Value,Potential Loyalists
57192,322,4,"142,3",5,1,1,7,Mid-Value,Potential Loyalists
57194,46,5,"250,75",5,1,1,7,Mid-Value,Potential Loyalists
57195,1476,5,"328,83",1,1,1,3,Low-Value,Lost
57196,449,2,"64,10000000000001",4,1,1,6,Mid-Value,Potential Loyalists
57199,656,4,"145,55",4,1,1,6,Mid-Value,Potential Loyalists
57200,1605,2,"54,6",1,1,1,3,Low-Value,Lost
57202,297,4,"125,9",5,1,1,7,Mid-Value,Potential Loyalists
57203,1278,1,"57,4",2,1,1,4,Low-Value,Can't Lose
57205,1060,1,"21,7",3,1,1,5,Low-Value,At Risk Customers
57207,81,4,"158,5",5,1,1,7,Mid-Value,Potential Loyalists
57208,874,2,"107,99999999999999",3,1,1,5,Low-Value,At Risk Customers
57209,879,1,"13,45",3,1,1,5,Low-Value,At Risk Customers
57210,259,1,"27,1",5,1,1,7,Mid-Value,Potential Loyalists
57211,155,4,"200,35",5,1,1,7,Mid-Value,Potential Loyalists
57213,18,4,"597,3000000000001",5,1,1,7,Mid-Value,Potential Loyalists
57214,696,2,"36,85",4,1,1,6,Mid-Value,Potential Loyalists
57215,503,3,"214,05",4,1,1,6,Mid-Value,Potential Loyalists
57216,715,2,"42,2",4,1,1,6,Mid-Value,Potential Loyalists
57220,95,2,"51,4",5,1,1,7,Mid-Value,Potential Loyalists
57224,18,1,"308,70000000000005",5,1,1,7,Mid-Value,Potential Loyalists
57228,517,2,"50,8",4,1,1,6,Mid-Value,Potential Loyalists
57229,128,5,"262,84999999999997",5,1,1,7,Mid-Value,Potential Loyalists
57233,647,1,"102,45",4,1,1,6,Mid-Value,Potential Loyalists
57239,152,4,"119,65",5,1,1,7,Mid-Value,Potential Loyalists
57241,22,4,"409,8",5,1,1,7,Mid-Value,Potential Loyalists
57243,1009,2,"37,8",3,1,1,5,Low-Value,At Risk Customers
57244,551,3,"80,95",4,1,1,6,Mid-Value,Potential Loyalists
57245,734,1,"97,4",3,1,1,5,Low-Value,At Risk Customers
57246,64,4,"79,75",5,1,1,7,Mid-Value,Potential Loyalists
57248,47,2,"80,05",5,1,1,7,Mid-Value,Potential Loyalists
57249,655,1,"338,54999999999995",4,1,1,6,Mid-Value,Potential Loyalists
57250,254,3,"101,6",5,1,1,7,Mid-Value,Potential Loyalists
57251,924,5,"480,4",3,1,1,5,Low-Value,At Risk Customers
57252,32,2,"32,099999999999994",5,1,1,7,Mid-Value,Potential Loyalists
57254,31,8,"236,15",5,2,1,8,High-Value,Potential Loyalists
57255,838,5,"78,25",3,1,1,5,Low-Value,At Risk Customers
57256,311,6,"352,95",5,1,1,7,Mid-Value,Potential Loyalists
57257,36,11,"322,6",5,2,1,8,High-Value,Potential Loyalists
57258,463,2,"149,8",4,1,1,6,Mid-Value,Potential Loyalists
57260,966,2,"33,95",3,1,1,5,Low-Value,At Risk Customers
57261,68,4,"289,0",5,1,1,7,Mid-Value,Potential Loyalists
57262,281,3,"62,9",5,1,1,7,Mid-Value,Potential Loyalists
57266,201,11,"682,0",5,2,2,9,High-Value,Champions
57267,28,1,"20,0",5,1,1,7,Mid-Value,Potential Loyalists
57268,148,2,"434,34999999999997",5,1,1,7,Mid-Value,Potential Loyalists
57269,14,3,"33,75",5,1,1,7,Mid-Value,Potential Loyalists
57270,78,5,"153,65",5,1,1,7,Mid-Value,Potential Loyalists
57272,283,2,"14,98",5,1,1,7,Mid-Value,Potential Loyalists
57273,733,2,"312,2",3,1,1,5,Low-Value,At Risk Customers
57274,130,1,"78,8",5,1,1,7,Mid-Value,Potential Loyalists
57276,931,3,"89,7",3,1,1,5,Low-Value,At Risk Customers
57277,156,1,"49,800000000000004",5,1,1,7,Mid-Value,Potential Loyalists
57278,1212,3,"181,0",2,1,1,4,Low-Value,Can't Lose
57280,1316,1,"20,7",2,1,1,4,Low-Value,Can't Lose
57283,635,4,"266,5",4,1,1,6,Mid-Value,Potential Loyalists
57284,1043,1,"20,2",3,1,1,5,Low-Value,At Risk Customers
57287,215,2,"42,35",5,1,1,7,Mid-Value,Potential Loyalists
57291,389,2,"22,15",4,1,1,6,Mid-Value,Potential Loyalists
57294,1748,1,"14,1",1,1,1,3,Low-Value,Lost
57295,1554,1,"48,15",1,1,1,3,Low-Value,Lost
57296,652,1,"13,2",4,1,1,6,Mid-Value,Potential Loyalists
57298,43,2,"80,65",5,1,1,7,Mid-Value,Potential Loyalists
57299,644,2,"240,14999999999998",4,1,1,6,Mid-Value,Potential Loyalists
57301,753,2,"66,5",3,1,1,5,Low-Value,At Risk Customers
57302,421,10,"536,7",4,2,1,7,Mid-Value,Potential Loyalists
57303,589,2,"49,9",4,1,1,6,Mid-Value,Potential Loyalists
57304,225,2,"79,6",5,1,1,7,Mid-Value,Potential Loyalists
57305,29,7,"407,65",5,2,1,8,High-Value,Potential Loyalists
57306,845,5,"548,8000000000001",3,1,1,5,Low-Value,At Risk Customers
57307,248,4,"111,1",5,1,1,7,Mid-Value,Potential Loyalists
57309,24,3,"148,95",5,1,1,7,Mid-Value,Potential Loyalists
57310,11,8,"773,7",5,2,2,9,High-Value,Champions
57311,419,7,"199,89999999999998",4,2,1,7,Mid-Value,Potential Loyalists
57313,0,2,"328,4",5,1,1,7,Mid-Value,Potential Loyalists
57315,354,2,"146,8",5,1,1,7,Mid-Value,Potential Loyalists
57316,487,1,"81,8",4,1,1,6,Mid-Value,Potential Loyalists
57319,1055,5,"226,89999999999998",3,1,1,5,Low-Value,At Risk Customers
57320,375,2,"458,45",4,1,1,6,Mid-Value,Potential Loyalists
57322,61,4,"408,9",5,1,1,7,Mid-Value,Potential Loyalists
57323,734,2,"94,1",3,1,1,5,Low-Value,At Risk Customers
57325,1694,1,"17,1",1,1,1,3,Low-Value,Lost
57326,339,5,"308,1",5,1,1,7,Mid-Value,Potential Loyalists
57328,156,1,"23,4",5,1,1,7,Mid-Value,Potential Loyalists
57329,831,2,"114,45",3,1,1,5,Low-Value,At Risk Customers
57330,1818,1,"11,9",1,1,1,3,Low-Value,Lost
57334,779,3,"92,35",3,1,1,5,Low-Value,At Risk Customers
57335,987,1,"24,15",3,1,1,5,Low-Value,At Risk Customers
57336,31,1,"22,2",5,1,1,7,Mid-Value,Potential Loyalists
57337,32,3,"94,44999999999999",5,1,1,7,Mid-Value,Potential Loyalists
57338,817,2,"269,3",3,1,1,5,Low-Value,At Risk Customers
57339,223,2,"22,499999999999996",5,1,1,7,Mid-Value,Potential Loyalists
57340,438,2,"132,6",4,1,1,6,Mid-Value,Potential Loyalists
57342,37,4,"153,25",5,1,1,7,Mid-Value,Potential Loyalists
57343,181,2,"140,3",5,1,1,7,Mid-Value,Potential Loyalists
57344,195,2,"53,0",5,1,1,7,Mid-Value,Potential Loyalists
57345,145,6,"288,35",5,1,1,7,Mid-Value,Potential Loyalists
57346,706,2,"13,95",4,1,1,6,Mid-Value,Potential Loyalists
57347,742,3,"38,3",3,1,1,5,Low-Value,At Risk Customers
57348,406,5,"315,1",4,1,1,6,Mid-Value,Potential Loyalists
57349,962,2,"57,05",3,1,1,5,Low-Value,At Risk Customers
57351,309,1,"29,05",5,1,1,7,Mid-Value,Potential Loyalists
57352,201,4,"302,2",5,1,1,7,Mid-Value,Potential Loyalists
57353,116,3,"70,55",5,1,1,7,Mid-Value,Potential Loyalists
57354,426,6,"468,0",4,1,1,6,Mid-Value,Potential Loyalists
57355,574,1,"155,4",4,1,1,6,Mid-Value,Potential Loyalists
57357,1804,1,"8,35",1,1,1,3,Low-Value,Lost
57359,7,3,"191,45",5,1,1,7,Mid-Value,Potential Loyalists
57362,13,7,"872,0",5,2,2,9,High-Value,Champions
57364,742,10,"452,25",3,2,1,6,Mid-Value,Potential Loyalists
57365,1218,1,"217,8",2,1,1,4,Low-Value,Can't Lose
57366,169,6,"567,5500000000001",5,1,1,7,Mid-Value,Potential Loyalists
57367,153,1,"20,9",5,1,1,7,Mid-Value,Potential Loyalists
57368,1018,1,"56,6",3,1,1,5,Low-Value,At Risk Customers
57370,834,2,"121,69999999999999",3,1,1,5,Low-Value,At Risk Customers
57371,47,14,"700,7",5,3,2,10,High-Value,Champions
57372,136,3,"150,15",5,1,1,7,Mid-Value,Potential Loyalists
57373,1584,2,"98,05",1,1,1,3,Low-Value,Lost
57374,613,6,"274,15000000000003",4,1,1,6,Mid-Value,Potential Loyalists
57375,746,5,"343,6",3,1,1,5,Low-Value,At Risk Customers
57376,566,1,"117,8",4,1,1,6,Mid-Value,Potential Loyalists
57377,517,3,"291,8",4,1,1,6,Mid-Value,Potential Loyalists
57378,524,6,"328,2",4,1,1,6,Mid-Value,Potential Loyalists
57379,887,2,"316,8",3,1,1,5,Low-Value,At Risk Customers
57382,854,1,"145,5",3,1,1,5,Low-Value,At Risk Customers
57383,24,1,"84,6",5,1,1,7,Mid-Value,Potential Loyalists
57385,118,7,"414,09999999999997",5,2,1,8,High-Value,Potential Loyalists
57387,646,2,"32,9",4,1,1,6,Mid-Value,Potential Loyalists
57390,1557,2,"219,45",1,1,1,3,Low-Value,Lost
57392,952,2,"112,5",3,1,1,5,Low-Value,At Risk Customers
57394,981,2,"184,54999999999998",3,1,1,5,Low-Value,At Risk Customers
57396,208,3,"128,15",5,1,1,7,Mid-Value,Potential Loyalists
57397,40,8,"445,55",5,2,1,8,High-Value,Potential Loyalists
57398,234,3,"243,65",5,1,1,7,Mid-Value,Potential Loyalists
57401,1805,1,"19,25",1,1,1,3,Low-Value,Lost
57403,926,4,"232,6",3,1,1,5,Low-Value,At Risk Customers
57404,80,2,"44,95",5,1,1,7,Mid-Value,Potential Loyalists
57405,699,5,"261,5",4,1,1,6,Mid-Value,Potential Loyalists
57406,691,3,"182,5",4,1,1,6,Mid-Value,Potential Loyalists
57407,263,4,"651,8500000000001",5,1,1,7,Mid-Value,Potential Loyalists
57409,118,3,"48,7",5,1,1,7,Mid-Value,Potential Loyalists
57410,1168,1,"65,55",2,1,1,4,Low-Value,Can't Lose
57415,746,4,"358,2",3,1,1,5,Low-Value,At Risk Customers
57416,928,2,"88,4",3,1,1,5,Low-Value,At Risk Customers
57417,767,3,"181,4",3,1,1,5,Low-Value,At Risk Customers
57420,1722,1,"16,0",1,1,1,3,Low-Value,Lost
57423,808,5,"270,54999999999995",3,1,1,5,Low-Value,At Risk Customers
57426,258,5,"297,25",5,1,1,7,Mid-Value,Potential Loyalists
57428,438,3,"239,45",4,1,1,6,Mid-Value,Potential Loyalists
57429,397,1,"58,6",4,1,1,6,Mid-Value,Potential Loyalists
57430,8,4,"784,5500000000001",5,1,2,8,High-Value,Potential Loyalists
57432,1277,1,"145,5",2,1,1,4,Low-Value,Can't Lose
57433,563,2,"72,65",4,1,1,6,Mid-Value,Potential Loyalists
57434,904,2,"102,3",3,1,1,5,Low-Value,At Risk Customers
57435,421,5,"238,7",4,1,1,6,Mid-Value,Potential Loyalists
57439,348,4,"258,0",5,1,1,7,Mid-Value,Potential Loyalists
57440,1334,1,"18,1",2,1,1,4,Low-Value,Can't Lose
57442,22,5,"441,25",5,1,1,7,Mid-Value,Potential Loyalists
57445,656,3,"70,75",4,1,1,6,Mid-Value,Potential Loyalists
57446,1424,1,"34,0",2,1,1,4,Low-Value,Can't Lose
57447,122,4,"273,04999999999995",5,1,1,7,Mid-Value,Potential Loyalists
57448,458,3,"165,2",4,1,1,6,Mid-Value,Potential Loyalists
57449,199,1,"124,19999999999999",5,1,1,7,Mid-Value,Potential Loyalists
57452,1691,1,"39,9",1,1,1,3,Low-Value,Lost
57453,11,11,"1243,4",5,2,2,9,High-Value,Champions
57454,538,5,"288,45",4,1,1,6,Mid-Value,Potential Loyalists
57455,428,3,"175,35",4,1,1,6,Mid-Value,Potential Loyalists
57460,956,3,"58,95",3,1,1,5,Low-Value,At Risk Customers
57461,97,1,"7,4",5,1,1,7,Mid-Value,Potential Loyalists
57462,480,10,"453,0",4,2,1,7,Mid-Value,Potential Loyalists
57464,856,2,"169,1",3,1,1,5,Low-Value,At Risk Customers
57465,373,3,"48,4",4,1,1,6,Mid-Value,Potential Loyalists
57466,710,1,"89,9",4,1,1,6,Mid-Value,Potential Loyalists
57469,232,7,"909,5999999999999",5,2,2,9,High-Value,Champions
57470,882,2,"36,1",3,1,1,5,Low-Value,At Risk Customers
57471,9,2,"97,45",5,1,1,7,Mid-Value,Potential Loyalists
57473,1600,1,"141,75",1,1,1,3,Low-Value,Lost
57474,1525,1,"23,65",1,1,1,3,Low-Value,Lost
57475,435,3,"85,05",4,1,1,6,Mid-Value,Potential Loyalists
57479,117,4,"132,25",5,1,1,7,Mid-Value,Potential Loyalists
57480,546,2,"296,2",4,1,1,6,Mid-Value,Potential Loyalists
57481,908,5,"344,35",3,1,1,5,Low-Value,At Risk Customers
57482,1194,2,"24,900000000000002",2,1,1,4,Low-Value,Can't Lose
57484,892,2,"179,7",3,1,1,5,Low-Value,At Risk Customers
57485,133,2,"145,25",5,1,1,7,Mid-Value,Potential Loyalists
57486,22,3,"111,7",5,1,1,7,Mid-Value,Potential Loyalists
57488,74,2,"77,19999999999999",5,1,1,7,Mid-Value,Potential Loyalists
57489,605,3,"293,6",4,1,1,6,Mid-Value,Potential Loyalists
57491,551,4,"77,80000000000001",4,1,1,6,Mid-Value,Potential Loyalists
57493,71,4,"485,25",5,1,1,7,Mid-Value,Potential Loyalists
57498,1105,1,"12,7",2,1,1,4,Low-Value,Can't Lose
57499,129,4,"307,65000000000003",5,1,1,7,Mid-Value,Potential Loyalists
57500,716,1,"32,15",4,1,1,6,Mid-Value,Potential Loyalists
57501,442,5,"166,95",4,1,1,6,Mid-Value,Potential Loyalists
57503,11,5,"215,4",5,1,1,7,Mid-Value,Potential Loyalists
57504,1459,1,"25,650000000000002",2,1,1,4,Low-Value,Can't Lose
57505,208,5,"200,15",5,1,1,7,Mid-Value,Potential Loyalists
57507,1020,1,"63,05",3,1,1,5,Low-Value,At Risk Customers
57508,530,1,"169,4",4,1,1,6,Mid-Value,Potential Loyalists
57510,451,8,"390,4",4,2,1,7,Mid-Value,Potential Loyalists
57511,1154,3,"246,20000000000002",2,1,1,4,Low-Value,Can't Lose
57512,184,2,"18,45",5,1,1,7,Mid-Value,Potential Loyalists
57513,1236,5,"123,6",2,1,1,4,Low-Value,Can't Lose
57515,1784,1,"48,15",1,1,1,3,Low-Value,Lost
57518,160,3,"590,5",5,1,1,7,Mid-Value,Potential Loyalists
57520,1299,2,"16,85",2,1,1,4,Low-Value,Can't Lose
57525,422,1,"17,5",4,1,1,6,Mid-Value,Potential Loyalists
57526,796,4,"240,55",3,1,1,5,Low-Value,At Risk Customers
57530,456,7,"287,7",4,2,1,7,Mid-Value,Potential Loyalists
57531,631,5,"235,15",4,1,1,6,Mid-Value,Potential Loyalists
57532,939,4,"722,45",3,1,2,6,Mid-Value,Potential Loyalists
57534,80,6,"443,75",5,1,1,7,Mid-Value,Potential Loyalists
57535,36,5,"276,6",5,1,1,7,Mid-Value,Potential Loyalists
57538,372,2,"329,05",4,1,1,6,Mid-Value,Potential Loyalists
57539,460,4,"214,8",4,1,1,6,Mid-Value,Potential Loyalists
57542,496,2,"200,7",4,1,1,6,Mid-Value,Potential Loyalists
57543,72,2,"45,5",5,1,1,7,Mid-Value,Potential Loyalists
57544,1403,1,"63,2",2,1,1,4,Low-Value,Can't Lose
57546,1478,2,"139,6",1,1,1,3,Low-Value,Lost
57547,1733,1,"49,15",1,1,1,3,Low-Value,Lost
57548,31,8,"1118,1",5,2,2,9,High-Value,Champions
57549,836,2,"50,75",3,1,1,5,Low-Value,At Risk Customers
57551,137,2,"160,6",5,1,1,7,Mid-Value,Potential Loyalists
57552,1316,1,"100,5",2,1,1,4,Low-Value,Can't Lose
57554,1274,1,"81,4",2,1,1,4,Low-Value,Can't Lose
57555,898,1,"31,7",3,1,1,5,Low-Value,At Risk Customers
57558,241,1,"19,45",5,1,1,7,Mid-Value,Potential Loyalists
57559,946,1,"12,5",3,1,1,5,Low-Value,At Risk Customers
57561,130,6,"299,05",5,1,1,7,Mid-Value,Potential Loyalists
57562,1320,3,"207,6",2,1,1,4,Low-Value,Can't Lose
57563,1325,1,"491,6",2,1,1,4,Low-Value,Can't Lose
57565,903,1,"54,7",3,1,1,5,Low-Value,At Risk Customers
57566,267,4,"207,3",5,1,1,7,Mid-Value,Potential Loyalists
57567,1287,2,"76,2",2,1,1,4,Low-Value,Can't Lose
57568,1350,1,"63,05",2,1,1,4,Low-Value,Can't Lose
57569,5,4,"433,44999999999993",5,1,1,7,Mid-Value,Potential Loyalists
57570,998,1,"40,92",3,1,1,5,Low-Value,At Risk Customers
57575,1224,5,"403,20000000000005",2,1,1,4,Low-Value,Can't Lose
57578,1126,1,"167,4",2,1,1,4,Low-Value,Can't Lose
57581,1128,8,"360,35",2,2,1,5,Low-Value,At Risk Customers
57582,1298,2,"60,7",2,1,1,4,Low-Value,Can't Lose
57585,28,6,"167,66",5,1,1,7,Mid-Value,Potential Loyalists
57586,863,1,"74,5",3,1,1,5,Low-Value,At Risk Customers
57587,994,2,"93,55000000000001",3,1,1,5,Low-Value,At Risk Customers
57589,143,7,"466,65000000000003",5,2,1,8,High-Value,Potential Loyalists
57590,313,4,"347,04999999999995",5,1,1,7,Mid-Value,Potential Loyalists
57591,4,8,"689,4000000000001",5,2,2,9,High-Value,Champions
57592,311,7,"413,95",5,2,1,8,High-Value,Potential Loyalists
57593,38,2,"43,25",5,1,1,7,Mid-Value,Potential Loyalists
57594,378,1,"94,1",4,1,1,6,Mid-Value,Potential Loyalists
57595,61,13,"1060,1",5,3,2,10,High-Value,Champions
57596,957,2,"48,900000000000006",3,1,1,5,Low-Value,At Risk Customers
57597,103,11,"467,25",5,2,1,8,High-Value,Potential Loyalists
57598,1077,1,"6,65",3,1,1,5,Low-Value,At Risk Customers
57600,461,9,"884,2499999999999",4,2,2,8,High-Value,Potential Loyalists
57601,1763,1,"47,05",1,1,1,3,Low-Value,Lost
57602,438,1,"81,3",4,1,1,6,Mid-Value,Potential Loyalists
57604,63,3,"37,25",5,1,1,7,Mid-Value,Potential Loyalists
57605,811,1,"13,4",3,1,1,5,Low-Value,At Risk Customers
57607,4,8,"452,7",5,2,1,8,High-Value,Potential Loyalists
57608,828,5,"596,2",3,1,1,5,Low-Value,At Risk Customers
57609,327,8,"371,20000000000005",5,2,1,8,High-Value,Potential Loyalists
57613,1417,1,"18,15",2,1,1,4,Low-Value,Can't Lose
57616,25,2,"180,3",5,1,1,7,Mid-Value,Potential Loyalists
57620,110,4,"329,25",5,1,1,7,Mid-Value,Potential Loyalists
57623,634,6,"690,6",4,1,2,7,Mid-Value,Potential Loyalists
57624,753,3,"183,35",3,1,1,5,Low-Value,At Risk Customers
57625,88,4,"319,8",5,1,1,7,Mid-Value,Potential Loyalists
57627,1,4,"205,65",5,1,1,7,Mid-Value,Potential Loyalists
57632,1078,2,"56,1",3,1,1,5,Low-Value,At Risk Customers
57634,985,1,"72,55",3,1,1,5,Low-Value,At Risk Customers
57635,602,1,"183,89999999999998",4,1,1,6,Mid-Value,Potential Loyalists
57636,3,15,"1210,1",5,3,2,10,High-Value,Champions
57638,354,7,"383,6",5,2,1,8,High-Value,Potential Loyalists
57639,760,4,"114,95",3,1,1,5,Low-Value,At Risk Customers
57640,152,3,"216,05",5,1,1,7,Mid-Value,Potential Loyalists
57641,323,1,"12,2",5,1,1,7,Mid-Value,Potential Loyalists
57642,1319,1,"51,35",2,1,1,4,Low-Value,Can't Lose
57643,50,7,"965,8",5,2,2,9,High-Value,Champions
57644,947,2,"432,9",3,1,1,5,Low-Value,At Risk Customers
57645,269,1,"33,05",5,1,1,7,Mid-Value,Potential Loyalists
57647,229,3,"106,15",5,1,1,7,Mid-Value,Potential Loyalists
57650,82,5,"434,6",5,1,1,7,Mid-Value,Potential Loyalists
57652,401,7,"244,10000000000002",4,2,1,7,Mid-Value,Potential Loyalists
57653,1474,1,"64,7",1,1,1,3,Low-Value,Lost
57655,83,2,"56,05",5,1,1,7,Mid-Value,Potential Loyalists
57657,1264,1,"75,75",2,1,1,4,Low-Value,Can't Lose
57658,113,13,"1247,3999999999999",5,3,2,10,High-Value,Champions
57659,746,1,"12,9",3,1,1,5,Low-Value,At Risk Customers
57660,1330,3,"529,35",2,1,1,4,Low-Value,Can't Lose
57661,444,9,"315,1",4,2,1,7,Mid-Value,Potential Loyalists
57662,753,3,"231,7",3,1,1,5,Low-Value,At Risk Customers
57663,396,2,"81,19999999999999",4,1,1,6,Mid-Value,Potential Loyalists
57664,1000,1,"50,2",3,1,1,5,Low-Value,At Risk Customers
57665,956,1,"14,8",3,1,1,5,Low-Value,At Risk Customers
57667,560,2,"164,7",4,1,1,6,Mid-Value,Potential Loyalists
57668,987,1,"4,0",3,1,1,5,Low-Value,At Risk Customers
57669,990,5,"775,15",3,1,2,6,Mid-Value,Potential Loyalists
57670,587,4,"217,14999999999998",4,1,1,6,Mid-Value,Potential Loyalists
57672,634,4,"156,9",4,1,1,6,Mid-Value,Potential Loyalists
57673,60,1,"19,8",5,1,1,7,Mid-Value,Potential Loyalists
57677,849,3,"81,35",3,1,1,5,Low-Value,At Risk Customers
57678,162,5,"174,4",5,1,1,7,Mid-Value,Potential Loyalists
57681,1438,1,"9,35",2,1,1,4,Low-Value,Can't Lose
57683,59,15,"1072,56",5,3,2,10,High-Value,Champions
57684,808,2,"49,949999999999996",3,1,1,5,Low-Value,At Risk Customers
57686,1361,3,"122,9",2,1,1,4,Low-Value,Can't Lose
57688,190,2,"265,09999999999997",5,1,1,7,Mid-Value,Potential Loyalists
57689,259,3,"142,89999999999998",5,1,1,7,Mid-Value,Potential Loyalists
57690,789,5,"176,6",3,1,1,5,Low-Value,At Risk Customers
57691,26,11,"317,05",5,2,1,8,High-Value,Potential Loyalists
57692,1575,2,"67,1",1,1,1,3,Low-Value,Lost
57693,466,4,"107,75",4,1,1,6,Mid-Value,Potential Loyalists
57694,80,5,"372,9",5,1,1,7,Mid-Value,Potential Loyalists
57696,396,4,"323,75",4,1,1,6,Mid-Value,Potential Loyalists
57697,22,5,"376,5",5,1,1,7,Mid-Value,Potential Loyalists
57699,514,1,"16,0",4,1,1,6,Mid-Value,Potential Loyalists
57702,556,3,"205,04999999999998",4,1,1,6,Mid-Value,Potential Loyalists
57703,597,4,"150,2",4,1,1,6,Mid-Value,Potential Loyalists
57706,180,5,"150,4",5,1,1,7,Mid-Value,Potential Loyalists
57707,452,2,"62,699999999999996",4,1,1,6,Mid-Value,Potential Loyalists
57708,428,8,"596,5",4,2,1,7,Mid-Value,Potential Loyalists
57709,80,2,"87,80000000000001",5,1,1,7,Mid-Value,Potential Loyalists
57710,951,2,"46,1",3,1,1,5,Low-Value,At Risk Customers
57711,820,5,"381,75",3,1,1,5,Low-Value,At Risk Customers
57712,74,2,"53,900000000000006",5,1,1,7,Mid-Value,Potential Loyalists
57713,0,5,"1840,8",5,1,3,9,High-Value,Champions
57714,60,6,"157,1",5,1,1,7,Mid-Value,Potential Loyalists
57715,641,5,"79,7",4,1,1,6,Mid-Value,Potential Loyalists
57716,1433,1,"71,25",2,1,1,4,Low-Value,Can't Lose
57717,60,6,"954,35",5,1,2,8,High-Value,Potential Loyalists
57719,45,6,"138,79999999999998",5,1,1,7,Mid-Value,Potential Loyalists
57720,74,8,"419,0",5,2,1,8,High-Value,Potential Loyalists
57721,75,7,"383,7",5,2,1,8,High-Value,Potential Loyalists
57722,650,3,"194,75",4,1,1,6,Mid-Value,Potential Loyalists
57725,396,11,"419,65000000000003",4,2,1,7,Mid-Value,Potential Loyalists
57726,505,3,"129,5",4,1,1,6,Mid-Value,Potential Loyalists
57727,859,3,"145,9",3,1,1,5,Low-Value,At Risk Customers
57728,207,3,"101,0",5,1,1,7,Mid-Value,Potential Loyalists
57729,147,3,"249,15",5,1,1,7,Mid-Value,Potential Loyalists
57730,507,3,"233,85",4,1,1,6,Mid-Value,Potential Loyalists
57731,22,1,"96,9",5,1,1,7,Mid-Value,Potential Loyalists
57732,665,4,"298,95",4,1,1,6,Mid-Value,Potential Loyalists
57734,536,3,"192,7",4,1,1,6,Mid-Value,Potential Loyalists
57737,207,1,"30,69",5,1,1,7,Mid-Value,Potential Loyalists
57738,927,1,"59,7",3,1,1,5,Low-Value,At Risk Customers
57739,1576,1,"14,35",1,1,1,3,Low-Value,Lost
57741,541,3,"254,5",4,1,1,6,Mid-Value,Potential Loyalists
57742,1685,1,"43,85",1,1,1,3,Low-Value,Lost
57744,244,2,"179,15",5,1,1,7,Mid-Value,Potential Loyalists
57745,930,1,"167,85000000000002",3,1,1,5,Low-Value,At Risk Customers
57746,780,7,"218,2",3,2,1,6,Mid-Value,Potential Loyalists
57748,1343,1,"10,15",2,1,1,4,Low-Value,Can't Lose
57749,392,11,"533,85",4,2,1,7,Mid-Value,Potential Loyalists
57750,537,1,"20,0",4,1,1,6,Mid-Value,Potential Loyalists
57753,1502,2,"24,200000000000003",1,1,1,3,Low-Value,Lost
57754,531,6,"244,7",4,1,1,6,Mid-Value,Potential Loyalists
57756,1821,1,"5,7",1,1,1,3,Low-Value,Lost
57757,518,4,"126,95",4,1,1,6,Mid-Value,Potential Loyalists
57758,642,8,"748,5",4,2,2,8,High-Value,Potential Loyalists
57759,129,11,"376,0",5,2,1,8,High-Value,Potential Loyalists
57760,174,3,"109,25",5,1,1,7,Mid-Value,Potential Loyalists
57761,120,5,"603,2",5,1,1,7,Mid-Value,Potential Loyalists
57763,914,1,"96,60000000000001",3,1,1,5,Low-Value,At Risk Customers
57765,263,2,"36,5",5,1,1,7,Mid-Value,Potential Loyalists
57767,496,3,"179,7",4,1,1,6,Mid-Value,Potential Loyalists
57768,433,6,"697,3",4,1,2,7,Mid-Value,Potential Loyalists
57769,417,5,"107,2",4,1,1,6,Mid-Value,Potential Loyalists
57770,58,6,"674,0",5,1,2,8,High-Value,Potential Loyalists
57773,119,5,"271,08",5,1,1,7,Mid-Value,Potential Loyalists
57774,799,5,"225,1",3,1,1,5,Low-Value,At Risk Customers
57775,1085,5,"304,75",3,1,1,5,Low-Value,At Risk Customers
57776,586,10,"708,5999999999999",4,2,2,8,High-Value,Potential Loyalists
57781,260,6,"204,55",5,1,1,7,Mid-Value,Potential Loyalists
57783,396,7,"481,8",4,2,1,7,Mid-Value,Potential Loyalists
57784,89,5,"935,15",5,1,2,8,High-Value,Potential Loyalists
57787,474,3,"265,0",4,1,1,6,Mid-Value,Potential Loyalists
57789,1683,1,"42,5",1,1,1,3,Low-Value,Lost
57790,8,4,"380,6",5,1,1,7,Mid-Value,Potential Loyalists
57792,47,2,"181,29999999999998",5,1,1,7,Mid-Value,Potential Loyalists
57793,143,2,"522,0",5,1,1,7,Mid-Value,Potential Loyalists
57794,40,8,"482,0",5,2,1,8,High-Value,Potential Loyalists
57795,1620,5,"371,1",1,1,1,3,Low-Value,Lost
57796,207,1,"84,3",5,1,1,7,Mid-Value,Potential Loyalists
57797,632,3,"75,89999999999999",4,1,1,6,Mid-Value,Potential Loyalists
57798,1123,3,"242,0",2,1,1,4,Low-Value,Can't Lose
57799,107,8,"651,35",5,2,1,8,High-Value,Potential Loyalists
57801,791,1,"31,55",3,1,1,5,Low-Value,At Risk Customers
57804,151,3,"70,25",5,1,1,7,Mid-Value,Potential Loyalists
57807,353,4,"355,70000000000005",5,1,1,7,Mid-Value,Potential Loyalists
57808,544,4,"320,45",4,1,1,6,Mid-Value,Potential Loyalists
57809,281,2,"93,35",5,1,1,7,Mid-Value,Potential Loyalists
57813,1706,1,"144,0",1,1,1,3,Low-Value,Lost
57814,74,4,"125,5",5,1,1,7,Mid-Value,Potential Loyalists
57815,445,3,"79,9",4,1,1,6,Mid-Value,Potential Loyalists
57816,769,6,"287,15",3,1,1,5,Low-Value,At Risk Customers
57818,161,7,"1089,2",5,2,2,9,High-Value,Champions
57819,431,1,"54,0",4,1,1,6,Mid-Value,Potential Loyalists
57820,395,4,"441,09999999999997",4,1,1,6,Mid-Value,Potential Loyalists
57821,1306,2,"98,5",2,1,1,4,Low-Value,Can't Lose
57823,201,3,"105,85",5,1,1,7,Mid-Value,Potential Loyalists
57824,115,4,"133,45",5,1,1,7,Mid-Value,Potential Loyalists
57825,42,3,"124,1",5,1,1,7,Mid-Value,Potential Loyalists
57826,689,5,"360,4",4,1,1,6,Mid-Value,Potential Loyalists
57829,17,5,"203,5",5,1,1,7,Mid-Value,Potential Loyalists
57831,416,2,"175,95",4,1,1,6,Mid-Value,Potential Loyalists
57832,1328,1,"5,25",2,1,1,4,Low-Value,Can't Lose
57833,82,4,"112,75",5,1,1,7,Mid-Value,Potential Loyalists
57834,500,4,"1201,6",4,1,2,7,Mid-Value,Potential Loyalists
57835,878,6,"102,7",3,1,1,5,Low-Value,At Risk Customers
57836,645,4,"557,35",4,1,1,6,Mid-Value,Potential Loyalists
57837,1163,2,"114,35",2,1,1,4,Low-Value,Can't Lose
57838,1254,1,"32,1",2,1,1,4,Low-Value,Can't Lose
57841,1160,6,"99,35",2,1,1,4,Low-Value,Can't Lose
57842,448,1,"46,05",4,1,1,6,Mid-Value,Potential Loyalists
57844,2,2,"150,3",5,1,1,7,Mid-Value,Potential Loyalists
57846,360,3,"250,35",5,1,1,7,Mid-Value,Potential Loyalists
57848,0,8,"675,05",5,2,2,9,High-Value,Champions
57849,1131,1,"39,55",2,1,1,4,Low-Value,Can't Lose
57850,14,3,"112,1",5,1,1,7,Mid-Value,Potential Loyalists
57853,757,1,"139,4",3,1,1,5,Low-Value,At Risk Customers
57855,544,2,"45,3",4,1,1,6,Mid-Value,Potential Loyalists
57856,487,6,"106,44999999999999",4,1,1,6,Mid-Value,Potential Loyalists
57858,68,6,"428,54999999999995",5,1,1,7,Mid-Value,Potential Loyalists
57859,390,4,"174,05",4,1,1,6,Mid-Value,Potential Loyalists
57860,817,2,"367,95",3,1,1,5,Low-Value,At Risk Customers
57863,635,1,"194,5",4,1,1,6,Mid-Value,Potential Loyalists
57864,232,1,"64,85",5,1,1,7,Mid-Value,Potential Loyalists
57865,5,2,"34,55",5,1,1,7,Mid-Value,Potential Loyalists
57868,1692,1,"87,15",1,1,1,3,Low-Value,Lost
57871,241,1,"6,45",5,1,1,7,Mid-Value,Potential Loyalists
57872,1222,4,"268,05",2,1,1,4,Low-Value,Can't Lose
57875,328,2,"119,65",5,1,1,7,Mid-Value,Potential Loyalists
57877,131,2,"57,2",5,1,1,7,Mid-Value,Potential Loyalists
57880,391,3,"325,09999999999997",4,1,1,6,Mid-Value,Potential Loyalists
57881,112,4,"284,65",5,1,1,7,Mid-Value,Potential Loyalists
57884,228,4,"221,25",5,1,1,7,Mid-Value,Potential Loyalists
57885,766,6,"480,45",3,1,1,5,Low-Value,At Risk Customers
57887,195,11,"539,2",5,2,1,8,High-Value,Potential Loyalists
57888,606,2,"101,25",4,1,1,6,Mid-Value,Potential Loyalists
57889,14,5,"163,20000000000002",5,1,1,7,Mid-Value,Potential Loyalists
57891,587,2,"165,15",4,1,1,6,Mid-Value,Potential Loyalists
57892,252,2,"15,35",5,1,1,7,Mid-Value,Potential Loyalists
57893,502,5,"638,8",4,1,1,6,Mid-Value,Potential Loyalists
57894,230,3,"234,75",5,1,1,7,Mid-Value,Potential Loyalists
57895,795,2,"18,799999999999997",3,1,1,5,Low-Value,At Risk Customers
57896,693,1,"41,8",4,1,1,6,Mid-Value,Potential Loyalists
57897,1812,1,"9,45",1,1,1,3,Low-Value,Lost
57898,323,2,"89,14999999999999",5,1,1,7,Mid-Value,Potential Loyalists
57900,1070,1,"39,8",3,1,1,5,Low-Value,At Risk Customers
57901,509,2,"122,35",4,1,1,6,Mid-Value,Potential Loyalists
57902,691,2,"56,1",4,1,1,6,Mid-Value,Potential Loyalists
57903,304,1,"50,5",5,1,1,7,Mid-Value,Potential Loyalists
57904,396,3,"127,35",4,1,1,6,Mid-Value,Potential Loyalists
57905,225,6,"346,05",5,1,1,7,Mid-Value,Potential Loyalists
57907,453,1,"72,9",4,1,1,6,Mid-Value,Potential Loyalists
57908,777,2,"153,15",3,1,1,5,Low-Value,At Risk Customers
57909,1396,1,"41,4",2,1,1,4,Low-Value,Can't Lose
57910,1291,2,"496,5",2,1,1,4,Low-Value,Can't Lose
57911,19,2,"37,599999999999994",5,1,1,7,Mid-Value,Potential Loyalists
57912,1180,3,"486,2",2,1,1,4,Low-Value,Can't Lose
57913,88,9,"665,7",5,2,2,9,High-Value,Champions
57915,1232,1,"37,4",2,1,1,4,Low-Value,Can't Lose
57916,49,6,"496,05",5,1,1,7,Mid-Value,Potential Loyalists
57917,672,3,"173,39999999999998",4,1,1,6,Mid-Value,Potential Loyalists
57918,1074,1,"38,0",3,1,1,5,Low-Value,At Risk Customers
57920,406,4,"101,65",4,1,1,6,Mid-Value,Potential Loyalists
57922,1259,2,"51,4",2,1,1,4,Low-Value,Can't Lose
57926,1171,1,"42,15",2,1,1,4,Low-Value,Can't Lose
57927,195,6,"184,95",5,1,1,7,Mid-Value,Potential Loyalists
57928,900,2,"120,55",3,1,1,5,Low-Value,At Risk Customers
57929,418,1,"28,8",4,1,1,6,Mid-Value,Potential Loyalists
57931,1181,3,"100,10000000000001",2,1,1,4,Low-Value,Can't Lose
57932,906,1,"88,8",3,1,1,5,Low-Value,At Risk Customers
57934,33,9,"370,5",5,2,1,8,High-Value,Potential Loyalists
57935,501,5,"913,25",4,1,2,7,Mid-Value,Potential Loyalists
57936,347,2,"71,85",5,1,1,7,Mid-Value,Potential Loyalists
57937,732,4,"346,6",3,1,1,5,Low-Value,At Risk Customers
57938,175,5,"265,7",5,1,1,7,Mid-Value,Potential Loyalists
57939,56,4,"128,25",5,1,1,7,Mid-Value,Potential Loyalists
57940,425,1,"97,05",4,1,1,6,Mid-Value,Potential Loyalists
57942,128,4,"416,1",5,1,1,7,Mid-Value,Potential Loyalists
57947,500,2,"25,45",4,1,1,6,Mid-Value,Potential Loyalists
57948,903,2,"140,6",3,1,1,5,Low-Value,At Risk Customers
57949,472,4,"310,95",4,1,1,6,Mid-Value,Potential Loyalists
57950,774,1,"75,5",3,1,1,5,Low-Value,At Risk Customers
57955,7,4,"202,9",5,1,1,7,Mid-Value,Potential Loyalists
57956,25,1,"64,5",5,1,1,7,Mid-Value,Potential Loyalists
57957,930,5,"343,9",3,1,1,5,Low-Value,At Risk Customers
57959,788,11,"1056,6499999999999",3,2,2,7,Mid-Value,Potential Loyalists
57961,307,5,"288,9",5,1,1,7,Mid-Value,Potential Loyalists
57962,700,3,"92,94999999999999",4,1,1,6,Mid-Value,Potential Loyalists
57963,1156,2,"166,35",2,1,1,4,Low-Value,Can't Lose
57964,24,1,"26,5",5,1,1,7,Mid-Value,Potential Loyalists
57966,432,2,"37,05",4,1,1,6,Mid-Value,Potential Loyalists
57969,35,3,"63,65",5,1,1,7,Mid-Value,Potential Loyalists
57971,766,2,"29,450000000000003",3,1,1,5,Low-Value,At Risk Customers
57972,189,2,"116,2",5,1,1,7,Mid-Value,Potential Loyalists
57974,1284,1,"56,5",2,1,1,4,Low-Value,Can't Lose
57975,56,7,"180,7",5,2,1,8,High-Value,Potential Loyalists
57976,786,5,"148,9",3,1,1,5,Low-Value,At Risk Customers
57978,425,7,"569,9",4,2,1,7,Mid-Value,Potential Loyalists
57980,1240,3,"39,75",2,1,1,4,Low-Value,Can't Lose
57981,561,2,"21,200000000000003",4,1,1,6,Mid-Value,Potential Loyalists
57983,99,4,"134,55",5,1,1,7,Mid-Value,Potential Loyalists
57984,192,8,"426,70000000000005",5,2,1,8,High-Value,Potential Loyalists
57985,256,3,"238,9",5,1,1,7,Mid-Value,Potential Loyalists
57986,983,1,"37,5",3,1,1,5,Low-Value,At Risk Customers
57988,682,3,"31,200000000000003",4,1,1,6,Mid-Value,Potential Loyalists
57992,297,1,"47,1",5,1,1,7,Mid-Value,Potential Loyalists
57994,298,1,"66,9",5,1,1,7,Mid-Value,Potential Loyalists
57995,130,1,"72,2",5,1,1,7,Mid-Value,Potential Loyalists
57998,264,1,"26,45",5,1,1,7,Mid-Value,Potential Loyalists
58003,1264,1,"41,8",2,1,1,4,Low-Value,Can't Lose
58005,20,4,"157,70000000000002",5,1,1,7,Mid-Value,Potential Loyalists
58006,152,4,"191,25",5,1,1,7,Mid-Value,Potential Loyalists
58007,399,2,"502,25",4,1,1,6,Mid-Value,Potential Loyalists
58009,226,2,"28,8",5,1,1,7,Mid-Value,Potential Loyalists
58011,715,3,"124,85",4,1,1,6,Mid-Value,Potential Loyalists
58012,612,1,"256,6",4,1,1,6,Mid-Value,Potential Loyalists
58013,667,1,"21,55",4,1,1,6,Mid-Value,Potential Loyalists
58015,207,5,"270,05",5,1,1,7,Mid-Value,Potential Loyalists
58016,419,2,"498,25",4,1,1,6,Mid-Value,Potential Loyalists
58017,779,4,"220,35",3,1,1,5,Low-Value,At Risk Customers
58019,1082,4,"106,35",3,1,1,5,Low-Value,At Risk Customers
58021,45,3,"160,7",5,1,1,7,Mid-Value,Potential Loyalists
58023,466,1,"14,4",4,1,1,6,Mid-Value,Potential Loyalists
58027,1,2,"186,89999999999998",5,1,1,7,Mid-Value,Potential Loyalists
58029,467,2,"102,6",4,1,1,6,Mid-Value,Potential Loyalists
58030,54,7,"256,0",5,2,1,8,High-Value,Potential Loyalists
58032,95,1,"14,3",5,1,1,7,Mid-Value,Potential Loyalists
58033,290,5,"372,95",5,1,1,7,Mid-Value,Potential Loyalists
58034,3,7,"727,05",5,2,2,9,High-Value,Champions
58035,647,1,"149,05",4,1,1,6,Mid-Value,Potential Loyalists
58036,452,3,"119,2",4,1,1,6,Mid-Value,Potential Loyalists
58037,330,6,"296,65000000000003",5,1,1,7,Mid-Value,Potential Loyalists
58038,45,4,"116,1",5,1,1,7,Mid-Value,Potential Loyalists
58039,521,2,"97,0",4,1,1,6,Mid-Value,Potential Loyalists
58041,430,2,"204,45",4,1,1,6,Mid-Value,Potential Loyalists
58043,63,3,"297,25",5,1,1,7,Mid-Value,Potential Loyalists
58044,788,1,"71,55",3,1,1,5,Low-Value,At Risk Customers
58046,1767,1,"11,95",1,1,1,3,Low-Value,Lost
58047,773,4,"117,25",3,1,1,5,Low-Value,At Risk Customers
58048,548,3,"265,3",4,1,1,6,Mid-Value,Potential Loyalists
58050,799,3,"87,0",3,1,1,5,Low-Value,At Risk Customers
58051,782,2,"115,5",3,1,1,5,Low-Value,At Risk Customers
58052,1490,1,"22,6",1,1,1,3,Low-Value,Lost
58053,4,12,"857,05",5,3,2,10,High-Value,Champions
58056,222,9,"360,35",5,2,1,8,High-Value,Potential Loyalists
58057,685,6,"314,20000000000005",4,1,1,6,Mid-Value,Potential Loyalists
58058,1284,1,"95,9",2,1,1,4,Low-Value,Can't Lose
58060,423,1,"19,85",4,1,1,6,Mid-Value,Potential Loyalists
58061,384,5,"568,4",4,1,1,6,Mid-Value,Potential Loyalists
58063,390,2,"56,15",4,1,1,6,Mid-Value,Potential Loyalists
58066,174,5,"116,1",5,1,1,7,Mid-Value,Potential Loyalists
58067,812,2,"169,4",3,1,1,5,Low-Value,At Risk Customers
58069,514,1,"278,9",4,1,1,6,Mid-Value,Potential Loyalists
58071,266,3,"207,3",5,1,1,7,Mid-Value,Potential Loyalists
58072,178,2,"121,55",5,1,1,7,Mid-Value,Potential Loyalists
58073,843,2,"15,7",3,1,1,5,Low-Value,At Risk Customers
58074,734,4,"240,39999999999998",3,1,1,5,Low-Value,At Risk Customers
58076,163,6,"162,45",5,1,1,7,Mid-Value,Potential Loyalists
58077,553,2,"119,4",4,1,1,6,Mid-Value,Potential Loyalists
58078,1232,2,"122,4",2,1,1,4,Low-Value,Can't Lose
58082,383,3,"292,35",4,1,1,6,Mid-Value,Potential Loyalists
58083,1513,1,"46,9",1,1,1,3,Low-Value,Lost
58084,477,3,"37,7",4,1,1,6,Mid-Value,Potential Loyalists
58085,1077,1,"91,0",3,1,1,5,Low-Value,At Risk Customers
58086,424,2,"68,7",4,1,1,6,Mid-Value,Potential Loyalists
58087,278,3,"177,6",5,1,1,7,Mid-Value,Potential Loyalists
58088,836,4,"123,6",3,1,1,5,Low-Value,At Risk Customers
58089,1086,1,"102,8",3,1,1,5,Low-Value,At Risk Customers
58091,1503,2,"67,1",1,1,1,3,Low-Value,Lost
58092,642,1,"31,05",4,1,1,6,Mid-Value,Potential Loyalists
58093,618,1,"42,45",4,1,1,6,Mid-Value,Potential Loyalists
58094,176,3,"164,35",5,1,1,7,Mid-Value,Potential Loyalists
58095,831,1,"41,6",3,1,1,5,Low-Value,At Risk Customers
58097,301,6,"248,70000000000002",5,1,1,7,Mid-Value,Potential Loyalists
58100,1268,1,"57,6",2,1,1,4,Low-Value,Can't Lose
58102,546,6,"256,11",4,1,1,6,Mid-Value,Potential Loyalists
58105,1116,2,"315,75",2,1,1,4,Low-Value,Can't Lose
58108,558,2,"185,7",4,1,1,6,Mid-Value,Potential Loyalists
58110,1676,1,"21,4",1,1,1,3,Low-Value,Lost
58112,647,1,"7,3",4,1,1,6,Mid-Value,Potential Loyalists
58117,1006,1,"18,8",3,1,1,5,Low-Value,At Risk Customers
58118,525,7,"295,95",4,2,1,7,Mid-Value,Potential Loyalists
58120,30,2,"41,15",5,1,1,7,Mid-Value,Potential Loyalists
58121,1132,1,"6,45",2,1,1,4,Low-Value,Can't Lose
58123,88,8,"262,85",5,2,1,8,High-Value,Potential Loyalists
58124,425,3,"84,55000000000001",4,1,1,6,Mid-Value,Potential Loyalists
58125,947,1,"117,2",3,1,1,5,Low-Value,At Risk Customers
58127,111,12,"715,3",5,3,2,10,High-Value,Champions
58128,1237,1,"337,35",2,1,1,4,Low-Value,Can't Lose
58129,355,2,"194,29999999999998",5,1,1,7,Mid-Value,Potential Loyalists
58130,1713,1,"6,75",1,1,1,3,Low-Value,Lost
58132,423,1,"51,4",4,1,1,6,Mid-Value,Potential Loyalists
58133,1558,1,"121,75",1,1,1,3,Low-Value,Lost
58134,24,1,"1,35",5,1,1,7,Mid-Value,Potential Loyalists
58135,201,7,"450,04999999999995",5,2,1,8,High-Value,Potential Loyalists
58136,76,11,"491,5",5,2,1,8,High-Value,Potential Loyalists
58138,533,1,"227,2",4,1,1,6,Mid-Value,Potential Loyalists
58140,236,3,"303,45",5,1,1,7,Mid-Value,Potential Loyalists
58143,75,3,"148,4",5,1,1,7,Mid-Value,Potential Loyalists
58146,36,1,"49,8",5,1,1,7,Mid-Value,Potential Loyalists
58148,1693,2,"60,0",1,1,1,3,Low-Value,Lost
58150,3,1,"36,4",5,1,1,7,Mid-Value,Potential Loyalists
58151,858,4,"965,5999999999999",3,1,2,6,Mid-Value,Potential Loyalists
58152,7,5,"416,1",5,1,1,7,Mid-Value,Potential Loyalists
58153,758,1,"35,0",3,1,1,5,Low-Value,At Risk Customers
58154,377,3,"205,3",4,1,1,6,Mid-Value,Potential Loyalists
58157,785,3,"163,60000000000002",3,1,1,5,Low-Value,At Risk Customers
58158,444,1,"51,15",4,1,1,6,Mid-Value,Potential Loyalists
58160,308,3,"190,25",5,1,1,7,Mid-Value,Potential Loyalists
58161,793,3,"104,3",3,1,1,5,Low-Value,At Risk Customers
58162,768,3,"66,5",3,1,1,5,Low-Value,At Risk Customers
58164,19,5,"157,4",5,1,1,7,Mid-Value,Potential Loyalists
58166,32,2,"32,3",5,1,1,7,Mid-Value,Potential Loyalists
58167,31,6,"155,8",5,1,1,7,Mid-Value,Potential Loyalists
58168,189,4,"324,65",5,1,1,7,Mid-Value,Potential Loyalists
58170,45,5,"288,65",5,1,1,7,Mid-Value,Potential Loyalists
58171,1194,1,"156,3",2,1,1,4,Low-Value,Can't Lose
58172,262,1,"63,25",5,1,1,7,Mid-Value,Potential Loyalists
58173,238,3,"441,2",5,1,1,7,Mid-Value,Potential Loyalists
58175,693,5,"130,9",4,1,1,6,Mid-Value,Potential Loyalists
58176,918,1,"17,1",3,1,1,5,Low-Value,At Risk Customers
58178,1303,1,"21,7",2,1,1,4,Low-Value,Can't Lose
58179,715,3,"109,55",4,1,1,6,Mid-Value,Potential Loyalists
58180,679,2,"61,85",4,1,1,6,Mid-Value,Potential Loyalists
58183,81,3,"46,75",5,1,1,7,Mid-Value,Potential Loyalists
58184,441,2,"27,05",4,1,1,6,Mid-Value,Potential Loyalists
58187,136,2,"72,85",5,1,1,7,Mid-Value,Potential Loyalists
58188,866,2,"120,0",3,1,1,5,Low-Value,At Risk Customers
58190,173,9,"875,5500000000001",5,2,2,9,High-Value,Champions
58191,437,6,"290,75",4,1,1,6,Mid-Value,Potential Loyalists
58192,233,1,"525,5999999999999",5,1,1,7,Mid-Value,Potential Loyalists
58193,32,3,"134,85",5,1,1,7,Mid-Value,Potential Loyalists
58194,27,4,"177,85000000000002",5,1,1,7,Mid-Value,Potential Loyalists
58195,199,11,"660,4",5,2,1,8,High-Value,Potential Loyalists
58197,606,4,"159,0",4,1,1,6,Mid-Value,Potential Loyalists
58198,992,2,"70,85",3,1,1,5,Low-Value,At Risk Customers
58199,787,2,"69,95",3,1,1,5,Low-Value,At Risk Customers
58200,26,3,"217,95",5,1,1,7,Mid-Value,Potential Loyalists
58201,543,4,"230,7",4,1,1,6,Mid-Value,Potential Loyalists
58202,1098,2,"17,549999999999997",2,1,1,4,Low-Value,Can't Lose
58204,1466,2,"211,0",1,1,1,3,Low-Value,Lost
58206,70,5,"284,6",5,1,1,7,Mid-Value,Potential Loyalists
58207,269,10,"248,85",5,2,1,8,High-Value,Potential Loyalists
58209,505,4,"190,64999999999998",4,1,1,6,Mid-Value,Potential Loyalists
58211,1727,1,"32,3",1,1,1,3,Low-Value,Lost
58212,53,3,"61,95",5,1,1,7,Mid-Value,Potential Loyalists
58215,40,11,"415,59999999999997",5,2,1,8,High-Value,Potential Loyalists
58216,1454,1,"36,85",2,1,1,4,Low-Value,Can't Lose
58217,619,5,"269,8",4,1,1,6,Mid-Value,Potential Loyalists
58218,136,2,"45,35",5,1,1,7,Mid-Value,Potential Loyalists
58222,1770,1,"43,1",1,1,1,3,Low-Value,Lost
58223,1788,1,"47,7",1,1,1,3,Low-Value,Lost
58224,513,2,"157,25",4,1,1,6,Mid-Value,Potential Loyalists
58225,448,3,"156,7",4,1,1,6,Mid-Value,Potential Loyalists
58227,824,2,"47,15",3,1,1,5,Low-Value,At Risk Customers
58228,75,4,"148,45",5,1,1,7,Mid-Value,Potential Loyalists
58229,178,3,"31,45",5,1,1,7,Mid-Value,Potential Loyalists
58230,34,3,"57,8",5,1,1,7,Mid-Value,Potential Loyalists
58231,1330,1,"32,4",2,1,1,4,Low-Value,Can't Lose
58232,664,5,"339,55",4,1,1,6,Mid-Value,Potential Loyalists
58234,31,4,"189,2",5,1,1,7,Mid-Value,Potential Loyalists
58235,1411,1,"41,0",2,1,1,4,Low-Value,Can't Lose
58236,1470,3,"85,75",1,1,1,3,Low-Value,Lost
58238,1047,2,"174,2",3,1,1,5,Low-Value,At Risk Customers
58240,974,4,"217,75",3,1,1,5,Low-Value,At Risk Customers
58242,192,2,"18,55",5,1,1,7,Mid-Value,Potential Loyalists
58243,146,3,"135,5",5,1,1,7,Mid-Value,Potential Loyalists
58244,549,2,"150,15",4,1,1,6,Mid-Value,Potential Loyalists
58245,75,3,"282,2",5,1,1,7,Mid-Value,Potential Loyalists
58246,817,2,"417,2",3,1,1,5,Low-Value,At Risk Customers
58247,141,4,"306,45",5,1,1,7,Mid-Value,Potential Loyalists
58249,916,2,"92,2",3,1,1,5,Low-Value,At Risk Customers
58250,136,6,"197,75",5,1,1,7,Mid-Value,Potential Loyalists
58252,1273,2,"28,5",2,1,1,4,Low-Value,Can't Lose
58253,1416,1,"56,95",2,1,1,4,Low-Value,Can't Lose
58254,1411,2,"71,64999999999999",2,1,1,4,Low-Value,Can't Lose
58256,989,1,"123,8",3,1,1,5,Low-Value,At Risk Customers
58257,758,2,"315,5",3,1,1,5,Low-Value,At Risk Customers
58260,444,4,"286,45",4,1,1,6,Mid-Value,Potential Loyalists
58261,118,3,"327,8",5,1,1,7,Mid-Value,Potential Loyalists
58262,1260,1,"52,0",2,1,1,4,Low-Value,Can't Lose
58264,1452,2,"105,5",2,1,1,4,Low-Value,Can't Lose
58265,301,2,"86,75",5,1,1,7,Mid-Value,Potential Loyalists
58267,40,7,"406,7",5,2,1,8,High-Value,Potential Loyalists
58268,507,6,"502,75",4,1,1,6,Mid-Value,Potential Loyalists
58269,974,1,"121,25",3,1,1,5,Low-Value,At Risk Customers
58270,204,2,"283,15000000000003",5,1,1,7,Mid-Value,Potential Loyalists
58273,591,1,"15,8",4,1,1,6,Mid-Value,Potential Loyalists
58274,490,4,"286,55",4,1,1,6,Mid-Value,Potential Loyalists
58276,761,2,"22,25",3,1,1,5,Low-Value,At Risk Customers
58277,104,3,"80,60000000000001",5,1,1,7,Mid-Value,Potential Loyalists
58278,1531,1,"26,55",1,1,1,3,Low-Value,Lost
58279,1116,4,"301,53",2,1,1,4,Low-Value,Can't Lose
58282,1326,2,"448,7",2,1,1,4,Low-Value,Can't Lose
58283,851,2,"42,5",3,1,1,5,Low-Value,At Risk Customers
58284,219,1,"15,4",5,1,1,7,Mid-Value,Potential Loyalists
58285,1649,2,"26,45",1,1,1,3,Low-Value,Lost
58288,369,4,"275,05",4,1,1,6,Mid-Value,Potential Loyalists
58289,1515,3,"84,35",1,1,1,3,Low-Value,Lost
58290,92,6,"138,75",5,1,1,7,Mid-Value,Potential Loyalists
58293,555,5,"264,95",4,1,1,6,Mid-Value,Potential Loyalists
58295,520,1,"21,9",4,1,1,6,Mid-Value,Potential Loyalists
58297,613,3,"179,3",4,1,1,6,Mid-Value,Potential Loyalists
58298,190,1,"117,2",5,1,1,7,Mid-Value,Potential Loyalists
58300,567,2,"96,6",4,1,1,6,Mid-Value,Potential Loyalists
58301,31,3,"178,5",5,1,1,7,Mid-Value,Potential Loyalists
58302,429,2,"15,95",4,1,1,6,Mid-Value,Potential Loyalists
58303,349,5,"220,8",5,1,1,7,Mid-Value,Potential Loyalists
58305,501,3,"236,5",4,1,1,6,Mid-Value,Potential Loyalists
58306,183,3,"1541,2",5,1,3,9,High-Value,Champions
58307,87,1,"8,75",5,1,1,7,Mid-Value,Potential Loyalists
58309,421,1,"8,95",4,1,1,6,Mid-Value,Potential Loyalists
58310,1022,3,"155,45",3,1,1,5,Low-Value,At Risk Customers
58311,750,10,"768,45",3,2,2,7,Mid-Value,Potential Loyalists
58313,800,1,"16,8",3,1,1,5,Low-Value,At Risk Customers
58314,992,1,"73,6",3,1,1,5,Low-Value,At Risk Customers
58316,1328,2,"221,85",2,1,1,4,Low-Value,Can't Lose
58317,1600,1,"44,1",1,1,1,3,Low-Value,Lost
58319,1653,1,"105,6",1,1,1,3,Low-Value,Lost
58320,252,3,"104,45",5,1,1,7,Mid-Value,Potential Loyalists
58321,659,8,"358,5",4,2,1,7,Mid-Value,Potential Loyalists
58322,168,2,"52,849999999999994",5,1,1,7,Mid-Value,Potential Loyalists
58323,884,1,"109,5",3,1,1,5,Low-Value,At Risk Customers
58324,543,3,"141,4",4,1,1,6,Mid-Value,Potential Loyalists
58325,936,4,"101,25",3,1,1,5,Low-Value,At Risk Customers
58326,403,3,"282,15",4,1,1,6,Mid-Value,Potential Loyalists
58327,918,3,"128,05",3,1,1,5,Low-Value,At Risk Customers
58330,48,2,"125,5",5,1,1,7,Mid-Value,Potential Loyalists
58331,31,3,"62,949999999999996",5,1,1,7,Mid-Value,Potential Loyalists
58332,806,4,"217,55",3,1,1,5,Low-Value,At Risk Customers
58333,437,2,"28,4",4,1,1,6,Mid-Value,Potential Loyalists
58335,1562,1,"3,9",1,1,1,3,Low-Value,Lost
58337,447,1,"59,4",4,1,1,6,Mid-Value,Potential Loyalists
58338,59,3,"221,04999999999998",5,1,1,7,Mid-Value,Potential Loyalists
58339,153,3,"49,85",5,1,1,7,Mid-Value,Potential Loyalists
58340,885,2,"52,1",3,1,1,5,Low-Value,At Risk Customers
58341,1601,1,"35,2",1,1,1,3,Low-Value,Lost
58343,367,6,"632,75",4,1,1,6,Mid-Value,Potential Loyalists
58344,93,4,"183,10000000000002",5,1,1,7,Mid-Value,Potential Loyalists
58345,527,2,"101,3",4,1,1,6,Mid-Value,Potential Loyalists
58348,389,1,"54,5",4,1,1,6,Mid-Value,Potential Loyalists
58350,1047,1,"6,2",3,1,1,5,Low-Value,At Risk Customers
58351,220,3,"112,25",5,1,1,7,Mid-Value,Potential Loyalists
58356,1289,2,"57,55",2,1,1,4,Low-Value,Can't Lose
58357,151,4,"486,1",5,1,1,7,Mid-Value,Potential Loyalists
58358,159,6,"1095,4",5,1,2,8,High-Value,Potential Loyalists
58359,1238,3,"120,25",2,1,1,4,Low-Value,Can't Lose
58360,588,4,"119,21",4,1,1,6,Mid-Value,Potential Loyalists
58362,525,4,"339,65",4,1,1,6,Mid-Value,Potential Loyalists
58363,860,3,"254,9",3,1,1,5,Low-Value,At Risk Customers
58364,428,1,"16,85",4,1,1,6,Mid-Value,Potential Loyalists
58365,345,1,"14,5",5,1,1,7,Mid-Value,Potential Loyalists
58367,399,4,"144,25",4,1,1,6,Mid-Value,Potential Loyalists
58368,1295,2,"167,2",2,1,1,4,Low-Value,Can't Lose
58369,171,3,"262,05",5,1,1,7,Mid-Value,Potential Loyalists
58370,40,2,"32,4",5,1,1,7,Mid-Value,Potential Loyalists
58371,29,5,"443,55",5,1,1,7,Mid-Value,Potential Loyalists
58372,514,2,"495,2",4,1,1,6,Mid-Value,Potential Loyalists
58373,791,2,"80,94999999999999",3,1,1,5,Low-Value,At Risk Customers
58374,110,3,"118,75",5,1,1,7,Mid-Value,Potential Loyalists
58376,341,2,"52,55",5,1,1,7,Mid-Value,Potential Loyalists
58377,738,5,"244,3",3,1,1,5,Low-Value,At Risk Customers
58378,981,1,"70,8",3,1,1,5,Low-Value,At Risk Customers
58382,860,5,"151,65",3,1,1,5,Low-Value,At Risk Customers
58383,777,1,"7,85",3,1,1,5,Low-Value,At Risk Customers
58384,739,2,"87,0",3,1,1,5,Low-Value,At Risk Customers
58386,339,3,"503,6",5,1,1,7,Mid-Value,Potential Loyalists
58387,54,5,"157,4",5,1,1,7,Mid-Value,Potential Loyalists
58388,1493,2,"24,9",1,1,1,3,Low-Value,Lost
58389,523,2,"133,6",4,1,1,6,Mid-Value,Potential Loyalists
58390,1558,2,"29,65",1,1,1,3,Low-Value,Lost
58392,178,8,"567,6",5,2,1,8,High-Value,Potential Loyalists
58395,651,7,"188,15",4,2,1,7,Mid-Value,Potential Loyalists
58397,940,2,"120,5",3,1,1,5,Low-Value,At Risk Customers
58398,210,3,"191,1",5,1,1,7,Mid-Value,Potential Loyalists
58399,1464,1,"60,7",1,1,1,3,Low-Value,Lost
58400,189,2,"82,3",5,1,1,7,Mid-Value,Potential Loyalists
58401,138,7,"331,75",5,2,1,8,High-Value,Potential Loyalists
58404,1485,1,"479,2",1,1,1,3,Low-Value,Lost
58405,1349,1,"55,3",2,1,1,4,Low-Value,Can't Lose
58407,17,6,"473,3",5,1,1,7,Mid-Value,Potential Loyalists
58408,7,7,"584,3",5,2,1,8,High-Value,Potential Loyalists
58410,238,1,"14,85",5,1,1,7,Mid-Value,Potential Loyalists
58413,17,4,"119,0",5,1,1,7,Mid-Value,Potential Loyalists
58415,220,1,"30,95",5,1,1,7,Mid-Value,Potential Loyalists
58416,884,3,"302,25",3,1,1,5,Low-Value,At Risk Customers
58418,444,4,"164,9",4,1,1,6,Mid-Value,Potential Loyalists
58419,1111,4,"322,75",2,1,1,4,Low-Value,Can't Lose
58423,25,1,"33,6",5,1,1,7,Mid-Value,Potential Loyalists
58424,77,4,"103,6",5,1,1,7,Mid-Value,Potential Loyalists
58425,264,1,"53,25",5,1,1,7,Mid-Value,Potential Loyalists
58426,1737,1,"49,1",1,1,1,3,Low-Value,Lost
58427,24,2,"49,349999999999994",5,1,1,7,Mid-Value,Potential Loyalists
58429,1632,1,"27,1",1,1,1,3,Low-Value,Lost
58430,58,3,"83,94999999999999",5,1,1,7,Mid-Value,Potential Loyalists
58431,1122,4,"159,05",2,1,1,4,Low-Value,Can't Lose
58432,632,5,"122,0",4,1,1,6,Mid-Value,Potential Loyalists
58433,126,10,"837,25",5,2,2,9,High-Value,Champions
58434,853,2,"427,95",3,1,1,5,Low-Value,At Risk Customers
58435,13,8,"349,1",5,2,1,8,High-Value,Potential Loyalists
58436,856,8,"881,3",3,2,2,7,Mid-Value,Potential Loyalists
58437,1819,1,"1,2",1,1,1,3,Low-Value,Lost
58439,25,3,"227,09999999999997",5,1,1,7,Mid-Value,Potential Loyalists
58440,334,4,"83,3",5,1,1,7,Mid-Value,Potential Loyalists
58441,727,2,"47,3",4,1,1,6,Mid-Value,Potential Loyalists
58443,475,3,"423,6",4,1,1,6,Mid-Value,Potential Loyalists
58444,71,11,"716,1500000000001",5,2,2,9,High-Value,Champions
58445,1098,3,"215,45",2,1,1,4,Low-Value,Can't Lose
58446,1561,2,"132,6",1,1,1,3,Low-Value,Lost
58447,241,8,"214,85000000000002",5,2,1,8,High-Value,Potential Loyalists
58448,984,1,"10,23",3,1,1,5,Low-Value,At Risk Customers
58449,931,3,"101,5",3,1,1,5,Low-Value,At Risk Customers
58451,40,3,"118,80000000000001",5,1,1,7,Mid-Value,Potential Loyalists
58454,461,2,"127,4",4,1,1,6,Mid-Value,Potential Loyalists
58455,24,6,"198,0",5,1,1,7,Mid-Value,Potential Loyalists
58456,71,1,"28,75",5,1,1,7,Mid-Value,Potential Loyalists
58460,509,3,"546,6",4,1,1,6,Mid-Value,Potential Loyalists
58461,206,5,"261,7",5,1,1,7,Mid-Value,Potential Loyalists
58462,459,8,"623,4",4,2,1,7,Mid-Value,Potential Loyalists
58464,755,6,"189,15",3,1,1,5,Low-Value,At Risk Customers
58465,42,5,"273,35",5,1,1,7,Mid-Value,Potential Loyalists
58467,315,2,"149,3",5,1,1,7,Mid-Value,Potential Loyalists
58468,174,3,"71,0",5,1,1,7,Mid-Value,Potential Loyalists
58469,333,2,"44,65",5,1,1,7,Mid-Value,Potential Loyalists
58470,232,3,"47,43",5,1,1,7,Mid-Value,Potential Loyalists
58473,151,3,"109,15",5,1,1,7,Mid-Value,Potential Loyalists
58474,159,4,"215,60000000000002",5,1,1,7,Mid-Value,Potential Loyalists
58475,697,3,"181,8",4,1,1,6,Mid-Value,Potential Loyalists
58476,17,2,"88,15",5,1,1,7,Mid-Value,Potential Loyalists
58477,38,9,"234,2",5,2,1,8,High-Value,Potential Loyalists
58479,503,4,"160,3",4,1,1,6,Mid-Value,Potential Loyalists
58480,711,2,"88,2",4,1,1,6,Mid-Value,Potential Loyalists
58481,400,6,"764,6",4,1,2,7,Mid-Value,Potential Loyalists
58483,613,6,"217,39999999999998",4,1,1,6,Mid-Value,Potential Loyalists
58485,824,5,"462,05",3,1,1,5,Low-Value,At Risk Customers
58486,745,1,"43,6",3,1,1,5,Low-Value,At Risk Customers
58487,194,4,"75,7",5,1,1,7,Mid-Value,Potential Loyalists
58489,202,1,"213,9",5,1,1,7,Mid-Value,Potential Loyalists
58490,1632,1,"27,4",1,1,1,3,Low-Value,Lost
58491,798,1,"6,45",3,1,1,5,Low-Value,At Risk Customers
58492,25,2,"29,85",5,1,1,7,Mid-Value,Potential Loyalists
58495,697,6,"496,25",4,1,1,6,Mid-Value,Potential Loyalists
58498,1233,2,"49,85",2,1,1,4,Low-Value,Can't Lose
58500,759,1,"247,20000000000002",3,1,1,5,Low-Value,At Risk Customers
58506,178,2,"182,65",5,1,1,7,Mid-Value,Potential Loyalists
58507,615,5,"107,75",4,1,1,6,Mid-Value,Potential Loyalists
58508,592,2,"97,3",4,1,1,6,Mid-Value,Potential Loyalists
58509,402,4,"312,2",4,1,1,6,Mid-Value,Potential Loyalists
58512,924,2,"136,95000000000002",3,1,1,5,Low-Value,At Risk Customers
58513,705,5,"318,6",4,1,1,6,Mid-Value,Potential Loyalists
58514,47,4,"270,8",5,1,1,7,Mid-Value,Potential Loyalists
58515,447,7,"414,8",4,2,1,7,Mid-Value,Potential Loyalists
58516,721,2,"190,35",4,1,1,6,Mid-Value,Potential Loyalists
58517,22,6,"433,3",5,1,1,7,Mid-Value,Potential Loyalists
58518,155,1,"2,5",5,1,1,7,Mid-Value,Potential Loyalists
58519,219,4,"195,39999999999998",5,1,1,7,Mid-Value,Potential Loyalists
58520,1485,1,"78,5",1,1,1,3,Low-Value,Lost
58524,90,4,"130,7",5,1,1,7,Mid-Value,Potential Loyalists
58525,370,4,"546,25",4,1,1,6,Mid-Value,Potential Loyalists
58526,1382,1,"84,8",2,1,1,4,Low-Value,Can't Lose
58529,557,6,"611,7",4,1,1,6,Mid-Value,Potential Loyalists
58530,599,1,"77,2",4,1,1,6,Mid-Value,Potential Loyalists
58533,155,4,"355,4",5,1,1,7,Mid-Value,Potential Loyalists
58534,734,2,"145,8",3,1,1,5,Low-Value,At Risk Customers
58535,493,2,"96,15",4,1,1,6,Mid-Value,Potential Loyalists
58537,17,3,"458,75",5,1,1,7,Mid-Value,Potential Loyalists
58538,395,2,"114,25",4,1,1,6,Mid-Value,Potential Loyalists
58539,1197,4,"343,15",2,1,1,4,Low-Value,Can't Lose
58540,34,3,"78,5",5,1,1,7,Mid-Value,Potential Loyalists
58541,109,2,"34,15",5,1,1,7,Mid-Value,Potential Loyalists
58542,469,1,"0,8",4,1,1,6,Mid-Value,Potential Loyalists
58544,388,7,"227,05",4,2,1,7,Mid-Value,Potential Loyalists
58545,468,1,"5,6",4,1,1,6,Mid-Value,Potential Loyalists
58548,1358,5,"165,1",2,1,1,4,Low-Value,Can't Lose
58551,21,8,"618,35",5,2,1,8,High-Value,Potential Loyalists
58553,93,2,"65,65",5,1,1,7,Mid-Value,Potential Loyalists
58554,106,2,"110,0",5,1,1,7,Mid-Value,Potential Loyalists
58557,1390,1,"158,0",2,1,1,4,Low-Value,Can't Lose
58560,476,3,"237,5",4,1,1,6,Mid-Value,Potential Loyalists
58562,1060,3,"202,4",3,1,1,5,Low-Value,At Risk Customers
58564,1064,3,"77,9",3,1,1,5,Low-Value,At Risk Customers
58566,382,5,"121,9",4,1,1,6,Mid-Value,Potential Loyalists
58567,827,5,"209,65",3,1,1,5,Low-Value,At Risk Customers
58571,1014,1,"32,55",3,1,1,5,Low-Value,At Risk Customers
58572,446,2,"82,65",4,1,1,6,Mid-Value,Potential Loyalists
58574,950,3,"217,39999999999998",3,1,1,5,Low-Value,At Risk Customers
58575,248,2,"241,4",5,1,1,7,Mid-Value,Potential Loyalists
58576,931,2,"219,5",3,1,1,5,Low-Value,At Risk Customers
58579,781,3,"142,70000000000002",3,1,1,5,Low-Value,At Risk Customers
58580,24,4,"107,5",5,1,1,7,Mid-Value,Potential Loyalists
58581,392,5,"1091,3999999999999",4,1,2,7,Mid-Value,Potential Loyalists
58582,655,1,"30,65",4,1,1,6,Mid-Value,Potential Loyalists
58583,972,1,"5,75",3,1,1,5,Low-Value,At Risk Customers
58584,1342,1,"96,44999999999999",2,1,1,4,Low-Value,Can't Lose
58586,732,7,"554,15",3,2,1,6,Mid-Value,Potential Loyalists
58587,1000,1,"34,5",3,1,1,5,Low-Value,At Risk Customers
58588,16,5,"286,7",5,1,1,7,Mid-Value,Potential Loyalists
58589,134,1,"20,9",5,1,1,7,Mid-Value,Potential Loyalists
58591,40,9,"1005,8",5,2,2,9,High-Value,Champions
58592,194,1,"121,94999999999999",5,1,1,7,Mid-Value,Potential Loyalists
58593,389,3,"71,35",4,1,1,6,Mid-Value,Potential Loyalists
58594,57,7,"284,09999999999997",5,2,1,8,High-Value,Potential Loyalists
58595,386,2,"349,75000000000006",4,1,1,6,Mid-Value,Potential Loyalists
58596,133,3,"41,65",5,1,1,7,Mid-Value,Potential Loyalists
58597,1735,2,"46,949999999999996",1,1,1,3,Low-Value,Lost
58598,1648,1,"144,7",1,1,1,3,Low-Value,Lost
58600,611,1,"18,75",4,1,1,6,Mid-Value,Potential Loyalists
58601,593,2,"118,6",4,1,1,6,Mid-Value,Potential Loyalists
58603,505,1,"53,6",4,1,1,6,Mid-Value,Potential Loyalists
58604,248,1,"19,65",5,1,1,7,Mid-Value,Potential Loyalists
58605,1297,1,"73,4",2,1,1,4,Low-Value,Can't Lose
58607,501,4,"224,05",4,1,1,6,Mid-Value,Potential Loyalists
58608,753,2,"66,8",3,1,1,5,Low-Value,At Risk Customers
58609,1132,1,"8,0",2,1,1,4,Low-Value,Can't Lose
58610,358,1,"6,45",5,1,1,7,Mid-Value,Potential Loyalists
58611,99,1,"12,3",5,1,1,7,Mid-Value,Potential Loyalists
58614,295,2,"102,55",5,1,1,7,Mid-Value,Potential Loyalists
58615,159,2,"77,35000000000001",5,1,1,7,Mid-Value,Potential Loyalists
58616,845,1,"41,0",3,1,1,5,Low-Value,At Risk Customers
58617,1082,3,"156,55000000000004",3,1,1,5,Low-Value,At Risk Customers
58619,7,6,"232,75",5,1,1,7,Mid-Value,Potential Loyalists
58621,1410,1,"146,10000000000002",2,1,1,4,Low-Value,Can't Lose
58624,530,1,"78,1",4,1,1,6,Mid-Value,Potential Loyalists
58631,821,2,"550,35",3,1,1,5,Low-Value,At Risk Customers
58633,649,3,"66,55",4,1,1,6,Mid-Value,Potential Loyalists
58634,18,2,"155,39999999999998",5,1,1,7,Mid-Value,Potential Loyalists
58637,8,8,"355,6",5,2,1,8,High-Value,Potential Loyalists
58638,578,6,"252,10000000000002",4,1,1,6,Mid-Value,Potential Loyalists
58641,1238,2,"62,8",2,1,1,4,Low-Value,Can't Lose
58642,4,2,"64,55000000000001",5,1,1,7,Mid-Value,Potential Loyalists
58644,489,3,"102,15",4,1,1,6,Mid-Value,Potential Loyalists
58645,135,3,"137,25",5,1,1,7,Mid-Value,Potential Loyalists
58647,36,3,"292,45",5,1,1,7,Mid-Value,Potential Loyalists
58648,182,4,"193,65",5,1,1,7,Mid-Value,Potential Loyalists
58649,1425,2,"124,75",2,1,1,4,Low-Value,Can't Lose
58650,235,5,"211,6",5,1,1,7,Mid-Value,Potential Loyalists
58651,209,2,"98,15",5,1,1,7,Mid-Value,Potential Loyalists
58655,1068,2,"120,0",3,1,1,5,Low-Value,At Risk Customers
58659,908,8,"362,9",3,2,1,6,Mid-Value,Potential Loyalists
58660,370,5,"121,1",4,1,1,6,Mid-Value,Potential Loyalists
58661,833,5,"92,45",3,1,1,5,Low-Value,At Risk Customers
58662,5,8,"377,65",5,2,1,8,High-Value,Potential Loyalists
58663,708,3,"169,7",4,1,1,6,Mid-Value,Potential Loyalists
58664,1315,1,"43,4",2,1,1,4,Low-Value,Can't Lose
58665,581,1,"174,0",4,1,1,6,Mid-Value,Potential Loyalists
58667,801,3,"211,15",3,1,1,5,Low-Value,At Risk Customers
58671,25,4,"253,29999999999998",5,1,1,7,Mid-Value,Potential Loyalists
58673,1817,1,"18,9",1,1,1,3,Low-Value,Lost
58678,1473,1,"113,69999999999999",1,1,1,3,Low-Value,Lost
58680,1587,1,"18,1",1,1,1,3,Low-Value,Lost
58682,264,2,"62,300000000000004",5,1,1,7,Mid-Value,Potential Loyalists
58683,355,2,"1541,6999999999998",5,1,3,9,High-Value,Champions
58685,1099,3,"285,55",2,1,1,4,Low-Value,Can't Lose
58687,676,1,"21,45",4,1,1,6,Mid-Value,Potential Loyalists
58689,1489,1,"121,2",1,1,1,3,Low-Value,Lost
58692,882,1,"23,9",3,1,1,5,Low-Value,At Risk Customers
58695,14,12,"458,7",5,3,1,9,High-Value,Champions
58697,56,3,"116,5",5,1,1,7,Mid-Value,Potential Loyalists
58698,6,15,"1206,75",5,3,2,10,High-Value,Champions
58699,521,3,"310,25",4,1,1,6,Mid-Value,Potential Loyalists
58700,1325,5,"180,04999999999998",2,1,1,4,Low-Value,Can't Lose
58701,92,3,"66,63",5,1,1,7,Mid-Value,Potential Loyalists
58703,333,3,"193,1",5,1,1,7,Mid-Value,Potential Loyalists
58704,1329,3,"199,54999999999998",2,1,1,4,Low-Value,Can't Lose
58705,441,3,"134,85",4,1,1,6,Mid-Value,Potential Loyalists
58706,84,8,"168,3",5,2,1,8,High-Value,Potential Loyalists
58707,741,5,"170,35",3,1,1,5,Low-Value,At Risk Customers
58708,7,5,"206,45",5,1,1,7,Mid-Value,Potential Loyalists
58709,1498,6,"456,29999999999995",1,1,1,3,Low-Value,Lost
58710,605,1,"20,6",4,1,1,6,Mid-Value,Potential Loyalists
58711,532,7,"644,05",4,2,1,7,Mid-Value,Potential Loyalists
58713,756,5,"525,0",3,1,1,5,Low-Value,At Risk Customers
58716,1537,1,"5,5",1,1,1,3,Low-Value,Lost
58718,1563,1,"151,8",1,1,1,3,Low-Value,Lost
58719,935,1,"31,0",3,1,1,5,Low-Value,At Risk Customers
58720,60,4,"218,85",5,1,1,7,Mid-Value,Potential Loyalists
58721,378,2,"104,2",4,1,1,6,Mid-Value,Potential Loyalists
58723,167,3,"205,85",5,1,1,7,Mid-Value,Potential Loyalists
58724,358,2,"70,25",5,1,1,7,Mid-Value,Potential Loyalists
58727,622,1,"7,6",4,1,1,6,Mid-Value,Potential Loyalists
58728,1507,1,"30,8",1,1,1,3,Low-Value,Lost
58729,253,1,"32,2",5,1,1,7,Mid-Value,Potential Loyalists
58730,452,2,"134,5",4,1,1,6,Mid-Value,Potential Loyalists
58731,884,4,"124,65",3,1,1,5,Low-Value,At Risk Customers
58732,190,6,"293,4",5,1,1,7,Mid-Value,Potential Loyalists
58733,197,2,"22,1",5,1,1,7,Mid-Value,Potential Loyalists
58734,1586,2,"338,29999999999995",1,1,1,3,Low-Value,Lost
58735,441,3,"226,10000000000002",4,1,1,6,Mid-Value,Potential Loyalists
58736,653,3,"113,75000000000001",4,1,1,6,Mid-Value,Potential Loyalists
58738,485,1,"17,15",4,1,1,6,Mid-Value,Potential Loyalists
58739,1042,1,"10,95",3,1,1,5,Low-Value,At Risk Customers
58741,518,2,"157,21",4,1,1,6,Mid-Value,Potential Loyalists
58742,530,3,"250,95",4,1,1,6,Mid-Value,Potential Loyalists
58743,158,2,"47,25",5,1,1,7,Mid-Value,Potential Loyalists
58744,179,1,"167,4",5,1,1,7,Mid-Value,Potential Loyalists
58745,1061,1,"3,9",3,1,1,5,Low-Value,At Risk Customers
58746,340,6,"530,65",5,1,1,7,Mid-Value,Potential Loyalists
58750,197,1,"41,5",5,1,1,7,Mid-Value,Potential Loyalists
58751,344,5,"290,75",5,1,1,7,Mid-Value,Potential Loyalists
58752,133,4,"460,79999999999995",5,1,1,7,Mid-Value,Potential Loyalists
58753,289,2,"289,25",5,1,1,7,Mid-Value,Potential Loyalists
58757,1158,1,"38,6",2,1,1,4,Low-Value,Can't Lose
58759,43,10,"753,5",5,2,2,9,High-Value,Champions
58760,137,3,"130,4",5,1,1,7,Mid-Value,Potential Loyalists
58761,1513,5,"280,35",1,1,1,3,Low-Value,Lost
58762,626,3,"204,25",4,1,1,6,Mid-Value,Potential Loyalists
58763,829,5,"296,2",3,1,1,5,Low-Value,At Risk Customers
58764,93,1,"52,05",5,1,1,7,Mid-Value,Potential Loyalists
58767,215,2,"33,629999999999995",5,1,1,7,Mid-Value,Potential Loyalists
58768,1022,1,"20,75",3,1,1,5,Low-Value,At Risk Customers
58769,960,2,"106,75",3,1,1,5,Low-Value,At Risk Customers
58771,1489,1,"117,8",1,1,1,3,Low-Value,Lost
58773,532,2,"49,6",4,1,1,6,Mid-Value,Potential Loyalists
58774,822,2,"29,36",3,1,1,5,Low-Value,At Risk Customers
58775,752,4,"215,1",3,1,1,5,Low-Value,At Risk Customers
58776,518,3,"121,80000000000001",4,1,1,6,Mid-Value,Potential Loyalists
58777,1631,2,"69,9",1,1,1,3,Low-Value,Lost
58778,259,1,"20,65",5,1,1,7,Mid-Value,Potential Loyalists
58780,1476,1,"52,0",1,1,1,3,Low-Value,Lost
58782,7,4,"184,2",5,1,1,7,Mid-Value,Potential Loyalists
58783,1282,1,"68,25",2,1,1,4,Low-Value,Can't Lose
58784,709,1,"251,7",4,1,1,6,Mid-Value,Potential Loyalists
58786,1356,1,"280,0",2,1,1,4,Low-Value,Can't Lose
58787,37,1,"48,45",5,1,1,7,Mid-Value,Potential Loyalists
58788,821,4,"225,4",3,1,1,5,Low-Value,At Risk Customers
58790,39,4,"164,45",5,1,1,7,Mid-Value,Potential Loyalists
58791,427,2,"92,85",4,1,1,6,Mid-Value,Potential Loyalists
58793,966,1,"58,050000000000004",3,1,1,5,Low-Value,At Risk Customers
58798,1377,1,"42,2",2,1,1,4,Low-Value,Can't Lose
58799,969,3,"86,0",3,1,1,5,Low-Value,At Risk Customers
58801,89,5,"323,2",5,1,1,7,Mid-Value,Potential Loyalists
58803,378,2,"896,2",4,1,2,7,Mid-Value,Potential Loyalists
58804,777,4,"186,15",3,1,1,5,Low-Value,At Risk Customers
58805,800,2,"85,0",3,1,1,5,Low-Value,At Risk Customers
58806,900,3,"143,55",3,1,1,5,Low-Value,At Risk Customers
58809,617,1,"20,65",4,1,1,6,Mid-Value,Potential Loyalists
58810,434,4,"232,2",4,1,1,6,Mid-Value,Potential Loyalists
58811,778,2,"96,0",3,1,1,5,Low-Value,At Risk Customers
58813,447,1,"16,2",4,1,1,6,Mid-Value,Potential Loyalists
58815,286,4,"265,2",5,1,1,7,Mid-Value,Potential Loyalists
58816,62,8,"1468,1",5,2,3,10,High-Value,Champions
58817,5,6,"444,2",5,1,1,7,Mid-Value,Potential Loyalists
58819,43,2,"71,4",5,1,1,7,Mid-Value,Potential Loyalists
58822,34,11,"486,25",5,2,1,8,High-Value,Potential Loyalists
58824,862,1,"331,9",3,1,1,5,Low-Value,At Risk Customers
58828,732,1,"232,7",3,1,1,5,Low-Value,At Risk Customers
58831,342,7,"446,95",5,2,1,8,High-Value,Potential Loyalists
58833,472,1,"19,9",4,1,1,6,Mid-Value,Potential Loyalists
58834,999,1,"82,25",3,1,1,5,Low-Value,At Risk Customers
58838,22,5,"309,45000000000005",5,1,1,7,Mid-Value,Potential Loyalists
58839,971,1,"71,1",3,1,1,5,Low-Value,At Risk Customers
58841,1106,7,"559,75",2,2,1,5,Low-Value,At Risk Customers
58842,21,1,"119,9",5,1,1,7,Mid-Value,Potential Loyalists
58843,31,5,"147,9",5,1,1,7,Mid-Value,Potential Loyalists
58844,1193,1,"60,1",2,1,1,4,Low-Value,Can't Lose
58845,95,2,"283,5",5,1,1,7,Mid-Value,Potential Loyalists
58846,1790,1,"2,2",1,1,1,3,Low-Value,Lost
58847,290,4,"326,55",5,1,1,7,Mid-Value,Potential Loyalists
58848,20,1,"2,6",5,1,1,7,Mid-Value,Potential Loyalists
58849,463,1,"270,0",4,1,1,6,Mid-Value,Potential Loyalists
58850,277,4,"489,15000000000003",5,1,1,7,Mid-Value,Potential Loyalists
58852,1817,1,"27,3",1,1,1,3,Low-Value,Lost
58853,626,2,"66,8",4,1,1,6,Mid-Value,Potential Loyalists
58854,181,6,"278,05",5,1,1,7,Mid-Value,Potential Loyalists
58857,1529,2,"296,4",1,1,1,3,Low-Value,Lost
58858,15,6,"768,85",5,1,2,8,High-Value,Potential Loyalists
58859,832,2,"46,2",3,1,1,5,Low-Value,At Risk Customers
58860,607,3,"101,0",4,1,1,6,Mid-Value,Potential Loyalists
58861,589,3,"55,1",4,1,1,6,Mid-Value,Potential Loyalists
58862,756,14,"851,26",3,3,2,8,High-Value,Potential Loyalists
58863,1016,1,"15,7",3,1,1,5,Low-Value,At Risk Customers
58867,318,4,"250,3",5,1,1,7,Mid-Value,Potential Loyalists
58868,31,10,"242,07999999999998",5,2,1,8,High-Value,Potential Loyalists
58869,70,8,"395,3",5,2,1,8,High-Value,Potential Loyalists
58872,1459,1,"55,0",2,1,1,4,Low-Value,Can't Lose
58873,739,4,"274,9",3,1,1,5,Low-Value,At Risk Customers
58874,17,4,"639,0500000000001",5,1,1,7,Mid-Value,Potential Loyalists
58875,439,2,"38,800000000000004",4,1,1,6,Mid-Value,Potential Loyalists
58879,567,1,"150,7",4,1,1,6,Mid-Value,Potential Loyalists
58881,748,1,"104,69999999999999",3,1,1,5,Low-Value,At Risk Customers
58882,997,1,"37,4",3,1,1,5,Low-Value,At Risk Customers
58883,1117,2,"25,599999999999998",2,1,1,4,Low-Value,Can't Lose
58885,423,4,"245,7",4,1,1,6,Mid-Value,Potential Loyalists
58886,768,1,"28,65",3,1,1,5,Low-Value,At Risk Customers
58887,381,4,"109,35",4,1,1,6,Mid-Value,Potential Loyalists
58888,756,3,"61,900000000000006",3,1,1,5,Low-Value,At Risk Customers
58889,226,2,"188,45",5,1,1,7,Mid-Value,Potential Loyalists
58893,1137,4,"97,75",2,1,1,4,Low-Value,Can't Lose
58895,180,1,"9,4",5,1,1,7,Mid-Value,Potential Loyalists
58896,939,1,"17,2",3,1,1,5,Low-Value,At Risk Customers
58897,81,3,"112,29999999999998",5,1,1,7,Mid-Value,Potential Loyalists
58898,989,1,"20,65",3,1,1,5,Low-Value,At Risk Customers
58899,1125,2,"51,550000000000004",2,1,1,4,Low-Value,Can't Lose
58900,1689,2,"78,6",1,1,1,3,Low-Value,Lost
58901,1031,2,"216,25",3,1,1,5,Low-Value,At Risk Customers
58902,43,4,"203,39999999999998",5,1,1,7,Mid-Value,Potential Loyalists
58903,1508,3,"125,60000000000001",1,1,1,3,Low-Value,Lost
58907,832,3,"161,9",3,1,1,5,Low-Value,At Risk Customers
58909,483,2,"107,3",4,1,1,6,Mid-Value,Potential Loyalists
58911,152,5,"355,15",5,1,1,7,Mid-Value,Potential Loyalists
58912,71,2,"62,25",5,1,1,7,Mid-Value,Potential Loyalists
58913,833,3,"119,3",3,1,1,5,Low-Value,At Risk Customers
58914,1226,1,"34,3",2,1,1,4,Low-Value,Can't Lose
58915,262,5,"290,45",5,1,1,7,Mid-Value,Potential Loyalists
58916,280,2,"171,7",5,1,1,7,Mid-Value,Potential Loyalists
58919,1597,2,"101,45",1,1,1,3,Low-Value,Lost
58920,113,4,"157,35",5,1,1,7,Mid-Value,Potential Loyalists
58921,685,1,"28,95",4,1,1,6,Mid-Value,Potential Loyalists
58923,1396,1,"8,55",2,1,1,4,Low-Value,Can't Lose
58924,1018,2,"13,45",3,1,1,5,Low-Value,At Risk Customers
58926,1265,4,"1120,3",2,1,2,5,Low-Value,At Risk Customers
58928,175,2,"153,8",5,1,1,7,Mid-Value,Potential Loyalists
58929,2,8,"692,3",5,2,2,9,High-Value,Champions
58932,1315,1,"5,0",2,1,1,4,Low-Value,Can't Lose
58933,348,1,"58,6",5,1,1,7,Mid-Value,Potential Loyalists
58935,90,7,"720,9",5,2,2,9,High-Value,Champions
58936,1102,2,"267,2",2,1,1,4,Low-Value,Can't Lose
58937,445,6,"255,75",4,1,1,6,Mid-Value,Potential Loyalists
58938,1512,2,"61,699999999999996",1,1,1,3,Low-Value,Lost
58939,466,1,"118,1",4,1,1,6,Mid-Value,Potential Loyalists
58941,412,1,"112,85",4,1,1,6,Mid-Value,Potential Loyalists
58945,123,3,"46,0",5,1,1,7,Mid-Value,Potential Loyalists
58946,88,3,"132,8",5,1,1,7,Mid-Value,Potential Loyalists
58947,202,2,"178,7",5,1,1,7,Mid-Value,Potential Loyalists
58949,138,7,"298,06",5,2,1,8,High-Value,Potential Loyalists
58950,140,5,"835,85",5,1,2,8,High-Value,Potential Loyalists
58953,104,12,"519,0",5,3,1,9,High-Value,Champions
58954,260,1,"9,85",5,1,1,7,Mid-Value,Potential Loyalists
58956,1793,1,"13,8",1,1,1,3,Low-Value,Lost
58957,627,1,"43,0",4,1,1,6,Mid-Value,Potential Loyalists
58962,792,1,"16,5",3,1,1,5,Low-Value,At Risk Customers
58964,515,3,"210,15",4,1,1,6,Mid-Value,Potential Loyalists
58965,420,2,"59,2",4,1,1,6,Mid-Value,Potential Loyalists
58968,79,2,"47,599999999999994",5,1,1,7,Mid-Value,Potential Loyalists
58969,334,3,"162,35",5,1,1,7,Mid-Value,Potential Loyalists
58971,1623,1,"43,1",1,1,1,3,Low-Value,Lost
58973,178,4,"174,05",5,1,1,7,Mid-Value,Potential Loyalists
58976,436,3,"139,85",4,1,1,6,Mid-Value,Potential Loyalists
58978,761,4,"458,25",3,1,1,5,Low-Value,At Risk Customers
58979,1340,1,"32,15",2,1,1,4,Low-Value,Can't Lose
58980,873,3,"399,25",3,1,1,5,Low-Value,At Risk Customers
58981,279,2,"71,15",5,1,1,7,Mid-Value,Potential Loyalists
58984,756,4,"89,5",3,1,1,5,Low-Value,At Risk Customers
58986,19,11,"547,8",5,2,1,8,High-Value,Potential Loyalists
58988,493,2,"92,2",4,1,1,6,Mid-Value,Potential Loyalists
58992,333,9,"336,15",5,2,1,8,High-Value,Potential Loyalists
58993,1397,5,"167,85",2,1,1,4,Low-Value,Can't Lose
58996,756,3,"152,55",3,1,1,5,Low-Value,At Risk Customers
58999,1730,1,"359,6",1,1,1,3,Low-Value,Lost
59000,1335,2,"141,5",2,1,1,4,Low-Value,Can't Lose
59001,672,2,"122,19999999999999",4,1,1,6,Mid-Value,Potential Loyalists
59004,616,2,"22,05",4,1,1,6,Mid-Value,Potential Loyalists
59005,1175,1,"24,0",2,1,1,4,Low-Value,Can't Lose
59007,4,1,"47,4",5,1,1,7,Mid-Value,Potential Loyalists
59008,880,1,"12,0",3,1,1,5,Low-Value,At Risk Customers
59010,48,3,"142,4",5,1,1,7,Mid-Value,Potential Loyalists
59011,60,2,"89,9",5,1,1,7,Mid-Value,Potential Loyalists
59013,131,5,"783,55",5,1,2,8,High-Value,Potential Loyalists
59014,34,8,"346,2",5,2,1,8,High-Value,Potential Loyalists
59016,161,3,"42,25",5,1,1,7,Mid-Value,Potential Loyalists
59017,774,1,"135,0",3,1,1,5,Low-Value,At Risk Customers
59019,148,2,"179,05",5,1,1,7,Mid-Value,Potential Loyalists
59021,339,2,"200,95",5,1,1,7,Mid-Value,Potential Loyalists
59023,1047,1,"216,0",3,1,1,5,Low-Value,At Risk Customers
59024,35,3,"85,4",5,1,1,7,Mid-Value,Potential Loyalists
59025,1,2,"173,6",5,1,1,7,Mid-Value,Potential Loyalists
59026,1802,1,"10,9",1,1,1,3,Low-Value,Lost
59028,1143,1,"23,3",2,1,1,4,Low-Value,Can't Lose
59030,1090,2,"196,15",3,1,1,5,Low-Value,At Risk Customers
59031,129,5,"456,05",5,1,1,7,Mid-Value,Potential Loyalists
59033,855,3,"80,8",3,1,1,5,Low-Value,At Risk Customers
59035,395,5,"417,25",4,1,1,6,Mid-Value,Potential Loyalists
59037,121,5,"399,22999999999996",5,1,1,7,Mid-Value,Potential Loyalists
59038,63,2,"209,85",5,1,1,7,Mid-Value,Potential Loyalists
59039,603,2,"50,400000000000006",4,1,1,6,Mid-Value,Potential Loyalists
59040,795,1,"5,8",3,1,1,5,Low-Value,At Risk Customers
59041,830,2,"35,93",3,1,1,5,Low-Value,At Risk Customers
59042,4,4,"326,5",5,1,1,7,Mid-Value,Potential Loyalists
59043,743,4,"988,75",3,1,2,6,Mid-Value,Potential Loyalists
59046,163,4,"291,05",5,1,1,7,Mid-Value,Potential Loyalists
59047,388,3,"616,05",4,1,1,6,Mid-Value,Potential Loyalists
59049,792,2,"140,65",3,1,1,5,Low-Value,At Risk Customers
59051,169,5,"383,6",5,1,1,7,Mid-Value,Potential Loyalists
59052,153,2,"101,8",5,1,1,7,Mid-Value,Potential Loyalists
59053,791,3,"172,8",3,1,1,5,Low-Value,At Risk Customers
59054,44,3,"199,15",5,1,1,7,Mid-Value,Potential Loyalists
59056,1354,3,"430,59999999999997",2,1,1,4,Low-Value,Can't Lose
59057,493,11,"552,4",4,2,1,7,Mid-Value,Potential Loyalists
59058,740,1,"3,5",3,1,1,5,Low-Value,At Risk Customers
59059,35,3,"128,75",5,1,1,7,Mid-Value,Potential Loyalists
59060,895,11,"664,35",3,2,2,7,Mid-Value,Potential Loyalists
59061,337,7,"257,95",5,2,1,8,High-Value,Potential Loyalists
59062,1798,1,"12,2",1,1,1,3,Low-Value,Lost
59064,267,3,"351,05000000000007",5,1,1,7,Mid-Value,Potential Loyalists
59065,248,7,"272,85",5,2,1,8,High-Value,Potential Loyalists
59067,1543,1,"30,55",1,1,1,3,Low-Value,Lost
59068,367,7,"362,2",4,2,1,7,Mid-Value,Potential Loyalists
59070,98,2,"209,65",5,1,1,7,Mid-Value,Potential Loyalists
59071,249,2,"80,25",5,1,1,7,Mid-Value,Potential Loyalists
59072,98,4,"252,45",5,1,1,7,Mid-Value,Potential Loyalists
59075,995,3,"186,15",3,1,1,5,Low-Value,At Risk Customers
59076,780,2,"168,64999999999998",3,1,1,5,Low-Value,At Risk Customers
59077,60,2,"142,5",5,1,1,7,Mid-Value,Potential Loyalists
59078,997,6,"259,05",3,1,1,5,Low-Value,At Risk Customers
59083,1014,1,"29,05",3,1,1,5,Low-Value,At Risk Customers
59084,10,6,"398,05",5,1,1,7,Mid-Value,Potential Loyalists
59085,48,1,"44,25",5,1,1,7,Mid-Value,Potential Loyalists
59089,82,5,"352,8",5,1,1,7,Mid-Value,Potential Loyalists
59090,644,1,"88,2",4,1,1,6,Mid-Value,Potential Loyalists
59092,361,4,"104,89999999999999",5,1,1,7,Mid-Value,Potential Loyalists
59094,1376,3,"180,2",2,1,1,4,Low-Value,Can't Lose
59095,557,5,"290,6",4,1,1,6,Mid-Value,Potential Loyalists
59100,293,2,"10,2",5,1,1,7,Mid-Value,Potential Loyalists
59101,189,3,"265,1",5,1,1,7,Mid-Value,Potential Loyalists
59102,133,5,"115,55",5,1,1,7,Mid-Value,Potential Loyalists
59104,83,3,"373,9",5,1,1,7,Mid-Value,Potential Loyalists
59106,714,3,"188,95000000000002",4,1,1,6,Mid-Value,Potential Loyalists
59108,1036,1,"21,85",3,1,1,5,Low-Value,At Risk Customers
59110,940,2,"110,5",3,1,1,5,Low-Value,At Risk Customers
59111,998,3,"119,2",3,1,1,5,Low-Value,At Risk Customers
59115,811,1,"9,1",3,1,1,5,Low-Value,At Risk Customers
59116,376,1,"110,8",4,1,1,6,Mid-Value,Potential Loyalists
59117,804,3,"60,2",3,1,1,5,Low-Value,At Risk Customers
59118,126,10,"647,35",5,2,1,8,High-Value,Potential Loyalists
59119,81,2,"178,4",5,1,1,7,Mid-Value,Potential Loyalists
59120,35,5,"412,1",5,1,1,7,Mid-Value,Potential Loyalists
59122,900,5,"500,1",3,1,1,5,Low-Value,At Risk Customers
59123,1152,2,"119,65",2,1,1,4,Low-Value,Can't Lose
59125,20,5,"605,8",5,1,1,7,Mid-Value,Potential Loyalists
59126,1387,1,"42,8",2,1,1,4,Low-Value,Can't Lose
59128,78,4,"79,65",5,1,1,7,Mid-Value,Potential Loyalists
59129,1461,1,"91,0",1,1,1,3,Low-Value,Lost
59130,612,5,"136,3",4,1,1,6,Mid-Value,Potential Loyalists
59132,158,7,"468,25",5,2,1,8,High-Value,Potential Loyalists
59135,178,3,"119,3",5,1,1,7,Mid-Value,Potential Loyalists
59137,1284,1,"237,8",2,1,1,4,Low-Value,Can't Lose
59138,900,5,"207,7",3,1,1,5,Low-Value,At Risk Customers
59139,599,1,"47,8",4,1,1,6,Mid-Value,Potential Loyalists
59140,506,3,"73,55",4,1,1,6,Mid-Value,Potential Loyalists
59141,384,1,"56,9",4,1,1,6,Mid-Value,Potential Loyalists
59142,1761,1,"42,45",1,1,1,3,Low-Value,Lost
59143,109,5,"402,85",5,1,1,7,Mid-Value,Potential Loyalists
59144,460,1,"127,75",4,1,1,6,Mid-Value,Potential Loyalists
59145,83,2,"86,1",5,1,1,7,Mid-Value,Potential Loyalists
59146,42,4,"368,8",5,1,1,7,Mid-Value,Potential Loyalists
59148,1317,2,"112,69999999999999",2,1,1,4,Low-Value,Can't Lose
59149,801,1,"84,9",3,1,1,5,Low-Value,At Risk Customers
59150,319,2,"399,5",5,1,1,7,Mid-Value,Potential Loyalists
59151,550,3,"223,70000000000002",4,1,1,6,Mid-Value,Potential Loyalists
59152,1110,7,"601,9",2,2,1,5,Low-Value,At Risk Customers
59154,866,3,"327,3",3,1,1,5,Low-Value,At Risk Customers
59155,636,2,"67,65",4,1,1,6,Mid-Value,Potential Loyalists
59156,1192,3,"110,35",2,1,1,4,Low-Value,Can't Lose
59159,385,5,"343,9",4,1,1,6,Mid-Value,Potential Loyalists
59162,175,3,"94,25",5,1,1,7,Mid-Value,Potential Loyalists
59163,9,3,"81,69999999999999",5,1,1,7,Mid-Value,Potential Loyalists
59164,110,4,"391,85",5,1,1,7,Mid-Value,Potential Loyalists
59165,405,4,"293,15000000000003",4,1,1,6,Mid-Value,Potential Loyalists
59166,874,3,"177,9",3,1,1,5,Low-Value,At Risk Customers
59167,514,7,"718,75",4,2,2,8,High-Value,Potential Loyalists
59168,869,3,"208,3",3,1,1,5,Low-Value,At Risk Customers
59169,114,3,"193,8",5,1,1,7,Mid-Value,Potential Loyalists
59170,37,5,"159,65",5,1,1,7,Mid-Value,Potential Loyalists
59171,139,6,"360,3",5,1,1,7,Mid-Value,Potential Loyalists
59173,439,4,"204,7",4,1,1,6,Mid-Value,Potential Loyalists
59175,526,1,"108,0",4,1,1,6,Mid-Value,Potential Loyalists
59178,169,2,"82,24999999999999",5,1,1,7,Mid-Value,Potential Loyalists
59179,431,3,"74,15",4,1,1,6,Mid-Value,Potential Loyalists
59181,1230,2,"274,34999999999997",2,1,1,4,Low-Value,Can't Lose
59182,1477,1,"67,5",1,1,1,3,Low-Value,Lost
59184,270,5,"278,5",5,1,1,7,Mid-Value,Potential Loyalists
59185,75,6,"374,85",5,1,1,7,Mid-Value,Potential Loyalists
59187,12,2,"79,8",5,1,1,7,Mid-Value,Potential Loyalists
59188,1651,1,"73,3",1,1,1,3,Low-Value,Lost
59189,38,1,"42,1",5,1,1,7,Mid-Value,Potential Loyalists
59191,1105,1,"253,95000000000002",2,1,1,4,Low-Value,Can't Lose
59192,105,5,"314,3",5,1,1,7,Mid-Value,Potential Loyalists
59194,1754,1,"26,1",1,1,1,3,Low-Value,Lost
59196,1331,1,"9,95",2,1,1,4,Low-Value,Can't Lose
59197,1237,2,"187,29999999999998",2,1,1,4,Low-Value,Can't Lose
59198,150,2,"20,549999999999997",5,1,1,7,Mid-Value,Potential Loyalists
59200,1046,2,"15,7",3,1,1,5,Low-Value,At Risk Customers
59201,1511,2,"238,7",1,1,1,3,Low-Value,Lost
59202,1516,2,"78,39999999999999",1,1,1,3,Low-Value,Lost
59203,1156,1,"70,15",2,1,1,4,Low-Value,Can't Lose
59204,307,1,"20,6",5,1,1,7,Mid-Value,Potential Loyalists
59208,166,2,"134,5",5,1,1,7,Mid-Value,Potential Loyalists
59209,850,5,"159,25",3,1,1,5,Low-Value,At Risk Customers
59210,196,1,"213,9",5,1,1,7,Mid-Value,Potential Loyalists
59211,265,5,"236,35",5,1,1,7,Mid-Value,Potential Loyalists
59212,191,4,"135,95",5,1,1,7,Mid-Value,Potential Loyalists
59213,886,2,"177,65",3,1,1,5,Low-Value,At Risk Customers
59214,266,2,"123,39999999999999",5,1,1,7,Mid-Value,Potential Loyalists
59215,556,7,"250,85",4,2,1,7,Mid-Value,Potential Loyalists
59216,1035,1,"23,45",3,1,1,5,Low-Value,At Risk Customers
59219,769,6,"523,35",3,1,1,5,Low-Value,At Risk Customers
59220,1406,1,"20,0",2,1,1,4,Low-Value,Can't Lose
59222,996,1,"597,0",3,1,1,5,Low-Value,At Risk Customers
59224,70,7,"353,75",5,2,1,8,High-Value,Potential Loyalists
59225,820,1,"25,1",3,1,1,5,Low-Value,At Risk Customers
59230,503,5,"603,65",4,1,1,6,Mid-Value,Potential Loyalists
59231,86,1,"12,5",5,1,1,7,Mid-Value,Potential Loyalists
59232,262,5,"262,6",5,1,1,7,Mid-Value,Potential Loyalists
59233,838,3,"161,05",3,1,1,5,Low-Value,At Risk Customers
59234,845,1,"4,15",3,1,1,5,Low-Value,At Risk Customers
59235,862,1,"60,0",3,1,1,5,Low-Value,At Risk Customers
59238,1202,1,"3,9",2,1,1,4,Low-Value,Can't Lose
59239,570,6,"166,2",4,1,1,6,Mid-Value,Potential Loyalists
59242,1270,1,"99,60000000000001",2,1,1,4,Low-Value,Can't Lose
59243,792,9,"485,0",3,2,1,6,Mid-Value,Potential Loyalists
59244,26,2,"15,25",5,1,1,7,Mid-Value,Potential Loyalists
59245,163,7,"671,8499999999999",5,2,2,9,High-Value,Champions
59247,222,6,"841,0500000000001",5,1,2,8,High-Value,Potential Loyalists
59248,292,1,"53,7",5,1,1,7,Mid-Value,Potential Loyalists
59250,24,3,"201,2",5,1,1,7,Mid-Value,Potential Loyalists
59251,92,2,"148,3",5,1,1,7,Mid-Value,Potential Loyalists
59254,92,4,"143,9",5,1,1,7,Mid-Value,Potential Loyalists
59255,463,2,"58,0",4,1,1,6,Mid-Value,Potential Loyalists
59256,239,2,"25,05",5,1,1,7,Mid-Value,Potential Loyalists
59257,1135,2,"69,8",2,1,1,4,Low-Value,Can't Lose
59259,1301,2,"43,65",2,1,1,4,Low-Value,Can't Lose
59260,183,9,"1021,25",5,2,2,9,High-Value,Champions
59261,1735,1,"47,75",1,1,1,3,Low-Value,Lost
59262,653,1,"116,75",4,1,1,6,Mid-Value,Potential Loyalists
59263,358,1,"50,4",5,1,1,7,Mid-Value,Potential Loyalists
59264,1509,2,"201,75",1,1,1,3,Low-Value,Lost
59265,951,2,"232,75",3,1,1,5,Low-Value,At Risk Customers
59266,582,2,"92,44999999999999",4,1,1,6,Mid-Value,Potential Loyalists
59267,1085,5,"322,3",3,1,1,5,Low-Value,At Risk Customers
59268,139,8,"350,15",5,2,1,8,High-Value,Potential Loyalists
59269,1147,1,"12,8",2,1,1,4,Low-Value,Can't Lose
59270,40,6,"297,1",5,1,1,7,Mid-Value,Potential Loyalists
59271,41,4,"201,0",5,1,1,7,Mid-Value,Potential Loyalists
59272,1398,2,"128,55",2,1,1,4,Low-Value,Can't Lose
59273,816,2,"107,15",3,1,1,5,Low-Value,At Risk Customers
59281,588,2,"88,85",4,1,1,6,Mid-Value,Potential Loyalists
59282,647,2,"97,5",4,1,1,6,Mid-Value,Potential Loyalists
59283,1577,3,"184,2",1,1,1,3,Low-Value,Lost
59284,1809,1,"201,89999999999998",1,1,1,3,Low-Value,Lost
59285,1279,3,"123,6",2,1,1,4,Low-Value,Can't Lose
59286,1593,1,"52,349999999999994",1,1,1,3,Low-Value,Lost
59287,1522,1,"28,75",1,1,1,3,Low-Value,Lost
59289,55,1,"97,7",5,1,1,7,Mid-Value,Potential Loyalists
59291,556,2,"136,04999999999998",4,1,1,6,Mid-Value,Potential Loyalists
59292,824,5,"312,04999999999995",3,1,1,5,Low-Value,At Risk Customers
59293,71,4,"477,35",5,1,1,7,Mid-Value,Potential Loyalists
59294,269,3,"250,0",5,1,1,7,Mid-Value,Potential Loyalists
59295,512,3,"422,0",4,1,1,6,Mid-Value,Potential Loyalists
59297,859,2,"47,7",3,1,1,5,Low-Value,At Risk Customers
59305,943,1,"251,7",3,1,1,5,Low-Value,At Risk Customers
59306,311,1,"62,5",5,1,1,7,Mid-Value,Potential Loyalists
59307,32,6,"481,6",5,1,1,7,Mid-Value,Potential Loyalists
59308,1748,1,"24,2",1,1,1,3,Low-Value,Lost
59309,631,7,"255,9",4,2,1,7,Mid-Value,Potential Loyalists
59311,122,10,"306,5",5,2,1,8,High-Value,Potential Loyalists
59313,137,2,"219,25",5,1,1,7,Mid-Value,Potential Loyalists
59317,375,1,"158,39999999999998",4,1,1,6,Mid-Value,Potential Loyalists
59318,393,9,"322,15",4,2,1,7,Mid-Value,Potential Loyalists
59320,923,4,"229,8",3,1,1,5,Low-Value,At Risk Customers
59321,23,8,"220,95",5,2,1,8,High-Value,Potential Loyalists
59322,960,1,"121,19999999999999",3,1,1,5,Low-Value,At Risk Customers
59323,1330,1,"32,55",2,1,1,4,Low-Value,Can't Lose
59324,86,3,"131,4",5,1,1,7,Mid-Value,Potential Loyalists
59329,746,1,"88,2",3,1,1,5,Low-Value,At Risk Customers
59330,546,3,"628,85",4,1,1,6,Mid-Value,Potential Loyalists
59332,433,2,"22,8",4,1,1,6,Mid-Value,Potential Loyalists
59333,13,2,"186,45",5,1,1,7,Mid-Value,Potential Loyalists
59335,1,2,"260,3",5,1,1,7,Mid-Value,Potential Loyalists
59337,222,6,"294,2",5,1,1,7,Mid-Value,Potential Loyalists
59338,18,7,"715,2",5,2,2,9,High-Value,Champions
59339,213,1,"86,9",5,1,1,7,Mid-Value,Potential Loyalists
59340,335,1,"9,15",5,1,1,7,Mid-Value,Potential Loyalists
59341,491,6,"390,35",4,1,1,6,Mid-Value,Potential Loyalists
59342,101,4,"185,65",5,1,1,7,Mid-Value,Potential Loyalists
59343,217,3,"85,75",5,1,1,7,Mid-Value,Potential Loyalists
59345,816,1,"125,85",3,1,1,5,Low-Value,At Risk Customers
59346,1156,1,"4,2",2,1,1,4,Low-Value,Can't Lose
59348,215,7,"411,55",5,2,1,8,High-Value,Potential Loyalists
59350,857,1,"70,35",3,1,1,5,Low-Value,At Risk Customers
59351,1739,1,"8,55",1,1,1,3,Low-Value,Lost
59352,1106,1,"45,75",2,1,1,4,Low-Value,Can't Lose
59358,188,7,"322,29999999999995",5,2,1,8,High-Value,Potential Loyalists
59359,952,2,"62,3",3,1,1,5,Low-Value,At Risk Customers
59360,633,10,"1053,8",4,2,2,8,High-Value,Potential Loyalists
59362,69,7,"462,45",5,2,1,8,High-Value,Potential Loyalists
59363,682,5,"217,45",4,1,1,6,Mid-Value,Potential Loyalists
59364,136,2,"106,05000000000001",5,1,1,7,Mid-Value,Potential Loyalists
59365,408,3,"141,45",4,1,1,6,Mid-Value,Potential Loyalists
59366,914,3,"47,8",3,1,1,5,Low-Value,At Risk Customers
59367,171,1,"17,7",5,1,1,7,Mid-Value,Potential Loyalists
59369,449,3,"93,75",4,1,1,6,Mid-Value,Potential Loyalists
59372,208,1,"61,349999999999994",5,1,1,7,Mid-Value,Potential Loyalists
59373,1137,4,"1234,25",2,1,2,5,Low-Value,At Risk Customers
59374,408,2,"34,15",4,1,1,6,Mid-Value,Potential Loyalists
59375,252,1,"25,3",5,1,1,7,Mid-Value,Potential Loyalists
59377,462,1,"15,5",4,1,1,6,Mid-Value,Potential Loyalists
59378,1326,2,"32,95",2,1,1,4,Low-Value,Can't Lose
59379,855,1,"97,80000000000001",3,1,1,5,Low-Value,At Risk Customers
59381,55,4,"254,59999999999997",5,1,1,7,Mid-Value,Potential Loyalists
59383,308,3,"88,1",5,1,1,7,Mid-Value,Potential Loyalists
59384,176,1,"117,1",5,1,1,7,Mid-Value,Potential Loyalists
59385,215,2,"219,14999999999998",5,1,1,7,Mid-Value,Potential Loyalists
59387,1757,1,"106,95",1,1,1,3,Low-Value,Lost
59389,264,1,"16,75",5,1,1,7,Mid-Value,Potential Loyalists
59390,782,3,"189,65",3,1,1,5,Low-Value,At Risk Customers
59391,324,7,"428,8",5,2,1,8,High-Value,Potential Loyalists
59395,85,1,"86,65",5,1,1,7,Mid-Value,Potential Loyalists
59397,31,2,"105,35",5,1,1,7,Mid-Value,Potential Loyalists
59398,1444,3,"112,2",2,1,1,4,Low-Value,Can't Lose
59400,218,6,"195,85",5,1,1,7,Mid-Value,Potential Loyalists
59401,115,1,"42,45",5,1,1,7,Mid-Value,Potential Loyalists
59404,1432,1,"14,3",2,1,1,4,Low-Value,Can't Lose
59405,1188,1,"60,05",2,1,1,4,Low-Value,Can't Lose
59407,1805,1,"8,6",1,1,1,3,Low-Value,Lost
59408,382,3,"88,45",4,1,1,6,Mid-Value,Potential Loyalists
59411,622,1,"644,8",4,1,1,6,Mid-Value,Potential Loyalists
59414,131,5,"158,05",5,1,1,7,Mid-Value,Potential Loyalists
59415,437,8,"311,75",4,2,1,7,Mid-Value,Potential Loyalists
59416,616,3,"402,95",4,1,1,6,Mid-Value,Potential Loyalists
59418,1275,1,"105,60000000000001",2,1,1,4,Low-Value,Can't Lose
59419,144,1,"25,1",5,1,1,7,Mid-Value,Potential Loyalists
59420,928,4,"200,74999999999997",3,1,1,5,Low-Value,At Risk Customers
59421,167,3,"76,25",5,1,1,7,Mid-Value,Potential Loyalists
59422,297,3,"148,15",5,1,1,7,Mid-Value,Potential Loyalists
59423,412,3,"93,85",4,1,1,6,Mid-Value,Potential Loyalists
59424,158,5,"504,5",5,1,1,7,Mid-Value,Potential Loyalists
59425,365,7,"559,45",5,2,1,8,High-Value,Potential Loyalists
59427,441,1,"9,3",4,1,1,6,Mid-Value,Potential Loyalists
59428,88,2,"64,6",5,1,1,7,Mid-Value,Potential Loyalists
59431,161,4,"242,5",5,1,1,7,Mid-Value,Potential Loyalists
59432,159,4,"346,05",5,1,1,7,Mid-Value,Potential Loyalists
59433,281,1,"127,95",5,1,1,7,Mid-Value,Potential Loyalists
59434,26,2,"141,1",5,1,1,7,Mid-Value,Potential Loyalists
59435,1257,2,"55,2",2,1,1,4,Low-Value,Can't Lose
59436,627,2,"27,5",4,1,1,6,Mid-Value,Potential Loyalists
59437,385,3,"409,2",4,1,1,6,Mid-Value,Potential Loyalists
59438,419,5,"138,4",4,1,1,6,Mid-Value,Potential Loyalists
59439,32,2,"278,55",5,1,1,7,Mid-Value,Potential Loyalists
59440,77,8,"438,4",5,2,1,8,High-Value,Potential Loyalists
59441,1731,1,"3,5",1,1,1,3,Low-Value,Lost
59442,3,3,"140,9",5,1,1,7,Mid-Value,Potential Loyalists
59443,240,3,"394,25",5,1,1,7,Mid-Value,Potential Loyalists
59445,234,1,"2,7",5,1,1,7,Mid-Value,Potential Loyalists
59446,1107,1,"85,5",2,1,1,4,Low-Value,Can't Lose
59447,263,12,"949,95",5,3,2,10,High-Value,Champions
59448,910,2,"228,99999999999997",3,1,1,5,Low-Value,At Risk Customers
59449,605,5,"183,35",4,1,1,6,Mid-Value,Potential Loyalists
59450,108,4,"77,75",5,1,1,7,Mid-Value,Potential Loyalists
59452,368,5,"392,25",4,1,1,6,Mid-Value,Potential Loyalists
59453,732,8,"341,6",3,2,1,6,Mid-Value,Potential Loyalists
59454,55,1,"32,9",5,1,1,7,Mid-Value,Potential Loyalists
59456,1090,1,"222,0",3,1,1,5,Low-Value,At Risk Customers
59457,1172,5,"414,65",2,1,1,4,Low-Value,Can't Lose
59462,381,7,"530,9",4,2,1,7,Mid-Value,Potential Loyalists
59464,22,8,"1176,7",5,2,2,9,High-Value,Champions
59465,56,3,"37,85",5,1,1,7,Mid-Value,Potential Loyalists
59467,1233,2,"53,9",2,1,1,4,Low-Value,Can't Lose
59468,5,3,"316,9",5,1,1,7,Mid-Value,Potential Loyalists
59469,434,1,"17,25",4,1,1,6,Mid-Value,Potential Loyalists
59471,300,1,"78,25",5,1,1,7,Mid-Value,Potential Loyalists
59472,552,4,"399,6",4,1,1,6,Mid-Value,Potential Loyalists
59474,139,3,"177,55",5,1,1,7,Mid-Value,Potential Loyalists
59476,770,1,"40,75",3,1,1,5,Low-Value,At Risk Customers
59477,178,5,"285,6",5,1,1,7,Mid-Value,Potential Loyalists
59480,1187,1,"239,3",2,1,1,4,Low-Value,Can't Lose
59482,1149,2,"57,0",2,1,1,4,Low-Value,Can't Lose
59484,1468,4,"328,8",1,1,1,3,Low-Value,Lost
59486,7,2,"53,2",5,1,1,7,Mid-Value,Potential Loyalists
59487,1684,2,"41,0",1,1,1,3,Low-Value,Lost
59488,523,1,"56,5",4,1,1,6,Mid-Value,Potential Loyalists
59489,115,7,"742,25",5,2,2,9,High-Value,Champions
59490,1016,1,"11,5",3,1,1,5,Low-Value,At Risk Customers
59492,730,1,"10,65",4,1,1,6,Mid-Value,Potential Loyalists
59493,168,2,"128,3",5,1,1,7,Mid-Value,Potential Loyalists
59494,593,5,"281,8",4,1,1,6,Mid-Value,Potential Loyalists
59495,627,1,"32,85",4,1,1,6,Mid-Value,Potential Loyalists
59496,75,1,"70,6",5,1,1,7,Mid-Value,Potential Loyalists
59497,759,3,"36,65",3,1,1,5,Low-Value,At Risk Customers
59498,613,6,"205,0",4,1,1,6,Mid-Value,Potential Loyalists
59499,154,3,"194,7",5,1,1,7,Mid-Value,Potential Loyalists
59502,768,3,"153,85",3,1,1,5,Low-Value,At Risk Customers
59504,167,6,"288,35",5,1,1,7,Mid-Value,Potential Loyalists
59505,864,5,"362,75",3,1,1,5,Low-Value,At Risk Customers
59506,1697,1,"12,2",1,1,1,3,Low-Value,Lost
59507,129,3,"139,0",5,1,1,7,Mid-Value,Potential Loyalists
59510,674,5,"179,1",4,1,1,6,Mid-Value,Potential Loyalists
59511,21,6,"333,05",5,1,1,7,Mid-Value,Potential Loyalists
59512,57,4,"87,4",5,1,1,7,Mid-Value,Potential Loyalists
59513,1480,1,"121,0",1,1,1,3,Low-Value,Lost
59516,1153,1,"10,23",2,1,1,4,Low-Value,Can't Lose
59519,17,7,"391,34999999999997",5,2,1,8,High-Value,Potential Loyalists
59520,623,5,"162,85",4,1,1,6,Mid-Value,Potential Loyalists
59524,134,2,"65,55",5,1,1,7,Mid-Value,Potential Loyalists
59525,450,8,"467,09999999999997",4,2,1,7,Mid-Value,Potential Loyalists
59526,1249,1,"29,8",2,1,1,4,Low-Value,Can't Lose
59529,768,3,"179,6",3,1,1,5,Low-Value,At Risk Customers
59534,1130,2,"59,15",2,1,1,4,Low-Value,Can't Lose
59537,995,2,"32,83",3,1,1,5,Low-Value,At Risk Customers
59539,34,4,"255,3",5,1,1,7,Mid-Value,Potential Loyalists
59541,451,2,"372,69999999999993",4,1,1,6,Mid-Value,Potential Loyalists
59543,616,5,"233,75",4,1,1,6,Mid-Value,Potential Loyalists
59545,575,3,"141,55",4,1,1,6,Mid-Value,Potential Loyalists
59546,284,1,"91,0",5,1,1,7,Mid-Value,Potential Loyalists
59547,1534,1,"27,55",1,1,1,3,Low-Value,Lost
59549,995,2,"148,65",3,1,1,5,Low-Value,At Risk Customers
59550,106,5,"187,7",5,1,1,7,Mid-Value,Potential Loyalists
59552,126,2,"199,1",5,1,1,7,Mid-Value,Potential Loyalists
59553,151,6,"401,65",5,1,1,7,Mid-Value,Potential Loyalists
59554,750,1,"32,55",3,1,1,5,Low-Value,At Risk Customers
59556,1488,2,"268,5",1,1,1,3,Low-Value,Lost
59558,372,5,"354,45",4,1,1,6,Mid-Value,Potential Loyalists
59559,770,1,"18,9",3,1,1,5,Low-Value,At Risk Customers
59560,1244,1,"68,2",2,1,1,4,Low-Value,Can't Lose
59562,753,5,"315,35",3,1,1,5,Low-Value,At Risk Customers
59564,91,5,"236,35",5,1,1,7,Mid-Value,Potential Loyalists
59567,226,3,"106,6",5,1,1,7,Mid-Value,Potential Loyalists
59568,360,2,"124,05",5,1,1,7,Mid-Value,Potential Loyalists
59569,748,5,"348,3",3,1,1,5,Low-Value,At Risk Customers
59570,271,2,"179,35",5,1,1,7,Mid-Value,Potential Loyalists
59572,189,6,"390,20000000000005",5,1,1,7,Mid-Value,Potential Loyalists
59573,667,2,"41,3",4,1,1,6,Mid-Value,Potential Loyalists
59575,165,1,"135,0",5,1,1,7,Mid-Value,Potential Loyalists
59577,352,3,"133,7",5,1,1,7,Mid-Value,Potential Loyalists
59579,907,4,"323,0",3,1,1,5,Low-Value,At Risk Customers
59580,603,4,"72,75",4,1,1,6,Mid-Value,Potential Loyalists
59582,106,4,"134,9",5,1,1,7,Mid-Value,Potential Loyalists
59585,376,8,"676,6999999999999",4,2,2,8,High-Value,Potential Loyalists
59586,386,3,"312,65",4,1,1,6,Mid-Value,Potential Loyalists
59588,503,7,"389,40000000000003",4,2,1,7,Mid-Value,Potential Loyalists
59593,176,5,"276,65",5,1,1,7,Mid-Value,Potential Loyalists
59594,732,6,"235,35000000000002",3,1,1,5,Low-Value,At Risk Customers
59595,136,2,"44,5",5,1,1,7,Mid-Value,Potential Loyalists
59596,250,2,"165,70000000000002",5,1,1,7,Mid-Value,Potential Loyalists
59597,149,2,"145,0",5,1,1,7,Mid-Value,Potential Loyalists
59598,274,4,"673,6",5,1,2,8,High-Value,Potential Loyalists
59600,960,1,"189,0",3,1,1,5,Low-Value,At Risk Customers
59601,430,9,"474,05",4,2,1,7,Mid-Value,Potential Loyalists
59602,73,3,"176,7",5,1,1,7,Mid-Value,Potential Loyalists
59603,851,2,"155,2",3,1,1,5,Low-Value,At Risk Customers
59604,505,4,"460,15",4,1,1,6,Mid-Value,Potential Loyalists
59605,502,7,"442,1",4,2,1,7,Mid-Value,Potential Loyalists
59607,1354,1,"33,9",2,1,1,4,Low-Value,Can't Lose
59608,1712,1,"51,150000000000006",1,1,1,3,Low-Value,Lost
59609,63,18,"1907,4",5,4,3,12,High-Value,Champions
59610,387,3,"281,95000000000005",4,1,1,6,Mid-Value,Potential Loyalists
59612,204,3,"77,3",5,1,1,7,Mid-Value,Potential Loyalists
59613,602,3,"248,75",4,1,1,6,Mid-Value,Potential Loyalists
59616,403,4,"317,9",4,1,1,6,Mid-Value,Potential Loyalists
59617,670,3,"108,5",4,1,1,6,Mid-Value,Potential Loyalists
59618,720,2,"33,650000000000006",4,1,1,6,Mid-Value,Potential Loyalists
59619,326,2,"40,25",5,1,1,7,Mid-Value,Potential Loyalists
59620,517,5,"194,8",4,1,1,6,Mid-Value,Potential Loyalists
59622,1676,2,"282,8",1,1,1,3,Low-Value,Lost
59623,41,4,"174,5",5,1,1,7,Mid-Value,Potential Loyalists
59624,36,11,"735,5000000000001",5,2,2,9,High-Value,Champions
59625,166,4,"136,6",5,1,1,7,Mid-Value,Potential Loyalists
59627,325,2,"102,0",5,1,1,7,Mid-Value,Potential Loyalists
59628,186,3,"161,8",5,1,1,7,Mid-Value,Potential Loyalists
59630,368,5,"419,2",4,1,1,6,Mid-Value,Potential Loyalists
59631,59,4,"140,3",5,1,1,7,Mid-Value,Potential Loyalists
59632,23,10,"1218,1",5,2,2,9,High-Value,Champions
59633,44,4,"394,8",5,1,1,7,Mid-Value,Potential Loyalists
59637,211,7,"407,4",5,2,1,8,High-Value,Potential Loyalists
59639,182,2,"64,80000000000001",5,1,1,7,Mid-Value,Potential Loyalists
59640,59,5,"341,3",5,1,1,7,Mid-Value,Potential Loyalists
59641,1192,1,"19,2",2,1,1,4,Low-Value,Can't Lose
59643,382,10,"530,15",4,2,1,7,Mid-Value,Potential Loyalists
59645,148,13,"849,2",5,3,2,10,High-Value,Champions
59647,252,3,"43,95",5,1,1,7,Mid-Value,Potential Loyalists
59648,1497,5,"219,05",1,1,1,3,Low-Value,Lost
59650,1116,2,"95,0",2,1,1,4,Low-Value,Can't Lose
59651,75,7,"176,58",5,2,1,8,High-Value,Potential Loyalists
59654,1634,2,"39,75",1,1,1,3,Low-Value,Lost
59655,54,6,"553,1999999999999",5,1,1,7,Mid-Value,Potential Loyalists
59656,10,3,"297,4",5,1,1,7,Mid-Value,Potential Loyalists
59657,78,2,"34,45",5,1,1,7,Mid-Value,Potential Loyalists
59658,411,3,"1333,6",4,1,3,8,High-Value,Potential Loyalists
59659,1218,8,"1089,5",2,2,2,6,Mid-Value,Potential Loyalists
59660,92,4,"45,6",5,1,1,7,Mid-Value,Potential Loyalists
59664,1711,2,"96,1",1,1,1,3,Low-Value,Lost
59666,291,1,"41,4",5,1,1,7,Mid-Value,Potential Loyalists
59668,164,3,"146,55",5,1,1,7,Mid-Value,Potential Loyalists
59670,162,2,"29,45",5,1,1,7,Mid-Value,Potential Loyalists
59671,361,2,"235,35",5,1,1,7,Mid-Value,Potential Loyalists
59672,959,3,"129,0",3,1,1,5,Low-Value,At Risk Customers
59675,199,9,"479,0",5,2,1,8,High-Value,Potential Loyalists
59676,231,4,"633,05",5,1,1,7,Mid-Value,Potential Loyalists
59677,1799,1,"84,3",1,1,1,3,Low-Value,Lost
59679,142,5,"230,64999999999998",5,1,1,7,Mid-Value,Potential Loyalists
59680,504,2,"109,35000000000001",4,1,1,6,Mid-Value,Potential Loyalists
59681,24,6,"579,85",5,1,1,7,Mid-Value,Potential Loyalists
59683,276,3,"40,6",5,1,1,7,Mid-Value,Potential Loyalists
59684,754,1,"73,6",3,1,1,5,Low-Value,At Risk Customers
59686,1595,3,"62,8",1,1,1,3,Low-Value,Lost
59687,1118,1,"55,75",2,1,1,4,Low-Value,Can't Lose
59689,111,9,"1232,05",5,2,2,9,High-Value,Champions
59690,1342,1,"343,2",2,1,1,4,Low-Value,Can't Lose
59692,630,1,"20,4",4,1,1,6,Mid-Value,Potential Loyalists
59695,1091,1,"113,45",3,1,1,5,Low-Value,At Risk Customers
59696,1582,1,"50,4",1,1,1,3,Low-Value,Lost
59697,734,2,"77,72",3,1,1,5,Low-Value,At Risk Customers
59698,1100,3,"631,1999999999999",2,1,1,4,Low-Value,Can't Lose
59701,913,1,"28,5",3,1,1,5,Low-Value,At Risk Customers
59702,1369,2,"131,7",2,1,1,4,Low-Value,Can't Lose
59704,501,4,"220,35",4,1,1,6,Mid-Value,Potential Loyalists
59705,21,4,"200,04999999999998",5,1,1,7,Mid-Value,Potential Loyalists
59706,1138,1,"58,050000000000004",2,1,1,4,Low-Value,Can't Lose
59707,340,5,"417,15999999999997",5,1,1,7,Mid-Value,Potential Loyalists
59711,170,3,"158,3",5,1,1,7,Mid-Value,Potential Loyalists
59715,1401,2,"76,19999999999999",2,1,1,4,Low-Value,Can't Lose
59717,209,2,"311,35",5,1,1,7,Mid-Value,Potential Loyalists
59719,421,4,"391,4",4,1,1,6,Mid-Value,Potential Loyalists
59720,321,11,"766,85",5,2,2,9,High-Value,Champions
59722,947,2,"131,14999999999998",3,1,1,5,Low-Value,At Risk Customers
59723,231,6,"591,9",5,1,1,7,Mid-Value,Potential Loyalists
59724,101,9,"347,2",5,2,1,8,High-Value,Potential Loyalists
59727,54,2,"69,95",5,1,1,7,Mid-Value,Potential Loyalists
59729,382,5,"81,15",4,1,1,6,Mid-Value,Potential Loyalists
59730,581,1,"95,1",4,1,1,6,Mid-Value,Potential Loyalists
59731,949,4,"160,7",3,1,1,5,Low-Value,At Risk Customers
59735,1118,1,"55,75",2,1,1,4,Low-Value,Can't Lose
59739,755,1,"227,2",3,1,1,5,Low-Value,At Risk Customers
59741,76,5,"404,9",5,1,1,7,Mid-Value,Potential Loyalists
59742,238,2,"45,75",5,1,1,7,Mid-Value,Potential Loyalists
59743,113,11,"571,25",5,2,1,8,High-Value,Potential Loyalists
59744,326,6,"507,35",5,1,1,7,Mid-Value,Potential Loyalists
59746,495,5,"144,45",4,1,1,6,Mid-Value,Potential Loyalists
59747,1814,1,"18,05",1,1,1,3,Low-Value,Lost
59748,7,1,"10,8",5,1,1,7,Mid-Value,Potential Loyalists
59749,1145,4,"485,15",2,1,1,4,Low-Value,Can't Lose
59750,103,4,"183,75",5,1,1,7,Mid-Value,Potential Loyalists
59751,981,1,"17,25",3,1,1,5,Low-Value,At Risk Customers
59753,92,4,"231,0",5,1,1,7,Mid-Value,Potential Loyalists
59755,157,4,"304,7",5,1,1,7,Mid-Value,Potential Loyalists
59756,368,9,"391,25",4,2,1,7,Mid-Value,Potential Loyalists
59758,195,3,"423,3",5,1,1,7,Mid-Value,Potential Loyalists
59759,39,3,"97,25",5,1,1,7,Mid-Value,Potential Loyalists
59760,370,2,"44,05",4,1,1,6,Mid-Value,Potential Loyalists
59761,138,2,"264,65",5,1,1,7,Mid-Value,Potential Loyalists
59763,54,8,"363,05",5,2,1,8,High-Value,Potential Loyalists
59764,1260,2,"49,3",2,1,1,4,Low-Value,Can't Lose
59765,185,5,"328,6",5,1,1,7,Mid-Value,Potential Loyalists
59766,641,5,"187,45",4,1,1,6,Mid-Value,Potential Loyalists
59767,59,6,"307,2",5,1,1,7,Mid-Value,Potential Loyalists
59768,67,1,"10,85",5,1,1,7,Mid-Value,Potential Loyalists
59769,104,8,"425,55",5,2,1,8,High-Value,Potential Loyalists
59770,22,19,"1674,05",5,4,3,12,High-Value,Champions
59771,1216,3,"137,4",2,1,1,4,Low-Value,Can't Lose
59776,63,1,"58,0",5,1,1,7,Mid-Value,Potential Loyalists
59777,270,15,"1448,15",5,3,3,11,High-Value,Champions
59778,370,2,"51,7",4,1,1,6,Mid-Value,Potential Loyalists
59779,1490,1,"156,3",1,1,1,3,Low-Value,Lost
59781,309,4,"173,70000000000002",5,1,1,7,Mid-Value,Potential Loyalists
59782,209,2,"37,75",5,1,1,7,Mid-Value,Potential Loyalists
59784,1330,1,"189,60000000000002",2,1,1,4,Low-Value,Can't Lose
59787,865,3,"203,75",3,1,1,5,Low-Value,At Risk Customers
59788,158,8,"234,35",5,2,1,8,High-Value,Potential Loyalists
59792,868,5,"241,05",3,1,1,5,Low-Value,At Risk Customers
59793,848,2,"52,099999999999994",3,1,1,5,Low-Value,At Risk Customers
59796,536,2,"132,2",4,1,1,6,Mid-Value,Potential Loyalists
59797,147,3,"334,55",5,1,1,7,Mid-Value,Potential Loyalists
59798,752,4,"439,79999999999995",3,1,1,5,Low-Value,At Risk Customers
59799,277,2,"179,05",5,1,1,7,Mid-Value,Potential Loyalists
59800,1077,1,"19,35",3,1,1,5,Low-Value,At Risk Customers
59802,1018,3,"72,05",3,1,1,5,Low-Value,At Risk Customers
59804,627,3,"373,55",4,1,1,6,Mid-Value,Potential Loyalists
59806,18,2,"44,0",5,1,1,7,Mid-Value,Potential Loyalists
59807,496,3,"343,5",4,1,1,6,Mid-Value,Potential Loyalists
59808,25,2,"61,129999999999995",5,1,1,7,Mid-Value,Potential Loyalists
59809,731,5,"134,3",3,1,1,5,Low-Value,At Risk Customers
59810,75,1,"14,4",5,1,1,7,Mid-Value,Potential Loyalists
59811,101,1,"34,65",5,1,1,7,Mid-Value,Potential Loyalists
59812,417,8,"271,7",4,2,1,7,Mid-Value,Potential Loyalists
59814,799,6,"242,0",3,1,1,5,Low-Value,At Risk Customers
59816,409,3,"117,05",4,1,1,6,Mid-Value,Potential Loyalists
59817,87,2,"746,05",5,1,2,8,High-Value,Potential Loyalists
59818,195,3,"153,25",5,1,1,7,Mid-Value,Potential Loyalists
59820,68,4,"182,95",5,1,1,7,Mid-Value,Potential Loyalists
59822,721,1,"4,95",4,1,1,6,Mid-Value,Potential Loyalists
59824,59,2,"9,4",5,1,1,7,Mid-Value,Potential Loyalists
59825,66,4,"206,29999999999998",5,1,1,7,Mid-Value,Potential Loyalists
59827,421,3,"82,45",4,1,1,6,Mid-Value,Potential Loyalists
59828,894,1,"71,1",3,1,1,5,Low-Value,At Risk Customers
59830,398,5,"231,3",4,1,1,6,Mid-Value,Potential Loyalists
59831,248,3,"70,4",5,1,1,7,Mid-Value,Potential Loyalists
59833,279,4,"136,2",5,1,1,7,Mid-Value,Potential Loyalists
59835,154,3,"389,1",5,1,1,7,Mid-Value,Potential Loyalists
59836,1172,3,"249,70000000000002",2,1,1,4,Low-Value,Can't Lose
59838,853,9,"459,55",3,2,1,6,Mid-Value,Potential Loyalists
59840,24,7,"198,6",5,2,1,8,High-Value,Potential Loyalists
59841,453,4,"659,8",4,1,1,6,Mid-Value,Potential Loyalists
59842,17,6,"622,75",5,1,1,7,Mid-Value,Potential Loyalists
59845,510,5,"182,25",4,1,1,6,Mid-Value,Potential Loyalists
59846,2,4,"202,15",5,1,1,7,Mid-Value,Potential Loyalists
59847,8,6,"445,05",5,1,1,7,Mid-Value,Potential Loyalists
59848,30,5,"127,0",5,1,1,7,Mid-Value,Potential Loyalists
59849,1223,2,"36,45",2,1,1,4,Low-Value,Can't Lose
59852,1287,9,"567,1",2,2,1,5,Low-Value,At Risk Customers
59853,89,2,"210,8",5,1,1,7,Mid-Value,Potential Loyalists
59854,36,6,"415,15",5,1,1,7,Mid-Value,Potential Loyalists
59858,991,3,"128,05",3,1,1,5,Low-Value,At Risk Customers
59859,1187,1,"23,45",2,1,1,4,Low-Value,Can't Lose
59860,216,1,"92,0",5,1,1,7,Mid-Value,Potential Loyalists
59864,5,5,"143,95",5,1,1,7,Mid-Value,Potential Loyalists
59865,867,3,"139,9",3,1,1,5,Low-Value,At Risk Customers
59866,1368,1,"1,35",2,1,1,4,Low-Value,Can't Lose
59867,828,3,"166,60000000000002",3,1,1,5,Low-Value,At Risk Customers
59871,87,5,"246,65",5,1,1,7,Mid-Value,Potential Loyalists
59872,514,4,"341,5",4,1,1,6,Mid-Value,Potential Loyalists
59874,1004,1,"63,2",3,1,1,5,Low-Value,At Risk Customers
59875,36,4,"190,3",5,1,1,7,Mid-Value,Potential Loyalists
59876,570,2,"35,25",4,1,1,6,Mid-Value,Potential Loyalists
59877,468,4,"152,1",4,1,1,6,Mid-Value,Potential Loyalists
59878,844,6,"247,10000000000002",3,1,1,5,Low-Value,At Risk Customers
59879,1123,3,"77,2",2,1,1,4,Low-Value,Can't Lose
59881,829,2,"34,5",3,1,1,5,Low-Value,At Risk Customers
59882,998,1,"22,85",3,1,1,5,Low-Value,At Risk Customers
59886,334,4,"215,3",5,1,1,7,Mid-Value,Potential Loyalists
59887,1587,1,"1,2",1,1,1,3,Low-Value,Lost
59891,932,2,"193,75",3,1,1,5,Low-Value,At Risk Customers
59893,337,9,"547,6",5,2,1,8,High-Value,Potential Loyalists
59894,91,6,"362,45",5,1,1,7,Mid-Value,Potential Loyalists
59895,535,1,"34,05",4,1,1,6,Mid-Value,Potential Loyalists
59896,839,2,"206,85",3,1,1,5,Low-Value,At Risk Customers
59897,28,4,"376,15",5,1,1,7,Mid-Value,Potential Loyalists
59899,1168,2,"99,2",2,1,1,4,Low-Value,Can't Lose
59900,289,6,"244,0",5,1,1,7,Mid-Value,Potential Loyalists
59901,544,5,"261,8",4,1,1,6,Mid-Value,Potential Loyalists
59902,599,3,"182,7",4,1,1,6,Mid-Value,Potential Loyalists
59907,65,2,"280,0",5,1,1,7,Mid-Value,Potential Loyalists
59909,22,5,"361,85",5,1,1,7,Mid-Value,Potential Loyalists
59910,959,3,"71,85",3,1,1,5,Low-Value,At Risk Customers
59911,1356,5,"269,6",2,1,1,4,Low-Value,Can't Lose
59912,291,2,"87,3",5,1,1,7,Mid-Value,Potential Loyalists
59914,790,2,"74,45",3,1,1,5,Low-Value,At Risk Customers
59917,782,1,"62,85",3,1,1,5,Low-Value,At Risk Customers
59918,1260,3,"166,45",2,1,1,4,Low-Value,Can't Lose
59919,1022,1,"22,45",3,1,1,5,Low-Value,At Risk Customers
59920,74,1,"15,95",5,1,1,7,Mid-Value,Potential Loyalists
59922,1000,2,"36,3",3,1,1,5,Low-Value,At Risk Customers
59923,749,4,"230,04999999999998",3,1,1,5,Low-Value,At Risk Customers
59924,730,11,"560,4",4,2,1,7,Mid-Value,Potential Loyalists
59927,130,3,"218,95000000000002",5,1,1,7,Mid-Value,Potential Loyalists
59928,813,4,"215,6",3,1,1,5,Low-Value,At Risk Customers
59929,216,4,"244,7",5,1,1,7,Mid-Value,Potential Loyalists
59930,52,2,"118,45",5,1,1,7,Mid-Value,Potential Loyalists
59936,76,2,"29,45",5,1,1,7,Mid-Value,Potential Loyalists
59938,381,3,"506,35",4,1,1,6,Mid-Value,Potential Loyalists
59941,155,1,"4,85",5,1,1,7,Mid-Value,Potential Loyalists
59942,80,5,"153,95",5,1,1,7,Mid-Value,Potential Loyalists
59945,1,3,"204,70000000000002",5,1,1,7,Mid-Value,Potential Loyalists
59946,734,2,"111,85",3,1,1,5,Low-Value,At Risk Customers
59949,1110,1,"73,8",2,1,1,4,Low-Value,Can't Lose
59950,496,1,"307,35",4,1,1,6,Mid-Value,Potential Loyalists
59951,28,7,"360,4",5,2,1,8,High-Value,Potential Loyalists
59953,456,5,"336,59999999999997",4,1,1,6,Mid-Value,Potential Loyalists
59954,750,4,"102,05",3,1,1,5,Low-Value,At Risk Customers
59955,1,2,"310,84999999999997",5,1,1,7,Mid-Value,Potential Loyalists
59957,362,1,"26,75",5,1,1,7,Mid-Value,Potential Loyalists
59959,1398,1,"23,3",2,1,1,4,Low-Value,Can't Lose
59960,110,3,"44,8",5,1,1,7,Mid-Value,Potential Loyalists
59963,749,5,"321,5",3,1,1,5,Low-Value,At Risk Customers
59964,516,3,"601,45",4,1,1,6,Mid-Value,Potential Loyalists
59965,75,4,"352,25",5,1,1,7,Mid-Value,Potential Loyalists
59966,1302,1,"126,4",2,1,1,4,Low-Value,Can't Lose
59967,507,4,"212,05",4,1,1,6,Mid-Value,Potential Loyalists
59968,536,1,"30,3",4,1,1,6,Mid-Value,Potential Loyalists
59971,554,6,"588,7",4,1,1,6,Mid-Value,Potential Loyalists
59972,1307,1,"14,0",2,1,1,4,Low-Value,Can't Lose
59973,50,5,"299,05",5,1,1,7,Mid-Value,Potential Loyalists
59974,611,3,"161,5",4,1,1,6,Mid-Value,Potential Loyalists
59975,174,5,"234,8",5,1,1,7,Mid-Value,Potential Loyalists
59978,341,2,"8,25",5,1,1,7,Mid-Value,Potential Loyalists
59979,817,5,"190,35",3,1,1,5,Low-Value,At Risk Customers
59982,970,4,"206,95",3,1,1,5,Low-Value,At Risk Customers
59983,209,2,"171,1",5,1,1,7,Mid-Value,Potential Loyalists
59988,188,2,"38,25",5,1,1,7,Mid-Value,Potential Loyalists
59989,376,2,"336,05",4,1,1,6,Mid-Value,Potential Loyalists
59990,862,1,"10,95",3,1,1,5,Low-Value,At Risk Customers
59991,861,1,"146,10000000000002",3,1,1,5,Low-Value,At Risk Customers
59992,852,2,"58,05",3,1,1,5,Low-Value,At Risk Customers
59993,250,1,"13,75",5,1,1,7,Mid-Value,Potential Loyalists
59994,533,4,"167,55",4,1,1,6,Mid-Value,Potential Loyalists
59996,57,2,"63,0",5,1,1,7,Mid-Value,Potential Loyalists
59998,872,2,"126,8",3,1,1,5,Low-Value,At Risk Customers
60002,417,5,"83,95",4,1,1,6,Mid-Value,Potential Loyalists
60003,803,11,"523,45",3,2,1,6,Mid-Value,Potential Loyalists
60005,1152,4,"316,8",2,1,1,4,Low-Value,Can't Lose
60008,879,2,"32,85",3,1,1,5,Low-Value,At Risk Customers
60009,119,1,"40,55",5,1,1,7,Mid-Value,Potential Loyalists
60010,1793,1,"28,55",1,1,1,3,Low-Value,Lost
60011,27,10,"850,4",5,2,2,9,High-Value,Champions
60012,20,5,"365,05",5,1,1,7,Mid-Value,Potential Loyalists
60013,220,1,"16,95",5,1,1,7,Mid-Value,Potential Loyalists
60014,1130,2,"172,5",2,1,1,4,Low-Value,Can't Lose
60015,349,6,"437,75",5,1,1,7,Mid-Value,Potential Loyalists
60016,105,3,"87,9",5,1,1,7,Mid-Value,Potential Loyalists
60017,365,7,"460,84999999999997",5,2,1,8,High-Value,Potential Loyalists
60018,336,9,"343,75",5,2,1,8,High-Value,Potential Loyalists
60021,857,2,"169,75",3,1,1,5,Low-Value,At Risk Customers
60022,563,7,"328,0",4,2,1,7,Mid-Value,Potential Loyalists
60023,488,1,"26,400000000000002",4,1,1,6,Mid-Value,Potential Loyalists
60024,600,2,"102,85",4,1,1,6,Mid-Value,Potential Loyalists
60025,769,3,"126,85000000000001",3,1,1,5,Low-Value,At Risk Customers
60026,100,6,"320,6",5,1,1,7,Mid-Value,Potential Loyalists
60027,589,8,"403,6",4,2,1,7,Mid-Value,Potential Loyalists
60029,560,3,"180,14999999999998",4,1,1,6,Mid-Value,Potential Loyalists
60030,540,3,"267,7",4,1,1,6,Mid-Value,Potential Loyalists
60032,437,3,"157,0",4,1,1,6,Mid-Value,Potential Loyalists
60034,444,2,"22,35",4,1,1,6,Mid-Value,Potential Loyalists
60035,395,1,"65,25",4,1,1,6,Mid-Value,Potential Loyalists
60036,918,7,"186,55",3,2,1,6,Mid-Value,Potential Loyalists
60037,378,6,"345,7",4,1,1,6,Mid-Value,Potential Loyalists
60041,1139,2,"276,09999999999997",2,1,1,4,Low-Value,Can't Lose
60043,435,3,"209,7",4,1,1,6,Mid-Value,Potential Loyalists
60045,54,2,"62,1",5,1,1,7,Mid-Value,Potential Loyalists
60047,438,6,"526,6",4,1,1,6,Mid-Value,Potential Loyalists
60049,462,3,"33,2",4,1,1,6,Mid-Value,Potential Loyalists
60050,395,2,"182,25",4,1,1,6,Mid-Value,Potential Loyalists
60053,438,6,"322,75",4,1,1,6,Mid-Value,Potential Loyalists
60058,509,3,"319,75",4,1,1,6,Mid-Value,Potential Loyalists
60060,374,2,"104,55000000000001",4,1,1,6,Mid-Value,Potential Loyalists
60062,414,2,"77,00000000000001",4,1,1,6,Mid-Value,Potential Loyalists
60063,1015,1,"40,65",3,1,1,5,Low-Value,At Risk Customers
60067,228,5,"269,3",5,1,1,7,Mid-Value,Potential Loyalists
60068,195,3,"91,0",5,1,1,7,Mid-Value,Potential Loyalists
60069,1415,2,"40,25",2,1,1,4,Low-Value,Can't Lose
60070,419,1,"11,95",4,1,1,6,Mid-Value,Potential Loyalists
60071,350,2,"390,5",5,1,1,7,Mid-Value,Potential Loyalists
60073,1499,2,"70,45",1,1,1,3,Low-Value,Lost
60074,125,5,"193,4",5,1,1,7,Mid-Value,Potential Loyalists
60076,315,2,"48,6",5,1,1,7,Mid-Value,Potential Loyalists
60077,393,2,"216,95",4,1,1,6,Mid-Value,Potential Loyalists
60079,79,4,"303,55",5,1,1,7,Mid-Value,Potential Loyalists
60082,804,1,"11,5",3,1,1,5,Low-Value,At Risk Customers
60083,593,1,"8,25",4,1,1,6,Mid-Value,Potential Loyalists
60085,435,1,"17,35",4,1,1,6,Mid-Value,Potential Loyalists
60087,164,2,"97,25",5,1,1,7,Mid-Value,Potential Loyalists
60088,1075,1,"20,4",3,1,1,5,Low-Value,At Risk Customers
60089,604,1,"25,650000000000002",4,1,1,6,Mid-Value,Potential Loyalists
60092,81,9,"564,05",5,2,1,8,High-Value,Potential Loyalists
60093,0,8,"263,25",5,2,1,8,High-Value,Potential Loyalists
60096,1512,3,"115,03",1,1,1,3,Low-Value,Lost
60098,1540,1,"8,6",1,1,1,3,Low-Value,Lost
60102,7,4,"138,05",5,1,1,7,Mid-Value,Potential Loyalists
60103,1306,3,"249,75",2,1,1,4,Low-Value,Can't Lose
60105,498,1,"145,8",4,1,1,6,Mid-Value,Potential Loyalists
60108,160,2,"63,9",5,1,1,7,Mid-Value,Potential Loyalists
60110,1495,1,"144,25",1,1,1,3,Low-Value,Lost
60112,1058,1,"121,65",3,1,1,5,Low-Value,At Risk Customers
60114,521,1,"117,2",4,1,1,6,Mid-Value,Potential Loyalists
60115,1189,4,"263,20000000000005",2,1,1,4,Low-Value,Can't Lose
60116,742,2,"132,0",3,1,1,5,Low-Value,At Risk Customers
60117,657,1,"12,1",4,1,1,6,Mid-Value,Potential Loyalists
60120,731,2,"124,5",3,1,1,5,Low-Value,At Risk Customers
60121,385,5,"558,3",4,1,1,6,Mid-Value,Potential Loyalists
60124,924,1,"71,55",3,1,1,5,Low-Value,At Risk Customers
60126,996,2,"39,93",3,1,1,5,Low-Value,At Risk Customers
60127,1784,1,"40,3",1,1,1,3,Low-Value,Lost
60130,404,3,"317,65",4,1,1,6,Mid-Value,Potential Loyalists
60131,682,1,"14,65",4,1,1,6,Mid-Value,Potential Loyalists
60132,379,7,"507,45",4,2,1,7,Mid-Value,Potential Loyalists
60134,146,7,"583,2",5,2,1,8,High-Value,Potential Loyalists
60135,36,6,"117,75",5,1,1,7,Mid-Value,Potential Loyalists
60138,511,1,"19,75",4,1,1,6,Mid-Value,Potential Loyalists
60141,1177,2,"382,0",2,1,1,4,Low-Value,Can't Lose
60143,134,5,"702,6500000000001",5,1,2,8,High-Value,Potential Loyalists
60145,1475,3,"162,35",1,1,1,3,Low-Value,Lost
60146,197,1,"9,8",5,1,1,7,Mid-Value,Potential Loyalists
60147,59,3,"70,7",5,1,1,7,Mid-Value,Potential Loyalists
60148,299,1,"16,85",5,1,1,7,Mid-Value,Potential Loyalists
60149,1593,2,"27,0",1,1,1,3,Low-Value,Lost
60150,598,2,"65,25",4,1,1,6,Mid-Value,Potential Loyalists
60151,1238,1,"30,69",2,1,1,4,Low-Value,Can't Lose
60153,504,1,"14,4",4,1,1,6,Mid-Value,Potential Loyalists
60154,414,3,"48,900000000000006",4,1,1,6,Mid-Value,Potential Loyalists
60158,186,3,"177,8",5,1,1,7,Mid-Value,Potential Loyalists
60159,824,2,"144,9",3,1,1,5,Low-Value,At Risk Customers
60160,998,4,"244,39999999999998",3,1,1,5,Low-Value,At Risk Customers
60161,557,2,"47,65",4,1,1,6,Mid-Value,Potential Loyalists
60162,87,5,"297,15",5,1,1,7,Mid-Value,Potential Loyalists
60163,992,3,"86,3",3,1,1,5,Low-Value,At Risk Customers
60165,678,4,"110,8",4,1,1,6,Mid-Value,Potential Loyalists
60166,1108,1,"27,3",2,1,1,4,Low-Value,Can't Lose
60167,89,3,"128,2",5,1,1,7,Mid-Value,Potential Loyalists
60169,154,4,"237,1",5,1,1,7,Mid-Value,Potential Loyalists
60170,19,7,"517,5",5,2,1,8,High-Value,Potential Loyalists
60171,566,3,"197,6",4,1,1,6,Mid-Value,Potential Loyalists
60173,55,3,"114,80000000000001",5,1,1,7,Mid-Value,Potential Loyalists
60176,208,4,"447,09999999999997",5,1,1,7,Mid-Value,Potential Loyalists
60179,52,5,"282,95",5,1,1,7,Mid-Value,Potential Loyalists
60180,411,2,"98,9",4,1,1,6,Mid-Value,Potential Loyalists
60181,1048,4,"157,0",3,1,1,5,Low-Value,At Risk Customers
60184,409,14,"903,25",4,3,2,9,High-Value,Champions
60185,1251,1,"40,75",2,1,1,4,Low-Value,Can't Lose
60186,564,3,"46,35",4,1,1,6,Mid-Value,Potential Loyalists
60187,159,6,"401,55",5,1,1,7,Mid-Value,Potential Loyalists
60188,1124,8,"268,85",2,2,1,5,Low-Value,At Risk Customers
60190,1033,1,"14,75",3,1,1,5,Low-Value,At Risk Customers
60191,468,2,"78,4",4,1,1,6,Mid-Value,Potential Loyalists
60193,517,2,"79,0",4,1,1,6,Mid-Value,Potential Loyalists
60194,557,1,"36,9",4,1,1,6,Mid-Value,Potential Loyalists
60196,1383,1,"19,45",2,1,1,4,Low-Value,Can't Lose
60198,159,4,"235,85",5,1,1,7,Mid-Value,Potential Loyalists
60199,1690,1,"15,4",1,1,1,3,Low-Value,Lost
60201,448,3,"189,05",4,1,1,6,Mid-Value,Potential Loyalists
60202,259,3,"56,7",5,1,1,7,Mid-Value,Potential Loyalists
60206,1365,1,"10,15",2,1,1,4,Low-Value,Can't Lose
60207,899,3,"331,20000000000005",3,1,1,5,Low-Value,At Risk Customers
60208,20,1,"62,1",5,1,1,7,Mid-Value,Potential Loyalists
60210,638,1,"63,2",4,1,1,6,Mid-Value,Potential Loyalists
60213,224,1,"8,850000000000001",5,1,1,7,Mid-Value,Potential Loyalists
60217,1220,2,"127,3",2,1,1,4,Low-Value,Can't Lose
60218,3,9,"311,6",5,2,1,8,High-Value,Potential Loyalists
60219,1098,2,"262,8",2,1,1,4,Low-Value,Can't Lose
60221,408,2,"3,6500000000000004",4,1,1,6,Mid-Value,Potential Loyalists
60222,1054,1,"17,25",3,1,1,5,Low-Value,At Risk Customers
60223,887,2,"177,2",3,1,1,5,Low-Value,At Risk Customers
60224,312,3,"149,95",5,1,1,7,Mid-Value,Potential Loyalists
60225,808,1,"35,55",3,1,1,5,Low-Value,At Risk Customers
60226,14,2,"23,8",5,1,1,7,Mid-Value,Potential Loyalists
60227,7,5,"219,35",5,1,1,7,Mid-Value,Potential Loyalists
60228,798,1,"90,35",3,1,1,5,Low-Value,At Risk Customers
60229,749,4,"52,2",3,1,1,5,Low-Value,At Risk Customers
60233,8,4,"498,0",5,1,1,7,Mid-Value,Potential Loyalists
60235,1670,2,"216,25",1,1,1,3,Low-Value,Lost
60238,407,3,"218,45",4,1,1,6,Mid-Value,Potential Loyalists
60240,1112,1,"58,949999999999996",2,1,1,4,Low-Value,Can't Lose
60241,258,2,"130,45",5,1,1,7,Mid-Value,Potential Loyalists
60242,73,3,"131,25",5,1,1,7,Mid-Value,Potential Loyalists
60244,1139,1,"160,6",2,1,1,4,Low-Value,Can't Lose
60245,969,2,"311,79999999999995",3,1,1,5,Low-Value,At Risk Customers
60246,1127,3,"124,80000000000001",2,1,1,4,Low-Value,Can't Lose
60247,12,3,"135,25",5,1,1,7,Mid-Value,Potential Loyalists
60248,1025,1,"33,9",3,1,1,5,Low-Value,At Risk Customers
60249,693,7,"332,35",4,2,1,7,Mid-Value,Potential Loyalists
60250,656,1,"73,5",4,1,1,6,Mid-Value,Potential Loyalists
60252,951,1,"23,25",3,1,1,5,Low-Value,At Risk Customers
60253,16,5,"162,14999999999998",5,1,1,7,Mid-Value,Potential Loyalists
60254,197,3,"206,35",5,1,1,7,Mid-Value,Potential Loyalists
60257,951,2,"129,2",3,1,1,5,Low-Value,At Risk Customers
60258,1202,3,"263,7",2,1,1,4,Low-Value,Can't Lose
60259,1389,2,"148,9",2,1,1,4,Low-Value,Can't Lose
60263,898,3,"76,6",3,1,1,5,Low-Value,At Risk Customers
60264,894,3,"232,85000000000002",3,1,1,5,Low-Value,At Risk Customers
60266,1116,7,"287,7",2,2,1,5,Low-Value,At Risk Customers
60270,835,4,"319,6",3,1,1,5,Low-Value,At Risk Customers
60271,1820,1,"39,2",1,1,1,3,Low-Value,Lost
60274,52,5,"676,5",5,1,2,8,High-Value,Potential Loyalists
60275,55,1,"38,3",5,1,1,7,Mid-Value,Potential Loyalists
60276,115,7,"375,9",5,2,1,8,High-Value,Potential Loyalists
60277,600,1,"41,95",4,1,1,6,Mid-Value,Potential Loyalists
60280,1175,2,"18,75",2,1,1,4,Low-Value,Can't Lose
60281,1092,2,"92,60000000000001",3,1,1,5,Low-Value,At Risk Customers
60282,1081,2,"135,15",3,1,1,5,Low-Value,At Risk Customers
60284,1100,8,"615,63",2,2,1,5,Low-Value,At Risk Customers
60287,748,3,"207,15",3,1,1,5,Low-Value,At Risk Customers
60288,577,2,"26,15",4,1,1,6,Mid-Value,Potential Loyalists
60290,860,6,"470,15000000000003",3,1,1,5,Low-Value,At Risk Customers
60291,1123,5,"200,05",2,1,1,4,Low-Value,Can't Lose
60292,1352,1,"17,85",2,1,1,4,Low-Value,Can't Lose
60295,657,7,"342,05",4,2,1,7,Mid-Value,Potential Loyalists
60298,68,8,"316,55",5,2,1,8,High-Value,Potential Loyalists
60299,34,16,"1908,35",5,3,3,11,High-Value,Champions
60300,130,4,"259,65",5,1,1,7,Mid-Value,Potential Loyalists
60301,165,1,"47,9",5,1,1,7,Mid-Value,Potential Loyalists
60302,1179,1,"5,85",2,1,1,4,Low-Value,Can't Lose
60303,965,1,"41,5",3,1,1,5,Low-Value,At Risk Customers
60304,795,1,"24,05",3,1,1,5,Low-Value,At Risk Customers
60305,397,7,"183,20000000000002",4,2,1,7,Mid-Value,Potential Loyalists
60306,362,8,"346,9",5,2,1,8,High-Value,Potential Loyalists
60307,37,3,"90,1",5,1,1,7,Mid-Value,Potential Loyalists
60308,626,2,"543,3",4,1,1,6,Mid-Value,Potential Loyalists
60309,108,7,"319,05",5,2,1,8,High-Value,Potential Loyalists
60310,1270,1,"97,2",2,1,1,4,Low-Value,Can't Lose
60311,84,6,"191,85",5,1,1,7,Mid-Value,Potential Loyalists
60312,502,2,"193,15",4,1,1,6,Mid-Value,Potential Loyalists
60313,304,5,"398,6",5,1,1,7,Mid-Value,Potential Loyalists
60314,25,3,"105,94999999999999",5,1,1,7,Mid-Value,Potential Loyalists
60316,858,3,"122,69999999999999",3,1,1,5,Low-Value,At Risk Customers
60317,178,6,"324,4",5,1,1,7,Mid-Value,Potential Loyalists
60318,745,2,"98,9",3,1,1,5,Low-Value,At Risk Customers
60319,658,1,"19,4",4,1,1,6,Mid-Value,Potential Loyalists
60320,283,1,"17,35",5,1,1,7,Mid-Value,Potential Loyalists
60321,19,3,"175,8",5,1,1,7,Mid-Value,Potential Loyalists
60322,1149,3,"131,6",2,1,1,4,Low-Value,Can't Lose
60323,722,1,"43,0",4,1,1,6,Mid-Value,Potential Loyalists
60325,753,4,"295,0",3,1,1,5,Low-Value,At Risk Customers
60326,543,1,"60,7",4,1,1,6,Mid-Value,Potential Loyalists
60329,213,3,"206,75",5,1,1,7,Mid-Value,Potential Loyalists
60330,54,1,"4,25",5,1,1,7,Mid-Value,Potential Loyalists
60333,137,1,"268,95000000000005",5,1,1,7,Mid-Value,Potential Loyalists
60334,476,4,"157,8",4,1,1,6,Mid-Value,Potential Loyalists
60335,690,1,"24,05",4,1,1,6,Mid-Value,Potential Loyalists
60339,129,3,"297,5",5,1,1,7,Mid-Value,Potential Loyalists
60340,638,4,"228,75",4,1,1,6,Mid-Value,Potential Loyalists
60341,168,7,"589,4000000000001",5,2,1,8,High-Value,Potential Loyalists
60344,513,2,"159,89999999999998",4,1,1,6,Mid-Value,Potential Loyalists
60346,343,5,"225,15",5,1,1,7,Mid-Value,Potential Loyalists
60348,844,2,"66,2",3,1,1,5,Low-Value,At Risk Customers
60349,66,19,"917,4",5,4,2,11,High-Value,Champions
60350,216,1,"31,650000000000002",5,1,1,7,Mid-Value,Potential Loyalists
60351,1473,1,"53,65",1,1,1,3,Low-Value,Lost
60352,524,3,"164,75",4,1,1,6,Mid-Value,Potential Loyalists
60353,1594,1,"16,15",1,1,1,3,Low-Value,Lost
60355,3,3,"414,69999999999993",5,1,1,7,Mid-Value,Potential Loyalists
60356,1519,2,"314,55",1,1,1,3,Low-Value,Lost
60357,502,3,"78,69999999999999",4,1,1,6,Mid-Value,Potential Loyalists
60358,1426,1,"192,35",2,1,1,4,Low-Value,Can't Lose
60360,263,1,"19,5",5,1,1,7,Mid-Value,Potential Loyalists
60361,153,5,"170,0",5,1,1,7,Mid-Value,Potential Loyalists
60362,136,2,"127,4",5,1,1,7,Mid-Value,Potential Loyalists
60363,197,6,"197,85000000000002",5,1,1,7,Mid-Value,Potential Loyalists
60365,1687,2,"410,70000000000005",1,1,1,3,Low-Value,Lost
60366,320,9,"524,2",5,2,1,8,High-Value,Potential Loyalists
60368,458,1,"10,6",4,1,1,6,Mid-Value,Potential Loyalists
60369,915,2,"57,85000000000001",3,1,1,5,Low-Value,At Risk Customers
60372,453,5,"242,54999999999998",4,1,1,6,Mid-Value,Potential Loyalists
60373,84,4,"365,15",5,1,1,7,Mid-Value,Potential Loyalists
60375,29,2,"31,1",5,1,1,7,Mid-Value,Potential Loyalists
60377,239,8,"734,1",5,2,2,9,High-Value,Champions
60378,404,4,"908,2499999999999",4,1,2,7,Mid-Value,Potential Loyalists
60379,546,4,"259,15",4,1,1,6,Mid-Value,Potential Loyalists
60380,1154,2,"222,99999999999997",2,1,1,4,Low-Value,Can't Lose
60383,629,1,"36,65",4,1,1,6,Mid-Value,Potential Loyalists
60385,920,6,"517,3",3,1,1,5,Low-Value,At Risk Customers
60386,1655,2,"125,4",1,1,1,3,Low-Value,Lost
60387,602,3,"46,45",4,1,1,6,Mid-Value,Potential Loyalists
60388,908,1,"23,2",3,1,1,5,Low-Value,At Risk Customers
60389,8,3,"169,75",5,1,1,7,Mid-Value,Potential Loyalists
60390,78,1,"5,15",5,1,1,7,Mid-Value,Potential Loyalists
60391,472,1,"52,4",4,1,1,6,Mid-Value,Potential Loyalists
60392,573,2,"132,8",4,1,1,6,Mid-Value,Potential Loyalists
60393,1,1,"235,6",5,1,1,7,Mid-Value,Potential Loyalists
60394,311,3,"257,25",5,1,1,7,Mid-Value,Potential Loyalists
60397,791,4,"329,45",3,1,1,5,Low-Value,At Risk Customers
60398,244,3,"157,15",5,1,1,7,Mid-Value,Potential Loyalists
60399,90,4,"72,94999999999999",5,1,1,7,Mid-Value,Potential Loyalists
60400,63,7,"675,4",5,2,2,9,High-Value,Champions
60401,20,8,"298,65",5,2,1,8,High-Value,Potential Loyalists
60402,438,3,"73,1",4,1,1,6,Mid-Value,Potential Loyalists
60403,312,10,"455,04999999999995",5,2,1,8,High-Value,Potential Loyalists
60404,44,3,"327,35",5,1,1,7,Mid-Value,Potential Loyalists
60405,606,1,"25,9",4,1,1,6,Mid-Value,Potential Loyalists
60406,170,1,"38,4",5,1,1,7,Mid-Value,Potential Loyalists
60407,1697,1,"4,3",1,1,1,3,Low-Value,Lost
60408,248,3,"429,3",5,1,1,7,Mid-Value,Potential Loyalists
60409,855,7,"212,9",3,2,1,6,Mid-Value,Potential Loyalists
60410,181,5,"1178,05",5,1,2,8,High-Value,Potential Loyalists
60414,290,3,"73,15",5,1,1,7,Mid-Value,Potential Loyalists
60415,139,1,"80,9",5,1,1,7,Mid-Value,Potential Loyalists
60416,124,2,"51,5",5,1,1,7,Mid-Value,Potential Loyalists
60418,1305,1,"85,6",2,1,1,4,Low-Value,Can't Lose
60419,766,2,"76,05",3,1,1,5,Low-Value,At Risk Customers
60420,757,5,"113,05",3,1,1,5,Low-Value,At Risk Customers
60421,508,3,"126,35",4,1,1,6,Mid-Value,Potential Loyalists
60422,1389,1,"6,45",2,1,1,4,Low-Value,Can't Lose
60425,881,1,"22,25",3,1,1,5,Low-Value,At Risk Customers
60427,1076,2,"138,65",3,1,1,5,Low-Value,At Risk Customers
60428,517,2,"59,6",4,1,1,6,Mid-Value,Potential Loyalists
60429,20,7,"1531,3",5,2,3,10,High-Value,Champions
60430,7,1,"12,25",5,1,1,7,Mid-Value,Potential Loyalists
60431,611,2,"54,75",4,1,1,6,Mid-Value,Potential Loyalists
60432,655,2,"189,3",4,1,1,6,Mid-Value,Potential Loyalists
60433,82,5,"162,65",5,1,1,7,Mid-Value,Potential Loyalists
60435,64,5,"228,7",5,1,1,7,Mid-Value,Potential Loyalists
60436,129,4,"422,6",5,1,1,7,Mid-Value,Potential Loyalists
60437,189,1,"33,5",5,1,1,7,Mid-Value,Potential Loyalists
60438,904,3,"106,2",3,1,1,5,Low-Value,At Risk Customers
60439,195,1,"33,75",5,1,1,7,Mid-Value,Potential Loyalists
60440,395,6,"290,15",4,1,1,6,Mid-Value,Potential Loyalists
60442,148,2,"42,2",5,1,1,7,Mid-Value,Potential Loyalists
60444,141,9,"272,40000000000003",5,2,1,8,High-Value,Potential Loyalists
60445,31,6,"296,1",5,1,1,7,Mid-Value,Potential Loyalists
60446,146,2,"231,75",5,1,1,7,Mid-Value,Potential Loyalists
60447,743,11,"1749,75",3,2,3,8,High-Value,Potential Loyalists
60448,159,4,"370,15",5,1,1,7,Mid-Value,Potential Loyalists
60449,33,11,"1121,75",5,2,2,9,High-Value,Champions
60451,89,2,"307,45",5,1,1,7,Mid-Value,Potential Loyalists
60453,609,2,"90,6",4,1,1,6,Mid-Value,Potential Loyalists
60454,986,2,"128,4",3,1,1,5,Low-Value,At Risk Customers
60455,1303,1,"155,7",2,1,1,4,Low-Value,Can't Lose
60456,1303,1,"86,3",2,1,1,4,Low-Value,Can't Lose
60459,1094,2,"161,2",3,1,1,5,Low-Value,At Risk Customers
60460,1304,2,"223,75",2,1,1,4,Low-Value,Can't Lose
60461,491,5,"332,20000000000005",4,1,1,6,Mid-Value,Potential Loyalists
60462,243,1,"12,65",5,1,1,7,Mid-Value,Potential Loyalists
60463,386,5,"332,8",4,1,1,6,Mid-Value,Potential Loyalists
60464,218,4,"278,95",5,1,1,7,Mid-Value,Potential Loyalists
60465,218,1,"40,1",5,1,1,7,Mid-Value,Potential Loyalists
60467,51,4,"160,45",5,1,1,7,Mid-Value,Potential Loyalists
60468,290,2,"111,55",5,1,1,7,Mid-Value,Potential Loyalists
60470,819,3,"182,75",3,1,1,5,Low-Value,At Risk Customers
60471,1026,1,"85,25",3,1,1,5,Low-Value,At Risk Customers
60472,149,3,"111,5",5,1,1,7,Mid-Value,Potential Loyalists
60473,1234,3,"137,9",2,1,1,4,Low-Value,Can't Lose
60474,14,4,"330,2",5,1,1,7,Mid-Value,Potential Loyalists
60476,132,5,"197,45",5,1,1,7,Mid-Value,Potential Loyalists
60477,532,6,"254,9",4,1,1,6,Mid-Value,Potential Loyalists
60478,42,3,"113,7",5,1,1,7,Mid-Value,Potential Loyalists
60479,320,3,"216,79999999999998",5,1,1,7,Mid-Value,Potential Loyalists
60480,177,3,"631,15",5,1,1,7,Mid-Value,Potential Loyalists
60482,118,7,"165,05",5,2,1,8,High-Value,Potential Loyalists
60484,1330,1,"7,6",2,1,1,4,Low-Value,Can't Lose
60485,951,2,"137,45",3,1,1,5,Low-Value,At Risk Customers
60486,367,4,"295,70000000000005",4,1,1,6,Mid-Value,Potential Loyalists
60487,1361,1,"49,35",2,1,1,4,Low-Value,Can't Lose
60488,277,2,"122,8",5,1,1,7,Mid-Value,Potential Loyalists
60491,35,5,"341,7",5,1,1,7,Mid-Value,Potential Loyalists
60493,1125,3,"109,8",2,1,1,4,Low-Value,Can't Lose
60494,108,4,"100,35",5,1,1,7,Mid-Value,Potential Loyalists
60495,326,11,"622,35",5,2,1,8,High-Value,Potential Loyalists
60496,94,8,"230,9",5,2,1,8,High-Value,Potential Loyalists
60497,72,2,"75,15",5,1,1,7,Mid-Value,Potential Loyalists
60498,1611,1,"34,650000000000006",1,1,1,3,Low-Value,Lost
60499,101,4,"113,30000000000001",5,1,1,7,Mid-Value,Potential Loyalists
60500,486,3,"182,95000000000002",4,1,1,6,Mid-Value,Potential Loyalists
60502,231,9,"665,4",5,2,2,9,High-Value,Champions
60503,576,1,"121,0",4,1,1,6,Mid-Value,Potential Loyalists
60507,129,7,"586,55",5,2,1,8,High-Value,Potential Loyalists
60508,488,2,"230,95",4,1,1,6,Mid-Value,Potential Loyalists
60510,916,3,"128,5",3,1,1,5,Low-Value,At Risk Customers
60511,135,5,"945,55",5,1,2,8,High-Value,Potential Loyalists
60512,409,3,"162,1",4,1,1,6,Mid-Value,Potential Loyalists
60513,914,1,"121,7",3,1,1,5,Low-Value,At Risk Customers
60515,783,3,"90,44999999999999",3,1,1,5,Low-Value,At Risk Customers
60518,490,10,"1086,2",4,2,2,8,High-Value,Potential Loyalists
60519,1553,1,"56,45",1,1,1,3,Low-Value,Lost
60520,179,4,"196,75",5,1,1,7,Mid-Value,Potential Loyalists
60522,51,4,"144,15",5,1,1,7,Mid-Value,Potential Loyalists
60523,216,2,"82,95",5,1,1,7,Mid-Value,Potential Loyalists
60525,766,3,"109,3",3,1,1,5,Low-Value,At Risk Customers
60526,1243,1,"35,099999999999994",2,1,1,4,Low-Value,Can't Lose
60527,214,5,"385,40000000000003",5,1,1,7,Mid-Value,Potential Loyalists
60529,1038,1,"135,0",3,1,1,5,Low-Value,At Risk Customers
60530,151,2,"148,5",5,1,1,7,Mid-Value,Potential Loyalists
60533,1508,3,"238,85",1,1,1,3,Low-Value,Lost
60535,1131,2,"88,95",2,1,1,4,Low-Value,Can't Lose
60537,1418,1,"84,8",2,1,1,4,Low-Value,Can't Lose
60539,53,3,"193,95",5,1,1,7,Mid-Value,Potential Loyalists
60541,220,3,"290,95",5,1,1,7,Mid-Value,Potential Loyalists
60542,908,1,"87,15",3,1,1,5,Low-Value,At Risk Customers
60543,530,7,"209,85",4,2,1,7,Mid-Value,Potential Loyalists
60544,258,2,"115,0",5,1,1,7,Mid-Value,Potential Loyalists
60545,591,4,"384,09999999999997",4,1,1,6,Mid-Value,Potential Loyalists
60546,482,2,"78,65",4,1,1,6,Mid-Value,Potential Loyalists
60547,189,2,"298,29999999999995",5,1,1,7,Mid-Value,Potential Loyalists
60548,1402,1,"5,75",2,1,1,4,Low-Value,Can't Lose
60549,1576,2,"94,35",1,1,1,3,Low-Value,Lost
60550,1125,1,"83,5",2,1,1,4,Low-Value,Can't Lose
60551,14,5,"202,3",5,1,1,7,Mid-Value,Potential Loyalists
60552,1123,1,"11,9",2,1,1,4,Low-Value,Can't Lose
60553,12,1,"53,6",5,1,1,7,Mid-Value,Potential Loyalists
60555,18,1,"135,6",5,1,1,7,Mid-Value,Potential Loyalists
60556,984,3,"117,65",3,1,1,5,Low-Value,At Risk Customers
60557,551,2,"94,35",4,1,1,6,Mid-Value,Potential Loyalists
60558,571,4,"170,39999999999998",4,1,1,6,Mid-Value,Potential Loyalists
60561,393,1,"90,0",4,1,1,6,Mid-Value,Potential Loyalists
60562,454,1,"30,8",4,1,1,6,Mid-Value,Potential Loyalists
60565,916,2,"48,4",3,1,1,5,Low-Value,At Risk Customers
60566,1558,4,"431,3",1,1,1,3,Low-Value,Lost
60567,850,2,"155,89999999999998",3,1,1,5,Low-Value,At Risk Customers
60569,369,8,"1042,65",4,2,2,8,High-Value,Potential Loyalists
60570,312,5,"677,8499999999999",5,1,2,8,High-Value,Potential Loyalists
60571,128,3,"276,5",5,1,1,7,Mid-Value,Potential Loyalists
60572,863,7,"285,0",3,2,1,6,Mid-Value,Potential Loyalists
60573,166,4,"281,3",5,1,1,7,Mid-Value,Potential Loyalists
60575,409,7,"331,45",4,2,1,7,Mid-Value,Potential Loyalists
60577,348,4,"89,95",5,1,1,7,Mid-Value,Potential Loyalists
60578,1027,1,"47,0",3,1,1,5,Low-Value,At Risk Customers
60579,249,1,"31,4",5,1,1,7,Mid-Value,Potential Loyalists
60581,1406,1,"501,0",2,1,1,4,Low-Value,Can't Lose
60583,911,1,"58,8",3,1,1,5,Low-Value,At Risk Customers
60584,148,4,"624,3",5,1,1,7,Mid-Value,Potential Loyalists
60585,155,2,"138,4",5,1,1,7,Mid-Value,Potential Loyalists
60586,895,1,"53,4",3,1,1,5,Low-Value,At Risk Customers
60587,1637,1,"7,0",1,1,1,3,Low-Value,Lost
60589,1186,2,"157,8",2,1,1,4,Low-Value,Can't Lose
60591,399,4,"232,75",4,1,1,6,Mid-Value,Potential Loyalists
60593,1545,1,"20,55",1,1,1,3,Low-Value,Lost
60594,155,4,"174,4",5,1,1,7,Mid-Value,Potential Loyalists
60595,127,8,"489,4",5,2,1,8,High-Value,Potential Loyalists
60598,1034,1,"17,55",3,1,1,5,Low-Value,At Risk Customers
60599,1066,2,"126,35",3,1,1,5,Low-Value,At Risk Customers
60600,77,4,"185,5",5,1,1,7,Mid-Value,Potential Loyalists
60601,1004,2,"55,0",3,1,1,5,Low-Value,At Risk Customers
60602,1171,1,"8,75",2,1,1,4,Low-Value,Can't Lose
60603,877,2,"190,0",3,1,1,5,Low-Value,At Risk Customers
60605,11,9,"481,4",5,2,1,8,High-Value,Potential Loyalists
60606,1361,1,"22,45",2,1,1,4,Low-Value,Can't Lose
60607,252,1,"35,0",5,1,1,7,Mid-Value,Potential Loyalists
60608,118,7,"660,05",5,2,1,8,High-Value,Potential Loyalists
60609,376,1,"17,0",4,1,1,6,Mid-Value,Potential Loyalists
60611,1551,1,"5,1",1,1,1,3,Low-Value,Lost
60612,514,2,"174,7",4,1,1,6,Mid-Value,Potential Loyalists
60613,1788,1,"63,0",1,1,1,3,Low-Value,Lost
60615,1,6,"662,9499999999999",5,1,1,7,Mid-Value,Potential Loyalists
60616,1366,2,"75,05",2,1,1,4,Low-Value,Can't Lose
60617,1622,1,"9,2",1,1,1,3,Low-Value,Lost
60618,132,5,"193,75",5,1,1,7,Mid-Value,Potential Loyalists
60619,539,3,"795,3499999999999",4,1,2,7,Mid-Value,Potential Loyalists
60620,318,3,"60,8",5,1,1,7,Mid-Value,Potential Loyalists
60621,721,8,"582,21",4,2,1,7,Mid-Value,Potential Loyalists
60624,1591,1,"125,85000000000001",1,1,1,3,Low-Value,Lost
60625,895,1,"22,9",3,1,1,5,Low-Value,At Risk Customers
60627,742,1,"92,0",3,1,1,5,Low-Value,At Risk Customers
60628,1097,1,"491,6",2,1,1,4,Low-Value,Can't Lose
60629,1170,5,"243,35",2,1,1,4,Low-Value,Can't Lose
60631,1069,1,"24,2",3,1,1,5,Low-Value,At Risk Customers
60632,85,2,"54,05",5,1,1,7,Mid-Value,Potential Loyalists
60633,181,3,"76,65",5,1,1,7,Mid-Value,Potential Loyalists
60634,29,2,"162,64999999999998",5,1,1,7,Mid-Value,Potential Loyalists
60635,375,1,"52,0",4,1,1,6,Mid-Value,Potential Loyalists
60639,1639,1,"39,3",1,1,1,3,Low-Value,Lost
60640,1640,1,"115,94999999999999",1,1,1,3,Low-Value,Lost
60641,138,3,"136,75",5,1,1,7,Mid-Value,Potential Loyalists
60642,406,6,"242,45",4,1,1,6,Mid-Value,Potential Loyalists
60644,998,1,"16,8",3,1,1,5,Low-Value,At Risk Customers
60645,609,6,"259,95",4,1,1,6,Mid-Value,Potential Loyalists
60647,167,5,"349,8",5,1,1,7,Mid-Value,Potential Loyalists
60649,739,5,"425,65",3,1,1,5,Low-Value,At Risk Customers
60650,825,4,"116,7",3,1,1,5,Low-Value,At Risk Customers
60651,167,2,"182,9",5,1,1,7,Mid-Value,Potential Loyalists
60654,507,3,"975,0600000000001",4,1,2,7,Mid-Value,Potential Loyalists
60656,1237,2,"165,75",2,1,1,4,Low-Value,Can't Lose
60663,588,2,"142,1",4,1,1,6,Mid-Value,Potential Loyalists
60664,58,11,"493,9",5,2,1,8,High-Value,Potential Loyalists
60666,756,5,"435,4",3,1,1,5,Low-Value,At Risk Customers
60667,445,4,"120,7",4,1,1,6,Mid-Value,Potential Loyalists
60669,882,4,"639,4",3,1,1,5,Low-Value,At Risk Customers
60673,27,6,"243,8",5,1,1,7,Mid-Value,Potential Loyalists
60676,38,4,"222,10000000000002",5,1,1,7,Mid-Value,Potential Loyalists
60679,503,1,"85,4",4,1,1,6,Mid-Value,Potential Loyalists
60680,172,6,"375,15000000000003",5,1,1,7,Mid-Value,Potential Loyalists
60681,132,2,"53,5",5,1,1,7,Mid-Value,Potential Loyalists
60682,728,1,"8,25",4,1,1,6,Mid-Value,Potential Loyalists
60683,907,2,"40,3",3,1,1,5,Low-Value,At Risk Customers
60684,46,4,"177,89999999999998",5,1,1,7,Mid-Value,Potential Loyalists
60686,126,5,"591,65",5,1,1,7,Mid-Value,Potential Loyalists
60688,1259,1,"19,0",2,1,1,4,Low-Value,Can't Lose
60692,85,2,"125,64999999999999",5,1,1,7,Mid-Value,Potential Loyalists
60693,160,3,"105,69999999999999",5,1,1,7,Mid-Value,Potential Loyalists
60694,1258,2,"31,299999999999997",2,1,1,4,Low-Value,Can't Lose
60695,2,1,"6,4",5,1,1,7,Mid-Value,Potential Loyalists
60696,1396,1,"23,25",2,1,1,4,Low-Value,Can't Lose
60697,601,2,"28,799999999999997",4,1,1,6,Mid-Value,Potential Loyalists
60698,254,7,"141,7",5,2,1,8,High-Value,Potential Loyalists
60702,852,2,"14,649999999999999",3,1,1,5,Low-Value,At Risk Customers
60704,748,1,"22,2",3,1,1,5,Low-Value,At Risk Customers
60705,631,1,"74,6",4,1,1,6,Mid-Value,Potential Loyalists
60706,335,3,"96,25000000000001",5,1,1,7,Mid-Value,Potential Loyalists
60707,750,3,"58,15",3,1,1,5,Low-Value,At Risk Customers
60710,437,9,"803,6",4,2,2,8,High-Value,Potential Loyalists
60711,11,6,"524,5500000000001",5,1,1,7,Mid-Value,Potential Loyalists
60712,28,15,"1204,9",5,3,2,10,High-Value,Champions
60715,14,3,"52,45",5,1,1,7,Mid-Value,Potential Loyalists
60716,96,13,"928,4",5,3,2,10,High-Value,Champions
60717,13,7,"378,0",5,2,1,8,High-Value,Potential Loyalists
60718,571,1,"64,1",4,1,1,6,Mid-Value,Potential Loyalists
60719,1486,5,"189,79999999999998",1,1,1,3,Low-Value,Lost
60721,124,4,"478,55",5,1,1,7,Mid-Value,Potential Loyalists
60722,901,4,"63,95",3,1,1,5,Low-Value,At Risk Customers
60723,301,2,"141,95",5,1,1,7,Mid-Value,Potential Loyalists
60724,167,2,"68,89999999999999",5,1,1,7,Mid-Value,Potential Loyalists
60726,1193,2,"175,25",2,1,1,4,Low-Value,Can't Lose
60727,756,11,"296,45",3,2,1,6,Mid-Value,Potential Loyalists
60728,1036,1,"22,05",3,1,1,5,Low-Value,At Risk Customers
60733,363,1,"510,90000000000003",5,1,1,7,Mid-Value,Potential Loyalists
60734,505,3,"130,6",4,1,1,6,Mid-Value,Potential Loyalists
60736,326,6,"408,09999999999997",5,1,1,7,Mid-Value,Potential Loyalists
60737,1366,4,"100,1",2,1,1,4,Low-Value,Can't Lose
60738,106,4,"146,3",5,1,1,7,Mid-Value,Potential Loyalists
60741,302,5,"338,55",5,1,1,7,Mid-Value,Potential Loyalists
60742,1041,1,"18,2",3,1,1,5,Low-Value,At Risk Customers
60743,531,2,"90,7",4,1,1,6,Mid-Value,Potential Loyalists
60745,353,1,"41,4",5,1,1,7,Mid-Value,Potential Loyalists
60746,906,4,"273,25",3,1,1,5,Low-Value,At Risk Customers
60752,8,5,"151,7",5,1,1,7,Mid-Value,Potential Loyalists
60753,1172,1,"4,85",2,1,1,4,Low-Value,Can't Lose
60755,1525,1,"24,2",1,1,1,3,Low-Value,Lost
60756,161,4,"194,9",5,1,1,7,Mid-Value,Potential Loyalists
60758,823,1,"20,45",3,1,1,5,Low-Value,At Risk Customers
60761,52,2,"51,05",5,1,1,7,Mid-Value,Potential Loyalists
60769,101,8,"820,05",5,2,2,9,High-Value,Champions
60770,3,7,"598,1999999999999",5,2,1,8,High-Value,Potential Loyalists
60771,159,3,"53,8",5,1,1,7,Mid-Value,Potential Loyalists
60772,676,2,"101,05",4,1,1,6,Mid-Value,Potential Loyalists
60773,842,1,"10,1",3,1,1,5,Low-Value,At Risk Customers
60774,556,3,"355,04999999999995",4,1,1,6,Mid-Value,Potential Loyalists
60775,603,1,"42,0",4,1,1,6,Mid-Value,Potential Loyalists
60777,354,1,"56,1",5,1,1,7,Mid-Value,Potential Loyalists
60778,766,2,"194,25",3,1,1,5,Low-Value,At Risk Customers
60779,378,8,"371,3",4,2,1,7,Mid-Value,Potential Loyalists
60781,1330,1,"202,04999999999998",2,1,1,4,Low-Value,Can't Lose
60782,705,1,"60,7",4,1,1,6,Mid-Value,Potential Loyalists
60783,78,3,"364,9",5,1,1,7,Mid-Value,Potential Loyalists
60784,200,2,"52,05",5,1,1,7,Mid-Value,Potential Loyalists
60785,211,3,"168,0",5,1,1,7,Mid-Value,Potential Loyalists
60786,718,2,"151,65",4,1,1,6,Mid-Value,Potential Loyalists
60788,668,3,"426,95",4,1,1,6,Mid-Value,Potential Loyalists
60789,519,5,"380,3",4,1,1,6,Mid-Value,Potential Loyalists
60791,1253,1,"30,6",2,1,1,4,Low-Value,Can't Lose
60792,697,2,"113,9",4,1,1,6,Mid-Value,Potential Loyalists
60793,165,5,"277,25",5,1,1,7,Mid-Value,Potential Loyalists
60794,20,8,"502,54999999999995",5,2,1,8,High-Value,Potential Loyalists
60795,853,2,"42,45",3,1,1,5,Low-Value,At Risk Customers
60798,37,6,"232,29999999999998",5,1,1,7,Mid-Value,Potential Loyalists
60800,63,5,"251,5",5,1,1,7,Mid-Value,Potential Loyalists
60804,754,6,"460,05",3,1,1,5,Low-Value,At Risk Customers
60805,4,4,"227,2",5,1,1,7,Mid-Value,Potential Loyalists
60808,466,1,"28,6",4,1,1,6,Mid-Value,Potential Loyalists
60809,0,11,"476,35",5,2,1,8,High-Value,Potential Loyalists
60810,22,7,"518,9000000000001",5,2,1,8,High-Value,Potential Loyalists
60813,862,1,"9,1",3,1,1,5,Low-Value,At Risk Customers
60817,66,2,"420,45",5,1,1,7,Mid-Value,Potential Loyalists
60819,360,1,"22,9",5,1,1,7,Mid-Value,Potential Loyalists
60821,767,5,"97,35",3,1,1,5,Low-Value,At Risk Customers
60823,730,3,"334,25",4,1,1,6,Mid-Value,Potential Loyalists
60824,890,1,"28,5",3,1,1,5,Low-Value,At Risk Customers
60825,206,8,"506,75000000000006",5,2,1,8,High-Value,Potential Loyalists
60826,126,6,"315,9",5,1,1,7,Mid-Value,Potential Loyalists
60828,1513,2,"74,0",1,1,1,3,Low-Value,Lost
60829,1659,1,"304,2",1,1,1,3,Low-Value,Lost
60831,22,2,"228,85",5,1,1,7,Mid-Value,Potential Loyalists
60833,347,4,"192,25",5,1,1,7,Mid-Value,Potential Loyalists
60837,423,4,"130,4",4,1,1,6,Mid-Value,Potential Loyalists
60838,1003,1,"37,8",3,1,1,5,Low-Value,At Risk Customers
60839,861,9,"276,25",3,2,1,6,Mid-Value,Potential Loyalists
60840,748,4,"190,45",3,1,1,5,Low-Value,At Risk Customers
60842,551,1,"31,349999999999998",4,1,1,6,Mid-Value,Potential Loyalists
60843,949,2,"128,3",3,1,1,5,Low-Value,At Risk Customers
60844,1011,1,"9,65",3,1,1,5,Low-Value,At Risk Customers
60845,774,3,"411,5",3,1,1,5,Low-Value,At Risk Customers
60847,822,2,"106,65",3,1,1,5,Low-Value,At Risk Customers
60848,1172,2,"59,8",2,1,1,4,Low-Value,Can't Lose
60852,34,4,"328,35",5,1,1,7,Mid-Value,Potential Loyalists
60854,274,4,"85,5",5,1,1,7,Mid-Value,Potential Loyalists
60858,30,20,"1353,05",5,4,3,12,High-Value,Champions
60861,829,1,"30,45",3,1,1,5,Low-Value,At Risk Customers
60862,475,2,"112,15",4,1,1,6,Mid-Value,Potential Loyalists
60863,1479,2,"70,3",1,1,1,3,Low-Value,Lost
60865,229,4,"198,89999999999998",5,1,1,7,Mid-Value,Potential Loyalists
60866,24,4,"332,75",5,1,1,7,Mid-Value,Potential Loyalists
60867,486,5,"413,4",4,1,1,6,Mid-Value,Potential Loyalists
60868,28,4,"400,7",5,1,1,7,Mid-Value,Potential Loyalists
60870,629,6,"229,45",4,1,1,6,Mid-Value,Potential Loyalists
60871,206,3,"426,65",5,1,1,7,Mid-Value,Potential Loyalists
60872,752,1,"38,6",3,1,1,5,Low-Value,At Risk Customers
60873,0,10,"457,55",5,2,1,8,High-Value,Potential Loyalists
60874,423,7,"170,3",4,2,1,7,Mid-Value,Potential Loyalists
60875,242,2,"164,35",5,1,1,7,Mid-Value,Potential Loyalists
60878,1,4,"515,8",5,1,1,7,Mid-Value,Potential Loyalists
60879,185,2,"183,85",5,1,1,7,Mid-Value,Potential Loyalists
60880,1399,1,"33,4",2,1,1,4,Low-Value,Can't Lose
60881,614,6,"308,95",4,1,1,6,Mid-Value,Potential Loyalists
60882,78,4,"108,0",5,1,1,7,Mid-Value,Potential Loyalists
60883,349,2,"432,3",5,1,1,7,Mid-Value,Potential Loyalists
60884,363,7,"322,65",5,2,1,8,High-Value,Potential Loyalists
60885,13,7,"738,1",5,2,2,9,High-Value,Champions
60886,1489,1,"37,8",1,1,1,3,Low-Value,Lost
60888,257,1,"19,5",5,1,1,7,Mid-Value,Potential Loyalists
60889,394,4,"266,9",4,1,1,6,Mid-Value,Potential Loyalists
60890,52,3,"292,95",5,1,1,7,Mid-Value,Potential Loyalists
60892,612,9,"1351,55",4,2,3,9,High-Value,Champions
60894,543,2,"97,2",4,1,1,6,Mid-Value,Potential Loyalists
60897,1268,3,"297,45",2,1,1,4,Low-Value,Can't Lose
60898,22,2,"88,9",5,1,1,7,Mid-Value,Potential Loyalists
60901,255,1,"74,95",5,1,1,7,Mid-Value,Potential Loyalists
60902,90,4,"159,45",5,1,1,7,Mid-Value,Potential Loyalists
60903,1470,1,"48,15",1,1,1,3,Low-Value,Lost
60906,136,4,"475,65",5,1,1,7,Mid-Value,Potential Loyalists
60907,73,11,"869,25",5,2,2,9,High-Value,Champions
60908,1434,2,"92,35",2,1,1,4,Low-Value,Can't Lose
60909,539,1,"21,1",4,1,1,6,Mid-Value,Potential Loyalists
60910,14,5,"381,75",5,1,1,7,Mid-Value,Potential Loyalists
60911,275,3,"71,64999999999999",5,1,1,7,Mid-Value,Potential Loyalists
60915,1023,2,"32,7",3,1,1,5,Low-Value,At Risk Customers
60916,472,7,"164,2",4,2,1,7,Mid-Value,Potential Loyalists
60917,66,2,"548,8499999999999",5,1,1,7,Mid-Value,Potential Loyalists
60918,25,4,"258,55",5,1,1,7,Mid-Value,Potential Loyalists
60920,761,1,"5,3",3,1,1,5,Low-Value,At Risk Customers
60922,1012,4,"985,1",3,1,2,6,Mid-Value,Potential Loyalists
60923,414,2,"60,5",4,1,1,6,Mid-Value,Potential Loyalists
60925,505,2,"72,9",4,1,1,6,Mid-Value,Potential Loyalists
60926,1610,1,"376,95000000000005",1,1,1,3,Low-Value,Lost
60928,981,2,"67,2",3,1,1,5,Low-Value,At Risk Customers
60929,881,2,"102,2",3,1,1,5,Low-Value,At Risk Customers
60931,762,1,"8,85",3,1,1,5,Low-Value,At Risk Customers
60932,334,1,"40,65",5,1,1,7,Mid-Value,Potential Loyalists
60933,750,3,"204,64999999999998",3,1,1,5,Low-Value,At Risk Customers
60935,971,4,"337,20000000000005",3,1,1,5,Low-Value,At Risk Customers
60936,541,2,"61,5",4,1,1,6,Mid-Value,Potential Loyalists
60938,720,6,"412,6",4,1,1,6,Mid-Value,Potential Loyalists
60939,1541,1,"0,8",1,1,1,3,Low-Value,Lost
60941,1641,2,"285,6",1,1,1,3,Low-Value,Lost
60942,140,3,"96,35",5,1,1,7,Mid-Value,Potential Loyalists
60943,732,1,"70,9",3,1,1,5,Low-Value,At Risk Customers
60944,1548,2,"72,85",1,1,1,3,Low-Value,Lost
60945,826,2,"24,900000000000002",3,1,1,5,Low-Value,At Risk Customers
60947,75,3,"272,05",5,1,1,7,Mid-Value,Potential Loyalists
60952,1138,1,"2,75",2,1,1,4,Low-Value,Can't Lose
60953,946,3,"535,9499999999999",3,1,1,5,Low-Value,At Risk Customers
60955,1517,2,"15,05",1,1,1,3,Low-Value,Lost
60956,933,2,"135,6",3,1,1,5,Low-Value,At Risk Customers
60957,1029,3,"52,4",3,1,1,5,Low-Value,At Risk Customers
60958,1011,3,"417,15",3,1,1,5,Low-Value,At Risk Customers
60959,1272,2,"37,35",2,1,1,4,Low-Value,Can't Lose
60960,494,1,"38,5",4,1,1,6,Mid-Value,Potential Loyalists
60962,432,1,"11,8",4,1,1,6,Mid-Value,Potential Loyalists
60963,1706,1,"225,9",1,1,1,3,Low-Value,Lost
60965,1240,2,"73,0",2,1,1,4,Low-Value,Can't Lose
60966,1270,3,"23,45",2,1,1,4,Low-Value,Can't Lose
60967,392,3,"296,55",4,1,1,6,Mid-Value,Potential Loyalists
60968,1296,1,"177,6",2,1,1,4,Low-Value,Can't Lose
60970,1673,1,"29,2",1,1,1,3,Low-Value,Lost
60971,30,1,"211,1",5,1,1,7,Mid-Value,Potential Loyalists
60972,291,4,"69,65",5,1,1,7,Mid-Value,Potential Loyalists
60973,33,1,"11,5",5,1,1,7,Mid-Value,Potential Loyalists
60974,29,1,"117,8",5,1,1,7,Mid-Value,Potential Loyalists
60975,28,7,"448,75",5,2,1,8,High-Value,Potential Loyalists
60976,1179,4,"87,9",2,1,1,4,Low-Value,Can't Lose
60978,420,3,"68,1",4,1,1,6,Mid-Value,Potential Loyalists
60979,1561,2,"162,45",1,1,1,3,Low-Value,Lost
60980,1677,3,"104,8",1,1,1,3,Low-Value,Lost
60983,29,2,"578,5000000000001",5,1,1,7,Mid-Value,Potential Loyalists
60984,645,5,"303,35",4,1,1,6,Mid-Value,Potential Loyalists
60985,1253,1,"60,7",2,1,1,4,Low-Value,Can't Lose
60986,25,5,"768,1500000000001",5,1,2,8,High-Value,Potential Loyalists
60987,481,2,"38,650000000000006",4,1,1,6,Mid-Value,Potential Loyalists
60988,632,3,"77,60000000000001",4,1,1,6,Mid-Value,Potential Loyalists
60989,438,2,"267,85",4,1,1,6,Mid-Value,Potential Loyalists
60993,412,5,"210,95",4,1,1,6,Mid-Value,Potential Loyalists
60994,1468,1,"19,0",1,1,1,3,Low-Value,Lost
60995,616,1,"79,0",4,1,1,6,Mid-Value,Potential Loyalists
60996,452,4,"344,55000000000007",4,1,1,6,Mid-Value,Potential Loyalists
60997,1684,1,"13,95",1,1,1,3,Low-Value,Lost
60998,90,5,"344,85",5,1,1,7,Mid-Value,Potential Loyalists
61000,1059,2,"64,45",3,1,1,5,Low-Value,At Risk Customers
61005,1676,1,"644,8",1,1,1,3,Low-Value,Lost
61006,427,2,"65,3",4,1,1,6,Mid-Value,Potential Loyalists
61007,1010,2,"718,05",3,1,2,6,Mid-Value,Potential Loyalists
61009,832,2,"21,349999999999998",3,1,1,5,Low-Value,At Risk Customers
61010,650,6,"460,54999999999995",4,1,1,6,Mid-Value,Potential Loyalists
61013,516,3,"548,6",4,1,1,6,Mid-Value,Potential Loyalists
61014,578,3,"347,59999999999997",4,1,1,6,Mid-Value,Potential Loyalists
61015,663,7,"426,5",4,2,1,7,Mid-Value,Potential Loyalists
61017,15,10,"1380,8999999999999",5,2,3,10,High-Value,Champions
61018,919,2,"471,30000000000007",3,1,1,5,Low-Value,At Risk Customers
61019,22,6,"152,45",5,1,1,7,Mid-Value,Potential Loyalists
61020,250,2,"100,6",5,1,1,7,Mid-Value,Potential Loyalists
61021,852,6,"487,5",3,1,1,5,Low-Value,At Risk Customers
61023,366,4,"191,5",4,1,1,6,Mid-Value,Potential Loyalists
61024,26,11,"488,9",5,2,1,8,High-Value,Potential Loyalists
61025,3,5,"243,1",5,1,1,7,Mid-Value,Potential Loyalists
61026,298,4,"835,6999999999999",5,1,2,8,High-Value,Potential Loyalists
61027,85,3,"33,400000000000006",5,1,1,7,Mid-Value,Potential Loyalists
61029,770,2,"29,05",3,1,1,5,Low-Value,At Risk Customers
61031,596,1,"8,1",4,1,1,6,Mid-Value,Potential Loyalists
61032,283,6,"246,7",5,1,1,7,Mid-Value,Potential Loyalists
61033,3,2,"509,65",5,1,1,7,Mid-Value,Potential Loyalists
61034,77,6,"384,5",5,1,1,7,Mid-Value,Potential Loyalists
61035,1474,1,"48,6",1,1,1,3,Low-Value,Lost
61036,528,2,"118,4",4,1,1,6,Mid-Value,Potential Loyalists
61038,18,7,"532,6",5,2,1,8,High-Value,Potential Loyalists
61042,1680,1,"500,6",1,1,1,3,Low-Value,Lost
61043,1,8,"254,7",5,2,1,8,High-Value,Potential Loyalists
61044,402,4,"212,85000000000002",4,1,1,6,Mid-Value,Potential Loyalists
61045,584,4,"152,65",4,1,1,6,Mid-Value,Potential Loyalists
61046,652,3,"164,55",4,1,1,6,Mid-Value,Potential Loyalists
61047,352,1,"94,2",5,1,1,7,Mid-Value,Potential Loyalists
61048,19,3,"259,9",5,1,1,7,Mid-Value,Potential Loyalists
61050,1007,2,"41,05",3,1,1,5,Low-Value,At Risk Customers
61052,80,3,"49,3",5,1,1,7,Mid-Value,Potential Loyalists
61053,202,1,"22,9",5,1,1,7,Mid-Value,Potential Loyalists
61054,379,5,"358,6",4,1,1,6,Mid-Value,Potential Loyalists
61055,1588,5,"327,4",1,1,1,3,Low-Value,Lost
61059,956,2,"13,55",3,1,1,5,Low-Value,At Risk Customers
61060,155,1,"7,0",5,1,1,7,Mid-Value,Potential Loyalists
61061,1763,1,"45,05",1,1,1,3,Low-Value,Lost
61067,25,4,"490,65",5,1,1,7,Mid-Value,Potential Loyalists
61068,26,3,"142,6",5,1,1,7,Mid-Value,Potential Loyalists
61070,545,2,"124,05",4,1,1,6,Mid-Value,Potential Loyalists
61071,605,1,"17,25",4,1,1,6,Mid-Value,Potential Loyalists
61073,763,7,"860,8",3,2,2,7,Mid-Value,Potential Loyalists
61076,1408,4,"215,5",2,1,1,4,Low-Value,Can't Lose
61078,1256,1,"68,2",2,1,1,4,Low-Value,Can't Lose
61079,1195,1,"9,7",2,1,1,4,Low-Value,Can't Lose
61080,854,4,"309,05",3,1,1,5,Low-Value,At Risk Customers
61081,1428,1,"8,1",2,1,1,4,Low-Value,Can't Lose
61082,796,1,"48,45",3,1,1,5,Low-Value,At Risk Customers
61084,78,5,"263,55",5,1,1,7,Mid-Value,Potential Loyalists
61087,146,2,"196,2",5,1,1,7,Mid-Value,Potential Loyalists
61088,924,3,"938,85",3,1,2,6,Mid-Value,Potential Loyalists
61090,938,2,"103,4",3,1,1,5,Low-Value,At Risk Customers
61091,126,2,"101,7",5,1,1,7,Mid-Value,Potential Loyalists
61093,918,1,"286,5",3,1,1,5,Low-Value,At Risk Customers
61094,206,5,"121,85",5,1,1,7,Mid-Value,Potential Loyalists
61095,1193,1,"34,5",2,1,1,4,Low-Value,Can't Lose
61097,1136,1,"86,9",2,1,1,4,Low-Value,Can't Lose
61098,285,1,"30,3",5,1,1,7,Mid-Value,Potential Loyalists
61099,85,11,"476,4",5,2,1,8,High-Value,Potential Loyalists
61100,187,3,"736,5",5,1,2,8,High-Value,Potential Loyalists
61102,552,6,"502,05",4,1,1,6,Mid-Value,Potential Loyalists
61103,1001,2,"162,9",3,1,1,5,Low-Value,At Risk Customers
61104,48,3,"152,64999999999998",5,1,1,7,Mid-Value,Potential Loyalists
61107,95,4,"241,1",5,1,1,7,Mid-Value,Potential Loyalists
61108,97,3,"64,6",5,1,1,7,Mid-Value,Potential Loyalists
61109,1420,2,"27,15",2,1,1,4,Low-Value,Can't Lose
61110,1469,2,"96,85",1,1,1,3,Low-Value,Lost
61112,1362,1,"13,65",2,1,1,4,Low-Value,Can't Lose
61113,14,9,"1027,2",5,2,2,9,High-Value,Champions
61115,698,1,"12,85",4,1,1,6,Mid-Value,Potential Loyalists
61116,80,4,"268,4",5,1,1,7,Mid-Value,Potential Loyalists
61121,1578,1,"14,75",1,1,1,3,Low-Value,Lost
61122,1240,2,"230,6",2,1,1,4,Low-Value,Can't Lose
61124,69,11,"580,1",5,2,1,8,High-Value,Potential Loyalists
61127,269,1,"50,4",5,1,1,7,Mid-Value,Potential Loyalists
61128,54,6,"318,29999999999995",5,1,1,7,Mid-Value,Potential Loyalists
61129,312,8,"366,75",5,2,1,8,High-Value,Potential Loyalists
61131,419,9,"711,75",4,2,2,8,High-Value,Potential Loyalists
61132,1195,2,"44,449999999999996",2,1,1,4,Low-Value,Can't Lose
61133,1104,2,"97,9",2,1,1,4,Low-Value,Can't Lose
61135,1501,6,"243,9",1,1,1,3,Low-Value,Lost
61136,893,5,"203,65",3,1,1,5,Low-Value,At Risk Customers
61137,319,3,"257,25",5,1,1,7,Mid-Value,Potential Loyalists
61138,1230,2,"341,95000000000005",2,1,1,4,Low-Value,Can't Lose
61140,134,3,"102,0",5,1,1,7,Mid-Value,Potential Loyalists
61142,516,2,"215,10000000000002",4,1,1,6,Mid-Value,Potential Loyalists
61143,195,1,"66,2",5,1,1,7,Mid-Value,Potential Loyalists
61144,367,1,"214,4",4,1,1,6,Mid-Value,Potential Loyalists
61145,11,9,"180,1",5,2,1,8,High-Value,Potential Loyalists
61146,4,3,"1230,75",5,1,2,8,High-Value,Potential Loyalists
61148,888,3,"105,60000000000001",3,1,1,5,Low-Value,At Risk Customers
61152,118,7,"506,15",5,2,1,8,High-Value,Potential Loyalists
61153,1200,2,"60,4",2,1,1,4,Low-Value,Can't Lose
61154,482,4,"285,3",4,1,1,6,Mid-Value,Potential Loyalists
61155,243,4,"276,1",5,1,1,7,Mid-Value,Potential Loyalists
61156,1554,1,"18,2",1,1,1,3,Low-Value,Lost
61158,15,12,"923,45",5,3,2,10,High-Value,Champions
61163,1476,1,"21,2",1,1,1,3,Low-Value,Lost
61164,758,2,"484,9",3,1,1,5,Low-Value,At Risk Customers
61165,497,8,"296,75",4,2,1,7,Mid-Value,Potential Loyalists
61169,59,5,"192,39999999999998",5,1,1,7,Mid-Value,Potential Loyalists
61170,1603,2,"189,4",1,1,1,3,Low-Value,Lost
61171,73,2,"99,1",5,1,1,7,Mid-Value,Potential Loyalists
61172,457,2,"91,64999999999999",4,1,1,6,Mid-Value,Potential Loyalists
61174,1139,1,"11,65",2,1,1,4,Low-Value,Can't Lose
61176,11,5,"503,4",5,1,1,7,Mid-Value,Potential Loyalists
61178,1057,1,"18,95",3,1,1,5,Low-Value,At Risk Customers
61180,248,2,"74,6",5,1,1,7,Mid-Value,Potential Loyalists
61181,417,3,"133,7",4,1,1,6,Mid-Value,Potential Loyalists
61182,1767,1,"46,8",1,1,1,3,Low-Value,Lost
61185,1046,1,"10,5",3,1,1,5,Low-Value,At Risk Customers
61186,397,2,"131,6",4,1,1,6,Mid-Value,Potential Loyalists
61189,355,2,"108,05",5,1,1,7,Mid-Value,Potential Loyalists
61190,162,3,"238,6",5,1,1,7,Mid-Value,Potential Loyalists
61192,908,1,"148,64999999999998",3,1,1,5,Low-Value,At Risk Customers
61194,41,10,"416,95",5,2,1,8,High-Value,Potential Loyalists
61195,572,4,"124,1",4,1,1,6,Mid-Value,Potential Loyalists
61197,211,2,"287,34999999999997",5,1,1,7,Mid-Value,Potential Loyalists
61198,1059,3,"418,7",3,1,1,5,Low-Value,At Risk Customers
61199,48,1,"6,6",5,1,1,7,Mid-Value,Potential Loyalists
61200,20,13,"491,1",5,3,1,9,High-Value,Champions
61201,498,1,"117,25",4,1,1,6,Mid-Value,Potential Loyalists
61202,1229,2,"76,6",2,1,1,4,Low-Value,Can't Lose
61203,1477,2,"88,7",1,1,1,3,Low-Value,Lost
61205,21,4,"252,79999999999998",5,1,1,7,Mid-Value,Potential Loyalists
61207,8,4,"228,2",5,1,1,7,Mid-Value,Potential Loyalists
61208,1364,8,"532,95",2,2,1,5,Low-Value,At Risk Customers
61209,361,6,"370,0",5,1,1,7,Mid-Value,Potential Loyalists
61211,1402,1,"58,9",2,1,1,4,Low-Value,Can't Lose
61214,191,6,"772,7",5,1,2,8,High-Value,Potential Loyalists
61215,1483,1,"27,1",1,1,1,3,Low-Value,Lost
61216,1227,3,"46,75",2,1,1,4,Low-Value,Can't Lose
61217,272,2,"59,4",5,1,1,7,Mid-Value,Potential Loyalists
61218,1603,1,"21,4",1,1,1,3,Low-Value,Lost
61220,271,7,"558,45",5,2,1,8,High-Value,Potential Loyalists
61222,1497,2,"187,75",1,1,1,3,Low-Value,Lost
61223,769,2,"90,85000000000001",3,1,1,5,Low-Value,At Risk Customers
61226,1762,1,"48,7",1,1,1,3,Low-Value,Lost
61228,1670,1,"208,4",1,1,1,3,Low-Value,Lost
61230,1459,1,"15,55",2,1,1,4,Low-Value,Can't Lose
61232,1053,1,"160,6",3,1,1,5,Low-Value,At Risk Customers
61233,141,1,"8,25",5,1,1,7,Mid-Value,Potential Loyalists
61235,994,2,"34,35",3,1,1,5,Low-Value,At Risk Customers
61238,1106,5,"291,7",2,1,1,4,Low-Value,Can't Lose
61240,245,5,"219,89999999999998",5,1,1,7,Mid-Value,Potential Loyalists
61242,26,2,"49,300000000000004",5,1,1,7,Mid-Value,Potential Loyalists
61243,370,1,"17,85",4,1,1,6,Mid-Value,Potential Loyalists
61244,413,2,"240,10000000000002",4,1,1,6,Mid-Value,Potential Loyalists
61245,1288,2,"190,9",2,1,1,4,Low-Value,Can't Lose
61247,1117,2,"42,95",2,1,1,4,Low-Value,Can't Lose
61249,126,2,"78,75",5,1,1,7,Mid-Value,Potential Loyalists
61250,430,2,"406,20000000000005",4,1,1,6,Mid-Value,Potential Loyalists
61251,312,6,"286,40000000000003",5,1,1,7,Mid-Value,Potential Loyalists
61252,43,3,"336,05",5,1,1,7,Mid-Value,Potential Loyalists
61254,91,3,"112,19999999999999",5,1,1,7,Mid-Value,Potential Loyalists
61255,683,2,"59,4",4,1,1,6,Mid-Value,Potential Loyalists
61256,284,4,"221,65",5,1,1,7,Mid-Value,Potential Loyalists
61259,206,3,"84,7",5,1,1,7,Mid-Value,Potential Loyalists
61260,239,4,"159,0",5,1,1,7,Mid-Value,Potential Loyalists
61261,123,6,"435,75",5,1,1,7,Mid-Value,Potential Loyalists
61262,50,3,"193,89999999999998",5,1,1,7,Mid-Value,Potential Loyalists
61263,100,4,"701,9",5,1,2,8,High-Value,Potential Loyalists
61269,1388,1,"52,2",2,1,1,4,Low-Value,Can't Lose
61272,27,5,"290,29999999999995",5,1,1,7,Mid-Value,Potential Loyalists
61275,83,8,"442,85",5,2,1,8,High-Value,Potential Loyalists
61276,222,5,"143,15",5,1,1,7,Mid-Value,Potential Loyalists
61277,23,6,"312,8",5,1,1,7,Mid-Value,Potential Loyalists
61279,57,9,"292,45",5,2,1,8,High-Value,Potential Loyalists
61281,742,1,"188,8",3,1,1,5,Low-Value,At Risk Customers
61283,1800,1,"30,25",1,1,1,3,Low-Value,Lost
61284,1817,1,"19,45",1,1,1,3,Low-Value,Lost
61288,500,3,"147,25",4,1,1,6,Mid-Value,Potential Loyalists
61289,311,6,"325,0",5,1,1,7,Mid-Value,Potential Loyalists
61290,232,8,"643,05",5,2,1,8,High-Value,Potential Loyalists
61293,20,6,"294,4",5,1,1,7,Mid-Value,Potential Loyalists
61294,531,1,"61,6",4,1,1,6,Mid-Value,Potential Loyalists
61295,370,1,"35,0",4,1,1,6,Mid-Value,Potential Loyalists
61298,870,3,"418,0",3,1,1,5,Low-Value,At Risk Customers
61299,437,4,"178,75",4,1,1,6,Mid-Value,Potential Loyalists
61300,94,1,"232,4",5,1,1,7,Mid-Value,Potential Loyalists
61301,57,2,"38,4",5,1,1,7,Mid-Value,Potential Loyalists
61304,357,1,"91,55",5,1,1,7,Mid-Value,Potential Loyalists
61306,1691,1,"19,6",1,1,1,3,Low-Value,Lost
61307,599,3,"246,54999999999998",4,1,1,6,Mid-Value,Potential Loyalists
61308,167,1,"67,5",5,1,1,7,Mid-Value,Potential Loyalists
61310,32,2,"27,35",5,1,1,7,Mid-Value,Potential Loyalists
61311,1,2,"223,60000000000002",5,1,1,7,Mid-Value,Potential Loyalists
61312,1146,2,"124,1",2,1,1,4,Low-Value,Can't Lose
61313,1092,2,"272,05",3,1,1,5,Low-Value,At Risk Customers
61314,1260,1,"47,5",2,1,1,4,Low-Value,Can't Lose
61315,897,4,"626,75",3,1,1,5,Low-Value,At Risk Customers
61316,1777,1,"7,85",1,1,1,3,Low-Value,Lost
61317,486,4,"70,21000000000001",4,1,1,6,Mid-Value,Potential Loyalists
61320,951,1,"32,55",3,1,1,5,Low-Value,At Risk Customers
61321,589,3,"120,35",4,1,1,6,Mid-Value,Potential Loyalists
61322,25,1,"47,5",5,1,1,7,Mid-Value,Potential Loyalists
61324,430,2,"109,94999999999999",4,1,1,6,Mid-Value,Potential Loyalists
61325,288,4,"77,9",5,1,1,7,Mid-Value,Potential Loyalists
61326,851,1,"64,3",3,1,1,5,Low-Value,At Risk Customers
61328,620,2,"294,1",4,1,1,6,Mid-Value,Potential Loyalists
61330,1424,2,"225,85000000000002",2,1,1,4,Low-Value,Can't Lose
61332,441,3,"180,35",4,1,1,6,Mid-Value,Potential Loyalists
61333,887,3,"153,2",3,1,1,5,Low-Value,At Risk Customers
61334,1814,1,"7,35",1,1,1,3,Low-Value,Lost
61335,406,2,"127,55",4,1,1,6,Mid-Value,Potential Loyalists
61336,1641,1,"16,15",1,1,1,3,Low-Value,Lost
61339,55,5,"230,2",5,1,1,7,Mid-Value,Potential Loyalists
61340,369,3,"256,5",4,1,1,6,Mid-Value,Potential Loyalists
61342,25,3,"168,5",5,1,1,7,Mid-Value,Potential Loyalists
61343,58,5,"265,85",5,1,1,7,Mid-Value,Potential Loyalists
61344,1434,1,"62,9",2,1,1,4,Low-Value,Can't Lose
61345,64,4,"154,7",5,1,1,7,Mid-Value,Potential Loyalists
61347,477,2,"209,3",4,1,1,6,Mid-Value,Potential Loyalists
61350,1363,1,"169,35000000000002",2,1,1,4,Low-Value,Can't Lose
61355,353,1,"12,05",5,1,1,7,Mid-Value,Potential Loyalists
61356,75,2,"36,8",5,1,1,7,Mid-Value,Potential Loyalists
61360,322,1,"83,1",5,1,1,7,Mid-Value,Potential Loyalists
61363,95,5,"203,65",5,1,1,7,Mid-Value,Potential Loyalists
61364,418,3,"281,55",4,1,1,6,Mid-Value,Potential Loyalists
61367,284,1,"27,9",5,1,1,7,Mid-Value,Potential Loyalists
61368,94,3,"79,7",5,1,1,7,Mid-Value,Potential Loyalists
61369,100,2,"120,6",5,1,1,7,Mid-Value,Potential Loyalists
61370,558,1,"9,3",4,1,1,6,Mid-Value,Potential Loyalists
61373,456,1,"20,7",4,1,1,6,Mid-Value,Potential Loyalists
61374,1349,1,"145,35000000000002",2,1,1,4,Low-Value,Can't Lose
61375,812,1,"12,4",3,1,1,5,Low-Value,At Risk Customers
61376,566,4,"131,25",4,1,1,6,Mid-Value,Potential Loyalists
61378,3,12,"937,45",5,3,2,10,High-Value,Champions
61380,29,5,"310,15",5,1,1,7,Mid-Value,Potential Loyalists
61381,1410,1,"56,9",2,1,1,4,Low-Value,Can't Lose
61382,605,2,"252,74999999999997",4,1,1,6,Mid-Value,Potential Loyalists
61385,591,3,"269,45",4,1,1,6,Mid-Value,Potential Loyalists
61386,143,6,"323,05",5,1,1,7,Mid-Value,Potential Loyalists
61388,1297,2,"47,05",2,1,1,4,Low-Value,Can't Lose
61392,3,5,"116,82",5,1,1,7,Mid-Value,Potential Loyalists
61396,1167,3,"305,15",2,1,1,4,Low-Value,Can't Lose
61397,59,1,"52,8",5,1,1,7,Mid-Value,Potential Loyalists
61398,1520,2,"170,35",1,1,1,3,Low-Value,Lost
61399,528,8,"416,75",4,2,1,7,Mid-Value,Potential Loyalists
61400,557,3,"144,39999999999998",4,1,1,6,Mid-Value,Potential Loyalists
61401,60,12,"1496,5",5,3,3,11,High-Value,Champions
61403,176,2,"76,1",5,1,1,7,Mid-Value,Potential Loyalists
61404,714,1,"27,900000000000002",4,1,1,6,Mid-Value,Potential Loyalists
61405,176,6,"274,7",5,1,1,7,Mid-Value,Potential Loyalists
61406,258,1,"101,1",5,1,1,7,Mid-Value,Potential Loyalists
61408,1252,1,"158,0",2,1,1,4,Low-Value,Can't Lose
61409,803,3,"333,1",3,1,1,5,Low-Value,At Risk Customers
61414,21,6,"440,5",5,1,1,7,Mid-Value,Potential Loyalists
61415,29,3,"116,85",5,1,1,7,Mid-Value,Potential Loyalists
61416,91,2,"41,45",5,1,1,7,Mid-Value,Potential Loyalists
61417,1028,5,"285,35",3,1,1,5,Low-Value,At Risk Customers
61421,1529,1,"21,75",1,1,1,3,Low-Value,Lost
61422,96,6,"234,7",5,1,1,7,Mid-Value,Potential Loyalists
61424,41,4,"225,55",5,1,1,7,Mid-Value,Potential Loyalists
61425,323,1,"17,3",5,1,1,7,Mid-Value,Potential Loyalists
61426,1714,1,"24,0",1,1,1,3,Low-Value,Lost
61431,124,7,"331,9",5,2,1,8,High-Value,Potential Loyalists
61432,647,1,"5,6",4,1,1,6,Mid-Value,Potential Loyalists
61434,403,4,"112,5",4,1,1,6,Mid-Value,Potential Loyalists
61435,462,5,"429,3",4,1,1,6,Mid-Value,Potential Loyalists
61437,701,1,"5,2",4,1,1,6,Mid-Value,Potential Loyalists
61438,19,1,"12,9",5,1,1,7,Mid-Value,Potential Loyalists
61440,1466,1,"233,2",1,1,1,3,Low-Value,Lost
61441,81,3,"164,4",5,1,1,7,Mid-Value,Potential Loyalists
61443,532,7,"387,8",4,2,1,7,Mid-Value,Potential Loyalists
61444,26,10,"792,65",5,2,2,9,High-Value,Champions
61445,119,5,"157,4",5,1,1,7,Mid-Value,Potential Loyalists
61449,1202,1,"49,0",2,1,1,4,Low-Value,Can't Lose
61451,852,4,"187,7",3,1,1,5,Low-Value,At Risk Customers
61452,522,7,"367,25",4,2,1,7,Mid-Value,Potential Loyalists
61454,880,9,"809,35",3,2,2,7,Mid-Value,Potential Loyalists
61455,144,2,"173,1",5,1,1,7,Mid-Value,Potential Loyalists
61457,959,2,"58,9",3,1,1,5,Low-Value,At Risk Customers
61458,230,6,"357,45",5,1,1,7,Mid-Value,Potential Loyalists
61460,129,1,"30,7",5,1,1,7,Mid-Value,Potential Loyalists
61462,501,2,"178,8",4,1,1,6,Mid-Value,Potential Loyalists
61464,348,4,"204,25",5,1,1,7,Mid-Value,Potential Loyalists
61468,1140,2,"70,44999999999999",2,1,1,4,Low-Value,Can't Lose
61469,544,6,"307,1",4,1,1,6,Mid-Value,Potential Loyalists
61471,267,1,"13,4",5,1,1,7,Mid-Value,Potential Loyalists
61472,573,1,"34,5",4,1,1,6,Mid-Value,Potential Loyalists
61473,61,7,"482,6",5,2,1,8,High-Value,Potential Loyalists
61474,20,1,"506,4",5,1,1,7,Mid-Value,Potential Loyalists
61475,378,4,"187,95",4,1,1,6,Mid-Value,Potential Loyalists
61476,31,14,"666,1",5,3,2,10,High-Value,Champions
61477,1237,1,"69,9",2,1,1,4,Low-Value,Can't Lose
61478,523,3,"1006,0",4,1,2,7,Mid-Value,Potential Loyalists
61480,1520,1,"9,45",1,1,1,3,Low-Value,Lost
61483,32,3,"127,5",5,1,1,7,Mid-Value,Potential Loyalists
61484,127,5,"93,75",5,1,1,7,Mid-Value,Potential Loyalists
61485,55,6,"199,9",5,1,1,7,Mid-Value,Potential Loyalists
61486,237,2,"23,450000000000003",5,1,1,7,Mid-Value,Potential Loyalists
61487,33,12,"322,05",5,3,1,9,High-Value,Champions
61488,374,4,"369,4",4,1,1,6,Mid-Value,Potential Loyalists
61489,96,3,"231,9",5,1,1,7,Mid-Value,Potential Loyalists
61490,133,6,"260,3",5,1,1,7,Mid-Value,Potential Loyalists
61491,356,6,"1719,3",5,1,3,9,High-Value,Champions
61494,80,11,"759,8",5,2,2,9,High-Value,Champions
61495,437,1,"16,55",4,1,1,6,Mid-Value,Potential Loyalists
61496,475,2,"114,5",4,1,1,6,Mid-Value,Potential Loyalists
61497,809,5,"351,96000000000004",3,1,1,5,Low-Value,At Risk Customers
61498,764,6,"370,95",3,1,1,5,Low-Value,At Risk Customers
61499,1124,5,"337,55",2,1,1,4,Low-Value,Can't Lose
61500,47,5,"971,65",5,1,2,8,High-Value,Potential Loyalists
61504,1427,1,"38,35",2,1,1,4,Low-Value,Can't Lose
61507,866,1,"14,5",3,1,1,5,Low-Value,At Risk Customers
61508,404,2,"297,2",4,1,1,6,Mid-Value,Potential Loyalists
61509,1728,1,"241,0",1,1,1,3,Low-Value,Lost
61516,115,7,"232,64999999999998",5,2,1,8,High-Value,Potential Loyalists
61517,893,9,"234,75",3,2,1,6,Mid-Value,Potential Loyalists
61519,140,3,"62,71",5,1,1,7,Mid-Value,Potential Loyalists
61520,935,5,"137,8",3,1,1,5,Low-Value,At Risk Customers
61521,978,1,"27,3",3,1,1,5,Low-Value,At Risk Customers
61523,1,3,"1128,05",5,1,2,8,High-Value,Potential Loyalists
61524,422,8,"380,9",4,2,1,7,Mid-Value,Potential Loyalists
61526,821,4,"212,75",3,1,1,5,Low-Value,At Risk Customers
61531,624,1,"40,0",4,1,1,6,Mid-Value,Potential Loyalists
61532,499,11,"1103,85",4,2,2,8,High-Value,Potential Loyalists
61534,1284,2,"308,59999999999997",2,1,1,4,Low-Value,Can't Lose
61535,11,9,"373,6",5,2,1,8,High-Value,Potential Loyalists
61537,271,7,"621,65",5,2,1,8,High-Value,Potential Loyalists
61538,1261,3,"116,94999999999999",2,1,1,4,Low-Value,Can't Lose
61539,1242,3,"254,65",2,1,1,4,Low-Value,Can't Lose
61542,565,5,"466,2",4,1,1,6,Mid-Value,Potential Loyalists
61543,850,5,"158,7",3,1,1,5,Low-Value,At Risk Customers
61544,25,3,"87,19999999999999",5,1,1,7,Mid-Value,Potential Loyalists
61545,888,5,"227,29999999999998",3,1,1,5,Low-Value,At Risk Customers
61548,473,2,"98,7",4,1,1,6,Mid-Value,Potential Loyalists
61549,192,3,"235,25",5,1,1,7,Mid-Value,Potential Loyalists
61550,244,9,"415,05",5,2,1,8,High-Value,Potential Loyalists
61551,52,5,"356,45",5,1,1,7,Mid-Value,Potential Loyalists
61553,318,1,"84,3",5,1,1,7,Mid-Value,Potential Loyalists
61554,718,5,"302,45",4,1,1,6,Mid-Value,Potential Loyalists
61556,987,2,"96,64999999999999",3,1,1,5,Low-Value,At Risk Customers
61557,183,2,"234,8",5,1,1,7,Mid-Value,Potential Loyalists
61558,31,1,"14,45",5,1,1,7,Mid-Value,Potential Loyalists
61559,329,1,"16,05",5,1,1,7,Mid-Value,Potential Loyalists
61560,1320,1,"120,0",2,1,1,4,Low-Value,Can't Lose
61561,612,4,"97,2",4,1,1,6,Mid-Value,Potential Loyalists
61564,635,2,"81,75",4,1,1,6,Mid-Value,Potential Loyalists
61566,267,1,"10,3",5,1,1,7,Mid-Value,Potential Loyalists
61570,582,1,"34,5",4,1,1,6,Mid-Value,Potential Loyalists
61571,1117,1,"154,64999999999998",2,1,1,4,Low-Value,Can't Lose
61573,180,3,"226,79999999999998",5,1,1,7,Mid-Value,Potential Loyalists
61574,149,2,"650,0500000000001",5,1,1,7,Mid-Value,Potential Loyalists
61575,259,3,"73,75",5,1,1,7,Mid-Value,Potential Loyalists
61576,9,3,"60,1",5,1,1,7,Mid-Value,Potential Loyalists
61577,111,4,"244,65",5,1,1,7,Mid-Value,Potential Loyalists
61579,1081,1,"174,3",3,1,1,5,Low-Value,At Risk Customers
61580,116,2,"114,05",5,1,1,7,Mid-Value,Potential Loyalists
61583,707,2,"21,5",4,1,1,6,Mid-Value,Potential Loyalists
61584,11,7,"430,8",5,2,1,8,High-Value,Potential Loyalists
61585,114,7,"415,1",5,2,1,8,High-Value,Potential Loyalists
61587,772,1,"16,8",3,1,1,5,Low-Value,At Risk Customers
61588,25,3,"104,4",5,1,1,7,Mid-Value,Potential Loyalists
61589,77,2,"51,949999999999996",5,1,1,7,Mid-Value,Potential Loyalists
61590,1334,1,"7,25",2,1,1,4,Low-Value,Can't Lose
61593,440,4,"245,55",4,1,1,6,Mid-Value,Potential Loyalists
61594,34,6,"511,7",5,1,1,7,Mid-Value,Potential Loyalists
61596,1473,1,"21,2",1,1,1,3,Low-Value,Lost
61598,391,1,"67,9",4,1,1,6,Mid-Value,Potential Loyalists
61599,192,1,"84,0",5,1,1,7,Mid-Value,Potential Loyalists
61600,740,1,"143,6",3,1,1,5,Low-Value,At Risk Customers
61601,1168,1,"23,75",2,1,1,4,Low-Value,Can't Lose
61603,784,4,"97,9",3,1,1,5,Low-Value,At Risk Customers
61604,144,2,"70,7",5,1,1,7,Mid-Value,Potential Loyalists
61608,199,2,"149,7",5,1,1,7,Mid-Value,Potential Loyalists
61610,227,3,"100,45",5,1,1,7,Mid-Value,Potential Loyalists
61612,216,1,"9,55",5,1,1,7,Mid-Value,Potential Loyalists
61613,1137,1,"21,8",2,1,1,4,Low-Value,Can't Lose
61614,419,3,"318,8",4,1,1,6,Mid-Value,Potential Loyalists
61615,1191,1,"88,5",2,1,1,4,Low-Value,Can't Lose
61616,553,1,"58,0",4,1,1,6,Mid-Value,Potential Loyalists
61619,103,3,"191,3",5,1,1,7,Mid-Value,Potential Loyalists
61621,716,4,"267,85",4,1,1,6,Mid-Value,Potential Loyalists
61623,139,12,"1095,83",5,3,2,10,High-Value,Champions
61624,643,8,"406,5",4,2,1,7,Mid-Value,Potential Loyalists
61626,358,4,"203,4",5,1,1,7,Mid-Value,Potential Loyalists
61627,1120,1,"23,9",2,1,1,4,Low-Value,Can't Lose
61628,12,3,"139,7",5,1,1,7,Mid-Value,Potential Loyalists
61630,357,2,"258,9",5,1,1,7,Mid-Value,Potential Loyalists
61631,321,2,"148,4",5,1,1,7,Mid-Value,Potential Loyalists
61632,489,6,"320,95",4,1,1,6,Mid-Value,Potential Loyalists
61634,1277,4,"384,9",2,1,1,4,Low-Value,Can't Lose
61635,779,4,"95,14999999999999",3,1,1,5,Low-Value,At Risk Customers
61636,259,2,"38,25",5,1,1,7,Mid-Value,Potential Loyalists
61637,214,5,"194,55",5,1,1,7,Mid-Value,Potential Loyalists
61638,524,2,"167,85",4,1,1,6,Mid-Value,Potential Loyalists
61640,608,2,"46,400000000000006",4,1,1,6,Mid-Value,Potential Loyalists
61642,129,7,"184,2",5,2,1,8,High-Value,Potential Loyalists
61650,376,8,"507,25",4,2,1,7,Mid-Value,Potential Loyalists
61653,125,3,"180,4",5,1,1,7,Mid-Value,Potential Loyalists
61654,1641,1,"173,0",1,1,1,3,Low-Value,Lost
61655,1765,1,"10,75",1,1,1,3,Low-Value,Lost
61657,307,6,"232,35",5,1,1,7,Mid-Value,Potential Loyalists
61658,7,8,"596,1",5,2,1,8,High-Value,Potential Loyalists
61659,430,1,"46,05",4,1,1,6,Mid-Value,Potential Loyalists
61660,461,6,"313,4",4,1,1,6,Mid-Value,Potential Loyalists
61664,1589,1,"91,5",1,1,1,3,Low-Value,Lost
61665,1489,2,"59,1",1,1,1,3,Low-Value,Lost
61666,596,2,"31,200000000000003",4,1,1,6,Mid-Value,Potential Loyalists
61667,564,1,"579,9",4,1,1,6,Mid-Value,Potential Loyalists
61669,552,2,"170,8",4,1,1,6,Mid-Value,Potential Loyalists
61670,717,1,"304,1",4,1,1,6,Mid-Value,Potential Loyalists
61671,361,5,"373,15",5,1,1,7,Mid-Value,Potential Loyalists
61674,396,3,"78,19999999999999",4,1,1,6,Mid-Value,Potential Loyalists
61675,631,3,"49,35",4,1,1,6,Mid-Value,Potential Loyalists
61679,264,5,"321,6",5,1,1,7,Mid-Value,Potential Loyalists
61680,177,1,"169,8",5,1,1,7,Mid-Value,Potential Loyalists
61682,224,4,"106,69999999999999",5,1,1,7,Mid-Value,Potential Loyalists
61684,1104,2,"216,1",2,1,1,4,Low-Value,Can't Lose
61686,706,1,"59,8",4,1,1,6,Mid-Value,Potential Loyalists
61687,424,2,"25,5",4,1,1,6,Mid-Value,Potential Loyalists
61688,1426,1,"154,55",2,1,1,4,Low-Value,Can't Lose
61689,1383,1,"89,0",2,1,1,4,Low-Value,Can't Lose
61691,14,2,"92,5",5,1,1,7,Mid-Value,Potential Loyalists
61692,48,6,"192,95",5,1,1,7,Mid-Value,Potential Loyalists
61693,57,8,"311,2",5,2,1,8,High-Value,Potential Loyalists
61698,243,3,"262,0",5,1,1,7,Mid-Value,Potential Loyalists
61699,4,6,"203,1",5,1,1,7,Mid-Value,Potential Loyalists
61700,1397,1,"117,2",2,1,1,4,Low-Value,Can't Lose
61702,92,10,"337,35",5,2,1,8,High-Value,Potential Loyalists
61705,394,1,"58,6",4,1,1,6,Mid-Value,Potential Loyalists
61706,526,3,"110,45",4,1,1,6,Mid-Value,Potential Loyalists
61707,23,3,"180,0",5,1,1,7,Mid-Value,Potential Loyalists
61709,538,3,"313,15",4,1,1,6,Mid-Value,Potential Loyalists
61711,752,2,"93,0",3,1,1,5,Low-Value,At Risk Customers
61714,381,7,"470,7",4,2,1,7,Mid-Value,Potential Loyalists
61717,238,3,"194,15",5,1,1,7,Mid-Value,Potential Loyalists
61718,62,7,"521,75",5,2,1,8,High-Value,Potential Loyalists
61719,166,6,"266,75",5,1,1,7,Mid-Value,Potential Loyalists
61720,668,4,"87,25",4,1,1,6,Mid-Value,Potential Loyalists
61722,1105,3,"122,65",2,1,1,4,Low-Value,Can't Lose
61723,265,8,"579,6500000000001",5,2,1,8,High-Value,Potential Loyalists
61725,1224,3,"98,9",2,1,1,4,Low-Value,Can't Lose
61730,220,8,"168,3",5,2,1,8,High-Value,Potential Loyalists
61731,881,1,"73,94999999999999",3,1,1,5,Low-Value,At Risk Customers
61732,1068,2,"47,4",3,1,1,5,Low-Value,At Risk Customers
61733,65,3,"143,45",5,1,1,7,Mid-Value,Potential Loyalists
61734,221,9,"268,65000000000003",5,2,1,8,High-Value,Potential Loyalists
61735,367,3,"859,1999999999999",4,1,2,7,Mid-Value,Potential Loyalists
61736,1377,1,"58,0",2,1,1,4,Low-Value,Can't Lose
61738,164,2,"308,95",5,1,1,7,Mid-Value,Potential Loyalists
61739,635,3,"424,45",4,1,1,6,Mid-Value,Potential Loyalists
61742,1728,1,"28,7",1,1,1,3,Low-Value,Lost
61743,7,7,"644,9499999999999",5,2,1,8,High-Value,Potential Loyalists
61744,511,2,"36,35",4,1,1,6,Mid-Value,Potential Loyalists
61745,15,5,"365,25",5,1,1,7,Mid-Value,Potential Loyalists
61749,636,3,"141,15",4,1,1,6,Mid-Value,Potential Loyalists
61750,341,1,"6,45",5,1,1,7,Mid-Value,Potential Loyalists
61753,308,3,"135,05",5,1,1,7,Mid-Value,Potential Loyalists
61758,14,5,"340,15",5,1,1,7,Mid-Value,Potential Loyalists
61759,1067,2,"85,9",3,1,1,5,Low-Value,At Risk Customers
61760,53,4,"247,45",5,1,1,7,Mid-Value,Potential Loyalists
61761,682,5,"255,55",4,1,1,6,Mid-Value,Potential Loyalists
61763,989,3,"107,0",3,1,1,5,Low-Value,At Risk Customers
61764,553,8,"265,85",4,2,1,7,Mid-Value,Potential Loyalists
61765,1078,3,"154,09999999999997",3,1,1,5,Low-Value,At Risk Customers
61768,433,6,"225,35000000000002",4,1,1,6,Mid-Value,Potential Loyalists
61769,560,7,"313,35",4,2,1,7,Mid-Value,Potential Loyalists
61770,449,2,"48,95",4,1,1,6,Mid-Value,Potential Loyalists
61772,4,2,"278,7",5,1,1,7,Mid-Value,Potential Loyalists
61774,63,2,"183,05",5,1,1,7,Mid-Value,Potential Loyalists
61775,925,2,"86,75",3,1,1,5,Low-Value,At Risk Customers
61777,1245,2,"541,9",2,1,1,4,Low-Value,Can't Lose
61778,195,3,"117,65",5,1,1,7,Mid-Value,Potential Loyalists
61780,5,6,"260,15",5,1,1,7,Mid-Value,Potential Loyalists
61781,930,4,"444,0",3,1,1,5,Low-Value,At Risk Customers
61782,369,3,"109,95",4,1,1,6,Mid-Value,Potential Loyalists
61784,452,2,"155,5",4,1,1,6,Mid-Value,Potential Loyalists
61786,827,3,"228,0",3,1,1,5,Low-Value,At Risk Customers
61787,30,1,"29,3",5,1,1,7,Mid-Value,Potential Loyalists
61788,1415,1,"10,23",2,1,1,4,Low-Value,Can't Lose
61789,307,7,"778,65",5,2,2,9,High-Value,Champions
61790,1040,2,"164,45",3,1,1,5,Low-Value,At Risk Customers
61791,319,3,"300,04999999999995",5,1,1,7,Mid-Value,Potential Loyalists
61792,362,4,"580,5",5,1,1,7,Mid-Value,Potential Loyalists
61794,720,1,"42,4",4,1,1,6,Mid-Value,Potential Loyalists
61797,34,2,"242,85",5,1,1,7,Mid-Value,Potential Loyalists
61798,947,1,"52,35",3,1,1,5,Low-Value,At Risk Customers
61799,1530,2,"503,25",1,1,1,3,Low-Value,Lost
61800,1011,2,"73,25",3,1,1,5,Low-Value,At Risk Customers
61801,486,3,"213,6",4,1,1,6,Mid-Value,Potential Loyalists
61802,69,3,"42,55",5,1,1,7,Mid-Value,Potential Loyalists
61803,953,4,"249,7",3,1,1,5,Low-Value,At Risk Customers
61804,892,4,"393,5",3,1,1,5,Low-Value,At Risk Customers
61805,157,1,"238,3",5,1,1,7,Mid-Value,Potential Loyalists
61806,1484,1,"92,55000000000001",1,1,1,3,Low-Value,Lost
61808,302,4,"323,1",5,1,1,7,Mid-Value,Potential Loyalists
61809,218,3,"73,8",5,1,1,7,Mid-Value,Potential Loyalists
61811,727,1,"10,45",4,1,1,6,Mid-Value,Potential Loyalists
61812,504,7,"387,25",4,2,1,7,Mid-Value,Potential Loyalists
61813,12,1,"348,6",5,1,1,7,Mid-Value,Potential Loyalists
61814,895,3,"283,59999999999997",3,1,1,5,Low-Value,At Risk Customers
61815,746,3,"80,6",3,1,1,5,Low-Value,At Risk Customers
61816,10,12,"666,65",5,3,2,10,High-Value,Champions
61817,1223,2,"64,9",2,1,1,4,Low-Value,Can't Lose
61818,637,4,"509,3",4,1,1,6,Mid-Value,Potential Loyalists
61820,82,6,"466,55",5,1,1,7,Mid-Value,Potential Loyalists
61821,760,1,"55,6",3,1,1,5,Low-Value,At Risk Customers
61823,144,5,"315,85",5,1,1,7,Mid-Value,Potential Loyalists
61824,463,2,"18,299999999999997",4,1,1,6,Mid-Value,Potential Loyalists
61825,1659,1,"180,1",1,1,1,3,Low-Value,Lost
61827,1406,1,"21,5",2,1,1,4,Low-Value,Can't Lose
61829,449,6,"173,2",4,1,1,6,Mid-Value,Potential Loyalists
61830,951,3,"238,2",3,1,1,5,Low-Value,At Risk Customers
61832,339,3,"85,85",5,1,1,7,Mid-Value,Potential Loyalists
61834,28,3,"129,25",5,1,1,7,Mid-Value,Potential Loyalists
61835,319,1,"29,75",5,1,1,7,Mid-Value,Potential Loyalists
61836,882,1,"19,8",3,1,1,5,Low-Value,At Risk Customers
61837,147,1,"1,9500000000000002",5,1,1,7,Mid-Value,Potential Loyalists
61839,192,4,"458,45",5,1,1,7,Mid-Value,Potential Loyalists
61840,803,1,"11,7",3,1,1,5,Low-Value,At Risk Customers
61842,23,4,"142,8",5,1,1,7,Mid-Value,Potential Loyalists
61843,48,1,"104,65",5,1,1,7,Mid-Value,Potential Loyalists
61844,589,1,"37,85",4,1,1,6,Mid-Value,Potential Loyalists
61846,445,3,"294,85",4,1,1,6,Mid-Value,Potential Loyalists
61847,385,6,"552,2",4,1,1,6,Mid-Value,Potential Loyalists
61850,20,2,"218,1",5,1,1,7,Mid-Value,Potential Loyalists
61851,331,5,"258,2",5,1,1,7,Mid-Value,Potential Loyalists
61852,585,6,"342,45",4,1,1,6,Mid-Value,Potential Loyalists
61853,23,6,"300,4",5,1,1,7,Mid-Value,Potential Loyalists
61854,10,4,"227,65",5,1,1,7,Mid-Value,Potential Loyalists
61855,1631,2,"57,7",1,1,1,3,Low-Value,Lost
61856,198,7,"742,0500000000001",5,2,2,9,High-Value,Champions
61857,11,2,"378,95",5,1,1,7,Mid-Value,Potential Loyalists
61858,697,3,"81,65",4,1,1,6,Mid-Value,Potential Loyalists
61861,588,4,"357,8",4,1,1,6,Mid-Value,Potential Loyalists
61863,268,1,"11,5",5,1,1,7,Mid-Value,Potential Loyalists
61864,239,3,"113,30000000000001",5,1,1,7,Mid-Value,Potential Loyalists
61865,450,15,"846,8",4,3,2,9,High-Value,Champions
61866,28,2,"73,5",5,1,1,7,Mid-Value,Potential Loyalists
61867,1077,1,"26,35",3,1,1,5,Low-Value,At Risk Customers
61871,116,5,"682,8499999999999",5,1,2,8,High-Value,Potential Loyalists
61872,727,6,"295,75",4,1,1,6,Mid-Value,Potential Loyalists
61873,912,2,"66,25",3,1,1,5,Low-Value,At Risk Customers
61874,7,5,"257,04999999999995",5,1,1,7,Mid-Value,Potential Loyalists
61875,23,2,"958,8",5,1,2,8,High-Value,Potential Loyalists
61877,183,4,"472,9",5,1,1,7,Mid-Value,Potential Loyalists
61878,393,1,"270,0",4,1,1,6,Mid-Value,Potential Loyalists
61879,361,1,"228,2",5,1,1,7,Mid-Value,Potential Loyalists
61881,250,1,"72,15",5,1,1,7,Mid-Value,Potential Loyalists
61882,792,1,"11,1",3,1,1,5,Low-Value,At Risk Customers
61883,416,6,"178,35",4,1,1,6,Mid-Value,Potential Loyalists
61884,514,1,"82,8",4,1,1,6,Mid-Value,Potential Loyalists
61885,705,4,"111,65",4,1,1,6,Mid-Value,Potential Loyalists
61887,1180,2,"127,75",2,1,1,4,Low-Value,Can't Lose
61888,156,7,"244,95",5,2,1,8,High-Value,Potential Loyalists
61890,630,3,"77,75",4,1,1,6,Mid-Value,Potential Loyalists
61892,880,1,"85,35",3,1,1,5,Low-Value,At Risk Customers
61893,131,3,"307,6",5,1,1,7,Mid-Value,Potential Loyalists
61897,327,2,"40,25",5,1,1,7,Mid-Value,Potential Loyalists
61900,47,10,"595,3",5,2,1,8,High-Value,Potential Loyalists
61902,1181,3,"353,4",2,1,1,4,Low-Value,Can't Lose
61903,1040,2,"153,95000000000002",3,1,1,5,Low-Value,At Risk Customers
61904,756,2,"387,34999999999997",3,1,1,5,Low-Value,At Risk Customers
61907,396,3,"131,85",4,1,1,6,Mid-Value,Potential Loyalists
61910,959,3,"242,55",3,1,1,5,Low-Value,At Risk Customers
61911,1271,1,"27,5",2,1,1,4,Low-Value,Can't Lose
61912,92,4,"195,3",5,1,1,7,Mid-Value,Potential Loyalists
61913,1627,2,"159,5",1,1,1,3,Low-Value,Lost
61914,98,2,"88,85",5,1,1,7,Mid-Value,Potential Loyalists
61915,102,1,"61,6",5,1,1,7,Mid-Value,Potential Loyalists
61916,1814,1,"48,8",1,1,1,3,Low-Value,Lost
61918,345,3,"75,85000000000001",5,1,1,7,Mid-Value,Potential Loyalists
61919,136,7,"470,79999999999995",5,2,1,8,High-Value,Potential Loyalists
61923,391,2,"29,75",4,1,1,6,Mid-Value,Potential Loyalists
61924,382,2,"34,7",4,1,1,6,Mid-Value,Potential Loyalists
61926,222,2,"39,4",5,1,1,7,Mid-Value,Potential Loyalists
61927,1182,2,"50,25",2,1,1,4,Low-Value,Can't Lose
61928,377,2,"86,8",4,1,1,6,Mid-Value,Potential Loyalists
61930,560,2,"61,2",4,1,1,6,Mid-Value,Potential Loyalists
61931,424,2,"63,75",4,1,1,6,Mid-Value,Potential Loyalists
61933,1643,1,"54,0",1,1,1,3,Low-Value,Lost
61935,163,2,"74,94999999999999",5,1,1,7,Mid-Value,Potential Loyalists
61936,51,1,"15,6",5,1,1,7,Mid-Value,Potential Loyalists
61937,453,6,"334,7",4,1,1,6,Mid-Value,Potential Loyalists
61938,381,7,"385,8",4,2,1,7,Mid-Value,Potential Loyalists
61939,287,3,"85,7",5,1,1,7,Mid-Value,Potential Loyalists
61942,778,3,"140,15",3,1,1,5,Low-Value,At Risk Customers
61943,90,14,"1123,35",5,3,2,10,High-Value,Champions
61946,1305,2,"126,19999999999999",2,1,1,4,Low-Value,Can't Lose
61948,61,8,"303,85",5,2,1,8,High-Value,Potential Loyalists
61950,22,11,"504,15000000000003",5,2,1,8,High-Value,Potential Loyalists
61952,725,3,"49,3",4,1,1,6,Mid-Value,Potential Loyalists
61954,1143,1,"24,8",2,1,1,4,Low-Value,Can't Lose
61955,783,1,"10,8",3,1,1,5,Low-Value,At Risk Customers
61956,1099,3,"187,15",2,1,1,4,Low-Value,Can't Lose
61958,528,3,"91,75",4,1,1,6,Mid-Value,Potential Loyalists
61959,1575,2,"252,29999999999998",1,1,1,3,Low-Value,Lost
61960,925,2,"189,0",3,1,1,5,Low-Value,At Risk Customers
61961,4,7,"355,05",5,2,1,8,High-Value,Potential Loyalists
61963,1266,1,"23,6",2,1,1,4,Low-Value,Can't Lose
61964,1176,1,"33,25",2,1,1,4,Low-Value,Can't Lose
61965,788,3,"833,7",3,1,2,6,Mid-Value,Potential Loyalists
61966,1216,2,"119,5",2,1,1,4,Low-Value,Can't Lose
61968,522,3,"60,3",4,1,1,6,Mid-Value,Potential Loyalists
61969,136,5,"339,95",5,1,1,7,Mid-Value,Potential Loyalists
61971,280,6,"225,75",5,1,1,7,Mid-Value,Potential Loyalists
61972,623,8,"335,9",4,2,1,7,Mid-Value,Potential Loyalists
61973,669,2,"260,05",4,1,1,6,Mid-Value,Potential Loyalists
61974,282,2,"96,85",5,1,1,7,Mid-Value,Potential Loyalists
61978,142,3,"300,65",5,1,1,7,Mid-Value,Potential Loyalists
61979,454,6,"467,25",4,1,1,6,Mid-Value,Potential Loyalists
61982,732,4,"277,1",3,1,1,5,Low-Value,At Risk Customers
61983,13,3,"178,20000000000002",5,1,1,7,Mid-Value,Potential Loyalists
61984,367,2,"113,7",4,1,1,6,Mid-Value,Potential Loyalists
61985,732,4,"97,3",3,1,1,5,Low-Value,At Risk Customers
61987,14,5,"227,20000000000002",5,1,1,7,Mid-Value,Potential Loyalists
61988,60,4,"168,35000000000002",5,1,1,7,Mid-Value,Potential Loyalists
61989,651,2,"72,4",4,1,1,6,Mid-Value,Potential Loyalists
61991,154,1,"8,9",5,1,1,7,Mid-Value,Potential Loyalists
61994,138,1,"398,0",5,1,1,7,Mid-Value,Potential Loyalists
61995,336,4,"61,400000000000006",5,1,1,7,Mid-Value,Potential Loyalists
61996,332,2,"43,8",5,1,1,7,Mid-Value,Potential Loyalists
61997,192,5,"552,0",5,1,1,7,Mid-Value,Potential Loyalists
61998,541,2,"118,9",4,1,1,6,Mid-Value,Potential Loyalists
62000,213,6,"692,95",5,1,2,8,High-Value,Potential Loyalists
62001,823,2,"187,9",3,1,1,5,Low-Value,At Risk Customers
62002,775,4,"188,2",3,1,1,5,Low-Value,At Risk Customers
62003,582,1,"2,95",4,1,1,6,Mid-Value,Potential Loyalists
62004,964,1,"12,5",3,1,1,5,Low-Value,At Risk Customers
62005,528,4,"301,9",4,1,1,6,Mid-Value,Potential Loyalists
62006,1362,3,"277,7",2,1,1,4,Low-Value,Can't Lose
62007,133,4,"393,65",5,1,1,7,Mid-Value,Potential Loyalists
62013,571,1,"27,0",4,1,1,6,Mid-Value,Potential Loyalists
62015,1260,3,"141,3",2,1,1,4,Low-Value,Can't Lose
62016,1480,1,"109,5",1,1,1,3,Low-Value,Lost
62017,1602,1,"34,35",1,1,1,3,Low-Value,Lost
62019,370,6,"505,0",4,1,1,6,Mid-Value,Potential Loyalists
62021,109,2,"80,5",5,1,1,7,Mid-Value,Potential Loyalists
62023,130,7,"418,29999999999995",5,2,1,8,High-Value,Potential Loyalists
62025,22,4,"245,2",5,1,1,7,Mid-Value,Potential Loyalists
62026,14,3,"170,89999999999998",5,1,1,7,Mid-Value,Potential Loyalists
62027,15,3,"224,75",5,1,1,7,Mid-Value,Potential Loyalists
62029,511,3,"131,15",4,1,1,6,Mid-Value,Potential Loyalists
62030,74,11,"487,8",5,2,1,8,High-Value,Potential Loyalists
62031,682,5,"868,0000000000001",4,1,2,7,Mid-Value,Potential Loyalists
62032,342,4,"574,7",5,1,1,7,Mid-Value,Potential Loyalists
62036,46,3,"68,21000000000001",5,1,1,7,Mid-Value,Potential Loyalists
62037,1346,1,"14,35",2,1,1,4,Low-Value,Can't Lose
62039,9,7,"316,9",5,2,1,8,High-Value,Potential Loyalists
62040,146,1,"8,7",5,1,1,7,Mid-Value,Potential Loyalists
62041,416,11,"912,65",4,2,2,8,High-Value,Potential Loyalists
62042,1808,1,"10,45",1,1,1,3,Low-Value,Lost
62044,12,7,"434,15",5,2,1,8,High-Value,Potential Loyalists
62045,579,1,"15,0",4,1,1,6,Mid-Value,Potential Loyalists
62047,1285,2,"111,4",2,1,1,4,Low-Value,Can't Lose
62049,1321,1,"31,8",2,1,1,4,Low-Value,Can't Lose
62050,7,3,"203,79999999999998",5,1,1,7,Mid-Value,Potential Loyalists
62052,555,2,"19,75",4,1,1,6,Mid-Value,Potential Loyalists
62055,168,3,"186,0",5,1,1,7,Mid-Value,Potential Loyalists
62056,1174,2,"115,25",2,1,1,4,Low-Value,Can't Lose
62057,1333,1,"28,9",2,1,1,4,Low-Value,Can't Lose
62058,254,1,"11,55",5,1,1,7,Mid-Value,Potential Loyalists
62059,32,3,"121,45",5,1,1,7,Mid-Value,Potential Loyalists
62062,1757,2,"81,44999999999999",1,1,1,3,Low-Value,Lost
62063,799,2,"272,8",3,1,1,5,Low-Value,At Risk Customers
62064,568,1,"86,85",4,1,1,6,Mid-Value,Potential Loyalists
62066,426,3,"127,10000000000001",4,1,1,6,Mid-Value,Potential Loyalists
62067,162,1,"81,30000000000001",5,1,1,7,Mid-Value,Potential Loyalists
62068,431,4,"229,4",4,1,1,6,Mid-Value,Potential Loyalists
62069,383,2,"201,25",4,1,1,6,Mid-Value,Potential Loyalists
62074,1552,2,"60,6",1,1,1,3,Low-Value,Lost
62075,142,2,"205,3",5,1,1,7,Mid-Value,Potential Loyalists
62076,143,2,"101,80000000000001",5,1,1,7,Mid-Value,Potential Loyalists
62078,1099,3,"319,7",2,1,1,4,Low-Value,Can't Lose
62080,1648,2,"68,0",1,1,1,3,Low-Value,Lost
62082,1809,1,"32,05",1,1,1,3,Low-Value,Lost
62083,1245,1,"6,35",2,1,1,4,Low-Value,Can't Lose
62084,747,3,"74,05",3,1,1,5,Low-Value,At Risk Customers
62087,82,5,"233,60000000000002",5,1,1,7,Mid-Value,Potential Loyalists
62089,50,3,"75,2",5,1,1,7,Mid-Value,Potential Loyalists
62090,346,4,"391,75",5,1,1,7,Mid-Value,Potential Loyalists
62096,952,1,"94,9",3,1,1,5,Low-Value,At Risk Customers
62098,155,2,"57,9",5,1,1,7,Mid-Value,Potential Loyalists
62099,216,3,"99,7",5,1,1,7,Mid-Value,Potential Loyalists
62100,1027,7,"1120,55",3,2,2,7,Mid-Value,Potential Loyalists
62104,497,3,"110,25",4,1,1,6,Mid-Value,Potential Loyalists
62105,318,3,"199,70000000000002",5,1,1,7,Mid-Value,Potential Loyalists
62106,600,5,"458,5",4,1,1,6,Mid-Value,Potential Loyalists
62108,755,4,"113,95",3,1,1,5,Low-Value,At Risk Customers
62111,1822,1,"12,25",1,1,1,3,Low-Value,Lost
62114,189,2,"168,5",5,1,1,7,Mid-Value,Potential Loyalists
62115,152,2,"148,7",5,1,1,7,Mid-Value,Potential Loyalists
62118,28,5,"239,3",5,1,1,7,Mid-Value,Potential Loyalists
62120,217,2,"123,19999999999999",5,1,1,7,Mid-Value,Potential Loyalists
62123,1138,2,"66,55",2,1,1,4,Low-Value,Can't Lose
62124,89,7,"622,1999999999999",5,2,1,8,High-Value,Potential Loyalists
62125,264,3,"60,85",5,1,1,7,Mid-Value,Potential Loyalists
62126,190,2,"65,2",5,1,1,7,Mid-Value,Potential Loyalists
62127,1067,3,"63,00000000000001",3,1,1,5,Low-Value,At Risk Customers
62131,376,8,"891,45",4,2,2,8,High-Value,Potential Loyalists
62132,1002,1,"232,1",3,1,1,5,Low-Value,At Risk Customers
62133,804,5,"617,6",3,1,1,5,Low-Value,At Risk Customers
62134,981,1,"276,2",3,1,1,5,Low-Value,At Risk Customers
62135,102,6,"321,99999999999994",5,1,1,7,Mid-Value,Potential Loyalists
62136,478,1,"7,7",4,1,1,6,Mid-Value,Potential Loyalists
62137,147,3,"213,10000000000002",5,1,1,7,Mid-Value,Potential Loyalists
62138,637,3,"264,25",4,1,1,6,Mid-Value,Potential Loyalists
62140,1736,1,"9,85",1,1,1,3,Low-Value,Lost
62141,171,3,"104,89999999999999",5,1,1,7,Mid-Value,Potential Loyalists
62143,874,4,"694,1",3,1,2,6,Mid-Value,Potential Loyalists
62144,775,6,"146,4",3,1,1,5,Low-Value,At Risk Customers
62145,915,1,"621,2",3,1,1,5,Low-Value,At Risk Customers
62147,777,3,"64,25",3,1,1,5,Low-Value,At Risk Customers
62148,13,5,"427,2",5,1,1,7,Mid-Value,Potential Loyalists
62149,631,4,"266,75",4,1,1,6,Mid-Value,Potential Loyalists
62150,175,3,"161,75",5,1,1,7,Mid-Value,Potential Loyalists
62151,349,8,"904,5999999999999",5,2,2,9,High-Value,Champions
62152,85,4,"109,80000000000001",5,1,1,7,Mid-Value,Potential Loyalists
62153,419,5,"748,41",4,1,2,7,Mid-Value,Potential Loyalists
62154,49,2,"10,8",5,1,1,7,Mid-Value,Potential Loyalists
62155,361,7,"178,05",5,2,1,8,High-Value,Potential Loyalists
62158,21,2,"138,3",5,1,1,7,Mid-Value,Potential Loyalists
62159,60,1,"2,2",5,1,1,7,Mid-Value,Potential Loyalists
62160,1244,4,"257,25",2,1,1,4,Low-Value,Can't Lose
62161,571,2,"154,85000000000002",4,1,1,6,Mid-Value,Potential Loyalists
62164,601,3,"77,1",4,1,1,6,Mid-Value,Potential Loyalists
62165,994,1,"14,15",3,1,1,5,Low-Value,At Risk Customers
62167,1354,5,"244,14999999999998",2,1,1,4,Low-Value,Can't Lose
62169,548,3,"56,45",4,1,1,6,Mid-Value,Potential Loyalists
62170,742,3,"1029,9",3,1,2,6,Mid-Value,Potential Loyalists
62172,498,1,"31,0",4,1,1,6,Mid-Value,Potential Loyalists
62175,8,2,"157,25",5,1,1,7,Mid-Value,Potential Loyalists
62176,543,2,"74,15",4,1,1,6,Mid-Value,Potential Loyalists
62177,1328,2,"103,85000000000001",2,1,1,4,Low-Value,Can't Lose
62179,516,4,"205,95",4,1,1,6,Mid-Value,Potential Loyalists
62180,196,5,"343,90000000000003",5,1,1,7,Mid-Value,Potential Loyalists
62182,172,1,"270,0",5,1,1,7,Mid-Value,Potential Loyalists
62183,329,4,"94,8",5,1,1,7,Mid-Value,Potential Loyalists
62186,221,7,"533,85",5,2,1,8,High-Value,Potential Loyalists
62187,3,5,"1435,0500000000002",5,1,3,9,High-Value,Champions
62188,38,9,"514,1",5,2,1,8,High-Value,Potential Loyalists
62189,91,1,"2,45",5,1,1,7,Mid-Value,Potential Loyalists
62191,59,3,"155,75",5,1,1,7,Mid-Value,Potential Loyalists
62193,1551,1,"38,35",1,1,1,3,Low-Value,Lost
62194,24,6,"381,40000000000003",5,1,1,7,Mid-Value,Potential Loyalists
62195,1773,1,"16,6",1,1,1,3,Low-Value,Lost
62199,902,3,"108,94999999999999",3,1,1,5,Low-Value,At Risk Customers
62201,1162,3,"122,6",2,1,1,4,Low-Value,Can't Lose
62203,10,4,"390,2",5,1,1,7,Mid-Value,Potential Loyalists
62204,134,5,"316,85",5,1,1,7,Mid-Value,Potential Loyalists
62205,1148,2,"51,85",2,1,1,4,Low-Value,Can't Lose
62206,240,13,"1327,4",5,3,3,11,High-Value,Champions
62207,17,4,"176,05",5,1,1,7,Mid-Value,Potential Loyalists
62209,897,2,"285,0",3,1,1,5,Low-Value,At Risk Customers
62210,699,6,"311,74",4,1,1,6,Mid-Value,Potential Loyalists
62211,875,2,"117,5",3,1,1,5,Low-Value,At Risk Customers
62212,426,4,"257,8",4,1,1,6,Mid-Value,Potential Loyalists
62215,1251,5,"533,75",2,1,1,4,Low-Value,Can't Lose
62216,133,6,"231,8",5,1,1,7,Mid-Value,Potential Loyalists
62219,454,1,"20,5",4,1,1,6,Mid-Value,Potential Loyalists
62222,24,11,"651,9",5,2,1,8,High-Value,Potential Loyalists
62223,196,2,"47,6",5,1,1,7,Mid-Value,Potential Loyalists
62226,27,7,"354,15",5,2,1,8,High-Value,Potential Loyalists
62227,7,6,"263,5",5,1,1,7,Mid-Value,Potential Loyalists
62228,253,3,"49,35",5,1,1,7,Mid-Value,Potential Loyalists
62230,1340,1,"376,95000000000005",2,1,1,4,Low-Value,Can't Lose
62232,49,2,"36,4",5,1,1,7,Mid-Value,Potential Loyalists
62234,54,10,"588,55",5,2,1,8,High-Value,Potential Loyalists
62236,1824,1,"13,0",1,1,1,3,Low-Value,Lost
62237,224,3,"272,4",5,1,1,7,Mid-Value,Potential Loyalists
62238,178,4,"352,4",5,1,1,7,Mid-Value,Potential Loyalists
62239,819,1,"47,85",3,1,1,5,Low-Value,At Risk Customers
62241,1277,4,"942,3",2,1,2,5,Low-Value,At Risk Customers
62243,66,4,"91,65",5,1,1,7,Mid-Value,Potential Loyalists
62244,94,5,"366,55",5,1,1,7,Mid-Value,Potential Loyalists
62246,1466,4,"211,85",1,1,1,3,Low-Value,Lost
62248,4,5,"591,5500000000001",5,1,1,7,Mid-Value,Potential Loyalists
62249,218,6,"160,4",5,1,1,7,Mid-Value,Potential Loyalists
62250,1116,1,"519,6",2,1,1,4,Low-Value,Can't Lose
62255,1293,1,"19,9",2,1,1,4,Low-Value,Can't Lose
62256,206,2,"233,35",5,1,1,7,Mid-Value,Potential Loyalists
62259,19,6,"433,8",5,1,1,7,Mid-Value,Potential Loyalists
62260,1540,1,"18,75",1,1,1,3,Low-Value,Lost
62261,627,5,"449,40000000000003",4,1,1,6,Mid-Value,Potential Loyalists
62263,546,1,"270,0",4,1,1,6,Mid-Value,Potential Loyalists
62264,1539,2,"55,55",1,1,1,3,Low-Value,Lost
62266,1820,1,"14,55",1,1,1,3,Low-Value,Lost
62268,47,2,"123,60000000000001",5,1,1,7,Mid-Value,Potential Loyalists
62270,194,3,"218,85",5,1,1,7,Mid-Value,Potential Loyalists
62272,1543,3,"444,95",1,1,1,3,Low-Value,Lost
62274,1336,5,"53,2",2,1,1,4,Low-Value,Can't Lose
62275,485,3,"32,25",4,1,1,6,Mid-Value,Potential Loyalists
62276,1123,3,"156,65",2,1,1,4,Low-Value,Can't Lose
62278,124,10,"496,15",5,2,1,8,High-Value,Potential Loyalists
62279,838,1,"96,8",3,1,1,5,Low-Value,At Risk Customers
62280,1340,2,"211,65",2,1,1,4,Low-Value,Can't Lose
62282,9,13,"879,35",5,3,2,10,High-Value,Champions
62284,10,5,"507,84999999999997",5,1,1,7,Mid-Value,Potential Loyalists
62285,156,5,"331,3",5,1,1,7,Mid-Value,Potential Loyalists
62287,47,3,"113,15",5,1,1,7,Mid-Value,Potential Loyalists
62288,64,2,"165,5",5,1,1,7,Mid-Value,Potential Loyalists
62289,0,17,"1716,9",5,4,3,12,High-Value,Champions
62291,614,3,"388,34999999999997",4,1,1,6,Mid-Value,Potential Loyalists
62292,721,1,"8,15",4,1,1,6,Mid-Value,Potential Loyalists
62294,174,6,"283,7",5,1,1,7,Mid-Value,Potential Loyalists
62295,1126,2,"104,1",2,1,1,4,Low-Value,Can't Lose
62296,11,2,"54,300000000000004",5,1,1,7,Mid-Value,Potential Loyalists
62297,914,1,"18,6",3,1,1,5,Low-Value,At Risk Customers
62298,407,7,"291,65",4,2,1,7,Mid-Value,Potential Loyalists
62299,11,8,"844,1999999999999",5,2,2,9,High-Value,Champions
62302,109,8,"359,1",5,2,1,8,High-Value,Potential Loyalists
62303,4,2,"350,35",5,1,1,7,Mid-Value,Potential Loyalists
62304,229,3,"119,55",5,1,1,7,Mid-Value,Potential Loyalists
62307,1077,2,"75,94999999999999",3,1,1,5,Low-Value,At Risk Customers
62309,61,2,"82,59",5,1,1,7,Mid-Value,Potential Loyalists
62311,521,1,"63,8",4,1,1,6,Mid-Value,Potential Loyalists
62315,1244,5,"371,2",2,1,1,4,Low-Value,Can't Lose
62317,742,6,"319,35",3,1,1,5,Low-Value,At Risk Customers
62318,557,5,"235,6",4,1,1,6,Mid-Value,Potential Loyalists
62321,488,6,"517,5",4,1,1,6,Mid-Value,Potential Loyalists
62322,317,1,"23,45",5,1,1,7,Mid-Value,Potential Loyalists
62324,984,1,"552,9",3,1,1,5,Low-Value,At Risk Customers
62326,20,1,"169,05",5,1,1,7,Mid-Value,Potential Loyalists
62328,1145,4,"94,25",2,1,1,4,Low-Value,Can't Lose
62329,56,3,"96,15",5,1,1,7,Mid-Value,Potential Loyalists
62334,1803,1,"31,4",1,1,1,3,Low-Value,Lost
62335,169,3,"86,85",5,1,1,7,Mid-Value,Potential Loyalists
62337,893,1,"162,6",3,1,1,5,Low-Value,At Risk Customers
62338,1274,1,"29,4",2,1,1,4,Low-Value,Can't Lose
62342,388,1,"19,1",4,1,1,6,Mid-Value,Potential Loyalists
62344,1185,2,"47,1",2,1,1,4,Low-Value,Can't Lose
62345,615,4,"123,15",4,1,1,6,Mid-Value,Potential Loyalists
62346,45,6,"160,7",5,1,1,7,Mid-Value,Potential Loyalists
62347,345,1,"17,95",5,1,1,7,Mid-Value,Potential Loyalists
62348,724,1,"11,4",4,1,1,6,Mid-Value,Potential Loyalists
62349,322,6,"353,3",5,1,1,7,Mid-Value,Potential Loyalists
62350,35,3,"245,15",5,1,1,7,Mid-Value,Potential Loyalists
62351,347,3,"232,50000000000003",5,1,1,7,Mid-Value,Potential Loyalists
62352,480,3,"141,1",4,1,1,6,Mid-Value,Potential Loyalists
62354,24,1,"59,9",5,1,1,7,Mid-Value,Potential Loyalists
62357,1042,3,"36,2",3,1,1,5,Low-Value,At Risk Customers
62358,328,4,"197,85",5,1,1,7,Mid-Value,Potential Loyalists
62359,374,5,"298,1",4,1,1,6,Mid-Value,Potential Loyalists
62360,449,2,"22,35",4,1,1,6,Mid-Value,Potential Loyalists
62361,714,4,"346,79999999999995",4,1,1,6,Mid-Value,Potential Loyalists
62363,1498,3,"191,95",1,1,1,3,Low-Value,Lost
62364,387,2,"154,15",4,1,1,6,Mid-Value,Potential Loyalists
62365,1109,1,"122,0",2,1,1,4,Low-Value,Can't Lose
62369,69,3,"93,85000000000001",5,1,1,7,Mid-Value,Potential Loyalists
62370,391,4,"766,5",4,1,2,7,Mid-Value,Potential Loyalists
62372,157,4,"121,2",5,1,1,7,Mid-Value,Potential Loyalists
62373,363,5,"167,4",5,1,1,7,Mid-Value,Potential Loyalists
62374,1274,5,"498,79999999999995",2,1,1,4,Low-Value,Can't Lose
62375,122,8,"182,45",5,2,1,8,High-Value,Potential Loyalists
62377,138,3,"229,55",5,1,1,7,Mid-Value,Potential Loyalists
62379,1651,1,"37,1",1,1,1,3,Low-Value,Lost
62380,88,10,"384,65000000000003",5,2,1,8,High-Value,Potential Loyalists
62381,407,5,"116,5",4,1,1,6,Mid-Value,Potential Loyalists
62382,452,2,"257,1",4,1,1,6,Mid-Value,Potential Loyalists
62383,188,3,"202,89999999999998",5,1,1,7,Mid-Value,Potential Loyalists
62385,350,3,"418,54999999999995",5,1,1,7,Mid-Value,Potential Loyalists
62386,146,1,"62,099999999999994",5,1,1,7,Mid-Value,Potential Loyalists
62387,564,1,"206,15",4,1,1,6,Mid-Value,Potential Loyalists
62388,26,9,"868,15",5,2,2,9,High-Value,Champions
62389,443,5,"223,85",4,1,1,6,Mid-Value,Potential Loyalists
62392,134,4,"127,20000000000002",5,1,1,7,Mid-Value,Potential Loyalists
62393,64,5,"759,4499999999999",5,1,2,8,High-Value,Potential Loyalists
62396,93,2,"138,95",5,1,1,7,Mid-Value,Potential Loyalists
62399,1056,1,"12,1",3,1,1,5,Low-Value,At Risk Customers
62400,197,2,"47,4",5,1,1,7,Mid-Value,Potential Loyalists
62402,1645,1,"101,0",1,1,1,3,Low-Value,Lost
62403,138,3,"111,05",5,1,1,7,Mid-Value,Potential Loyalists
62404,71,2,"66,55",5,1,1,7,Mid-Value,Potential Loyalists
62405,50,2,"202,95",5,1,1,7,Mid-Value,Potential Loyalists
62406,1522,3,"97,6",1,1,1,3,Low-Value,Lost
62409,518,1,"316,0",4,1,1,6,Mid-Value,Potential Loyalists
62410,687,2,"72,3",4,1,1,6,Mid-Value,Potential Loyalists
62412,357,3,"110,05",5,1,1,7,Mid-Value,Potential Loyalists
62413,787,1,"66,5",3,1,1,5,Low-Value,At Risk Customers
62414,99,6,"386,29999999999995",5,1,1,7,Mid-Value,Potential Loyalists
62415,635,2,"139,55",4,1,1,6,Mid-Value,Potential Loyalists
62416,378,1,"17,25",4,1,1,6,Mid-Value,Potential Loyalists
62417,143,2,"32,85",5,1,1,7,Mid-Value,Potential Loyalists
62418,412,3,"121,50000000000001",4,1,1,6,Mid-Value,Potential Loyalists
62419,1303,2,"64,6",2,1,1,4,Low-Value,Can't Lose
62420,921,3,"188,85000000000002",3,1,1,5,Low-Value,At Risk Customers
62421,784,4,"108,0",3,1,1,5,Low-Value,At Risk Customers
62423,1050,1,"53,25",3,1,1,5,Low-Value,At Risk Customers
62424,11,4,"377,8",5,1,1,7,Mid-Value,Potential Loyalists
62425,24,1,"163,65",5,1,1,7,Mid-Value,Potential Loyalists
62426,128,2,"61,150000000000006",5,1,1,7,Mid-Value,Potential Loyalists
62428,184,2,"63,75",5,1,1,7,Mid-Value,Potential Loyalists
62429,3,4,"520,0",5,1,1,7,Mid-Value,Potential Loyalists
62431,574,3,"147,7",4,1,1,6,Mid-Value,Potential Loyalists
62433,883,4,"323,85",3,1,1,5,Low-Value,At Risk Customers
62434,247,2,"63,75",5,1,1,7,Mid-Value,Potential Loyalists
62435,220,2,"144,8",5,1,1,7,Mid-Value,Potential Loyalists
62436,210,1,"316,1",5,1,1,7,Mid-Value,Potential Loyalists
62437,676,2,"43,2",4,1,1,6,Mid-Value,Potential Loyalists
62441,770,11,"699,9",3,2,2,7,Mid-Value,Potential Loyalists
62443,925,2,"181,4",3,1,1,5,Low-Value,At Risk Customers
62444,505,3,"137,9",4,1,1,6,Mid-Value,Potential Loyalists
62445,140,2,"134,7",5,1,1,7,Mid-Value,Potential Loyalists
62446,114,4,"116,65",5,1,1,7,Mid-Value,Potential Loyalists
62447,423,3,"141,54999999999998",4,1,1,6,Mid-Value,Potential Loyalists
62452,392,2,"68,6",4,1,1,6,Mid-Value,Potential Loyalists
62453,783,3,"224,35",3,1,1,5,Low-Value,At Risk Customers
62454,374,1,"38,8",4,1,1,6,Mid-Value,Potential Loyalists
62458,1239,5,"387,9",2,1,1,4,Low-Value,Can't Lose
62459,258,1,"121,64999999999999",5,1,1,7,Mid-Value,Potential Loyalists
62461,381,2,"218,8",4,1,1,6,Mid-Value,Potential Loyalists
62462,1247,1,"12,25",2,1,1,4,Low-Value,Can't Lose
62463,987,2,"28,15",3,1,1,5,Low-Value,At Risk Customers
62465,102,3,"124,45",5,1,1,7,Mid-Value,Potential Loyalists
62466,266,3,"432,6",5,1,1,7,Mid-Value,Potential Loyalists
62468,333,1,"19,55",5,1,1,7,Mid-Value,Potential Loyalists
62469,1055,1,"914,2",3,1,2,6,Mid-Value,Potential Loyalists
62470,837,2,"80,05",3,1,1,5,Low-Value,At Risk Customers
62471,603,5,"156,7",4,1,1,6,Mid-Value,Potential Loyalists
62473,313,2,"26,65",5,1,1,7,Mid-Value,Potential Loyalists
62474,880,3,"167,10000000000002",3,1,1,5,Low-Value,At Risk Customers
62476,128,1,"100,8",5,1,1,7,Mid-Value,Potential Loyalists
62477,20,2,"68,9",5,1,1,7,Mid-Value,Potential Loyalists
62479,1585,1,"149,2",1,1,1,3,Low-Value,Lost
62483,866,1,"579,9",3,1,1,5,Low-Value,At Risk Customers
62486,1807,1,"12,6",1,1,1,3,Low-Value,Lost
62487,311,3,"354,35",5,1,1,7,Mid-Value,Potential Loyalists
62488,116,4,"597,75",5,1,1,7,Mid-Value,Potential Loyalists
62489,711,1,"9,65",4,1,1,6,Mid-Value,Potential Loyalists
62490,86,8,"344,8",5,2,1,8,High-Value,Potential Loyalists
62491,937,1,"45,0",3,1,1,5,Low-Value,At Risk Customers
62492,952,8,"343,05",3,2,1,6,Mid-Value,Potential Loyalists
62493,880,1,"178,2",3,1,1,5,Low-Value,At Risk Customers
62495,186,2,"206,6",5,1,1,7,Mid-Value,Potential Loyalists
62496,87,4,"364,75",5,1,1,7,Mid-Value,Potential Loyalists
62500,853,5,"288,25",3,1,1,5,Low-Value,At Risk Customers
62504,190,6,"808,8",5,1,2,8,High-Value,Potential Loyalists
62505,1057,2,"160,8",3,1,1,5,Low-Value,At Risk Customers
62506,1228,1,"5,5",2,1,1,4,Low-Value,Can't Lose
62508,91,1,"5,7",5,1,1,7,Mid-Value,Potential Loyalists
62509,101,6,"286,25",5,1,1,7,Mid-Value,Potential Loyalists
62511,1205,1,"49,25",2,1,1,4,Low-Value,Can't Lose
62512,1100,1,"487,5",2,1,1,4,Low-Value,Can't Lose
62513,809,7,"329,55",3,2,1,6,Mid-Value,Potential Loyalists
62515,31,3,"96,25",5,1,1,7,Mid-Value,Potential Loyalists
62516,146,8,"461,75",5,2,1,8,High-Value,Potential Loyalists
62517,11,5,"387,94",5,1,1,7,Mid-Value,Potential Loyalists
62519,249,2,"31,700000000000003",5,1,1,7,Mid-Value,Potential Loyalists
62520,1631,1,"24,4",1,1,1,3,Low-Value,Lost
62523,120,4,"382,65",5,1,1,7,Mid-Value,Potential Loyalists
62524,301,8,"496,75",5,2,1,8,High-Value,Potential Loyalists
62527,331,3,"130,65",5,1,1,7,Mid-Value,Potential Loyalists
62528,82,4,"221,75",5,1,1,7,Mid-Value,Potential Loyalists
62529,481,1,"124,5",4,1,1,6,Mid-Value,Potential Loyalists
62530,66,13,"666,0500000000001",5,3,2,10,High-Value,Champions
62532,1630,2,"123,6",1,1,1,3,Low-Value,Lost
62535,895,1,"13,4",3,1,1,5,Low-Value,At Risk Customers
62539,362,4,"235,25",5,1,1,7,Mid-Value,Potential Loyalists
62540,9,5,"441,9",5,1,1,7,Mid-Value,Potential Loyalists
62541,12,3,"166,95",5,1,1,7,Mid-Value,Potential Loyalists
62542,727,1,"17,8",4,1,1,6,Mid-Value,Potential Loyalists
62545,118,4,"129,8",5,1,1,7,Mid-Value,Potential Loyalists
62548,115,6,"167,7",5,1,1,7,Mid-Value,Potential Loyalists
62549,1042,1,"39,2",3,1,1,5,Low-Value,At Risk Customers
62551,391,3,"329,25",4,1,1,6,Mid-Value,Potential Loyalists
62555,147,2,"200,0",5,1,1,7,Mid-Value,Potential Loyalists
62556,1622,1,"63,75",1,1,1,3,Low-Value,Lost
62557,784,3,"152,65",3,1,1,5,Low-Value,At Risk Customers
62558,554,1,"37,5",4,1,1,6,Mid-Value,Potential Loyalists
62559,989,1,"110,39999999999999",3,1,1,5,Low-Value,At Risk Customers
62560,614,10,"1060,75",4,2,2,8,High-Value,Potential Loyalists
62561,993,1,"50,400000000000006",3,1,1,5,Low-Value,At Risk Customers
62563,0,6,"480,4",5,1,1,7,Mid-Value,Potential Loyalists
62569,162,3,"87,5",5,1,1,7,Mid-Value,Potential Loyalists
62570,1376,2,"125,94999999999999",2,1,1,4,Low-Value,Can't Lose
62572,1050,1,"22,6",3,1,1,5,Low-Value,At Risk Customers
62575,829,6,"130,54999999999998",3,1,1,5,Low-Value,At Risk Customers
62579,1275,2,"86,60000000000001",2,1,1,4,Low-Value,Can't Lose
62582,171,9,"564,65",5,2,1,8,High-Value,Potential Loyalists
62584,1495,1,"81,8",1,1,1,3,Low-Value,Lost
62586,783,8,"412,95",3,2,1,6,Mid-Value,Potential Loyalists
62587,126,3,"282,8",5,1,1,7,Mid-Value,Potential Loyalists
62588,256,3,"193,1",5,1,1,7,Mid-Value,Potential Loyalists
62590,1215,2,"81,4",2,1,1,4,Low-Value,Can't Lose
62591,376,3,"46,75",4,1,1,6,Mid-Value,Potential Loyalists
62592,1390,2,"45,75",2,1,1,4,Low-Value,Can't Lose
62593,835,5,"266,7",3,1,1,5,Low-Value,At Risk Customers
62594,885,1,"45,8",3,1,1,5,Low-Value,At Risk Customers
62598,1657,2,"244,95",1,1,1,3,Low-Value,Lost
62599,18,9,"825,25",5,2,2,9,High-Value,Champions
62601,252,2,"13,15",5,1,1,7,Mid-Value,Potential Loyalists
62602,11,3,"188,85000000000002",5,1,1,7,Mid-Value,Potential Loyalists
62603,1113,3,"53,2",2,1,1,4,Low-Value,Can't Lose
62604,1198,2,"57,35",2,1,1,4,Low-Value,Can't Lose
62607,1634,1,"26,4",1,1,1,3,Low-Value,Lost
62608,130,1,"107,5",5,1,1,7,Mid-Value,Potential Loyalists
62610,145,4,"243,3",5,1,1,7,Mid-Value,Potential Loyalists
62611,216,6,"477,25",5,1,1,7,Mid-Value,Potential Loyalists
62618,328,4,"180,95",5,1,1,7,Mid-Value,Potential Loyalists
62619,154,2,"139,20000000000002",5,1,1,7,Mid-Value,Potential Loyalists
62620,145,7,"1279,4499999999998",5,2,2,9,High-Value,Champions
62624,796,6,"196,8",3,1,1,5,Low-Value,At Risk Customers
62625,829,2,"21,75",3,1,1,5,Low-Value,At Risk Customers
62626,987,3,"315,45",3,1,1,5,Low-Value,At Risk Customers
62627,798,5,"297,0",3,1,1,5,Low-Value,At Risk Customers
62629,1105,1,"15,2",2,1,1,4,Low-Value,Can't Lose
62632,121,6,"220,65",5,1,1,7,Mid-Value,Potential Loyalists
62634,1412,1,"45,4",2,1,1,4,Low-Value,Can't Lose
62635,14,3,"315,7",5,1,1,7,Mid-Value,Potential Loyalists
62636,529,3,"194,9",4,1,1,6,Mid-Value,Potential Loyalists
62639,24,2,"266,1",5,1,1,7,Mid-Value,Potential Loyalists
62640,1379,1,"94,1",2,1,1,4,Low-Value,Can't Lose
62641,44,5,"150,95",5,1,1,7,Mid-Value,Potential Loyalists
62642,1197,2,"56,699999999999996",2,1,1,4,Low-Value,Can't Lose
62643,123,8,"601,55",5,2,1,8,High-Value,Potential Loyalists
62644,1564,1,"83,2",1,1,1,3,Low-Value,Lost
62648,511,2,"67,25",4,1,1,6,Mid-Value,Potential Loyalists
62649,212,1,"91,35",5,1,1,7,Mid-Value,Potential Loyalists
62651,448,2,"365,75",4,1,1,6,Mid-Value,Potential Loyalists
62653,1555,2,"66,4",1,1,1,3,Low-Value,Lost
62654,60,6,"425,4",5,1,1,7,Mid-Value,Potential Loyalists
62655,1272,1,"100,8",2,1,1,4,Low-Value,Can't Lose
62657,533,1,"125,4",4,1,1,6,Mid-Value,Potential Loyalists
62658,21,7,"511,95000000000005",5,2,1,8,High-Value,Potential Loyalists
62660,1626,1,"20,6",1,1,1,3,Low-Value,Lost
62661,392,10,"278,1",4,2,1,7,Mid-Value,Potential Loyalists
62664,1354,1,"11,35",2,1,1,4,Low-Value,Can't Lose
62665,1811,1,"9,85",1,1,1,3,Low-Value,Lost
62666,531,3,"480,90000000000003",4,1,1,6,Mid-Value,Potential Loyalists
62667,535,1,"89,8",4,1,1,6,Mid-Value,Potential Loyalists
62669,886,2,"162,85000000000002",3,1,1,5,Low-Value,At Risk Customers
62672,756,1,"69,3",3,1,1,5,Low-Value,At Risk Customers
62673,38,2,"169,29999999999998",5,1,1,7,Mid-Value,Potential Loyalists
62676,1247,1,"48,449999999999996",2,1,1,4,Low-Value,Can't Lose
62677,1327,1,"107,3",2,1,1,4,Low-Value,Can't Lose
62679,54,5,"235,85000000000002",5,1,1,7,Mid-Value,Potential Loyalists
62682,107,1,"16,75",5,1,1,7,Mid-Value,Potential Loyalists
62683,1704,1,"12,7",1,1,1,3,Low-Value,Lost
62684,1016,2,"28,45",3,1,1,5,Low-Value,At Risk Customers
62686,504,1,"103,1",4,1,1,6,Mid-Value,Potential Loyalists
62687,549,3,"311,85",4,1,1,6,Mid-Value,Potential Loyalists
62688,1037,1,"17,25",3,1,1,5,Low-Value,At Risk Customers
62689,253,3,"107,19999999999999",5,1,1,7,Mid-Value,Potential Loyalists
62690,837,3,"240,4",3,1,1,5,Low-Value,At Risk Customers
62691,1751,1,"3,8",1,1,1,3,Low-Value,Lost
62692,578,8,"424,3",4,2,1,7,Mid-Value,Potential Loyalists
62694,334,1,"127,95",5,1,1,7,Mid-Value,Potential Loyalists
62696,907,1,"88,5",3,1,1,5,Low-Value,At Risk Customers
62697,382,6,"399,5",4,1,1,6,Mid-Value,Potential Loyalists
62699,965,1,"74,8",3,1,1,5,Low-Value,At Risk Customers
62701,97,2,"73,45",5,1,1,7,Mid-Value,Potential Loyalists
62702,637,2,"34,95",4,1,1,6,Mid-Value,Potential Loyalists
62704,591,2,"129,25",4,1,1,6,Mid-Value,Potential Loyalists
62708,45,3,"195,70000000000002",5,1,1,7,Mid-Value,Potential Loyalists
62709,3,11,"782,7",5,2,2,9,High-Value,Champions
62710,351,1,"55,75",5,1,1,7,Mid-Value,Potential Loyalists
62712,1109,3,"355,45",2,1,1,4,Low-Value,Can't Lose
62713,901,6,"450,65",3,1,1,5,Low-Value,At Risk Customers
62714,690,2,"91,75",4,1,1,6,Mid-Value,Potential Loyalists
62715,1449,1,"12,55",2,1,1,4,Low-Value,Can't Lose
62717,53,4,"61,2",5,1,1,7,Mid-Value,Potential Loyalists
62719,95,7,"310,25",5,2,1,8,High-Value,Potential Loyalists
62720,0,18,"1556,9",5,4,3,12,High-Value,Champions
62724,617,1,"12,1",4,1,1,6,Mid-Value,Potential Loyalists
62726,65,2,"172,8",5,1,1,7,Mid-Value,Potential Loyalists
62728,181,7,"412,75",5,2,1,8,High-Value,Potential Loyalists
62729,1088,4,"256,35",3,1,1,5,Low-Value,At Risk Customers
62731,514,3,"201,3",4,1,1,6,Mid-Value,Potential Loyalists
62732,560,4,"199,1",4,1,1,6,Mid-Value,Potential Loyalists
62734,701,2,"65,85",4,1,1,6,Mid-Value,Potential Loyalists
62735,552,4,"226,99999999999997",4,1,1,6,Mid-Value,Potential Loyalists
62736,1536,2,"163,9",1,1,1,3,Low-Value,Lost
62737,142,4,"400,70000000000005",5,1,1,7,Mid-Value,Potential Loyalists
62738,758,4,"366,75",3,1,1,5,Low-Value,At Risk Customers
62739,354,2,"213,8",5,1,1,7,Mid-Value,Potential Loyalists
62740,1055,3,"190,35000000000002",3,1,1,5,Low-Value,At Risk Customers
62741,381,3,"214,50000000000003",4,1,1,6,Mid-Value,Potential Loyalists
62742,1339,2,"46,7",2,1,1,4,Low-Value,Can't Lose
62745,379,9,"2468,75",4,2,4,10,High-Value,Champions
62746,398,3,"155,3",4,1,1,6,Mid-Value,Potential Loyalists
62752,476,6,"545,7",4,1,1,6,Mid-Value,Potential Loyalists
62753,1292,1,"87,2",2,1,1,4,Low-Value,Can't Lose
62756,1494,3,"75,15",1,1,1,3,Low-Value,Lost
62762,164,2,"66,45",5,1,1,7,Mid-Value,Potential Loyalists
62763,120,14,"678,8000000000001",5,3,2,10,High-Value,Champions
62764,278,7,"337,45",5,2,1,8,High-Value,Potential Loyalists
62765,116,3,"215,89999999999998",5,1,1,7,Mid-Value,Potential Loyalists
62766,734,1,"58,2",3,1,1,5,Low-Value,At Risk Customers
62768,220,1,"44,95",5,1,1,7,Mid-Value,Potential Loyalists
62773,126,4,"926,3999999999999",5,1,2,8,High-Value,Potential Loyalists
62776,173,4,"138,55",5,1,1,7,Mid-Value,Potential Loyalists
62778,437,12,"1320,15",4,3,2,9,High-Value,Champions
62782,714,1,"14,05",4,1,1,6,Mid-Value,Potential Loyalists
62784,25,6,"340,8",5,1,1,7,Mid-Value,Potential Loyalists
62786,67,4,"145,6",5,1,1,7,Mid-Value,Potential Loyalists
62787,151,2,"94,8",5,1,1,7,Mid-Value,Potential Loyalists
62789,157,8,"907,55",5,2,2,9,High-Value,Champions
62790,779,5,"477,85",3,1,1,5,Low-Value,At Risk Customers
62792,1720,2,"43,8",1,1,1,3,Low-Value,Lost
62793,995,1,"15,5",3,1,1,5,Low-Value,At Risk Customers
62794,1111,2,"236,3",2,1,1,4,Low-Value,Can't Lose
62797,167,3,"62,2",5,1,1,7,Mid-Value,Potential Loyalists
62799,773,5,"108,45",3,1,1,5,Low-Value,At Risk Customers
62802,437,7,"327,4",4,2,1,7,Mid-Value,Potential Loyalists
62803,52,9,"613,9",5,2,1,8,High-Value,Potential Loyalists
62805,383,5,"421,75",4,1,1,6,Mid-Value,Potential Loyalists
62806,524,1,"75,7",4,1,1,6,Mid-Value,Potential Loyalists
62807,420,3,"110,44999999999999",4,1,1,6,Mid-Value,Potential Loyalists
62808,1294,1,"73,6",2,1,1,4,Low-Value,Can't Lose
62809,710,2,"56,5",4,1,1,6,Mid-Value,Potential Loyalists
62812,165,4,"82,8",5,1,1,7,Mid-Value,Potential Loyalists
62813,267,7,"377,65",5,2,1,8,High-Value,Potential Loyalists
62814,1501,1,"16,4",1,1,1,3,Low-Value,Lost
62815,907,2,"208,3",3,1,1,5,Low-Value,At Risk Customers
62817,319,1,"14,65",5,1,1,7,Mid-Value,Potential Loyalists
62818,3,4,"102,1",5,1,1,7,Mid-Value,Potential Loyalists
62819,735,12,"612,7",3,3,1,7,Mid-Value,Potential Loyalists
62820,84,11,"1010,3499999999999",5,2,2,9,High-Value,Champions
62821,36,7,"495,4",5,2,1,8,High-Value,Potential Loyalists
62822,228,1,"18,45",5,1,1,7,Mid-Value,Potential Loyalists
62825,574,2,"97,19999999999999",4,1,1,6,Mid-Value,Potential Loyalists
62826,58,8,"501,1",5,2,1,8,High-Value,Potential Loyalists
62827,391,2,"32,9",4,1,1,6,Mid-Value,Potential Loyalists
62828,974,4,"610,0",3,1,1,5,Low-Value,At Risk Customers
62829,289,2,"18,15",5,1,1,7,Mid-Value,Potential Loyalists
62830,572,5,"651,9499999999999",4,1,1,6,Mid-Value,Potential Loyalists
62832,1583,1,"21,1",1,1,1,3,Low-Value,Lost
62833,715,2,"100,7",4,1,1,6,Mid-Value,Potential Loyalists
62835,256,2,"39,65",5,1,1,7,Mid-Value,Potential Loyalists
62836,54,2,"76,05",5,1,1,7,Mid-Value,Potential Loyalists
62837,133,5,"476,75",5,1,1,7,Mid-Value,Potential Loyalists
62840,505,5,"626,5999999999999",4,1,1,6,Mid-Value,Potential Loyalists
62841,257,4,"369,35",5,1,1,7,Mid-Value,Potential Loyalists
62842,28,5,"286,25",5,1,1,7,Mid-Value,Potential Loyalists
62843,276,10,"780,5999999999999",5,2,2,9,High-Value,Champions
62846,533,5,"176,6",4,1,1,6,Mid-Value,Potential Loyalists
62847,559,4,"82,39999999999999",4,1,1,6,Mid-Value,Potential Loyalists
62848,535,1,"162,0",4,1,1,6,Mid-Value,Potential Loyalists
62849,1269,1,"48,1",2,1,1,4,Low-Value,Can't Lose
62850,10,4,"281,95",5,1,1,7,Mid-Value,Potential Loyalists
62851,7,2,"268,45",5,1,1,7,Mid-Value,Potential Loyalists
62852,386,4,"203,35",4,1,1,6,Mid-Value,Potential Loyalists
62853,32,3,"139,9",5,1,1,7,Mid-Value,Potential Loyalists
62855,619,2,"126,75",4,1,1,6,Mid-Value,Potential Loyalists
62857,15,8,"282,25",5,2,1,8,High-Value,Potential Loyalists
62859,156,5,"395,5",5,1,1,7,Mid-Value,Potential Loyalists
62861,225,2,"87,60000000000001",5,1,1,7,Mid-Value,Potential Loyalists
62864,94,6,"387,35",5,1,1,7,Mid-Value,Potential Loyalists
62867,732,2,"154,5",3,1,1,5,Low-Value,At Risk Customers
62869,133,1,"69,25",5,1,1,7,Mid-Value,Potential Loyalists
62871,1111,3,"224,3",2,1,1,4,Low-Value,Can't Lose
62872,373,4,"320,84999999999997",4,1,1,6,Mid-Value,Potential Loyalists
62873,875,1,"70,0",3,1,1,5,Low-Value,At Risk Customers
62874,1611,1,"84,44999999999999",1,1,1,3,Low-Value,Lost
62875,777,2,"110,85",3,1,1,5,Low-Value,At Risk Customers
62876,626,1,"418,9",4,1,1,6,Mid-Value,Potential Loyalists
62879,1105,7,"695,25",2,2,2,6,Mid-Value,Potential Loyalists
62880,233,2,"54,65",5,1,1,7,Mid-Value,Potential Loyalists
62881,1474,3,"617,1",1,1,1,3,Low-Value,Lost
62882,802,1,"52,85",3,1,1,5,Low-Value,At Risk Customers
62889,1340,1,"14,5",2,1,1,4,Low-Value,Can't Lose
62890,613,2,"91,69999999999999",4,1,1,6,Mid-Value,Potential Loyalists
62892,481,5,"187,0",4,1,1,6,Mid-Value,Potential Loyalists
62893,417,4,"219,5",4,1,1,6,Mid-Value,Potential Loyalists
62894,855,3,"156,7",3,1,1,5,Low-Value,At Risk Customers
62895,1811,1,"12,1",1,1,1,3,Low-Value,Lost
62897,909,2,"237,3",3,1,1,5,Low-Value,At Risk Customers
62899,328,1,"51,85",5,1,1,7,Mid-Value,Potential Loyalists
62900,177,4,"345,05",5,1,1,7,Mid-Value,Potential Loyalists
62902,930,3,"174,55",3,1,1,5,Low-Value,At Risk Customers
62903,635,1,"147,25",4,1,1,6,Mid-Value,Potential Loyalists
62904,31,2,"19,45",5,1,1,7,Mid-Value,Potential Loyalists
62905,144,3,"245,01",5,1,1,7,Mid-Value,Potential Loyalists
62909,75,2,"51,550000000000004",5,1,1,7,Mid-Value,Potential Loyalists
62910,213,6,"301,75",5,1,1,7,Mid-Value,Potential Loyalists
62911,455,3,"222,14999999999998",4,1,1,6,Mid-Value,Potential Loyalists
62912,581,5,"211,1",4,1,1,6,Mid-Value,Potential Loyalists
62914,145,3,"477,79999999999995",5,1,1,7,Mid-Value,Potential Loyalists
62915,335,8,"589,3499999999999",5,2,1,8,High-Value,Potential Loyalists
62916,206,3,"285,15",5,1,1,7,Mid-Value,Potential Loyalists
62917,23,4,"89,15",5,1,1,7,Mid-Value,Potential Loyalists
62918,418,6,"394,15000000000003",4,1,1,6,Mid-Value,Potential Loyalists
62919,658,3,"106,65",4,1,1,6,Mid-Value,Potential Loyalists
62920,407,2,"23,299999999999997",4,1,1,6,Mid-Value,Potential Loyalists
62922,1002,3,"83,3",3,1,1,5,Low-Value,At Risk Customers
62923,59,9,"480,2",5,2,1,8,High-Value,Potential Loyalists
62926,278,5,"189,6",5,1,1,7,Mid-Value,Potential Loyalists
62927,55,1,"86,1",5,1,1,7,Mid-Value,Potential Loyalists
62930,425,2,"206,7",4,1,1,6,Mid-Value,Potential Loyalists
62931,1413,1,"13,9",2,1,1,4,Low-Value,Can't Lose
62933,735,4,"237,65",3,1,1,5,Low-Value,At Risk Customers
62934,734,4,"267,54999999999995",3,1,1,5,Low-Value,At Risk Customers
62937,406,2,"160,65",4,1,1,6,Mid-Value,Potential Loyalists
62939,876,3,"118,55",3,1,1,5,Low-Value,At Risk Customers
62940,271,7,"444,55",5,2,1,8,High-Value,Potential Loyalists
62941,1365,2,"50,35",2,1,1,4,Low-Value,Can't Lose
62942,180,6,"463,7",5,1,1,7,Mid-Value,Potential Loyalists
62945,293,2,"96,1",5,1,1,7,Mid-Value,Potential Loyalists
62947,36,10,"486,95",5,2,1,8,High-Value,Potential Loyalists
62949,16,8,"570,0",5,2,1,8,High-Value,Potential Loyalists
62951,69,16,"646,65",5,3,1,9,High-Value,Champions
62954,81,7,"311,7",5,2,1,8,High-Value,Potential Loyalists
62955,880,2,"95,8",3,1,1,5,Low-Value,At Risk Customers
62956,734,1,"55,3",3,1,1,5,Low-Value,At Risk Customers
62957,98,8,"429,35",5,2,1,8,High-Value,Potential Loyalists
62958,255,4,"94,55",5,1,1,7,Mid-Value,Potential Loyalists
62959,329,3,"198,10000000000002",5,1,1,7,Mid-Value,Potential Loyalists
62960,95,13,"719,81",5,3,2,10,High-Value,Champions
62962,1739,1,"131,5",1,1,1,3,Low-Value,Lost
62966,795,2,"64,0",3,1,1,5,Low-Value,At Risk Customers
62967,745,2,"63,95",3,1,1,5,Low-Value,At Risk Customers
62968,24,5,"135,15",5,1,1,7,Mid-Value,Potential Loyalists
62970,42,5,"228,4",5,1,1,7,Mid-Value,Potential Loyalists
62971,1626,1,"48,1",1,1,1,3,Low-Value,Lost
62972,409,2,"68,6",4,1,1,6,Mid-Value,Potential Loyalists
62975,63,3,"87,3",5,1,1,7,Mid-Value,Potential Loyalists
62977,561,1,"111,1",4,1,1,6,Mid-Value,Potential Loyalists
62981,1645,1,"158,39999999999998",1,1,1,3,Low-Value,Lost
62982,150,5,"282,95",5,1,1,7,Mid-Value,Potential Loyalists
62983,73,2,"249,15",5,1,1,7,Mid-Value,Potential Loyalists
62984,760,4,"227,5",3,1,1,5,Low-Value,At Risk Customers
62985,1238,2,"131,6",2,1,1,4,Low-Value,Can't Lose
62987,427,4,"202,6",4,1,1,6,Mid-Value,Potential Loyalists
62988,56,1,"73,65",5,1,1,7,Mid-Value,Potential Loyalists
62990,873,2,"178,2",3,1,1,5,Low-Value,At Risk Customers
62992,1460,1,"18,3",2,1,1,4,Low-Value,Can't Lose
62993,165,1,"60,5",5,1,1,7,Mid-Value,Potential Loyalists
62994,18,2,"149,64999999999998",5,1,1,7,Mid-Value,Potential Loyalists
62995,1008,2,"52,8",3,1,1,5,Low-Value,At Risk Customers
62996,1652,3,"81,75",1,1,1,3,Low-Value,Lost
62997,266,1,"20,7",5,1,1,7,Mid-Value,Potential Loyalists
62999,1,6,"414,4",5,1,1,7,Mid-Value,Potential Loyalists
63000,538,2,"63,3",4,1,1,6,Mid-Value,Potential Loyalists
63001,805,1,"20,95",3,1,1,5,Low-Value,At Risk Customers
63002,790,5,"202,6",3,1,1,5,Low-Value,At Risk Customers
63003,3,12,"1183,9",5,3,2,10,High-Value,Champions
63006,611,1,"60,0",4,1,1,6,Mid-Value,Potential Loyalists
63008,572,2,"537,05",4,1,1,6,Mid-Value,Potential Loyalists
63009,251,2,"121,3",5,1,1,7,Mid-Value,Potential Loyalists
63010,3,4,"275,75",5,1,1,7,Mid-Value,Potential Loyalists
63011,1282,3,"449,7",2,1,1,4,Low-Value,Can't Lose
63012,412,7,"415,70000000000005",4,2,1,7,Mid-Value,Potential Loyalists
63013,107,5,"140,55",5,1,1,7,Mid-Value,Potential Loyalists
63016,164,3,"100,2",5,1,1,7,Mid-Value,Potential Loyalists
63017,183,4,"161,15",5,1,1,7,Mid-Value,Potential Loyalists
63019,181,3,"214,05",5,1,1,7,Mid-Value,Potential Loyalists
63020,487,6,"360,0",4,1,1,6,Mid-Value,Potential Loyalists
63021,1044,4,"581,0",3,1,1,5,Low-Value,At Risk Customers
63023,169,2,"46,5",5,1,1,7,Mid-Value,Potential Loyalists
63027,48,3,"264,65",5,1,1,7,Mid-Value,Potential Loyalists
63029,1170,1,"51,85",2,1,1,4,Low-Value,Can't Lose
63032,87,1,"8,55",5,1,1,7,Mid-Value,Potential Loyalists
63033,67,3,"41,55",5,1,1,7,Mid-Value,Potential Loyalists
63034,867,2,"319,4",3,1,1,5,Low-Value,At Risk Customers
63035,612,1,"28,55",4,1,1,6,Mid-Value,Potential Loyalists
63038,367,2,"91,05000000000001",4,1,1,6,Mid-Value,Potential Loyalists
63039,186,10,"499,9",5,2,1,8,High-Value,Potential Loyalists
63040,1263,1,"108,0",2,1,1,4,Low-Value,Can't Lose
63042,162,9,"820,4000000000001",5,2,2,9,High-Value,Champions
63043,367,8,"186,8",4,2,1,7,Mid-Value,Potential Loyalists
63044,43,3,"194,0",5,1,1,7,Mid-Value,Potential Loyalists
63045,230,9,"286,55",5,2,1,8,High-Value,Potential Loyalists
63046,368,4,"268,0",4,1,1,6,Mid-Value,Potential Loyalists
63047,91,1,"25,45",5,1,1,7,Mid-Value,Potential Loyalists
63049,101,4,"204,73999999999998",5,1,1,7,Mid-Value,Potential Loyalists
63052,1022,1,"97,8",3,1,1,5,Low-Value,At Risk Customers
63053,74,8,"655,05",5,2,1,8,High-Value,Potential Loyalists
63054,731,13,"369,2",3,3,1,7,Mid-Value,Potential Loyalists
63056,40,6,"292,35",5,1,1,7,Mid-Value,Potential Loyalists
63057,1591,2,"69,10000000000001",1,1,1,3,Low-Value,Lost
63058,84,3,"335,15",5,1,1,7,Mid-Value,Potential Loyalists
63061,771,2,"75,89999999999999",3,1,1,5,Low-Value,At Risk Customers
63062,934,2,"83,6",3,1,1,5,Low-Value,At Risk Customers
63063,271,6,"977,05",5,1,2,8,High-Value,Potential Loyalists
63066,105,4,"108,9",5,1,1,7,Mid-Value,Potential Loyalists
63067,108,3,"1298,6",5,1,2,8,High-Value,Potential Loyalists
63068,1466,2,"64,0",1,1,1,3,Low-Value,Lost
63069,1232,2,"142,9",2,1,1,4,Low-Value,Can't Lose
63070,1152,1,"23,35",2,1,1,4,Low-Value,Can't Lose
63071,7,4,"220,79999999999998",5,1,1,7,Mid-Value,Potential Loyalists
63073,1547,1,"60,6",1,1,1,3,Low-Value,Lost
63074,770,1,"58,9",3,1,1,5,Low-Value,At Risk Customers
63075,747,4,"476,75",3,1,1,5,Low-Value,At Risk Customers
63076,774,6,"244,8",3,1,1,5,Low-Value,At Risk Customers
63077,1106,1,"174,3",2,1,1,4,Low-Value,Can't Lose
63078,501,10,"525,25",4,2,1,7,Mid-Value,Potential Loyalists
63079,1473,1,"30,0",1,1,1,3,Low-Value,Lost
63080,1099,4,"126,8",2,1,1,4,Low-Value,Can't Lose
63081,426,9,"654,1",4,2,1,7,Mid-Value,Potential Loyalists
63082,1288,1,"1,2",2,1,1,4,Low-Value,Can't Lose
63084,458,4,"187,6",4,1,1,6,Mid-Value,Potential Loyalists
63085,568,1,"109,8",4,1,1,6,Mid-Value,Potential Loyalists
63086,709,2,"178,89999999999998",4,1,1,6,Mid-Value,Potential Loyalists
63087,521,1,"28,1",4,1,1,6,Mid-Value,Potential Loyalists
63088,20,2,"627,8",5,1,1,7,Mid-Value,Potential Loyalists
63089,734,6,"166,75",3,1,1,5,Low-Value,At Risk Customers
63090,235,3,"78,25",5,1,1,7,Mid-Value,Potential Loyalists
63091,418,5,"234,29999999999998",4,1,1,6,Mid-Value,Potential Loyalists
63093,1157,1,"67,7",2,1,1,4,Low-Value,Can't Lose
63094,572,3,"419,25",4,1,1,6,Mid-Value,Potential Loyalists
63096,124,3,"264,05",5,1,1,7,Mid-Value,Potential Loyalists
63097,38,10,"663,4",5,2,2,9,High-Value,Champions
63098,1138,1,"5,0",2,1,1,4,Low-Value,Can't Lose
63099,261,1,"5,1",5,1,1,7,Mid-Value,Potential Loyalists
63100,118,8,"463,8",5,2,1,8,High-Value,Potential Loyalists
63104,1066,1,"9,3",3,1,1,5,Low-Value,At Risk Customers
63106,1125,1,"15,0",2,1,1,4,Low-Value,Can't Lose
63107,481,2,"87,75",4,1,1,6,Mid-Value,Potential Loyalists
63110,727,3,"40,0",4,1,1,6,Mid-Value,Potential Loyalists
63111,69,4,"118,85",5,1,1,7,Mid-Value,Potential Loyalists
63112,3,5,"184,25",5,1,1,7,Mid-Value,Potential Loyalists
63115,551,5,"148,95",4,1,1,6,Mid-Value,Potential Loyalists
63118,258,2,"26,299999999999997",5,1,1,7,Mid-Value,Potential Loyalists
63119,1490,1,"34,3",1,1,1,3,Low-Value,Lost
63122,795,9,"338,8",3,2,1,6,Mid-Value,Potential Loyalists
63124,1407,2,"105,35",2,1,1,4,Low-Value,Can't Lose
63126,1726,2,"31,1",1,1,1,3,Low-Value,Lost
63127,124,1,"53,400000000000006",5,1,1,7,Mid-Value,Potential Loyalists
63128,321,6,"423,1",5,1,1,7,Mid-Value,Potential Loyalists
63129,1522,4,"125,64999999999999",1,1,1,3,Low-Value,Lost
63130,311,2,"64,6",5,1,1,7,Mid-Value,Potential Loyalists
63133,852,5,"197,25",3,1,1,5,Low-Value,At Risk Customers
63136,1101,2,"28,299999999999997",2,1,1,4,Low-Value,Can't Lose
63138,760,1,"91,0",3,1,1,5,Low-Value,At Risk Customers
63139,1083,1,"4,6",3,1,1,5,Low-Value,At Risk Customers
63141,1154,3,"110,7",2,1,1,4,Low-Value,Can't Lose
63142,398,1,"25,6",4,1,1,6,Mid-Value,Potential Loyalists
63146,773,1,"30,0",3,1,1,5,Low-Value,At Risk Customers
63147,109,2,"131,35",5,1,1,7,Mid-Value,Potential Loyalists
63149,946,4,"176,6",3,1,1,5,Low-Value,At Risk Customers
63150,67,2,"52,35",5,1,1,7,Mid-Value,Potential Loyalists
63152,586,2,"98,44999999999999",4,1,1,6,Mid-Value,Potential Loyalists
63154,759,4,"400,95000000000005",3,1,1,5,Low-Value,At Risk Customers
63159,608,2,"84,80000000000001",4,1,1,6,Mid-Value,Potential Loyalists
63160,189,17,"569,05",5,4,1,10,High-Value,Champions
63165,1590,2,"36,7",1,1,1,3,Low-Value,Lost
63166,675,3,"260,8",4,1,1,6,Mid-Value,Potential Loyalists
63167,295,1,"9,95",5,1,1,7,Mid-Value,Potential Loyalists
63169,78,1,"23,9",5,1,1,7,Mid-Value,Potential Loyalists
63171,554,4,"225,3",4,1,1,6,Mid-Value,Potential Loyalists
63172,973,1,"191,3",3,1,1,5,Low-Value,At Risk Customers
63173,390,3,"298,8",4,1,1,6,Mid-Value,Potential Loyalists
63174,221,2,"166,8",5,1,1,7,Mid-Value,Potential Loyalists
63175,130,2,"24,4",5,1,1,7,Mid-Value,Potential Loyalists
63176,824,5,"437,65000000000003",3,1,1,5,Low-Value,At Risk Customers
63177,363,5,"156,6",5,1,1,7,Mid-Value,Potential Loyalists
63178,135,3,"295,3",5,1,1,7,Mid-Value,Potential Loyalists
63179,1240,1,"33,6",2,1,1,4,Low-Value,Can't Lose
63180,1565,1,"16,9",1,1,1,3,Low-Value,Lost
63183,297,4,"94,85",5,1,1,7,Mid-Value,Potential Loyalists
63185,945,1,"42,75",3,1,1,5,Low-Value,At Risk Customers
63186,527,3,"115,9",4,1,1,6,Mid-Value,Potential Loyalists
63188,295,2,"28,549999999999997",5,1,1,7,Mid-Value,Potential Loyalists
63189,775,3,"185,5",3,1,1,5,Low-Value,At Risk Customers
63190,308,5,"212,2",5,1,1,7,Mid-Value,Potential Loyalists
63192,1005,3,"104,25",3,1,1,5,Low-Value,At Risk Customers
63193,924,2,"168,6",3,1,1,5,Low-Value,At Risk Customers
63195,297,1,"12,85",5,1,1,7,Mid-Value,Potential Loyalists
63199,17,4,"215,39999999999998",5,1,1,7,Mid-Value,Potential Loyalists
63200,248,6,"553,2",5,1,1,7,Mid-Value,Potential Loyalists
63201,334,5,"296,0",5,1,1,7,Mid-Value,Potential Loyalists
63204,25,2,"117,55",5,1,1,7,Mid-Value,Potential Loyalists
63205,190,2,"87,39999999999999",5,1,1,7,Mid-Value,Potential Loyalists
63207,539,4,"331,35",4,1,1,6,Mid-Value,Potential Loyalists
63208,1335,1,"84,4",2,1,1,4,Low-Value,Can't Lose
63210,1399,1,"16,55",2,1,1,4,Low-Value,Can't Lose
63211,761,5,"121,2",3,1,1,5,Low-Value,At Risk Customers
63212,703,5,"275,7",4,1,1,6,Mid-Value,Potential Loyalists
63213,1221,4,"215,7",2,1,1,4,Low-Value,Can't Lose
63215,88,3,"52,55",5,1,1,7,Mid-Value,Potential Loyalists
63218,1107,3,"216,65",2,1,1,4,Low-Value,Can't Lose
63220,765,3,"227,45",3,1,1,5,Low-Value,At Risk Customers
63222,113,1,"87,15",5,1,1,7,Mid-Value,Potential Loyalists
63223,188,2,"178,0",5,1,1,7,Mid-Value,Potential Loyalists
63224,93,1,"16,15",5,1,1,7,Mid-Value,Potential Loyalists
63225,1265,2,"92,85",2,1,1,4,Low-Value,Can't Lose
63226,61,1,"31,6",5,1,1,7,Mid-Value,Potential Loyalists
63232,113,4,"132,4",5,1,1,7,Mid-Value,Potential Loyalists
63234,43,10,"287,5",5,2,1,8,High-Value,Potential Loyalists
63235,393,1,"29,3",4,1,1,6,Mid-Value,Potential Loyalists
63238,45,16,"893,15",5,3,2,10,High-Value,Champions
63239,322,4,"104,45",5,1,1,7,Mid-Value,Potential Loyalists
63240,83,9,"545,0500000000001",5,2,1,8,High-Value,Potential Loyalists
63241,420,3,"79,6",4,1,1,6,Mid-Value,Potential Loyalists
63242,781,7,"591,6",3,2,1,6,Mid-Value,Potential Loyalists
63243,868,6,"383,5",3,1,1,5,Low-Value,At Risk Customers
63244,768,4,"212,55",3,1,1,5,Low-Value,At Risk Customers
63245,850,2,"127,8",3,1,1,5,Low-Value,At Risk Customers
63247,753,2,"133,25",3,1,1,5,Low-Value,At Risk Customers
63248,546,1,"163,6",4,1,1,6,Mid-Value,Potential Loyalists
63250,1130,2,"27,2",2,1,1,4,Low-Value,Can't Lose
63251,642,1,"39,05",4,1,1,6,Mid-Value,Potential Loyalists
63252,819,5,"252,25",3,1,1,5,Low-Value,At Risk Customers
63253,533,7,"579,25",4,2,1,7,Mid-Value,Potential Loyalists
63254,551,1,"6,1",4,1,1,6,Mid-Value,Potential Loyalists
63256,1606,2,"167,85000000000002",1,1,1,3,Low-Value,Lost
63258,755,2,"195,29999999999998",3,1,1,5,Low-Value,At Risk Customers
63260,41,3,"70,05",5,1,1,7,Mid-Value,Potential Loyalists
63261,551,4,"161,29999999999998",4,1,1,6,Mid-Value,Potential Loyalists
63266,249,1,"99,5",5,1,1,7,Mid-Value,Potential Loyalists
63270,15,2,"79,25",5,1,1,7,Mid-Value,Potential Loyalists
63271,23,1,"318,3",5,1,1,7,Mid-Value,Potential Loyalists
63272,1139,2,"54,099999999999994",2,1,1,4,Low-Value,Can't Lose
63273,402,3,"210,85000000000002",4,1,1,6,Mid-Value,Potential Loyalists
63275,849,4,"307,05",3,1,1,5,Low-Value,At Risk Customers
63277,924,1,"48,4",3,1,1,5,Low-Value,At Risk Customers
63278,5,2,"82,60000000000001",5,1,1,7,Mid-Value,Potential Loyalists
63279,1705,2,"97,14999999999999",1,1,1,3,Low-Value,Lost
63280,21,5,"510,75",5,1,1,7,Mid-Value,Potential Loyalists
63281,1144,7,"371,25",2,2,1,5,Low-Value,At Risk Customers
63282,1041,1,"16,2",3,1,1,5,Low-Value,At Risk Customers
63283,262,4,"196,4",5,1,1,7,Mid-Value,Potential Loyalists
63284,262,3,"109,6",5,1,1,7,Mid-Value,Potential Loyalists
63286,336,1,"26,75",5,1,1,7,Mid-Value,Potential Loyalists
63287,479,4,"487,4",4,1,1,6,Mid-Value,Potential Loyalists
63288,14,3,"230,2",5,1,1,7,Mid-Value,Potential Loyalists
63289,1713,1,"17,9",1,1,1,3,Low-Value,Lost
63290,572,1,"117,2",4,1,1,6,Mid-Value,Potential Loyalists
63291,191,1,"79,9",5,1,1,7,Mid-Value,Potential Loyalists
63292,159,4,"197,9",5,1,1,7,Mid-Value,Potential Loyalists
63298,77,2,"80,35",5,1,1,7,Mid-Value,Potential Loyalists
63299,396,5,"152,4",4,1,1,6,Mid-Value,Potential Loyalists
63300,1223,3,"106,15",2,1,1,4,Low-Value,Can't Lose
63302,251,3,"36,6",5,1,1,7,Mid-Value,Potential Loyalists
63303,14,3,"596,7",5,1,1,7,Mid-Value,Potential Loyalists
63304,292,5,"215,7",5,1,1,7,Mid-Value,Potential Loyalists
63306,1526,1,"7,65",1,1,1,3,Low-Value,Lost
63308,211,13,"527,25",5,3,1,9,High-Value,Champions
63309,146,2,"1048,3999999999999",5,1,2,8,High-Value,Potential Loyalists
63311,125,2,"58,9",5,1,1,7,Mid-Value,Potential Loyalists
63312,43,6,"470,05",5,1,1,7,Mid-Value,Potential Loyalists
63313,1026,1,"84,85",3,1,1,5,Low-Value,At Risk Customers
63314,724,3,"281,5",4,1,1,6,Mid-Value,Potential Loyalists
63315,32,6,"670,45",5,1,2,8,High-Value,Potential Loyalists
63316,321,4,"174,7",5,1,1,7,Mid-Value,Potential Loyalists
63317,369,1,"126,4",4,1,1,6,Mid-Value,Potential Loyalists
63318,1120,2,"34,75",2,1,1,4,Low-Value,Can't Lose
63320,318,2,"108,30000000000001",5,1,1,7,Mid-Value,Potential Loyalists
63321,1561,2,"39,85",1,1,1,3,Low-Value,Lost
63322,159,9,"558,3000000000001",5,2,1,8,High-Value,Potential Loyalists
63325,42,2,"145,9",5,1,1,7,Mid-Value,Potential Loyalists
63326,333,1,"7,5",5,1,1,7,Mid-Value,Potential Loyalists
63327,871,2,"378,4",3,1,1,5,Low-Value,At Risk Customers
63329,1692,1,"140,85000000000002",1,1,1,3,Low-Value,Lost
63330,141,3,"129,25",5,1,1,7,Mid-Value,Potential Loyalists
63331,1089,3,"69,65",3,1,1,5,Low-Value,At Risk Customers
63334,686,1,"46,8",4,1,1,6,Mid-Value,Potential Loyalists
63335,1152,3,"83,0",2,1,1,4,Low-Value,Can't Lose
63337,1271,4,"555,35",2,1,1,4,Low-Value,Can't Lose
63342,1352,1,"99,5",2,1,1,4,Low-Value,Can't Lose
63343,71,7,"616,75",5,2,1,8,High-Value,Potential Loyalists
63344,969,3,"54,25",3,1,1,5,Low-Value,At Risk Customers
63348,696,3,"540,5",4,1,1,6,Mid-Value,Potential Loyalists
63350,884,1,"31,950000000000003",3,1,1,5,Low-Value,At Risk Customers
63351,4,1,"123,6",5,1,1,7,Mid-Value,Potential Loyalists
63353,637,9,"381,65",4,2,1,7,Mid-Value,Potential Loyalists
63354,1708,1,"5,5",1,1,1,3,Low-Value,Lost
63355,1580,2,"102,44999999999999",1,1,1,3,Low-Value,Lost
63356,641,7,"1235,5",4,2,2,8,High-Value,Potential Loyalists
63357,263,2,"807,1999999999999",5,1,2,8,High-Value,Potential Loyalists
63359,1424,1,"11,75",2,1,1,4,Low-Value,Can't Lose
63361,53,1,"19,1",5,1,1,7,Mid-Value,Potential Loyalists
63362,1708,1,"135,0",1,1,1,3,Low-Value,Lost
63363,490,2,"132,10000000000002",4,1,1,6,Mid-Value,Potential Loyalists
63365,64,1,"33,9",5,1,1,7,Mid-Value,Potential Loyalists
63366,279,2,"125,2",5,1,1,7,Mid-Value,Potential Loyalists
63371,248,4,"129,35",5,1,1,7,Mid-Value,Potential Loyalists
63372,504,1,"222,0",4,1,1,6,Mid-Value,Potential Loyalists
63373,34,3,"140,6",5,1,1,7,Mid-Value,Potential Loyalists
63374,43,9,"285,09999999999997",5,2,1,8,High-Value,Potential Loyalists
63376,1330,1,"52,4",2,1,1,4,Low-Value,Can't Lose
63380,1383,1,"13,15",2,1,1,4,Low-Value,Can't Lose
63382,1595,1,"86,5",1,1,1,3,Low-Value,Lost
63387,1474,2,"82,1",1,1,1,3,Low-Value,Lost
63388,804,3,"114,9",3,1,1,5,Low-Value,At Risk Customers
63390,1030,1,"15,4",3,1,1,5,Low-Value,At Risk Customers
63396,314,1,"273,5",5,1,1,7,Mid-Value,Potential Loyalists
63398,155,1,"128,8",5,1,1,7,Mid-Value,Potential Loyalists
63403,235,4,"334,45",5,1,1,7,Mid-Value,Potential Loyalists
63404,1113,5,"739,35",2,1,2,5,Low-Value,At Risk Customers
63405,55,2,"61,550000000000004",5,1,1,7,Mid-Value,Potential Loyalists
63408,49,4,"82,3",5,1,1,7,Mid-Value,Potential Loyalists
63412,456,3,"185,65",4,1,1,6,Mid-Value,Potential Loyalists
63413,319,1,"133,5",5,1,1,7,Mid-Value,Potential Loyalists
63414,1732,1,"120,89999999999999",1,1,1,3,Low-Value,Lost
63415,623,5,"160,65",4,1,1,6,Mid-Value,Potential Loyalists
63418,1680,1,"31,55",1,1,1,3,Low-Value,Lost
63420,300,6,"285,34999999999997",5,1,1,7,Mid-Value,Potential Loyalists
63421,950,2,"66,15",3,1,1,5,Low-Value,At Risk Customers
63422,331,1,"21,55",5,1,1,7,Mid-Value,Potential Loyalists
63423,488,1,"193,25",4,1,1,6,Mid-Value,Potential Loyalists
63424,6,2,"189,85",5,1,1,7,Mid-Value,Potential Loyalists
63425,1238,2,"112,8",2,1,1,4,Low-Value,Can't Lose
63426,958,1,"73,15",3,1,1,5,Low-Value,At Risk Customers
63427,627,1,"155,7",4,1,1,6,Mid-Value,Potential Loyalists
63428,512,1,"233,7",4,1,1,6,Mid-Value,Potential Loyalists
63431,897,2,"305,95",3,1,1,5,Low-Value,At Risk Customers
63432,150,2,"168,7",5,1,1,7,Mid-Value,Potential Loyalists
63434,1532,1,"32,0",1,1,1,3,Low-Value,Lost
63436,239,2,"86,25",5,1,1,7,Mid-Value,Potential Loyalists
63437,794,2,"52,35",3,1,1,5,Low-Value,At Risk Customers
63438,983,3,"112,3",3,1,1,5,Low-Value,At Risk Customers
63443,191,3,"108,06",5,1,1,7,Mid-Value,Potential Loyalists
63447,1167,3,"91,35",2,1,1,4,Low-Value,Can't Lose
63448,1437,1,"161,2",2,1,1,4,Low-Value,Can't Lose
63452,1171,4,"206,15",2,1,1,4,Low-Value,Can't Lose
63453,234,2,"24,3",5,1,1,7,Mid-Value,Potential Loyalists
63454,195,2,"164,55",5,1,1,7,Mid-Value,Potential Loyalists
63455,886,4,"108,1",3,1,1,5,Low-Value,At Risk Customers
63458,210,3,"130,14999999999998",5,1,1,7,Mid-Value,Potential Loyalists
63459,847,1,"8,05",3,1,1,5,Low-Value,At Risk Customers
63462,1787,1,"9,75",1,1,1,3,Low-Value,Lost
63463,1075,2,"377,59999999999997",3,1,1,5,Low-Value,At Risk Customers
63465,1772,2,"73,7",1,1,1,3,Low-Value,Lost
63466,452,12,"765,4",4,3,2,9,High-Value,Champions
63467,824,6,"290,65",3,1,1,5,Low-Value,At Risk Customers
63470,818,4,"179,35000000000002",3,1,1,5,Low-Value,At Risk Customers
63472,403,5,"220,05",4,1,1,6,Mid-Value,Potential Loyalists
63473,14,3,"307,05",5,1,1,7,Mid-Value,Potential Loyalists
63475,757,6,"226,3",3,1,1,5,Low-Value,At Risk Customers
63477,272,7,"122,6",5,2,1,8,High-Value,Potential Loyalists
63478,1048,1,"18,65",3,1,1,5,Low-Value,At Risk Customers
63479,1785,1,"11,9",1,1,1,3,Low-Value,Lost
63480,740,6,"286,2",3,1,1,5,Low-Value,At Risk Customers
63482,1115,3,"104,95",2,1,1,4,Low-Value,Can't Lose
63484,258,7,"372,25",5,2,1,8,High-Value,Potential Loyalists
63485,269,4,"217,3",5,1,1,7,Mid-Value,Potential Loyalists
63486,158,6,"600,5",5,1,1,7,Mid-Value,Potential Loyalists
63488,804,3,"65,3",3,1,1,5,Low-Value,At Risk Customers
63489,623,2,"75,15",4,1,1,6,Mid-Value,Potential Loyalists
63490,936,2,"73,0",3,1,1,5,Low-Value,At Risk Customers
63491,1215,2,"27,45",2,1,1,4,Low-Value,Can't Lose
63492,520,4,"63,4",4,1,1,6,Mid-Value,Potential Loyalists
63493,1168,5,"169,05",2,1,1,4,Low-Value,Can't Lose
63495,1253,1,"6,1",2,1,1,4,Low-Value,Can't Lose
63496,1590,1,"121,2",1,1,1,3,Low-Value,Lost
63497,630,3,"203,5",4,1,1,6,Mid-Value,Potential Loyalists
63499,415,3,"26,1",4,1,1,6,Mid-Value,Potential Loyalists
63500,81,4,"143,75",5,1,1,7,Mid-Value,Potential Loyalists
63502,1698,1,"120,0",1,1,1,3,Low-Value,Lost
63504,256,1,"4,2",5,1,1,7,Mid-Value,Potential Loyalists
63505,350,3,"157,15",5,1,1,7,Mid-Value,Potential Loyalists
63507,478,3,"164,35000000000002",4,1,1,6,Mid-Value,Potential Loyalists
63509,715,2,"154,3",4,1,1,6,Mid-Value,Potential Loyalists
63510,1352,1,"127,80000000000001",2,1,1,4,Low-Value,Can't Lose
63511,749,3,"260,4",3,1,1,5,Low-Value,At Risk Customers
63514,398,2,"104,95",4,1,1,6,Mid-Value,Potential Loyalists
63515,789,4,"248,85000000000002",3,1,1,5,Low-Value,At Risk Customers
63517,368,3,"91,0",4,1,1,6,Mid-Value,Potential Loyalists
63519,825,3,"76,6",3,1,1,5,Low-Value,At Risk Customers
63521,577,3,"133,95",4,1,1,6,Mid-Value,Potential Loyalists
63522,522,6,"456,5",4,1,1,6,Mid-Value,Potential Loyalists
63523,1788,1,"26,1",1,1,1,3,Low-Value,Lost
63525,132,6,"549,5",5,1,1,7,Mid-Value,Potential Loyalists
63526,192,1,"42,9",5,1,1,7,Mid-Value,Potential Loyalists
63527,113,4,"184,25",5,1,1,7,Mid-Value,Potential Loyalists
63530,182,4,"354,0",5,1,1,7,Mid-Value,Potential Loyalists
63531,336,3,"47,25",5,1,1,7,Mid-Value,Potential Loyalists
63534,1478,2,"32,4",1,1,1,3,Low-Value,Lost
63535,9,1,"40,92",5,1,1,7,Mid-Value,Potential Loyalists
63539,14,3,"110,1",5,1,1,7,Mid-Value,Potential Loyalists
63540,195,2,"63,25",5,1,1,7,Mid-Value,Potential Loyalists
63542,58,7,"619,55",5,2,1,8,High-Value,Potential Loyalists
63544,129,6,"453,54999999999995",5,1,1,7,Mid-Value,Potential Loyalists
63545,347,5,"231,05",5,1,1,7,Mid-Value,Potential Loyalists
63546,144,5,"234,45",5,1,1,7,Mid-Value,Potential Loyalists
63549,488,5,"214,85",4,1,1,6,Mid-Value,Potential Loyalists
63550,54,4,"482,79999999999995",5,1,1,7,Mid-Value,Potential Loyalists
63551,668,14,"679,15",4,3,2,9,High-Value,Champions
63553,395,8,"458,95",4,2,1,7,Mid-Value,Potential Loyalists
63554,662,2,"27,65",4,1,1,6,Mid-Value,Potential Loyalists
63556,615,2,"15,45",4,1,1,6,Mid-Value,Potential Loyalists
63557,743,2,"114,25",3,1,1,5,Low-Value,At Risk Customers
63562,770,1,"250,7",3,1,1,5,Low-Value,At Risk Customers
63563,240,4,"159,85",5,1,1,7,Mid-Value,Potential Loyalists
63565,864,2,"115,8",3,1,1,5,Low-Value,At Risk Customers
63566,13,8,"753,0",5,2,2,9,High-Value,Champions
63567,159,4,"484,45",5,1,1,7,Mid-Value,Potential Loyalists
63570,1172,3,"159,15",2,1,1,4,Low-Value,Can't Lose
63571,65,1,"42,45",5,1,1,7,Mid-Value,Potential Loyalists
63572,215,2,"94,89999999999999",5,1,1,7,Mid-Value,Potential Loyalists
63579,555,2,"387,55",4,1,1,6,Mid-Value,Potential Loyalists
63581,875,2,"87,2",3,1,1,5,Low-Value,At Risk Customers
63582,291,1,"19,05",5,1,1,7,Mid-Value,Potential Loyalists
63585,876,1,"7,8",3,1,1,5,Low-Value,At Risk Customers
63586,604,5,"392,25",4,1,1,6,Mid-Value,Potential Loyalists
63589,1236,2,"35,0",2,1,1,4,Low-Value,Can't Lose
63592,288,1,"31,4",5,1,1,7,Mid-Value,Potential Loyalists
63593,186,2,"275,55",5,1,1,7,Mid-Value,Potential Loyalists
63594,13,17,"967,35",5,4,2,11,High-Value,Champions
63595,537,3,"204,95",4,1,1,6,Mid-Value,Potential Loyalists
63598,858,3,"253,6",3,1,1,5,Low-Value,At Risk Customers
63599,898,4,"354,65",3,1,1,5,Low-Value,At Risk Customers
63600,32,7,"176,8",5,2,1,8,High-Value,Potential Loyalists
63601,643,4,"148,0",4,1,1,6,Mid-Value,Potential Loyalists
63602,592,1,"8,7",4,1,1,6,Mid-Value,Potential Loyalists
63605,0,6,"705,75",5,1,2,8,High-Value,Potential Loyalists
63606,10,6,"163,3",5,1,1,7,Mid-Value,Potential Loyalists
63608,124,5,"210,0",5,1,1,7,Mid-Value,Potential Loyalists
63609,1252,5,"218,8",2,1,1,4,Low-Value,Can't Lose
63610,1141,1,"34,45",2,1,1,4,Low-Value,Can't Lose
63611,1469,3,"125,1",1,1,1,3,Low-Value,Lost
63612,570,1,"39,3",4,1,1,6,Mid-Value,Potential Loyalists
63614,946,1,"29,25",3,1,1,5,Low-Value,At Risk Customers
63617,941,2,"169,60000000000002",3,1,1,5,Low-Value,At Risk Customers
63618,91,4,"100,1",5,1,1,7,Mid-Value,Potential Loyalists
63619,1484,1,"41,8",1,1,1,3,Low-Value,Lost
63620,980,1,"501,4",3,1,1,5,Low-Value,At Risk Customers
63621,455,3,"163,25",4,1,1,6,Mid-Value,Potential Loyalists
63622,1781,1,"5,0",1,1,1,3,Low-Value,Lost
63625,481,2,"99,8",4,1,1,6,Mid-Value,Potential Loyalists
63626,1286,2,"238,95",2,1,1,4,Low-Value,Can't Lose
63627,388,11,"731,15",4,2,2,8,High-Value,Potential Loyalists
63628,424,10,"511,2",4,2,1,7,Mid-Value,Potential Loyalists
63629,360,5,"163,6",5,1,1,7,Mid-Value,Potential Loyalists
63633,1249,1,"13,55",2,1,1,4,Low-Value,Can't Lose
63634,57,6,"675,15",5,1,2,8,High-Value,Potential Loyalists
63635,409,5,"434,3",4,1,1,6,Mid-Value,Potential Loyalists
63637,1713,1,"228,7",1,1,1,3,Low-Value,Lost
63639,341,3,"1071,15",5,1,2,8,High-Value,Potential Loyalists
63641,413,3,"53,95",4,1,1,6,Mid-Value,Potential Loyalists
63642,643,3,"102,5",4,1,1,6,Mid-Value,Potential Loyalists
63643,381,8,"326,9",4,2,1,7,Mid-Value,Potential Loyalists
63645,10,11,"673,7",5,2,2,9,High-Value,Champions
63646,373,2,"71,8",4,1,1,6,Mid-Value,Potential Loyalists
63649,235,6,"462,6",5,1,1,7,Mid-Value,Potential Loyalists
63650,394,4,"245,35000000000002",4,1,1,6,Mid-Value,Potential Loyalists
63651,176,11,"946,95",5,2,2,9,High-Value,Champions
63652,81,1,"28,15",5,1,1,7,Mid-Value,Potential Loyalists
63654,214,2,"44,550000000000004",5,1,1,7,Mid-Value,Potential Loyalists
63655,339,7,"445,75",5,2,1,8,High-Value,Potential Loyalists
63656,53,7,"460,75",5,2,1,8,High-Value,Potential Loyalists
63657,253,2,"27,05",5,1,1,7,Mid-Value,Potential Loyalists
63659,29,5,"248,85",5,1,1,7,Mid-Value,Potential Loyalists
63661,113,1,"37,8",5,1,1,7,Mid-Value,Potential Loyalists
63663,630,1,"28,55",4,1,1,6,Mid-Value,Potential Loyalists
63664,1324,3,"104,75",2,1,1,4,Low-Value,Can't Lose
63665,297,6,"295,15",5,1,1,7,Mid-Value,Potential Loyalists
63666,468,2,"118,85",4,1,1,6,Mid-Value,Potential Loyalists
63667,1104,5,"292,4",2,1,1,4,Low-Value,Can't Lose
63668,248,5,"531,5",5,1,1,7,Mid-Value,Potential Loyalists
63669,95,2,"119,1",5,1,1,7,Mid-Value,Potential Loyalists
63670,1572,2,"45,849999999999994",1,1,1,3,Low-Value,Lost
63671,387,4,"151,65",4,1,1,6,Mid-Value,Potential Loyalists
63672,1117,3,"42,25",2,1,1,4,Low-Value,Can't Lose
63674,1242,2,"59,8",2,1,1,4,Low-Value,Can't Lose
63675,1132,2,"42,1",2,1,1,4,Low-Value,Can't Lose
63676,1131,2,"62,95",2,1,1,4,Low-Value,Can't Lose
63677,157,7,"404,85",5,2,1,8,High-Value,Potential Loyalists
63678,237,4,"310,85",5,1,1,7,Mid-Value,Potential Loyalists
63679,1642,1,"66,1",1,1,1,3,Low-Value,Lost
63680,732,5,"702,35",3,1,2,6,Mid-Value,Potential Loyalists
63682,1,6,"353,4",5,1,1,7,Mid-Value,Potential Loyalists
63684,269,1,"55,0",5,1,1,7,Mid-Value,Potential Loyalists
63685,733,6,"284,7",3,1,1,5,Low-Value,At Risk Customers
63687,153,11,"895,75",5,2,2,9,High-Value,Champions
63689,470,9,"641,75",4,2,1,7,Mid-Value,Potential Loyalists
63692,186,5,"163,6",5,1,1,7,Mid-Value,Potential Loyalists
63693,1526,4,"210,35000000000002",1,1,1,3,Low-Value,Lost
63695,432,1,"29,95",4,1,1,6,Mid-Value,Potential Loyalists
63697,138,3,"182,60000000000002",5,1,1,7,Mid-Value,Potential Loyalists
63698,5,3,"338,25",5,1,1,7,Mid-Value,Potential Loyalists
63700,750,2,"45,7",3,1,1,5,Low-Value,At Risk Customers
63702,482,1,"19,9",4,1,1,6,Mid-Value,Potential Loyalists
63703,367,1,"219,89999999999998",4,1,1,6,Mid-Value,Potential Loyalists
63704,528,1,"126,1",4,1,1,6,Mid-Value,Potential Loyalists
63705,5,4,"371,35",5,1,1,7,Mid-Value,Potential Loyalists
63708,1078,3,"79,94999999999999",3,1,1,5,Low-Value,At Risk Customers
63709,46,1,"135,0",5,1,1,7,Mid-Value,Potential Loyalists
63710,480,1,"41,9",4,1,1,6,Mid-Value,Potential Loyalists
63712,1084,4,"446,15",3,1,1,5,Low-Value,At Risk Customers
63715,202,1,"22,7",5,1,1,7,Mid-Value,Potential Loyalists
63716,172,2,"121,89999999999999",5,1,1,7,Mid-Value,Potential Loyalists
63717,1641,3,"146,20000000000002",1,1,1,3,Low-Value,Lost
63718,563,2,"169,6",4,1,1,6,Mid-Value,Potential Loyalists
63719,423,5,"756,05",4,1,2,7,Mid-Value,Potential Loyalists
63720,1342,2,"140,6",2,1,1,4,Low-Value,Can't Lose
63724,742,5,"404,28000000000003",3,1,1,5,Low-Value,At Risk Customers
63730,734,1,"23,1",3,1,1,5,Low-Value,At Risk Customers
63731,202,7,"266,0",5,2,1,8,High-Value,Potential Loyalists
63732,502,2,"75,35",4,1,1,6,Mid-Value,Potential Loyalists
63733,394,1,"149,05",4,1,1,6,Mid-Value,Potential Loyalists
63735,4,4,"192,5",5,1,1,7,Mid-Value,Potential Loyalists
63736,18,3,"105,19999999999999",5,1,1,7,Mid-Value,Potential Loyalists
63737,670,8,"429,9",4,2,1,7,Mid-Value,Potential Loyalists
63738,886,3,"157,4",3,1,1,5,Low-Value,At Risk Customers
63739,977,2,"28,7",3,1,1,5,Low-Value,At Risk Customers
63740,243,1,"39,95",5,1,1,7,Mid-Value,Potential Loyalists
63742,1463,1,"4,5",1,1,1,3,Low-Value,Lost
63743,211,5,"723,8",5,1,2,8,High-Value,Potential Loyalists
63744,711,3,"222,7",4,1,1,6,Mid-Value,Potential Loyalists
63746,69,2,"119,6",5,1,1,7,Mid-Value,Potential Loyalists
63748,16,2,"38,55",5,1,1,7,Mid-Value,Potential Loyalists
63750,440,7,"407,40000000000003",4,2,1,7,Mid-Value,Potential Loyalists
63751,169,2,"129,9",5,1,1,7,Mid-Value,Potential Loyalists
63752,638,3,"56,5",4,1,1,6,Mid-Value,Potential Loyalists
63754,71,2,"69,05",5,1,1,7,Mid-Value,Potential Loyalists
63755,327,4,"423,0",5,1,1,7,Mid-Value,Potential Loyalists
63757,26,12,"773,15",5,3,2,10,High-Value,Champions
63758,766,2,"17,0",3,1,1,5,Low-Value,At Risk Customers
63759,379,14,"707,8",4,3,2,9,High-Value,Champions
63761,144,3,"43,35",5,1,1,7,Mid-Value,Potential Loyalists
63762,871,2,"61,85",3,1,1,5,Low-Value,At Risk Customers
63763,77,1,"234,45000000000002",5,1,1,7,Mid-Value,Potential Loyalists
63765,1235,1,"99,5",2,1,1,4,Low-Value,Can't Lose
63767,15,3,"38,5",5,1,1,7,Mid-Value,Potential Loyalists
63768,391,8,"347,05",4,2,1,7,Mid-Value,Potential Loyalists
63769,479,2,"70,85",4,1,1,6,Mid-Value,Potential Loyalists
63770,1351,1,"30,69",2,1,1,4,Low-Value,Can't Lose
63771,339,1,"62,4",5,1,1,7,Mid-Value,Potential Loyalists
63773,827,1,"49,8",3,1,1,5,Low-Value,At Risk Customers
63776,15,3,"234,05",5,1,1,7,Mid-Value,Potential Loyalists
63777,321,1,"225,7",5,1,1,7,Mid-Value,Potential Loyalists
63778,244,2,"26,85",5,1,1,7,Mid-Value,Potential Loyalists
63780,54,2,"191,8",5,1,1,7,Mid-Value,Potential Loyalists
63781,972,2,"70,25",3,1,1,5,Low-Value,At Risk Customers
63783,1732,1,"87,4",1,1,1,3,Low-Value,Lost
63784,1470,1,"40,65",1,1,1,3,Low-Value,Lost
63785,598,2,"85,30000000000001",4,1,1,6,Mid-Value,Potential Loyalists
63787,67,4,"93,45",5,1,1,7,Mid-Value,Potential Loyalists
63788,111,5,"338,15",5,1,1,7,Mid-Value,Potential Loyalists
63793,553,3,"294,05",4,1,1,6,Mid-Value,Potential Loyalists
63794,497,2,"53,0",4,1,1,6,Mid-Value,Potential Loyalists
63797,732,5,"568,95",3,1,1,5,Low-Value,At Risk Customers
63799,360,3,"390,40000000000003",5,1,1,7,Mid-Value,Potential Loyalists
63800,567,1,"71,1",4,1,1,6,Mid-Value,Potential Loyalists
63801,1790,1,"58,6",1,1,1,3,Low-Value,Lost
63803,881,1,"12,35",3,1,1,5,Low-Value,At Risk Customers
63804,38,4,"241,04999999999998",5,1,1,7,Mid-Value,Potential Loyalists
63805,445,1,"39,2",4,1,1,6,Mid-Value,Potential Loyalists
63808,225,3,"659,5",5,1,1,7,Mid-Value,Potential Loyalists
63809,20,7,"156,0",5,2,1,8,High-Value,Potential Loyalists
63812,185,2,"36,5",5,1,1,7,Mid-Value,Potential Loyalists
63813,85,6,"439,65000000000003",5,1,1,7,Mid-Value,Potential Loyalists
63817,25,4,"546,6",5,1,1,7,Mid-Value,Potential Loyalists
63819,27,7,"523,0",5,2,1,8,High-Value,Potential Loyalists
63820,9,4,"100,4",5,1,1,7,Mid-Value,Potential Loyalists
63822,686,1,"28,200000000000003",4,1,1,6,Mid-Value,Potential Loyalists
63823,699,3,"138,35000000000002",4,1,1,6,Mid-Value,Potential Loyalists
63825,1303,4,"254,7",2,1,1,4,Low-Value,Can't Lose
63826,38,7,"663,1500000000001",5,2,1,8,High-Value,Potential Loyalists
63827,10,6,"444,6",5,1,1,7,Mid-Value,Potential Loyalists
63831,24,11,"1127,25",5,2,2,9,High-Value,Champions
63832,440,2,"125,8",4,1,1,6,Mid-Value,Potential Loyalists
63833,465,2,"320,0",4,1,1,6,Mid-Value,Potential Loyalists
63837,658,6,"493,0",4,1,1,6,Mid-Value,Potential Loyalists
63838,1703,1,"16,35",1,1,1,3,Low-Value,Lost
63841,26,7,"448,6",5,2,1,8,High-Value,Potential Loyalists
63842,129,5,"405,44999999999993",5,1,1,7,Mid-Value,Potential Loyalists
63843,432,9,"556,1999999999999",4,2,1,7,Mid-Value,Potential Loyalists
63844,202,5,"135,5",5,1,1,7,Mid-Value,Potential Loyalists
63845,921,4,"214,6",3,1,1,5,Low-Value,At Risk Customers
63847,32,5,"626,2",5,1,1,7,Mid-Value,Potential Loyalists
63848,417,2,"154,64999999999998",4,1,1,6,Mid-Value,Potential Loyalists
63849,219,4,"290,05",5,1,1,7,Mid-Value,Potential Loyalists
63850,983,5,"160,85",3,1,1,5,Low-Value,At Risk Customers
63851,802,1,"10,95",3,1,1,5,Low-Value,At Risk Customers
63854,744,5,"411,75",3,1,1,5,Low-Value,At Risk Customers
63856,615,6,"254,35",4,1,1,6,Mid-Value,Potential Loyalists
63858,563,1,"7,5",4,1,1,6,Mid-Value,Potential Loyalists
63860,836,1,"17,85",3,1,1,5,Low-Value,At Risk Customers
63861,24,10,"1056,6000000000001",5,2,2,9,High-Value,Champions
63863,181,2,"95,44999999999999",5,1,1,7,Mid-Value,Potential Loyalists
63864,165,2,"34,4",5,1,1,7,Mid-Value,Potential Loyalists
63867,921,2,"424,4",3,1,1,5,Low-Value,At Risk Customers
63868,1613,1,"40,2",1,1,1,3,Low-Value,Lost
63869,1419,2,"35,65",2,1,1,4,Low-Value,Can't Lose
63871,1610,3,"206,8",1,1,1,3,Low-Value,Lost
63872,760,2,"59,5",3,1,1,5,Low-Value,At Risk Customers
63877,103,4,"82,39999999999999",5,1,1,7,Mid-Value,Potential Loyalists
63878,530,1,"31,6",4,1,1,6,Mid-Value,Potential Loyalists
63879,59,5,"87,95",5,1,1,7,Mid-Value,Potential Loyalists
63880,876,7,"451,34999999999997",3,2,1,6,Mid-Value,Potential Loyalists
63881,811,1,"54,0",3,1,1,5,Low-Value,At Risk Customers
63882,431,2,"27,65",4,1,1,6,Mid-Value,Potential Loyalists
63883,813,3,"409,25",3,1,1,5,Low-Value,At Risk Customers
63885,822,1,"9,3",3,1,1,5,Low-Value,At Risk Customers
63886,431,4,"255,35000000000002",4,1,1,6,Mid-Value,Potential Loyalists
63888,1183,1,"9,35",2,1,1,4,Low-Value,Can't Lose
63889,477,2,"356,55",4,1,1,6,Mid-Value,Potential Loyalists
63892,719,2,"57,050000000000004",4,1,1,6,Mid-Value,Potential Loyalists
63893,1303,3,"180,85000000000002",2,1,1,4,Low-Value,Can't Lose
63895,832,2,"49,7",3,1,1,5,Low-Value,At Risk Customers
63898,42,3,"176,75",5,1,1,7,Mid-Value,Potential Loyalists
63899,13,8,"655,1",5,2,1,8,High-Value,Potential Loyalists
63901,80,6,"360,3",5,1,1,7,Mid-Value,Potential Loyalists
63902,495,5,"316,05",4,1,1,6,Mid-Value,Potential Loyalists
63903,1221,1,"93,0",2,1,1,4,Low-Value,Can't Lose
63904,182,2,"312,0",5,1,1,7,Mid-Value,Potential Loyalists
63905,350,6,"302,65",5,1,1,7,Mid-Value,Potential Loyalists
63906,1642,1,"148,55",1,1,1,3,Low-Value,Lost
63909,142,3,"101,4",5,1,1,7,Mid-Value,Potential Loyalists
63914,134,6,"391,5",5,1,1,7,Mid-Value,Potential Loyalists
63915,745,6,"135,54999999999998",3,1,1,5,Low-Value,At Risk Customers
63917,151,5,"399,45",5,1,1,7,Mid-Value,Potential Loyalists
63918,25,7,"293,35",5,2,1,8,High-Value,Potential Loyalists
63919,36,3,"57,5",5,1,1,7,Mid-Value,Potential Loyalists
63920,421,4,"119,95",4,1,1,6,Mid-Value,Potential Loyalists
63921,435,3,"137,85",4,1,1,6,Mid-Value,Potential Loyalists
63924,46,2,"132,9",5,1,1,7,Mid-Value,Potential Loyalists
63925,552,1,"51,6",4,1,1,6,Mid-Value,Potential Loyalists
63928,1446,1,"43,55",2,1,1,4,Low-Value,Can't Lose
63930,83,8,"225,05",5,2,1,8,High-Value,Potential Loyalists
63931,36,1,"48,9",5,1,1,7,Mid-Value,Potential Loyalists
63932,5,4,"383,8",5,1,1,7,Mid-Value,Potential Loyalists
63934,103,8,"289,3",5,2,1,8,High-Value,Potential Loyalists
63935,752,3,"66,2",3,1,1,5,Low-Value,At Risk Customers
63937,208,2,"186,45",5,1,1,7,Mid-Value,Potential Loyalists
63939,985,4,"215,95000000000002",3,1,1,5,Low-Value,At Risk Customers
63941,559,4,"155,35",4,1,1,6,Mid-Value,Potential Loyalists
63942,1110,2,"150,35",2,1,1,4,Low-Value,Can't Lose
63947,600,2,"90,94999999999999",4,1,1,6,Mid-Value,Potential Loyalists
63949,16,1,"24,4",5,1,1,7,Mid-Value,Potential Loyalists
63950,1230,2,"131,4",2,1,1,4,Low-Value,Can't Lose
63951,718,2,"78,85",4,1,1,6,Mid-Value,Potential Loyalists
63952,118,5,"400,1",5,1,1,7,Mid-Value,Potential Loyalists
63954,167,4,"147,1",5,1,1,7,Mid-Value,Potential Loyalists
63955,156,5,"706,95",5,1,2,8,High-Value,Potential Loyalists
63957,297,2,"53,650000000000006",5,1,1,7,Mid-Value,Potential Loyalists
63958,1104,6,"338,3",2,1,1,4,Low-Value,Can't Lose
63959,239,5,"198,6",5,1,1,7,Mid-Value,Potential Loyalists
63960,641,1,"8,1",4,1,1,6,Mid-Value,Potential Loyalists
63961,195,2,"210,2",5,1,1,7,Mid-Value,Potential Loyalists
63962,353,2,"57,85",5,1,1,7,Mid-Value,Potential Loyalists
63963,1022,2,"64,95",3,1,1,5,Low-Value,At Risk Customers
63964,259,3,"47,55",5,1,1,7,Mid-Value,Potential Loyalists
63965,10,5,"156,3",5,1,1,7,Mid-Value,Potential Loyalists
63966,556,3,"149,85",4,1,1,6,Mid-Value,Potential Loyalists
63968,1373,1,"51,55",2,1,1,4,Low-Value,Can't Lose
63969,686,4,"220,65",4,1,1,6,Mid-Value,Potential Loyalists
63970,1285,1,"28,7",2,1,1,4,Low-Value,Can't Lose
63972,386,3,"331,3",4,1,1,6,Mid-Value,Potential Loyalists
63974,1786,1,"22,45",1,1,1,3,Low-Value,Lost
63977,830,2,"102,45",3,1,1,5,Low-Value,At Risk Customers
63984,12,5,"210,3",5,1,1,7,Mid-Value,Potential Loyalists
63985,195,1,"56,699999999999996",5,1,1,7,Mid-Value,Potential Loyalists
63986,211,6,"309,65000000000003",5,1,1,7,Mid-Value,Potential Loyalists
63989,1219,1,"14,8",2,1,1,4,Low-Value,Can't Lose
63990,1614,2,"212,29999999999998",1,1,1,3,Low-Value,Lost
63991,789,7,"558,6",3,2,1,6,Mid-Value,Potential Loyalists
63992,1101,1,"14,6",2,1,1,4,Low-Value,Can't Lose
63993,48,3,"70,9",5,1,1,7,Mid-Value,Potential Loyalists
63994,239,3,"83,3",5,1,1,7,Mid-Value,Potential Loyalists
63997,34,7,"406,45",5,2,1,8,High-Value,Potential Loyalists
63998,81,3,"88,9",5,1,1,7,Mid-Value,Potential Loyalists
64000,239,4,"274,84999999999997",5,1,1,7,Mid-Value,Potential Loyalists
64001,222,2,"189,8",5,1,1,7,Mid-Value,Potential Loyalists
64002,191,3,"384,15",5,1,1,7,Mid-Value,Potential Loyalists
64003,734,5,"252,25",3,1,1,5,Low-Value,At Risk Customers
64005,78,3,"692,8",5,1,2,8,High-Value,Potential Loyalists
64008,112,9,"304,15",5,2,1,8,High-Value,Potential Loyalists
64010,956,2,"187,2",3,1,1,5,Low-Value,At Risk Customers
64012,435,7,"245,4",4,2,1,7,Mid-Value,Potential Loyalists
64013,172,6,"769,55",5,1,2,8,High-Value,Potential Loyalists
64015,460,5,"198,35",4,1,1,6,Mid-Value,Potential Loyalists
64016,1039,2,"70,15",3,1,1,5,Low-Value,At Risk Customers
64017,934,5,"572,0",3,1,1,5,Low-Value,At Risk Customers
64018,292,1,"253,2",5,1,1,7,Mid-Value,Potential Loyalists
64019,1701,1,"24,5",1,1,1,3,Low-Value,Lost
64020,881,1,"20,6",3,1,1,5,Low-Value,At Risk Customers
64021,224,3,"230,35",5,1,1,7,Mid-Value,Potential Loyalists
64022,64,12,"567,3",5,3,1,9,High-Value,Champions
64023,726,1,"32,65",4,1,1,6,Mid-Value,Potential Loyalists
64026,496,2,"89,60000000000001",4,1,1,6,Mid-Value,Potential Loyalists
64027,36,3,"279,7",5,1,1,7,Mid-Value,Potential Loyalists
64028,347,3,"192,3",5,1,1,7,Mid-Value,Potential Loyalists
64029,1210,2,"331,54999999999995",2,1,1,4,Low-Value,Can't Lose
64032,489,7,"379,2",4,2,1,7,Mid-Value,Potential Loyalists
64034,27,8,"555,9",5,2,1,8,High-Value,Potential Loyalists
64035,452,3,"108,15",4,1,1,6,Mid-Value,Potential Loyalists
64037,889,3,"278,70000000000005",3,1,1,5,Low-Value,At Risk Customers
64038,605,2,"245,55",4,1,1,6,Mid-Value,Potential Loyalists
64040,789,5,"536,95",3,1,1,5,Low-Value,At Risk Customers
64041,833,4,"233,0",3,1,1,5,Low-Value,At Risk Customers
64043,925,5,"380,2",3,1,1,5,Low-Value,At Risk Customers
64044,669,4,"103,9",4,1,1,6,Mid-Value,Potential Loyalists
64045,231,2,"24,55",5,1,1,7,Mid-Value,Potential Loyalists
64047,1255,1,"141,25",2,1,1,4,Low-Value,Can't Lose
64048,1589,1,"75,7",1,1,1,3,Low-Value,Lost
64049,267,2,"188,9",5,1,1,7,Mid-Value,Potential Loyalists
64052,166,1,"40,8",5,1,1,7,Mid-Value,Potential Loyalists
64054,214,5,"360,65",5,1,1,7,Mid-Value,Potential Loyalists
64057,988,3,"890,5",3,1,2,6,Mid-Value,Potential Loyalists
64058,1429,1,"20,15",2,1,1,4,Low-Value,Can't Lose
64060,241,15,"828,2",5,3,2,10,High-Value,Champions
64061,375,1,"45,8",4,1,1,6,Mid-Value,Potential Loyalists
64063,140,12,"481,8",5,3,1,9,High-Value,Champions
64064,603,1,"158,4",4,1,1,6,Mid-Value,Potential Loyalists
64066,535,7,"626,75",4,2,1,7,Mid-Value,Potential Loyalists
64069,13,5,"357,5",5,1,1,7,Mid-Value,Potential Loyalists
64071,19,1,"355,6",5,1,1,7,Mid-Value,Potential Loyalists
64072,446,1,"10,6",4,1,1,6,Mid-Value,Potential Loyalists
64073,410,15,"967,25",4,3,2,9,High-Value,Champions
64074,1079,5,"405,95000000000005",3,1,1,5,Low-Value,At Risk Customers
64076,951,5,"337,2",3,1,1,5,Low-Value,At Risk Customers
64078,28,4,"296,65",5,1,1,7,Mid-Value,Potential Loyalists
64081,417,3,"428,09999999999997",4,1,1,6,Mid-Value,Potential Loyalists
64082,1337,2,"134,95",2,1,1,4,Low-Value,Can't Lose
64084,1758,1,"38,35",1,1,1,3,Low-Value,Lost
64085,1455,2,"85,55",2,1,1,4,Low-Value,Can't Lose
64086,488,3,"173,75",4,1,1,6,Mid-Value,Potential Loyalists
64087,1343,1,"86,9",2,1,1,4,Low-Value,Can't Lose
64088,1449,1,"84,8",2,1,1,4,Low-Value,Can't Lose
64092,1158,2,"336,2",2,1,1,4,Low-Value,Can't Lose
64093,603,3,"156,3",4,1,1,6,Mid-Value,Potential Loyalists
64097,1648,1,"17,7",1,1,1,3,Low-Value,Lost
64098,21,6,"282,40000000000003",5,1,1,7,Mid-Value,Potential Loyalists
64100,766,1,"20,5",3,1,1,5,Low-Value,At Risk Customers
64102,1119,2,"118,65",2,1,1,4,Low-Value,Can't Lose
64104,238,1,"77,2",5,1,1,7,Mid-Value,Potential Loyalists
64105,599,3,"507,40000000000003",4,1,1,6,Mid-Value,Potential Loyalists
64106,1351,1,"2,2",2,1,1,4,Low-Value,Can't Lose
64107,873,6,"324,8",3,1,1,5,Low-Value,At Risk Customers
64108,360,1,"31,2",5,1,1,7,Mid-Value,Potential Loyalists
64109,1653,1,"30,9",1,1,1,3,Low-Value,Lost
64110,26,3,"151,4",5,1,1,7,Mid-Value,Potential Loyalists
64111,1326,1,"20,5",2,1,1,4,Low-Value,Can't Lose
64112,700,1,"40,9",4,1,1,6,Mid-Value,Potential Loyalists
64114,12,6,"361,8",5,1,1,7,Mid-Value,Potential Loyalists
64115,197,3,"147,70000000000002",5,1,1,7,Mid-Value,Potential Loyalists
64117,469,1,"12,15",4,1,1,6,Mid-Value,Potential Loyalists
64118,1731,1,"23,1",1,1,1,3,Low-Value,Lost
64119,125,5,"517,45",5,1,1,7,Mid-Value,Potential Loyalists
64121,928,3,"67,65",3,1,1,5,Low-Value,At Risk Customers
64123,23,6,"145,5",5,1,1,7,Mid-Value,Potential Loyalists
64125,1555,2,"70,35",1,1,1,3,Low-Value,Lost
64127,83,4,"209,55",5,1,1,7,Mid-Value,Potential Loyalists
64131,738,3,"162,25",3,1,1,5,Low-Value,At Risk Customers
64132,84,1,"136,05",5,1,1,7,Mid-Value,Potential Loyalists
64133,74,6,"169,45",5,1,1,7,Mid-Value,Potential Loyalists
64134,1544,1,"51,85",1,1,1,3,Low-Value,Lost
64142,7,8,"587,5",5,2,1,8,High-Value,Potential Loyalists
64143,206,3,"148,0",5,1,1,7,Mid-Value,Potential Loyalists
64144,154,1,"32,0",5,1,1,7,Mid-Value,Potential Loyalists
64145,1,1,"71,0",5,1,1,7,Mid-Value,Potential Loyalists
64146,75,4,"231,0",5,1,1,7,Mid-Value,Potential Loyalists
64147,691,3,"196,2",4,1,1,6,Mid-Value,Potential Loyalists
64148,0,5,"205,65",5,1,1,7,Mid-Value,Potential Loyalists
64149,418,2,"67,0",4,1,1,6,Mid-Value,Potential Loyalists
64150,1595,1,"51,0",1,1,1,3,Low-Value,Lost
64151,122,4,"294,20000000000005",5,1,1,7,Mid-Value,Potential Loyalists
64152,1538,4,"185,85",1,1,1,3,Low-Value,Lost
64153,357,3,"422,45",5,1,1,7,Mid-Value,Potential Loyalists
64154,446,2,"65,0",4,1,1,6,Mid-Value,Potential Loyalists
64157,125,3,"249,70000000000002",5,1,1,7,Mid-Value,Potential Loyalists
64158,42,3,"32,05",5,1,1,7,Mid-Value,Potential Loyalists
64160,828,1,"83,5",3,1,1,5,Low-Value,At Risk Customers
64161,793,1,"24,6",3,1,1,5,Low-Value,At Risk Customers
64162,27,3,"214,1",5,1,1,7,Mid-Value,Potential Loyalists
64163,500,6,"972,0999999999999",4,1,2,7,Mid-Value,Potential Loyalists
64164,308,3,"186,3",5,1,1,7,Mid-Value,Potential Loyalists
64166,880,5,"372,4",3,1,1,5,Low-Value,At Risk Customers
64168,536,1,"191,3",4,1,1,6,Mid-Value,Potential Loyalists
64172,243,1,"11,5",5,1,1,7,Mid-Value,Potential Loyalists
64174,57,3,"102,80000000000001",5,1,1,7,Mid-Value,Potential Loyalists
64175,44,1,"10,45",5,1,1,7,Mid-Value,Potential Loyalists
64176,353,3,"58,900000000000006",5,1,1,7,Mid-Value,Potential Loyalists
64179,281,4,"190,6",5,1,1,7,Mid-Value,Potential Loyalists
64182,356,2,"79,6",5,1,1,7,Mid-Value,Potential Loyalists
64183,1272,1,"29,6",2,1,1,4,Low-Value,Can't Lose
64184,1475,2,"230,10000000000002",1,1,1,3,Low-Value,Lost
64185,378,6,"176,3",4,1,1,6,Mid-Value,Potential Loyalists
64189,103,4,"334,8",5,1,1,7,Mid-Value,Potential Loyalists
64191,1,9,"411,65000000000003",5,2,1,8,High-Value,Potential Loyalists
64192,951,1,"22,6",3,1,1,5,Low-Value,At Risk Customers
64193,892,1,"47,3",3,1,1,5,Low-Value,At Risk Customers
64194,774,4,"231,2",3,1,1,5,Low-Value,At Risk Customers
64199,348,4,"132,6",5,1,1,7,Mid-Value,Potential Loyalists
64201,953,1,"19,4",3,1,1,5,Low-Value,At Risk Customers
64202,647,4,"78,1",4,1,1,6,Mid-Value,Potential Loyalists
64203,200,4,"124,15",5,1,1,7,Mid-Value,Potential Loyalists
64204,1295,3,"459,20000000000005",2,1,1,4,Low-Value,Can't Lose
64205,534,1,"55,9",4,1,1,6,Mid-Value,Potential Loyalists
64206,15,5,"212,55",5,1,1,7,Mid-Value,Potential Loyalists
64207,241,8,"832,65",5,2,2,9,High-Value,Champions
64208,136,1,"5,699999999999999",5,1,1,7,Mid-Value,Potential Loyalists
64209,929,1,"106,75",3,1,1,5,Low-Value,At Risk Customers
64210,1164,4,"461,75",2,1,1,4,Low-Value,Can't Lose
64212,158,7,"813,2",5,2,2,9,High-Value,Champions
64213,229,1,"5,0",5,1,1,7,Mid-Value,Potential Loyalists
64214,656,2,"189,5",4,1,1,6,Mid-Value,Potential Loyalists
64215,440,3,"138,2",4,1,1,6,Mid-Value,Potential Loyalists
64217,28,2,"64,65",5,1,1,7,Mid-Value,Potential Loyalists
64219,912,2,"27,05",3,1,1,5,Low-Value,At Risk Customers
64220,876,1,"27,8",3,1,1,5,Low-Value,At Risk Customers
64221,1007,1,"63,85",3,1,1,5,Low-Value,At Risk Customers
64223,1390,2,"10,95",2,1,1,4,Low-Value,Can't Lose
64224,280,1,"11,35",5,1,1,7,Mid-Value,Potential Loyalists
64225,658,1,"62,15",4,1,1,6,Mid-Value,Potential Loyalists
64226,269,2,"39,0",5,1,1,7,Mid-Value,Potential Loyalists
64228,1289,3,"132,05",2,1,1,4,Low-Value,Can't Lose
64229,1227,2,"446,5",2,1,1,4,Low-Value,Can't Lose
64231,10,1,"28,4",5,1,1,7,Mid-Value,Potential Loyalists
64232,54,13,"676,25",5,3,2,10,High-Value,Champions
64234,66,7,"214,85",5,2,1,8,High-Value,Potential Loyalists
64235,1247,1,"11,4",2,1,1,4,Low-Value,Can't Lose
64236,908,1,"124,80000000000001",3,1,1,5,Low-Value,At Risk Customers
64239,492,2,"90,5",4,1,1,6,Mid-Value,Potential Loyalists
64241,10,7,"150,15",5,2,1,8,High-Value,Potential Loyalists
64242,491,2,"140,89999999999998",4,1,1,6,Mid-Value,Potential Loyalists
64244,595,1,"0,6",4,1,1,6,Mid-Value,Potential Loyalists
64246,297,3,"153,85000000000002",5,1,1,7,Mid-Value,Potential Loyalists
64247,390,6,"424,65",4,1,1,6,Mid-Value,Potential Loyalists
64248,1601,1,"14,65",1,1,1,3,Low-Value,Lost
64249,1250,2,"53,900000000000006",2,1,1,4,Low-Value,Can't Lose
64250,175,5,"453,9",5,1,1,7,Mid-Value,Potential Loyalists
64251,573,3,"155,89999999999998",4,1,1,6,Mid-Value,Potential Loyalists
64254,402,4,"82,55000000000001",4,1,1,6,Mid-Value,Potential Loyalists
64255,12,15,"1007,4",5,3,2,10,High-Value,Champions
64256,19,5,"176,0",5,1,1,7,Mid-Value,Potential Loyalists
64257,1009,2,"47,6",3,1,1,5,Low-Value,At Risk Customers
64258,579,5,"433,8",4,1,1,6,Mid-Value,Potential Loyalists
64259,913,3,"98,10000000000001",3,1,1,5,Low-Value,At Risk Customers
64260,531,1,"74,0",4,1,1,6,Mid-Value,Potential Loyalists
64262,434,4,"136,1",4,1,1,6,Mid-Value,Potential Loyalists
64263,815,1,"9,75",3,1,1,5,Low-Value,At Risk Customers
64265,379,3,"320,0",4,1,1,6,Mid-Value,Potential Loyalists
64266,1663,1,"147,0",1,1,1,3,Low-Value,Lost
64267,39,3,"130,85",5,1,1,7,Mid-Value,Potential Loyalists
64268,468,3,"90,5",4,1,1,6,Mid-Value,Potential Loyalists
64273,789,1,"51,15",3,1,1,5,Low-Value,At Risk Customers
64274,1312,2,"27,0",2,1,1,4,Low-Value,Can't Lose
64276,1171,2,"196,2",2,1,1,4,Low-Value,Can't Lose
64277,861,1,"35,0",3,1,1,5,Low-Value,At Risk Customers
64280,241,1,"84,65",5,1,1,7,Mid-Value,Potential Loyalists
64282,1468,1,"83,5",1,1,1,3,Low-Value,Lost
64284,236,5,"410,7",5,1,1,7,Mid-Value,Potential Loyalists
64285,203,4,"352,15000000000003",5,1,1,7,Mid-Value,Potential Loyalists
64286,122,5,"206,89999999999998",5,1,1,7,Mid-Value,Potential Loyalists
64287,445,4,"205,65",4,1,1,6,Mid-Value,Potential Loyalists
64290,831,2,"67,3",3,1,1,5,Low-Value,At Risk Customers
64292,197,3,"174,5",5,1,1,7,Mid-Value,Potential Loyalists
64293,138,8,"408,95",5,2,1,8,High-Value,Potential Loyalists
64294,820,2,"239,5",3,1,1,5,Low-Value,At Risk Customers
64295,256,3,"101,4",5,1,1,7,Mid-Value,Potential Loyalists
64296,724,2,"180,05",4,1,1,6,Mid-Value,Potential Loyalists
64299,66,3,"133,25",5,1,1,7,Mid-Value,Potential Loyalists
64300,53,13,"567,05",5,3,1,9,High-Value,Champions
64303,207,3,"193,65",5,1,1,7,Mid-Value,Potential Loyalists
64304,843,1,"38,05",3,1,1,5,Low-Value,At Risk Customers
64305,112,7,"518,65",5,2,1,8,High-Value,Potential Loyalists
64306,26,8,"530,05",5,2,1,8,High-Value,Potential Loyalists
64308,249,2,"42,300000000000004",5,1,1,7,Mid-Value,Potential Loyalists
64309,390,2,"76,65",4,1,1,6,Mid-Value,Potential Loyalists
64311,218,7,"441,55",5,2,1,8,High-Value,Potential Loyalists
64314,94,4,"233,25000000000003",5,1,1,7,Mid-Value,Potential Loyalists
64315,1158,1,"16,55",2,1,1,4,Low-Value,Can't Lose
64318,49,4,"159,75",5,1,1,7,Mid-Value,Potential Loyalists
64319,383,3,"913,95",4,1,2,7,Mid-Value,Potential Loyalists
64320,1282,1,"331,9",2,1,1,4,Low-Value,Can't Lose
64321,924,1,"25,8",3,1,1,5,Low-Value,At Risk Customers
64322,211,4,"242,70000000000002",5,1,1,7,Mid-Value,Potential Loyalists
64324,197,2,"52,75",5,1,1,7,Mid-Value,Potential Loyalists
64326,165,2,"49,849999999999994",5,1,1,7,Mid-Value,Potential Loyalists
64328,277,3,"39,5",5,1,1,7,Mid-Value,Potential Loyalists
64329,556,2,"145,55",4,1,1,6,Mid-Value,Potential Loyalists
64330,1509,3,"56,449999999999996",1,1,1,3,Low-Value,Lost
64331,1454,1,"56,7",2,1,1,4,Low-Value,Can't Lose
64332,608,3,"181,05",4,1,1,6,Mid-Value,Potential Loyalists
64333,862,4,"364,6",3,1,1,5,Low-Value,At Risk Customers
64334,1033,1,"51,7",3,1,1,5,Low-Value,At Risk Customers
64335,433,2,"29,5",4,1,1,6,Mid-Value,Potential Loyalists
64336,1237,2,"101,15",2,1,1,4,Low-Value,Can't Lose
64337,1030,1,"6,35",3,1,1,5,Low-Value,At Risk Customers
64339,1605,2,"374,85",1,1,1,3,Low-Value,Lost
64340,1475,1,"19,0",1,1,1,3,Low-Value,Lost
64341,38,9,"484,25",5,2,1,8,High-Value,Potential Loyalists
64342,1006,1,"67,35",3,1,1,5,Low-Value,At Risk Customers
64343,838,6,"272,4",3,1,1,5,Low-Value,At Risk Customers
64351,1604,1,"30,75",1,1,1,3,Low-Value,Lost
64352,13,6,"498,80000000000007",5,1,1,7,Mid-Value,Potential Loyalists
64353,1368,3,"119,75",2,1,1,4,Low-Value,Can't Lose
64356,603,1,"49,95",4,1,1,6,Mid-Value,Potential Loyalists
64357,1439,2,"120,9",2,1,1,4,Low-Value,Can't Lose
64359,595,6,"193,29999999999998",4,1,1,6,Mid-Value,Potential Loyalists
64360,30,2,"39,650000000000006",5,1,1,7,Mid-Value,Potential Loyalists
64362,231,7,"484,7",5,2,1,8,High-Value,Potential Loyalists
64363,1497,2,"96,44999999999999",1,1,1,3,Low-Value,Lost
64364,1426,1,"35,6",2,1,1,4,Low-Value,Can't Lose
64366,967,3,"87,8",3,1,1,5,Low-Value,At Risk Customers
64367,76,4,"348,04999999999995",5,1,1,7,Mid-Value,Potential Loyalists
64369,353,2,"156,1",5,1,1,7,Mid-Value,Potential Loyalists
64371,79,3,"145,05",5,1,1,7,Mid-Value,Potential Loyalists
64372,846,5,"415,75",3,1,1,5,Low-Value,At Risk Customers
64373,353,1,"126,4",5,1,1,7,Mid-Value,Potential Loyalists
64377,226,5,"184,6",5,1,1,7,Mid-Value,Potential Loyalists
64378,1590,1,"44,9",1,1,1,3,Low-Value,Lost
64381,407,6,"273,3",4,1,1,6,Mid-Value,Potential Loyalists
64384,296,2,"85,44999999999999",5,1,1,7,Mid-Value,Potential Loyalists
64385,696,1,"341,4",4,1,1,6,Mid-Value,Potential Loyalists
64386,368,5,"129,3",4,1,1,6,Mid-Value,Potential Loyalists
64387,217,4,"649,4499999999999",5,1,1,7,Mid-Value,Potential Loyalists
64388,362,3,"119,9",5,1,1,7,Mid-Value,Potential Loyalists
64389,182,4,"428,2",5,1,1,7,Mid-Value,Potential Loyalists
64391,85,3,"144,25",5,1,1,7,Mid-Value,Potential Loyalists
64393,34,3,"422,6",5,1,1,7,Mid-Value,Potential Loyalists
64396,687,2,"89,75",4,1,1,6,Mid-Value,Potential Loyalists
64397,1355,1,"101,10000000000001",2,1,1,4,Low-Value,Can't Lose
64398,150,6,"754,65",5,1,2,8,High-Value,Potential Loyalists
64399,357,8,"485,05",5,2,1,8,High-Value,Potential Loyalists
64401,631,2,"118,6",4,1,1,6,Mid-Value,Potential Loyalists
64405,389,4,"155,4",4,1,1,6,Mid-Value,Potential Loyalists
64406,6,3,"113,55000000000001",5,1,1,7,Mid-Value,Potential Loyalists
64408,1723,2,"145,0",1,1,1,3,Low-Value,Lost
64409,58,1,"50,4",5,1,1,7,Mid-Value,Potential Loyalists
64411,1197,2,"283,5",2,1,1,4,Low-Value,Can't Lose
64412,60,6,"130,1",5,1,1,7,Mid-Value,Potential Loyalists
64413,278,3,"262,35",5,1,1,7,Mid-Value,Potential Loyalists
64414,532,3,"280,0",4,1,1,6,Mid-Value,Potential Loyalists
64415,607,5,"227,0",4,1,1,6,Mid-Value,Potential Loyalists
64416,1041,1,"9,55",3,1,1,5,Low-Value,At Risk Customers
64418,1629,2,"63,15",1,1,1,3,Low-Value,Lost
64419,874,4,"368,3",3,1,1,5,Low-Value,At Risk Customers
64422,704,4,"108,7",4,1,1,6,Mid-Value,Potential Loyalists
64423,274,3,"158,9",5,1,1,7,Mid-Value,Potential Loyalists
64424,388,7,"398,05000000000007",4,2,1,7,Mid-Value,Potential Loyalists
64428,40,6,"166,45",5,1,1,7,Mid-Value,Potential Loyalists
64429,312,6,"378,6",5,1,1,7,Mid-Value,Potential Loyalists
64430,294,4,"242,64999999999998",5,1,1,7,Mid-Value,Potential Loyalists
64432,451,1,"42,45",4,1,1,6,Mid-Value,Potential Loyalists
64434,538,6,"433,15",4,1,1,6,Mid-Value,Potential Loyalists
64435,1313,2,"128,4",2,1,1,4,Low-Value,Can't Lose
64438,1041,2,"147,45",3,1,1,5,Low-Value,At Risk Customers
64440,76,1,"14,45",5,1,1,7,Mid-Value,Potential Loyalists
64442,428,6,"424,0",4,1,1,6,Mid-Value,Potential Loyalists
64443,1083,1,"18,9",3,1,1,5,Low-Value,At Risk Customers
64444,1064,1,"14,65",3,1,1,5,Low-Value,At Risk Customers
64445,295,4,"173,60000000000002",5,1,1,7,Mid-Value,Potential Loyalists
64446,1221,1,"62,099999999999994",2,1,1,4,Low-Value,Can't Lose
64448,1169,2,"127,2",2,1,1,4,Low-Value,Can't Lose
64449,225,3,"87,0",5,1,1,7,Mid-Value,Potential Loyalists
64451,554,2,"195,35",4,1,1,6,Mid-Value,Potential Loyalists
64452,756,3,"214,1",3,1,1,5,Low-Value,At Risk Customers
64453,361,1,"48,3",5,1,1,7,Mid-Value,Potential Loyalists
64454,95,5,"664,45",5,1,2,8,High-Value,Potential Loyalists
64458,876,1,"190,2",3,1,1,5,Low-Value,At Risk Customers
64459,219,1,"87,15",5,1,1,7,Mid-Value,Potential Loyalists
64461,551,3,"63,95",4,1,1,6,Mid-Value,Potential Loyalists
64462,446,1,"20,75",4,1,1,6,Mid-Value,Potential Loyalists
64463,578,1,"270,0",4,1,1,6,Mid-Value,Potential Loyalists
64465,488,7,"215,9",4,2,1,7,Mid-Value,Potential Loyalists
64466,299,1,"31,65",5,1,1,7,Mid-Value,Potential Loyalists
64467,485,1,"19,1",4,1,1,6,Mid-Value,Potential Loyalists
64470,955,2,"131,75",3,1,1,5,Low-Value,At Risk Customers
64472,237,5,"167,05",5,1,1,7,Mid-Value,Potential Loyalists
64473,357,5,"96,89999999999999",5,1,1,7,Mid-Value,Potential Loyalists
64474,581,2,"255,5",4,1,1,6,Mid-Value,Potential Loyalists
64476,231,1,"81,8",5,1,1,7,Mid-Value,Potential Loyalists
64477,187,2,"116,7",5,1,1,7,Mid-Value,Potential Loyalists
64478,98,3,"64,3",5,1,1,7,Mid-Value,Potential Loyalists
64479,776,1,"42,2",3,1,1,5,Low-Value,At Risk Customers
64480,760,1,"19,9",3,1,1,5,Low-Value,At Risk Customers
64481,22,7,"482,1",5,2,1,8,High-Value,Potential Loyalists
64483,586,4,"81,2",4,1,1,6,Mid-Value,Potential Loyalists
64484,190,6,"353,6",5,1,1,7,Mid-Value,Potential Loyalists
64486,17,5,"671,5",5,1,2,8,High-Value,Potential Loyalists
64488,41,8,"242,1",5,2,1,8,High-Value,Potential Loyalists
64489,1053,2,"117,05000000000001",3,1,1,5,Low-Value,At Risk Customers
64490,869,4,"227,95000000000002",3,1,1,5,Low-Value,At Risk Customers
64491,702,2,"71,8",4,1,1,6,Mid-Value,Potential Loyalists
64492,229,3,"150,75",5,1,1,7,Mid-Value,Potential Loyalists
64493,72,4,"437,4",5,1,1,7,Mid-Value,Potential Loyalists
64494,509,1,"46,5",4,1,1,6,Mid-Value,Potential Loyalists
64495,1115,2,"209,25",2,1,1,4,Low-Value,Can't Lose
64496,1610,2,"198,6",1,1,1,3,Low-Value,Lost
64497,493,7,"799,75",4,2,2,8,High-Value,Potential Loyalists
64498,1241,4,"155,6",2,1,1,4,Low-Value,Can't Lose
64500,661,14,"469,7",4,3,1,8,High-Value,Potential Loyalists
64502,1053,1,"83,3",3,1,1,5,Low-Value,At Risk Customers
64508,15,2,"80,15",5,1,1,7,Mid-Value,Potential Loyalists
64513,1637,2,"512,0",1,1,1,3,Low-Value,Lost
64514,385,4,"396,84999999999997",4,1,1,6,Mid-Value,Potential Loyalists
64515,15,2,"409,75",5,1,1,7,Mid-Value,Potential Loyalists
64517,124,3,"68,4",5,1,1,7,Mid-Value,Potential Loyalists
64518,221,5,"294,6",5,1,1,7,Mid-Value,Potential Loyalists
64519,899,4,"157,20000000000002",3,1,1,5,Low-Value,At Risk Customers
64520,417,15,"1078,6",4,3,2,9,High-Value,Champions
64521,325,1,"29,2",5,1,1,7,Mid-Value,Potential Loyalists
64523,381,4,"182,95",4,1,1,6,Mid-Value,Potential Loyalists
64526,786,2,"176,89999999999998",3,1,1,5,Low-Value,At Risk Customers
64529,129,3,"149,7",5,1,1,7,Mid-Value,Potential Loyalists
64530,1064,1,"14,35",3,1,1,5,Low-Value,At Risk Customers
64531,142,3,"376,0",5,1,1,7,Mid-Value,Potential Loyalists
64533,29,5,"304,05",5,1,1,7,Mid-Value,Potential Loyalists
64534,206,7,"364,1",5,2,1,8,High-Value,Potential Loyalists
64535,606,1,"18,7",4,1,1,6,Mid-Value,Potential Loyalists
64538,1039,3,"213,95",3,1,1,5,Low-Value,At Risk Customers
64540,1592,1,"78,0",1,1,1,3,Low-Value,Lost
64543,554,6,"262,5",4,1,1,6,Mid-Value,Potential Loyalists
64545,239,6,"683,4000000000001",5,1,2,8,High-Value,Potential Loyalists
64546,1551,4,"99,4",1,1,1,3,Low-Value,Lost
64548,941,2,"176,7",3,1,1,5,Low-Value,At Risk Customers
64549,1529,2,"35,5",1,1,1,3,Low-Value,Lost
64550,916,3,"434,4",3,1,1,5,Low-Value,At Risk Customers
64551,7,9,"908,9",5,2,2,9,High-Value,Champions
64552,608,2,"113,85",4,1,1,6,Mid-Value,Potential Loyalists
64553,123,4,"102,14999999999999",5,1,1,7,Mid-Value,Potential Loyalists
64554,1196,2,"122,1",2,1,1,4,Low-Value,Can't Lose
64555,1722,1,"108,0",1,1,1,3,Low-Value,Lost
64558,1229,1,"35,7",2,1,1,4,Low-Value,Can't Lose
64561,1319,1,"8,75",2,1,1,4,Low-Value,Can't Lose
64562,772,3,"140,65",3,1,1,5,Low-Value,At Risk Customers
64563,311,7,"536,6",5,2,1,8,High-Value,Potential Loyalists
64565,1100,2,"102,55",2,1,1,4,Low-Value,Can't Lose
64566,1601,1,"27,25",1,1,1,3,Low-Value,Lost
64567,1219,1,"145,5",2,1,1,4,Low-Value,Can't Lose
64570,353,4,"220,20000000000002",5,1,1,7,Mid-Value,Potential Loyalists
64571,57,12,"938,5",5,3,2,10,High-Value,Champions
64572,1253,7,"555,0",2,2,1,5,Low-Value,At Risk Customers
64573,1269,4,"187,20000000000002",2,1,1,4,Low-Value,Can't Lose
64574,875,1,"122,4",3,1,1,5,Low-Value,At Risk Customers
64576,164,1,"18,8",5,1,1,7,Mid-Value,Potential Loyalists
64578,173,6,"622,0",5,1,1,7,Mid-Value,Potential Loyalists
64579,32,6,"313,0",5,1,1,7,Mid-Value,Potential Loyalists
64581,297,1,"26,1",5,1,1,7,Mid-Value,Potential Loyalists
64582,1509,1,"55,25",1,1,1,3,Low-Value,Lost
64583,897,2,"179,3",3,1,1,5,Low-Value,At Risk Customers
64584,69,4,"182,89999999999998",5,1,1,7,Mid-Value,Potential Loyalists
64585,267,1,"44,0",5,1,1,7,Mid-Value,Potential Loyalists
64587,423,1,"11,9",4,1,1,6,Mid-Value,Potential Loyalists
64588,4,4,"461,75",5,1,1,7,Mid-Value,Potential Loyalists
64589,563,3,"161,3",4,1,1,6,Mid-Value,Potential Loyalists
64590,430,1,"50,85",4,1,1,6,Mid-Value,Potential Loyalists
64598,780,6,"295,95",3,1,1,5,Low-Value,At Risk Customers
64599,718,1,"27,1",4,1,1,6,Mid-Value,Potential Loyalists
64601,1549,1,"80,45",1,1,1,3,Low-Value,Lost
64602,175,5,"382,45",5,1,1,7,Mid-Value,Potential Loyalists
64605,326,4,"133,35",5,1,1,7,Mid-Value,Potential Loyalists
64606,1345,2,"56,3",2,1,1,4,Low-Value,Can't Lose
64608,106,4,"179,20000000000002",5,1,1,7,Mid-Value,Potential Loyalists
64609,66,4,"178,9",5,1,1,7,Mid-Value,Potential Loyalists
64610,795,5,"289,9",3,1,1,5,Low-Value,At Risk Customers
64611,537,4,"895,7",4,1,2,7,Mid-Value,Potential Loyalists
64612,1478,2,"134,2",1,1,1,3,Low-Value,Lost
64615,1144,2,"232,25",2,1,1,4,Low-Value,Can't Lose
64618,166,4,"211,04999999999998",5,1,1,7,Mid-Value,Potential Loyalists
64619,7,2,"78,05",5,1,1,7,Mid-Value,Potential Loyalists
64620,600,4,"123,9",4,1,1,6,Mid-Value,Potential Loyalists
64621,1144,2,"208,45",2,1,1,4,Low-Value,Can't Lose
64622,960,1,"1162,0",3,1,2,6,Mid-Value,Potential Loyalists
64625,416,9,"283,59999999999997",4,2,1,7,Mid-Value,Potential Loyalists
64627,87,9,"501,2",5,2,1,8,High-Value,Potential Loyalists
64628,651,2,"133,7",4,1,1,6,Mid-Value,Potential Loyalists
64632,1577,1,"17,25",1,1,1,3,Low-Value,Lost
64633,1269,1,"55,5",2,1,1,4,Low-Value,Can't Lose
64634,75,1,"12,1",5,1,1,7,Mid-Value,Potential Loyalists
64635,1047,1,"3,6",3,1,1,5,Low-Value,At Risk Customers
64636,150,2,"45,2",5,1,1,7,Mid-Value,Potential Loyalists
64640,34,10,"463,45",5,2,1,8,High-Value,Potential Loyalists
64642,317,4,"94,45",5,1,1,7,Mid-Value,Potential Loyalists
64643,155,4,"403,9",5,1,1,7,Mid-Value,Potential Loyalists
64644,814,2,"53,4",3,1,1,5,Low-Value,At Risk Customers
64645,595,5,"75,85",4,1,1,6,Mid-Value,Potential Loyalists
64646,179,5,"286,85",5,1,1,7,Mid-Value,Potential Loyalists
64647,672,3,"153,15",4,1,1,6,Mid-Value,Potential Loyalists
64649,129,7,"392,78000000000003",5,2,1,8,High-Value,Potential Loyalists
64651,230,2,"50,05",5,1,1,7,Mid-Value,Potential Loyalists
64654,966,3,"532,15",3,1,1,5,Low-Value,At Risk Customers
64655,182,4,"730,15",5,1,2,8,High-Value,Potential Loyalists
64656,14,5,"243,45",5,1,1,7,Mid-Value,Potential Loyalists
64658,465,2,"27,65",4,1,1,6,Mid-Value,Potential Loyalists
64660,41,5,"331,95",5,1,1,7,Mid-Value,Potential Loyalists
64661,511,4,"266,35",4,1,1,6,Mid-Value,Potential Loyalists
64662,583,1,"11,4",4,1,1,6,Mid-Value,Potential Loyalists
64663,659,1,"8,75",4,1,1,6,Mid-Value,Potential Loyalists
64666,669,2,"89,2",4,1,1,6,Mid-Value,Potential Loyalists
64667,438,1,"8,35",4,1,1,6,Mid-Value,Potential Loyalists
64668,745,3,"110,25",3,1,1,5,Low-Value,At Risk Customers
64671,1133,3,"154,45",2,1,1,4,Low-Value,Can't Lose
64672,654,4,"239,25",4,1,1,6,Mid-Value,Potential Loyalists
64673,826,13,"494,7",3,3,1,7,Mid-Value,Potential Loyalists
64674,346,4,"225,35",5,1,1,7,Mid-Value,Potential Loyalists
64675,55,11,"1105,31",5,2,2,9,High-Value,Champions
64676,172,4,"400,85",5,1,1,7,Mid-Value,Potential Loyalists
64678,541,2,"94,1",4,1,1,6,Mid-Value,Potential Loyalists
64679,236,2,"113,45",5,1,1,7,Mid-Value,Potential Loyalists
64680,1373,3,"99,6",2,1,1,4,Low-Value,Can't Lose
64681,23,4,"266,7",5,1,1,7,Mid-Value,Potential Loyalists
64682,495,5,"295,3",4,1,1,6,Mid-Value,Potential Loyalists
64684,19,6,"373,8",5,1,1,7,Mid-Value,Potential Loyalists
64688,193,7,"743,5500000000001",5,2,2,9,High-Value,Champions
64689,182,2,"36,6",5,1,1,7,Mid-Value,Potential Loyalists
64690,924,4,"137,35",3,1,1,5,Low-Value,At Risk Customers
64692,10,9,"388,9",5,2,1,8,High-Value,Potential Loyalists
64694,1334,1,"13,200000000000001",2,1,1,4,Low-Value,Can't Lose
64696,552,4,"321,04999999999995",4,1,1,6,Mid-Value,Potential Loyalists
64697,376,9,"362,75",4,2,1,7,Mid-Value,Potential Loyalists
64698,1,3,"461,2",5,1,1,7,Mid-Value,Potential Loyalists
64699,1101,1,"83,0",2,1,1,4,Low-Value,Can't Lose
64702,1188,3,"163,05",2,1,1,4,Low-Value,Can't Lose
64704,113,8,"804,2",5,2,2,9,High-Value,Champions
64705,231,4,"150,25",5,1,1,7,Mid-Value,Potential Loyalists
64706,1404,1,"9,55",2,1,1,4,Low-Value,Can't Lose
64709,619,1,"56,7",4,1,1,6,Mid-Value,Potential Loyalists
64712,452,5,"252,65",4,1,1,6,Mid-Value,Potential Loyalists
64714,30,6,"499,6",5,1,1,7,Mid-Value,Potential Loyalists
64716,217,2,"173,75",5,1,1,7,Mid-Value,Potential Loyalists
64719,173,3,"355,09999999999997",5,1,1,7,Mid-Value,Potential Loyalists
64722,446,10,"433,55",4,2,1,7,Mid-Value,Potential Loyalists
64724,739,2,"46,150000000000006",3,1,1,5,Low-Value,At Risk Customers
64725,535,5,"289,5",4,1,1,6,Mid-Value,Potential Loyalists
64726,370,7,"395,95000000000005",4,2,1,7,Mid-Value,Potential Loyalists
64727,1061,4,"334,95",3,1,1,5,Low-Value,At Risk Customers
64728,894,3,"22,8",3,1,1,5,Low-Value,At Risk Customers
64729,1635,2,"317,79999999999995",1,1,1,3,Low-Value,Lost
64732,159,6,"758,05",5,1,2,8,High-Value,Potential Loyalists
64733,504,5,"108,3",4,1,1,6,Mid-Value,Potential Loyalists
64735,1819,1,"0,75",1,1,1,3,Low-Value,Lost
64739,1012,1,"18,45",3,1,1,5,Low-Value,At Risk Customers
64742,990,2,"105,19999999999999",3,1,1,5,Low-Value,At Risk Customers
64743,1211,1,"32,55",2,1,1,4,Low-Value,Can't Lose
64744,46,4,"149,4",5,1,1,7,Mid-Value,Potential Loyalists
64745,1050,5,"119,4",3,1,1,5,Low-Value,At Risk Customers
64746,74,6,"596,75",5,1,1,7,Mid-Value,Potential Loyalists
64748,760,5,"188,75",3,1,1,5,Low-Value,At Risk Customers
64751,157,5,"275,31",5,1,1,7,Mid-Value,Potential Loyalists
64754,1404,1,"753,7",2,1,2,5,Low-Value,At Risk Customers
64756,1144,1,"29,85",2,1,1,4,Low-Value,Can't Lose
64757,112,5,"134,3",5,1,1,7,Mid-Value,Potential Loyalists
64762,15,10,"1098,8",5,2,2,9,High-Value,Champions
64763,35,13,"517,55",5,3,1,9,High-Value,Champions
64765,11,22,"1567,5",5,5,3,13,High-Value,Champions
64766,1012,2,"86,95",3,1,1,5,Low-Value,At Risk Customers
64767,108,2,"31,25",5,1,1,7,Mid-Value,Potential Loyalists
64769,1089,1,"5,1",3,1,1,5,Low-Value,At Risk Customers
64770,754,7,"414,1",3,2,1,6,Mid-Value,Potential Loyalists
64774,1219,2,"302,7",2,1,1,4,Low-Value,Can't Lose
64775,663,2,"67,7",4,1,1,6,Mid-Value,Potential Loyalists
64777,1211,2,"22,549999999999997",2,1,1,4,Low-Value,Can't Lose
64778,225,3,"227,85",5,1,1,7,Mid-Value,Potential Loyalists
64779,461,2,"101,85000000000001",4,1,1,6,Mid-Value,Potential Loyalists
64782,122,2,"96,85000000000001",5,1,1,7,Mid-Value,Potential Loyalists
64784,374,2,"128,3",4,1,1,6,Mid-Value,Potential Loyalists
64786,473,5,"270,75",4,1,1,6,Mid-Value,Potential Loyalists
64787,81,6,"385,6",5,1,1,7,Mid-Value,Potential Loyalists
64791,92,4,"187,95",5,1,1,7,Mid-Value,Potential Loyalists
64792,494,4,"184,2",4,1,1,6,Mid-Value,Potential Loyalists
64793,248,3,"139,1",5,1,1,7,Mid-Value,Potential Loyalists
64794,1617,1,"67,6",1,1,1,3,Low-Value,Lost
64796,139,2,"175,29999999999998",5,1,1,7,Mid-Value,Potential Loyalists
64797,345,1,"19,55",5,1,1,7,Mid-Value,Potential Loyalists
64798,883,1,"226,9",3,1,1,5,Low-Value,At Risk Customers
64799,1459,1,"109,9",2,1,1,4,Low-Value,Can't Lose
64801,10,5,"221,0",5,1,1,7,Mid-Value,Potential Loyalists
64802,219,3,"178,3",5,1,1,7,Mid-Value,Potential Loyalists
64804,631,2,"151,45",4,1,1,6,Mid-Value,Potential Loyalists
64806,15,4,"283,6",5,1,1,7,Mid-Value,Potential Loyalists
64807,83,5,"237,55",5,1,1,7,Mid-Value,Potential Loyalists
64808,36,8,"156,5",5,2,1,8,High-Value,Potential Loyalists
64810,576,2,"81,4",4,1,1,6,Mid-Value,Potential Loyalists
64812,30,5,"256,1",5,1,1,7,Mid-Value,Potential Loyalists
64813,1383,1,"84,9",2,1,1,4,Low-Value,Can't Lose
64814,907,2,"203,54999999999998",3,1,1,5,Low-Value,At Risk Customers
64815,327,3,"213,29999999999998",5,1,1,7,Mid-Value,Potential Loyalists
64817,691,2,"32,849999999999994",4,1,1,6,Mid-Value,Potential Loyalists
64818,313,1,"10,85",5,1,1,7,Mid-Value,Potential Loyalists
64820,1374,1,"22,45",2,1,1,4,Low-Value,Can't Lose
64821,337,8,"1002,5500000000001",5,2,2,9,High-Value,Champions
64822,1064,1,"32,9",3,1,1,5,Low-Value,At Risk Customers
64823,1455,1,"16,15",2,1,1,4,Low-Value,Can't Lose
64824,43,8,"283,35",5,2,1,8,High-Value,Potential Loyalists
64828,539,3,"106,0",4,1,1,6,Mid-Value,Potential Loyalists
64832,1080,1,"7,9",3,1,1,5,Low-Value,At Risk Customers
64834,988,1,"25,2",3,1,1,5,Low-Value,At Risk Customers
64835,414,1,"41,0",4,1,1,6,Mid-Value,Potential Loyalists
64836,1452,1,"17,95",2,1,1,4,Low-Value,Can't Lose
64838,13,3,"201,5",5,1,1,7,Mid-Value,Potential Loyalists
64839,791,1,"20,6",3,1,1,5,Low-Value,At Risk Customers
64841,479,6,"431,15",4,1,1,6,Mid-Value,Potential Loyalists
64842,377,2,"29,700000000000003",4,1,1,6,Mid-Value,Potential Loyalists
64845,124,4,"71,15",5,1,1,7,Mid-Value,Potential Loyalists
64846,375,4,"195,45",4,1,1,6,Mid-Value,Potential Loyalists
64847,1322,2,"131,3",2,1,1,4,Low-Value,Can't Lose
64849,285,2,"27,05",5,1,1,7,Mid-Value,Potential Loyalists
64850,220,4,"87,75",5,1,1,7,Mid-Value,Potential Loyalists
64851,131,3,"158,45",5,1,1,7,Mid-Value,Potential Loyalists
64852,484,3,"51,6",4,1,1,6,Mid-Value,Potential Loyalists
64854,1605,2,"180,05",1,1,1,3,Low-Value,Lost
64856,1184,1,"19,2",2,1,1,4,Low-Value,Can't Lose
64857,114,4,"127,35",5,1,1,7,Mid-Value,Potential Loyalists
64859,48,5,"113,9",5,1,1,7,Mid-Value,Potential Loyalists
64863,350,10,"593,55",5,2,1,8,High-Value,Potential Loyalists
64865,355,3,"110,0",5,1,1,7,Mid-Value,Potential Loyalists
64866,177,1,"32,0",5,1,1,7,Mid-Value,Potential Loyalists
64870,902,6,"548,4",3,1,1,5,Low-Value,At Risk Customers
64871,125,7,"281,3",5,2,1,8,High-Value,Potential Loyalists
64872,1387,1,"5,95",2,1,1,4,Low-Value,Can't Lose
64875,1088,1,"49,2",3,1,1,5,Low-Value,At Risk Customers
64876,1361,1,"42,5",2,1,1,4,Low-Value,Can't Lose
64877,15,3,"111,9",5,1,1,7,Mid-Value,Potential Loyalists
64878,59,6,"472,25",5,1,1,7,Mid-Value,Potential Loyalists
64881,215,2,"86,9",5,1,1,7,Mid-Value,Potential Loyalists
64882,571,2,"99,39999999999999",4,1,1,6,Mid-Value,Potential Loyalists
64884,747,1,"56,6",3,1,1,5,Low-Value,At Risk Customers
64885,244,12,"632,45",5,3,1,9,High-Value,Champions
64887,37,4,"84,64999999999999",5,1,1,7,Mid-Value,Potential Loyalists
64891,161,3,"164,5",5,1,1,7,Mid-Value,Potential Loyalists
64893,1036,2,"12,850000000000001",3,1,1,5,Low-Value,At Risk Customers
64896,197,3,"190,1",5,1,1,7,Mid-Value,Potential Loyalists
64897,198,1,"46,9",5,1,1,7,Mid-Value,Potential Loyalists
64898,1690,1,"195,7",1,1,1,3,Low-Value,Lost
64901,368,5,"367,6",4,1,1,6,Mid-Value,Potential Loyalists
64902,1371,3,"85,25",2,1,1,4,Low-Value,Can't Lose
64905,144,1,"44,1",5,1,1,7,Mid-Value,Potential Loyalists
64906,7,2,"163,5",5,1,1,7,Mid-Value,Potential Loyalists
64910,795,1,"156,05",3,1,1,5,Low-Value,At Risk Customers
64911,125,1,"114,0",5,1,1,7,Mid-Value,Potential Loyalists
64913,1688,1,"78,4",1,1,1,3,Low-Value,Lost
64914,1275,6,"271,9",2,1,1,4,Low-Value,Can't Lose
64916,554,4,"521,15",4,1,1,6,Mid-Value,Potential Loyalists
64918,738,7,"328,05",3,2,1,6,Mid-Value,Potential Loyalists
64919,505,2,"93,7",4,1,1,6,Mid-Value,Potential Loyalists
64920,577,3,"323,09999999999997",4,1,1,6,Mid-Value,Potential Loyalists
64922,213,1,"15,85",5,1,1,7,Mid-Value,Potential Loyalists
64924,987,2,"128,35",3,1,1,5,Low-Value,At Risk Customers
64927,23,4,"109,35",5,1,1,7,Mid-Value,Potential Loyalists
64928,1288,1,"13,6",2,1,1,4,Low-Value,Can't Lose
64929,518,1,"5,8",4,1,1,6,Mid-Value,Potential Loyalists
64930,708,3,"124,65",4,1,1,6,Mid-Value,Potential Loyalists
64931,1712,1,"19,2",1,1,1,3,Low-Value,Lost
64932,78,3,"153,64999999999998",5,1,1,7,Mid-Value,Potential Loyalists
64933,25,3,"61,6",5,1,1,7,Mid-Value,Potential Loyalists
64934,41,10,"386,25",5,2,1,8,High-Value,Potential Loyalists
64937,446,9,"354,45",4,2,1,7,Mid-Value,Potential Loyalists
64939,385,1,"323,6",4,1,1,6,Mid-Value,Potential Loyalists
64940,1260,2,"70,6",2,1,1,4,Low-Value,Can't Lose
64941,41,3,"57,650000000000006",5,1,1,7,Mid-Value,Potential Loyalists
64942,28,3,"138,5",5,1,1,7,Mid-Value,Potential Loyalists
64943,92,1,"156,05",5,1,1,7,Mid-Value,Potential Loyalists
64944,1772,1,"31,3",1,1,1,3,Low-Value,Lost
64946,4,6,"558,5",5,1,1,7,Mid-Value,Potential Loyalists
64947,1461,1,"60,1",1,1,1,3,Low-Value,Lost
64948,416,7,"126,94999999999999",4,2,1,7,Mid-Value,Potential Loyalists
64949,980,1,"9,2",3,1,1,5,Low-Value,At Risk Customers
64950,370,5,"222,3",4,1,1,6,Mid-Value,Potential Loyalists
64953,490,2,"766,6999999999999",4,1,2,7,Mid-Value,Potential Loyalists
64954,1340,3,"177,6",2,1,1,4,Low-Value,Can't Lose
64958,186,1,"54,6",5,1,1,7,Mid-Value,Potential Loyalists
64959,174,3,"61,150000000000006",5,1,1,7,Mid-Value,Potential Loyalists
64960,147,11,"872,8",5,2,2,9,High-Value,Champions
64961,80,4,"122,65",5,1,1,7,Mid-Value,Potential Loyalists
64962,1443,1,"21,4",2,1,1,4,Low-Value,Can't Lose
64963,104,8,"381,65",5,2,1,8,High-Value,Potential Loyalists
64965,188,2,"30,45",5,1,1,7,Mid-Value,Potential Loyalists
64967,27,1,"22,0",5,1,1,7,Mid-Value,Potential Loyalists
64971,207,4,"70,4",5,1,1,7,Mid-Value,Potential Loyalists
64973,57,4,"180,85",5,1,1,7,Mid-Value,Potential Loyalists
64974,223,4,"235,5",5,1,1,7,Mid-Value,Potential Loyalists
64975,381,3,"258,1",4,1,1,6,Mid-Value,Potential Loyalists
64976,268,2,"153,3",5,1,1,7,Mid-Value,Potential Loyalists
64980,736,7,"380,6",3,2,1,6,Mid-Value,Potential Loyalists
64981,724,1,"32,2",4,1,1,6,Mid-Value,Potential Loyalists
64982,515,1,"29,3",4,1,1,6,Mid-Value,Potential Loyalists
64983,804,1,"70,0",3,1,1,5,Low-Value,At Risk Customers
64984,456,3,"710,9000000000001",4,1,2,7,Mid-Value,Potential Loyalists
64985,914,1,"19,4",3,1,1,5,Low-Value,At Risk Customers
64986,1667,1,"67,8",1,1,1,3,Low-Value,Lost
64987,776,4,"121,7",3,1,1,5,Low-Value,At Risk Customers
64988,1084,1,"17,5",3,1,1,5,Low-Value,At Risk Customers
64989,1229,2,"63,4",2,1,1,4,Low-Value,Can't Lose
64990,182,2,"28,05",5,1,1,7,Mid-Value,Potential Loyalists
64992,539,9,"456,7",4,2,1,7,Mid-Value,Potential Loyalists
64993,274,12,"684,0",5,3,2,10,High-Value,Champions
64994,1070,4,"281,3",3,1,1,5,Low-Value,At Risk Customers
64996,52,3,"133,45",5,1,1,7,Mid-Value,Potential Loyalists
64997,761,1,"15,75",3,1,1,5,Low-Value,At Risk Customers
65000,686,4,"230,2",4,1,1,6,Mid-Value,Potential Loyalists
65001,533,5,"183,3",4,1,1,6,Mid-Value,Potential Loyalists
65003,450,2,"142,05",4,1,1,6,Mid-Value,Potential Loyalists
65004,1483,1,"22,5",1,1,1,3,Low-Value,Lost
65006,1175,3,"121,69999999999999",2,1,1,4,Low-Value,Can't Lose
65007,697,3,"193,0",4,1,1,6,Mid-Value,Potential Loyalists
65008,819,2,"63,85",3,1,1,5,Low-Value,At Risk Customers
65013,38,1,"23,25",5,1,1,7,Mid-Value,Potential Loyalists
65014,146,2,"171,8",5,1,1,7,Mid-Value,Potential Loyalists
65015,188,8,"312,65",5,2,1,8,High-Value,Potential Loyalists
65019,935,1,"12,0",3,1,1,5,Low-Value,At Risk Customers
65021,238,2,"88,75",5,1,1,7,Mid-Value,Potential Loyalists
65022,102,4,"200,1",5,1,1,7,Mid-Value,Potential Loyalists
65024,52,7,"364,8",5,2,1,8,High-Value,Potential Loyalists
65027,204,1,"48,6",5,1,1,7,Mid-Value,Potential Loyalists
65028,491,4,"51,65",4,1,1,6,Mid-Value,Potential Loyalists
65029,433,3,"96,15",4,1,1,6,Mid-Value,Potential Loyalists
65031,108,2,"213,39999999999998",5,1,1,7,Mid-Value,Potential Loyalists
65032,201,1,"112,25",5,1,1,7,Mid-Value,Potential Loyalists
65033,778,9,"609,3",3,2,1,6,Mid-Value,Potential Loyalists
65034,1295,1,"33,8",2,1,1,4,Low-Value,Can't Lose
65035,1601,1,"64,3",1,1,1,3,Low-Value,Lost
65036,382,2,"106,5",4,1,1,6,Mid-Value,Potential Loyalists
65037,380,5,"313,55",4,1,1,6,Mid-Value,Potential Loyalists
65038,1104,1,"8,3",2,1,1,4,Low-Value,Can't Lose
65039,815,3,"241,2",3,1,1,5,Low-Value,At Risk Customers
65040,132,8,"504,25",5,2,1,8,High-Value,Potential Loyalists
65041,452,1,"15,4",4,1,1,6,Mid-Value,Potential Loyalists
65042,649,4,"126,3",4,1,1,6,Mid-Value,Potential Loyalists
65043,634,2,"52,2",4,1,1,6,Mid-Value,Potential Loyalists
65045,1412,2,"69,4",2,1,1,4,Low-Value,Can't Lose
65048,623,2,"63,8",4,1,1,6,Mid-Value,Potential Loyalists
65049,1583,1,"16,2",1,1,1,3,Low-Value,Lost
65050,324,2,"97,0",5,1,1,7,Mid-Value,Potential Loyalists
65055,312,4,"125,0",5,1,1,7,Mid-Value,Potential Loyalists
65057,474,2,"35,16",4,1,1,6,Mid-Value,Potential Loyalists
65058,659,1,"6,35",4,1,1,6,Mid-Value,Potential Loyalists
65059,980,2,"120,30000000000001",3,1,1,5,Low-Value,At Risk Customers
65060,246,2,"138,6",5,1,1,7,Mid-Value,Potential Loyalists
65061,128,9,"778,1999999999999",5,2,2,9,High-Value,Champions
65062,29,1,"35,4",5,1,1,7,Mid-Value,Potential Loyalists
65063,887,1,"234,4",3,1,1,5,Low-Value,At Risk Customers
65066,1099,2,"45,7",2,1,1,4,Low-Value,Can't Lose
65069,465,4,"268,4",4,1,1,6,Mid-Value,Potential Loyalists
65070,11,6,"347,45",5,1,1,7,Mid-Value,Potential Loyalists
65071,1662,1,"52,8",1,1,1,3,Low-Value,Lost
65072,399,7,"289,75",4,2,1,7,Mid-Value,Potential Loyalists
65073,246,1,"44,0",5,1,1,7,Mid-Value,Potential Loyalists
65074,98,5,"294,95",5,1,1,7,Mid-Value,Potential Loyalists
65075,693,4,"577,45",4,1,1,6,Mid-Value,Potential Loyalists
65076,754,2,"131,0",3,1,1,5,Low-Value,At Risk Customers
65079,23,1,"48,6",5,1,1,7,Mid-Value,Potential Loyalists
65080,756,2,"126,6",3,1,1,5,Low-Value,At Risk Customers
65081,516,3,"174,0",4,1,1,6,Mid-Value,Potential Loyalists
65082,66,1,"28,45",5,1,1,7,Mid-Value,Potential Loyalists
65083,435,3,"70,6",4,1,1,6,Mid-Value,Potential Loyalists
65084,690,2,"236,2",4,1,1,6,Mid-Value,Potential Loyalists
65085,1488,2,"356,85",1,1,1,3,Low-Value,Lost
65086,169,1,"2,7",5,1,1,7,Mid-Value,Potential Loyalists
65092,910,4,"121,75",3,1,1,5,Low-Value,At Risk Customers
65093,752,6,"560,25",3,1,1,5,Low-Value,At Risk Customers
65094,365,3,"182,15",5,1,1,7,Mid-Value,Potential Loyalists
65096,738,4,"304,1",3,1,1,5,Low-Value,At Risk Customers
65097,469,1,"7,4",4,1,1,6,Mid-Value,Potential Loyalists
65098,37,5,"308,95",5,1,1,7,Mid-Value,Potential Loyalists
65099,82,9,"816,3499999999999",5,2,2,9,High-Value,Champions
65100,423,5,"584,3",4,1,1,6,Mid-Value,Potential Loyalists
65104,11,2,"159,5",5,1,1,7,Mid-Value,Potential Loyalists
65105,97,3,"129,1",5,1,1,7,Mid-Value,Potential Loyalists
65107,431,8,"440,95",4,2,1,7,Mid-Value,Potential Loyalists
65108,116,9,"537,5",5,2,1,8,High-Value,Potential Loyalists
65110,1004,1,"10,6",3,1,1,5,Low-Value,At Risk Customers
65111,691,3,"70,3",4,1,1,6,Mid-Value,Potential Loyalists
65114,437,3,"142,6",4,1,1,6,Mid-Value,Potential Loyalists
65116,79,4,"126,05",5,1,1,7,Mid-Value,Potential Loyalists
65118,1477,1,"350,85",1,1,1,3,Low-Value,Lost
65120,516,4,"140,1",4,1,1,6,Mid-Value,Potential Loyalists
65123,38,11,"432,45",5,2,1,8,High-Value,Potential Loyalists
65124,388,3,"570,65",4,1,1,6,Mid-Value,Potential Loyalists
65126,8,2,"171,5",5,1,1,7,Mid-Value,Potential Loyalists
65127,244,8,"511,49999999999994",5,2,1,8,High-Value,Potential Loyalists
65128,774,5,"408,16",3,1,1,5,Low-Value,At Risk Customers
65129,368,2,"74,0",4,1,1,6,Mid-Value,Potential Loyalists
65130,113,1,"33,1",5,1,1,7,Mid-Value,Potential Loyalists
65132,237,2,"37,300000000000004",5,1,1,7,Mid-Value,Potential Loyalists
65133,1653,1,"65,9",1,1,1,3,Low-Value,Lost
65135,1384,1,"29,05",2,1,1,4,Low-Value,Can't Lose
65136,923,2,"114,15",3,1,1,5,Low-Value,At Risk Customers
65137,43,3,"171,75",5,1,1,7,Mid-Value,Potential Loyalists
65138,14,6,"511,2",5,1,1,7,Mid-Value,Potential Loyalists
65139,1531,1,"18,15",1,1,1,3,Low-Value,Lost
65141,646,3,"170,95",4,1,1,6,Mid-Value,Potential Loyalists
65142,1021,1,"14,35",3,1,1,5,Low-Value,At Risk Customers
65143,1624,3,"100,9",1,1,1,3,Low-Value,Lost
65144,102,2,"217,5",5,1,1,7,Mid-Value,Potential Loyalists
65145,1544,1,"12,95",1,1,1,3,Low-Value,Lost
65148,27,5,"296,3",5,1,1,7,Mid-Value,Potential Loyalists
65149,98,2,"31,7",5,1,1,7,Mid-Value,Potential Loyalists
65150,12,8,"546,4499999999999",5,2,1,8,High-Value,Potential Loyalists
65151,1235,3,"137,15",2,1,1,4,Low-Value,Can't Lose
65152,162,2,"330,8",5,1,1,7,Mid-Value,Potential Loyalists
65155,274,3,"143,29999999999998",5,1,1,7,Mid-Value,Potential Loyalists
65156,140,5,"200,4",5,1,1,7,Mid-Value,Potential Loyalists
65157,29,2,"102,9",5,1,1,7,Mid-Value,Potential Loyalists
65158,569,2,"203,7",4,1,1,6,Mid-Value,Potential Loyalists
65159,501,1,"9,2",4,1,1,6,Mid-Value,Potential Loyalists
65160,1689,1,"18,2",1,1,1,3,Low-Value,Lost
65161,49,1,"10,6",5,1,1,7,Mid-Value,Potential Loyalists
65165,245,4,"334,4",5,1,1,7,Mid-Value,Potential Loyalists
65170,59,6,"716,85",5,1,2,8,High-Value,Potential Loyalists
65171,423,2,"52,05",4,1,1,6,Mid-Value,Potential Loyalists
65173,357,1,"6,45",5,1,1,7,Mid-Value,Potential Loyalists
65175,1108,1,"199,0",2,1,1,4,Low-Value,Can't Lose
65177,8,5,"349,15",5,1,1,7,Mid-Value,Potential Loyalists
65178,58,3,"156,89999999999998",5,1,1,7,Mid-Value,Potential Loyalists
65179,1461,3,"61,85",1,1,1,3,Low-Value,Lost
65180,703,1,"72,1",4,1,1,6,Mid-Value,Potential Loyalists
65183,685,1,"28,3",4,1,1,6,Mid-Value,Potential Loyalists
65184,809,4,"52,55",3,1,1,5,Low-Value,At Risk Customers
65187,152,6,"403,95",5,1,1,7,Mid-Value,Potential Loyalists
65189,35,1,"5,35",5,1,1,7,Mid-Value,Potential Loyalists
65190,525,4,"225,9",4,1,1,6,Mid-Value,Potential Loyalists
65191,152,1,"17,7",5,1,1,7,Mid-Value,Potential Loyalists
65192,288,1,"20,75",5,1,1,7,Mid-Value,Potential Loyalists
65193,751,2,"190,82",3,1,1,5,Low-Value,At Risk Customers
65194,689,1,"9,8",4,1,1,6,Mid-Value,Potential Loyalists
65195,290,3,"182,8",5,1,1,7,Mid-Value,Potential Loyalists
65196,574,4,"437,55",4,1,1,6,Mid-Value,Potential Loyalists
65197,1233,4,"302,05",2,1,1,4,Low-Value,Can't Lose
65198,607,4,"187,35",4,1,1,6,Mid-Value,Potential Loyalists
65199,101,4,"155,75",5,1,1,7,Mid-Value,Potential Loyalists
65200,134,6,"585,35",5,1,1,7,Mid-Value,Potential Loyalists
65201,132,4,"165,6",5,1,1,7,Mid-Value,Potential Loyalists
65202,262,1,"24,8",5,1,1,7,Mid-Value,Potential Loyalists
65203,817,1,"512,9",3,1,1,5,Low-Value,At Risk Customers
65205,995,1,"215,4",3,1,1,5,Low-Value,At Risk Customers
65206,248,13,"596,9499999999999",5,3,1,9,High-Value,Champions
65207,327,5,"111,35",5,1,1,7,Mid-Value,Potential Loyalists
65209,800,3,"215,29999999999998",3,1,1,5,Low-Value,At Risk Customers
65210,533,7,"334,75",4,2,1,7,Mid-Value,Potential Loyalists
65212,563,2,"102,65",4,1,1,6,Mid-Value,Potential Loyalists
65213,741,3,"77,95",3,1,1,5,Low-Value,At Risk Customers
65214,224,3,"159,35",5,1,1,7,Mid-Value,Potential Loyalists
65217,25,4,"976,5",5,1,2,8,High-Value,Potential Loyalists
65218,112,8,"227,1",5,2,1,8,High-Value,Potential Loyalists
65220,299,2,"150,25",5,1,1,7,Mid-Value,Potential Loyalists
65221,354,2,"146,5",5,1,1,7,Mid-Value,Potential Loyalists
65222,1270,1,"103,1",2,1,1,4,Low-Value,Can't Lose
65223,177,3,"168,75",5,1,1,7,Mid-Value,Potential Loyalists
65225,333,2,"81,35",5,1,1,7,Mid-Value,Potential Loyalists
65228,615,1,"12,85",4,1,1,6,Mid-Value,Potential Loyalists
65229,576,1,"73,3",4,1,1,6,Mid-Value,Potential Loyalists
65230,145,6,"805,9",5,1,2,8,High-Value,Potential Loyalists
65231,28,5,"288,35",5,1,1,7,Mid-Value,Potential Loyalists
65232,1009,3,"161,8",3,1,1,5,Low-Value,At Risk Customers
65233,1432,1,"181,4",2,1,1,4,Low-Value,Can't Lose
65235,1219,1,"88,94999999999999",2,1,1,4,Low-Value,Can't Lose
65236,481,6,"272,7",4,1,1,6,Mid-Value,Potential Loyalists
65237,14,1,"30,0",5,1,1,7,Mid-Value,Potential Loyalists
65240,1586,1,"60,7",1,1,1,3,Low-Value,Lost
65242,164,2,"93,39999999999999",5,1,1,7,Mid-Value,Potential Loyalists
65243,91,2,"41,55",5,1,1,7,Mid-Value,Potential Loyalists
65244,1251,5,"415,35",2,1,1,4,Low-Value,Can't Lose
65245,530,2,"190,65",4,1,1,6,Mid-Value,Potential Loyalists
65246,1363,2,"40,9",2,1,1,4,Low-Value,Can't Lose
65249,90,1,"52,85",5,1,1,7,Mid-Value,Potential Loyalists
65252,826,2,"97,35",3,1,1,5,Low-Value,At Risk Customers
65254,905,2,"264,1",3,1,1,5,Low-Value,At Risk Customers
65255,852,1,"39,45",3,1,1,5,Low-Value,At Risk Customers
65257,115,3,"256,85",5,1,1,7,Mid-Value,Potential Loyalists
65258,35,10,"529,65",5,2,1,8,High-Value,Potential Loyalists
65261,63,5,"247,1",5,1,1,7,Mid-Value,Potential Loyalists
65263,31,1,"12,1",5,1,1,7,Mid-Value,Potential Loyalists
65265,267,3,"109,75",5,1,1,7,Mid-Value,Potential Loyalists
65266,424,2,"42,55",4,1,1,6,Mid-Value,Potential Loyalists
65268,743,1,"75,6",3,1,1,5,Low-Value,At Risk Customers
65269,55,5,"276,85",5,1,1,7,Mid-Value,Potential Loyalists
65272,1542,3,"239,10000000000002",1,1,1,3,Low-Value,Lost
65274,512,2,"159,85",4,1,1,6,Mid-Value,Potential Loyalists
65275,486,2,"268,6",4,1,1,6,Mid-Value,Potential Loyalists
65277,164,4,"279,04999999999995",5,1,1,7,Mid-Value,Potential Loyalists
65278,22,6,"519,45",5,1,1,7,Mid-Value,Potential Loyalists
65280,729,1,"109,55",4,1,1,6,Mid-Value,Potential Loyalists
65281,192,7,"623,3499999999999",5,2,1,8,High-Value,Potential Loyalists
65282,1565,1,"17,6",1,1,1,3,Low-Value,Lost
65283,1715,1,"45,6",1,1,1,3,Low-Value,Lost
65284,49,2,"72,3",5,1,1,7,Mid-Value,Potential Loyalists
65287,1684,1,"254,70000000000002",1,1,1,3,Low-Value,Lost
65288,49,4,"97,25",5,1,1,7,Mid-Value,Potential Loyalists
65290,38,3,"233,89999999999998",5,1,1,7,Mid-Value,Potential Loyalists
65291,533,1,"6,7",4,1,1,6,Mid-Value,Potential Loyalists
65292,1393,1,"10,75",2,1,1,4,Low-Value,Can't Lose
65293,146,2,"124,25",5,1,1,7,Mid-Value,Potential Loyalists
65294,641,1,"418,9",4,1,1,6,Mid-Value,Potential Loyalists
65295,1454,1,"309,0",2,1,1,4,Low-Value,Can't Lose
65297,9,9,"302,3",5,2,1,8,High-Value,Potential Loyalists
65299,396,2,"37,65",4,1,1,6,Mid-Value,Potential Loyalists
65301,465,3,"266,45",4,1,1,6,Mid-Value,Potential Loyalists
65303,345,1,"6,2",5,1,1,7,Mid-Value,Potential Loyalists
65305,222,2,"39,25",5,1,1,7,Mid-Value,Potential Loyalists
65307,565,3,"121,3",4,1,1,6,Mid-Value,Potential Loyalists
65310,752,3,"283,5",3,1,1,5,Low-Value,At Risk Customers
65311,348,7,"282,3",5,2,1,8,High-Value,Potential Loyalists
65312,376,5,"669,75",4,1,2,7,Mid-Value,Potential Loyalists
65313,73,3,"183,0",5,1,1,7,Mid-Value,Potential Loyalists
65315,0,10,"1345,45",5,2,3,10,High-Value,Champions
65316,180,2,"114,69999999999999",5,1,1,7,Mid-Value,Potential Loyalists
65318,530,1,"36,9",4,1,1,6,Mid-Value,Potential Loyalists
65319,378,6,"750,4",4,1,2,7,Mid-Value,Potential Loyalists
65320,566,6,"672,5",4,1,2,7,Mid-Value,Potential Loyalists
65321,4,6,"297,09999999999997",5,1,1,7,Mid-Value,Potential Loyalists
65322,300,6,"353,04999999999995",5,1,1,7,Mid-Value,Potential Loyalists
65323,521,4,"211,25",4,1,1,6,Mid-Value,Potential Loyalists
65324,898,1,"53,2",3,1,1,5,Low-Value,At Risk Customers
65325,1105,2,"45,4",2,1,1,4,Low-Value,Can't Lose
65326,263,3,"119,65",5,1,1,7,Mid-Value,Potential Loyalists
65327,777,3,"94,89999999999999",3,1,1,5,Low-Value,At Risk Customers
65329,210,11,"442,7",5,2,1,8,High-Value,Potential Loyalists
65332,172,1,"235,5",5,1,1,7,Mid-Value,Potential Loyalists
65333,4,2,"180,10000000000002",5,1,1,7,Mid-Value,Potential Loyalists
65334,4,2,"148,6",5,1,1,7,Mid-Value,Potential Loyalists
65335,112,1,"9,55",5,1,1,7,Mid-Value,Potential Loyalists
65336,801,3,"105,75",3,1,1,5,Low-Value,At Risk Customers
65337,18,4,"275,35",5,1,1,7,Mid-Value,Potential Loyalists
65338,168,7,"908,8999999999999",5,2,2,9,High-Value,Champions
65341,1269,1,"173,3",2,1,1,4,Low-Value,Can't Lose
65342,398,3,"639,2",4,1,1,6,Mid-Value,Potential Loyalists
65343,599,3,"91,0",4,1,1,6,Mid-Value,Potential Loyalists
65345,967,1,"31,349999999999998",3,1,1,5,Low-Value,At Risk Customers
65347,1303,5,"443,85",2,1,1,4,Low-Value,Can't Lose
65348,612,7,"809,8000000000001",4,2,2,8,High-Value,Potential Loyalists
65349,1121,3,"300,5",2,1,1,4,Low-Value,Can't Lose
65350,238,7,"636,85",5,2,1,8,High-Value,Potential Loyalists
65353,524,5,"183,85",4,1,1,6,Mid-Value,Potential Loyalists
65354,505,1,"233,7",4,1,1,6,Mid-Value,Potential Loyalists
65356,156,7,"676,55",5,2,2,9,High-Value,Champions
65357,1775,1,"52,6",1,1,1,3,Low-Value,Lost
65359,142,4,"115,94999999999999",5,1,1,7,Mid-Value,Potential Loyalists
65363,137,2,"171,9",5,1,1,7,Mid-Value,Potential Loyalists
65364,606,4,"64,39999999999999",4,1,1,6,Mid-Value,Potential Loyalists
65368,14,5,"172,1",5,1,1,7,Mid-Value,Potential Loyalists
65369,677,4,"111,0",4,1,1,6,Mid-Value,Potential Loyalists
65370,38,3,"220,05",5,1,1,7,Mid-Value,Potential Loyalists
65371,957,3,"109,65",3,1,1,5,Low-Value,At Risk Customers
65372,587,6,"416,3",4,1,1,6,Mid-Value,Potential Loyalists
65374,1264,1,"1,6",2,1,1,4,Low-Value,Can't Lose
65375,145,1,"73,4",5,1,1,7,Mid-Value,Potential Loyalists
65378,218,7,"543,65",5,2,1,8,High-Value,Potential Loyalists
65380,218,1,"19,65",5,1,1,7,Mid-Value,Potential Loyalists
65381,1742,1,"1,05",1,1,1,3,Low-Value,Lost
65382,1055,1,"68,7",3,1,1,5,Low-Value,At Risk Customers
65383,263,6,"227,3",5,1,1,7,Mid-Value,Potential Loyalists
65384,127,8,"225,11",5,2,1,8,High-Value,Potential Loyalists
65385,603,3,"160,9",4,1,1,6,Mid-Value,Potential Loyalists
65386,1122,1,"132,2",2,1,1,4,Low-Value,Can't Lose
65387,700,2,"76,65",4,1,1,6,Mid-Value,Potential Loyalists
65388,438,3,"108,45",4,1,1,6,Mid-Value,Potential Loyalists
65389,37,4,"293,75",5,1,1,7,Mid-Value,Potential Loyalists
65390,446,1,"51,15",4,1,1,6,Mid-Value,Potential Loyalists
65391,410,2,"144,79999999999998",4,1,1,6,Mid-Value,Potential Loyalists
65392,5,2,"90,25",5,1,1,7,Mid-Value,Potential Loyalists
65393,624,1,"13,4",4,1,1,6,Mid-Value,Potential Loyalists
65394,1250,3,"291,65",2,1,1,4,Low-Value,Can't Lose
65395,366,7,"510,0",4,2,1,7,Mid-Value,Potential Loyalists
65396,140,6,"287,9",5,1,1,7,Mid-Value,Potential Loyalists
65399,141,10,"300,55",5,2,1,8,High-Value,Potential Loyalists
65400,1234,2,"134,9",2,1,1,4,Low-Value,Can't Lose
65401,1419,1,"267,0",2,1,1,4,Low-Value,Can't Lose
65402,203,2,"357,20000000000005",5,1,1,7,Mid-Value,Potential Loyalists
65403,52,7,"336,16",5,2,1,8,High-Value,Potential Loyalists
65404,221,2,"284,95",5,1,1,7,Mid-Value,Potential Loyalists
65406,57,4,"344,09999999999997",5,1,1,7,Mid-Value,Potential Loyalists
65407,363,3,"91,2",5,1,1,7,Mid-Value,Potential Loyalists
65409,1090,1,"13,25",3,1,1,5,Low-Value,At Risk Customers
65410,132,7,"220,05",5,2,1,8,High-Value,Potential Loyalists
65411,69,5,"182,64999999999998",5,1,1,7,Mid-Value,Potential Loyalists
65412,626,2,"94,4",4,1,1,6,Mid-Value,Potential Loyalists
65413,47,4,"123,15",5,1,1,7,Mid-Value,Potential Loyalists
65414,153,3,"161,1",5,1,1,7,Mid-Value,Potential Loyalists
65415,419,1,"18,65",4,1,1,6,Mid-Value,Potential Loyalists
65419,386,2,"210,85000000000002",4,1,1,6,Mid-Value,Potential Loyalists
65420,494,3,"112,4",4,1,1,6,Mid-Value,Potential Loyalists
65421,276,2,"246,9",5,1,1,7,Mid-Value,Potential Loyalists
65424,41,7,"673,3000000000001",5,2,2,9,High-Value,Champions
65425,606,9,"895,65",4,2,2,8,High-Value,Potential Loyalists
65426,1577,2,"126,60000000000001",1,1,1,3,Low-Value,Lost
65429,558,2,"243,95",4,1,1,6,Mid-Value,Potential Loyalists
65430,1481,1,"79,9",1,1,1,3,Low-Value,Lost
65432,632,3,"421,0",4,1,1,6,Mid-Value,Potential Loyalists
65434,1433,3,"112,39999999999999",2,1,1,4,Low-Value,Can't Lose
65436,154,3,"291,65",5,1,1,7,Mid-Value,Potential Loyalists
65439,125,5,"275,8",5,1,1,7,Mid-Value,Potential Loyalists
65443,1432,1,"432,0",2,1,1,4,Low-Value,Can't Lose
65444,1637,1,"30,8",1,1,1,3,Low-Value,Lost
65445,395,2,"110,5",4,1,1,6,Mid-Value,Potential Loyalists
65446,724,5,"159,10000000000002",4,1,1,6,Mid-Value,Potential Loyalists
65450,135,2,"121,1",5,1,1,7,Mid-Value,Potential Loyalists
65451,1118,3,"127,1",2,1,1,4,Low-Value,Can't Lose
65452,51,2,"38,8",5,1,1,7,Mid-Value,Potential Loyalists
65453,1293,1,"73,4",2,1,1,4,Low-Value,Can't Lose
65454,1323,2,"298,35",2,1,1,4,Low-Value,Can't Lose
65455,820,1,"5,75",3,1,1,5,Low-Value,At Risk Customers
65456,52,3,"188,79999999999998",5,1,1,7,Mid-Value,Potential Loyalists
65459,24,9,"457,70000000000005",5,2,1,8,High-Value,Potential Loyalists
65463,589,6,"619,8",4,1,1,6,Mid-Value,Potential Loyalists
65464,334,2,"20,95",5,1,1,7,Mid-Value,Potential Loyalists
65466,1778,1,"28,7",1,1,1,3,Low-Value,Lost
65467,560,6,"428,6",4,1,1,6,Mid-Value,Potential Loyalists
65468,25,5,"352,8",5,1,1,7,Mid-Value,Potential Loyalists
65469,650,3,"264,4",4,1,1,6,Mid-Value,Potential Loyalists
65470,283,3,"114,39999999999999",5,1,1,7,Mid-Value,Potential Loyalists
65471,563,6,"579,0",4,1,1,6,Mid-Value,Potential Loyalists
65474,410,7,"574,9499999999999",4,2,1,7,Mid-Value,Potential Loyalists
65476,300,2,"81,8",5,1,1,7,Mid-Value,Potential Loyalists
65478,240,2,"54,55",5,1,1,7,Mid-Value,Potential Loyalists
65479,435,3,"424,3",4,1,1,6,Mid-Value,Potential Loyalists
65480,1322,2,"192,64999999999998",2,1,1,4,Low-Value,Can't Lose
65482,17,15,"1624,85",5,3,3,11,High-Value,Champions
65484,1636,1,"64,35",1,1,1,3,Low-Value,Lost
65486,908,2,"34,7",3,1,1,5,Low-Value,At Risk Customers
65487,321,3,"214,6",5,1,1,7,Mid-Value,Potential Loyalists
65488,659,4,"157,9",4,1,1,6,Mid-Value,Potential Loyalists
65490,1448,1,"425,7",2,1,1,4,Low-Value,Can't Lose
65491,776,3,"117,15",3,1,1,5,Low-Value,At Risk Customers
65492,596,1,"2,75",4,1,1,6,Mid-Value,Potential Loyalists
65493,59,7,"235,0",5,2,1,8,High-Value,Potential Loyalists
65494,379,4,"152,05",4,1,1,6,Mid-Value,Potential Loyalists
65495,301,6,"105,85",5,1,1,7,Mid-Value,Potential Loyalists
65497,822,1,"44,25",3,1,1,5,Low-Value,At Risk Customers
65498,1101,2,"305,5",2,1,1,4,Low-Value,Can't Lose
65500,377,1,"12,6",4,1,1,6,Mid-Value,Potential Loyalists
65502,62,3,"195,45",5,1,1,7,Mid-Value,Potential Loyalists
65507,1770,1,"0,6",1,1,1,3,Low-Value,Lost
65508,143,2,"120,6",5,1,1,7,Mid-Value,Potential Loyalists
65509,525,1,"21,1",4,1,1,6,Mid-Value,Potential Loyalists
65512,98,2,"99,15",5,1,1,7,Mid-Value,Potential Loyalists
65514,1,20,"842,8",5,4,2,11,High-Value,Champions
65515,1197,1,"54,8",2,1,1,4,Low-Value,Can't Lose
65517,804,11,"331,6",3,2,1,6,Mid-Value,Potential Loyalists
65518,500,1,"20,7",4,1,1,6,Mid-Value,Potential Loyalists
65519,1688,1,"126,1",1,1,1,3,Low-Value,Lost
65520,929,1,"66,30000000000001",3,1,1,5,Low-Value,At Risk Customers
65522,762,2,"79,25",3,1,1,5,Low-Value,At Risk Customers
65523,1272,1,"6,1",2,1,1,4,Low-Value,Can't Lose
65524,3,3,"98,14999999999999",5,1,1,7,Mid-Value,Potential Loyalists
65527,766,3,"149,65",3,1,1,5,Low-Value,At Risk Customers
65529,1791,1,"104,1",1,1,1,3,Low-Value,Lost
65532,586,1,"92,4",4,1,1,6,Mid-Value,Potential Loyalists
65534,986,2,"150,85",3,1,1,5,Low-Value,At Risk Customers
65536,657,1,"19,2",4,1,1,6,Mid-Value,Potential Loyalists
65537,208,4,"517,75",5,1,1,7,Mid-Value,Potential Loyalists
65539,183,5,"768,4",5,1,2,8,High-Value,Potential Loyalists
65540,83,7,"451,2",5,2,1,8,High-Value,Potential Loyalists
65541,1238,1,"48,150000000000006",2,1,1,4,Low-Value,Can't Lose
65542,384,3,"171,5",4,1,1,6,Mid-Value,Potential Loyalists
65543,321,1,"13,75",5,1,1,7,Mid-Value,Potential Loyalists
65545,155,6,"409,55",5,1,1,7,Mid-Value,Potential Loyalists
65546,362,3,"27,450000000000003",5,1,1,7,Mid-Value,Potential Loyalists
65547,762,4,"185,45",3,1,1,5,Low-Value,At Risk Customers
65548,197,7,"745,5999999999999",5,2,2,9,High-Value,Champions
65549,1265,5,"198,35",2,1,1,4,Low-Value,Can't Lose
65550,1147,2,"51,2",2,1,1,4,Low-Value,Can't Lose
65551,7,2,"45,7",5,1,1,7,Mid-Value,Potential Loyalists
65553,1488,1,"76,2",1,1,1,3,Low-Value,Lost
65554,533,2,"421,1",4,1,1,6,Mid-Value,Potential Loyalists
65555,512,2,"67,19999999999999",4,1,1,6,Mid-Value,Potential Loyalists
65556,1362,2,"23,15",2,1,1,4,Low-Value,Can't Lose
65557,216,4,"220,15000000000003",5,1,1,7,Mid-Value,Potential Loyalists
65558,2,2,"81,9",5,1,1,7,Mid-Value,Potential Loyalists
65560,903,3,"235,6",3,1,1,5,Low-Value,At Risk Customers
65561,10,1,"56,7",5,1,1,7,Mid-Value,Potential Loyalists
65562,1094,6,"322,55",3,1,1,5,Low-Value,At Risk Customers
65563,1333,2,"80,2",2,1,1,4,Low-Value,Can't Lose
65565,4,2,"84,19999999999999",5,1,1,7,Mid-Value,Potential Loyalists
65566,1284,2,"121,25",2,1,1,4,Low-Value,Can't Lose
65568,430,3,"104,1",4,1,1,6,Mid-Value,Potential Loyalists
65570,742,5,"374,15",3,1,1,5,Low-Value,At Risk Customers
65571,146,4,"364,35",5,1,1,7,Mid-Value,Potential Loyalists
65574,286,4,"57,150000000000006",5,1,1,7,Mid-Value,Potential Loyalists
65575,179,16,"1890,55",5,3,3,11,High-Value,Champions
65581,376,7,"988,85",4,2,2,8,High-Value,Potential Loyalists
65582,135,5,"115,25",5,1,1,7,Mid-Value,Potential Loyalists
65583,329,4,"169,4",5,1,1,7,Mid-Value,Potential Loyalists
65584,165,7,"514,4499999999999",5,2,1,8,High-Value,Potential Loyalists
65586,47,3,"54,7",5,1,1,7,Mid-Value,Potential Loyalists
65587,36,4,"118,85",5,1,1,7,Mid-Value,Potential Loyalists
65588,584,6,"243,39999999999998",4,1,1,6,Mid-Value,Potential Loyalists
65589,152,7,"315,6",5,2,1,8,High-Value,Potential Loyalists
65590,91,7,"799,9499999999999",5,2,2,9,High-Value,Champions
65591,827,3,"88,65",3,1,1,5,Low-Value,At Risk Customers
65593,1113,3,"201,79999999999998",2,1,1,4,Low-Value,Can't Lose
65594,985,3,"44,7",3,1,1,5,Low-Value,At Risk Customers
65595,1637,1,"15,7",1,1,1,3,Low-Value,Lost
65596,110,2,"211,5",5,1,1,7,Mid-Value,Potential Loyalists
65597,398,2,"74,1",4,1,1,6,Mid-Value,Potential Loyalists
65598,1664,3,"62,400000000000006",1,1,1,3,Low-Value,Lost
65599,167,10,"358,75",5,2,1,8,High-Value,Potential Loyalists
65600,1182,2,"19,85",2,1,1,4,Low-Value,Can't Lose
65606,927,1,"21,4",3,1,1,5,Low-Value,At Risk Customers
65607,31,7,"406,4",5,2,1,8,High-Value,Potential Loyalists
65608,199,10,"261,25",5,2,1,8,High-Value,Potential Loyalists
65609,751,1,"163,5",3,1,1,5,Low-Value,At Risk Customers
65610,196,1,"94,1",5,1,1,7,Mid-Value,Potential Loyalists
65611,1093,2,"268,5",3,1,1,5,Low-Value,At Risk Customers
65613,255,3,"195,35",5,1,1,7,Mid-Value,Potential Loyalists
65616,1022,3,"176,75",3,1,1,5,Low-Value,At Risk Customers
65617,355,7,"403,8",5,2,1,8,High-Value,Potential Loyalists
65619,750,2,"159,60000000000002",3,1,1,5,Low-Value,At Risk Customers
65620,242,4,"134,5",5,1,1,7,Mid-Value,Potential Loyalists
65621,1492,1,"83,2",1,1,1,3,Low-Value,Lost
65622,196,3,"76,4",5,1,1,7,Mid-Value,Potential Loyalists
65623,1708,1,"8,6",1,1,1,3,Low-Value,Lost
65624,502,4,"549,35",4,1,1,6,Mid-Value,Potential Loyalists
65625,1018,1,"77,5",3,1,1,5,Low-Value,At Risk Customers
65626,654,4,"80,05",4,1,1,6,Mid-Value,Potential Loyalists
65627,12,7,"490,7",5,2,1,8,High-Value,Potential Loyalists
65629,76,8,"380,3",5,2,1,8,High-Value,Potential Loyalists
65630,19,6,"212,95",5,1,1,7,Mid-Value,Potential Loyalists
65631,383,1,"12,9",4,1,1,6,Mid-Value,Potential Loyalists
65632,600,1,"46,9",4,1,1,6,Mid-Value,Potential Loyalists
65635,341,1,"8,1",5,1,1,7,Mid-Value,Potential Loyalists
65636,480,2,"74,55",4,1,1,6,Mid-Value,Potential Loyalists
65639,38,3,"61,349999999999994",5,1,1,7,Mid-Value,Potential Loyalists
65640,95,6,"301,5",5,1,1,7,Mid-Value,Potential Loyalists
65642,446,1,"168,05",4,1,1,6,Mid-Value,Potential Loyalists
65644,5,2,"59,6",5,1,1,7,Mid-Value,Potential Loyalists
65646,171,2,"78,6",5,1,1,7,Mid-Value,Potential Loyalists
65647,1702,1,"54,0",1,1,1,3,Low-Value,Lost
65649,266,6,"336,15000000000003",5,1,1,7,Mid-Value,Potential Loyalists
65651,837,1,"28,25",3,1,1,5,Low-Value,At Risk Customers
65653,1111,3,"350,55",2,1,1,4,Low-Value,Can't Lose
65654,335,1,"46,05",5,1,1,7,Mid-Value,Potential Loyalists
65655,62,5,"264,75",5,1,1,7,Mid-Value,Potential Loyalists
65656,86,2,"46,05",5,1,1,7,Mid-Value,Potential Loyalists
65657,536,6,"419,70000000000005",4,1,1,6,Mid-Value,Potential Loyalists
65658,1761,1,"5,95",1,1,1,3,Low-Value,Lost
65659,924,1,"126,4",3,1,1,5,Low-Value,At Risk Customers
65660,610,1,"42,15",4,1,1,6,Mid-Value,Potential Loyalists
65661,5,4,"228,8",5,1,1,7,Mid-Value,Potential Loyalists
65662,69,1,"54,8",5,1,1,7,Mid-Value,Potential Loyalists
65664,467,4,"81,44999999999999",4,1,1,6,Mid-Value,Potential Loyalists
65665,240,2,"90,05",5,1,1,7,Mid-Value,Potential Loyalists
65666,21,4,"148,95",5,1,1,7,Mid-Value,Potential Loyalists
65667,1071,1,"25,85",3,1,1,5,Low-Value,At Risk Customers
65668,749,4,"360,70000000000005",3,1,1,5,Low-Value,At Risk Customers
65670,963,3,"121,6",3,1,1,5,Low-Value,At Risk Customers
65671,224,1,"23,1",5,1,1,7,Mid-Value,Potential Loyalists
65673,11,10,"1389,8",5,2,3,10,High-Value,Champions
65676,533,2,"96,2",4,1,1,6,Mid-Value,Potential Loyalists
65677,558,3,"245,85",4,1,1,6,Mid-Value,Potential Loyalists
65678,9,4,"84,25",5,1,1,7,Mid-Value,Potential Loyalists
65679,308,1,"41,0",5,1,1,7,Mid-Value,Potential Loyalists
65681,369,6,"765,7499999999999",4,1,2,7,Mid-Value,Potential Loyalists
65684,376,3,"172,6",4,1,1,6,Mid-Value,Potential Loyalists
65686,504,1,"5,8",4,1,1,6,Mid-Value,Potential Loyalists
65687,155,4,"494,05",5,1,1,7,Mid-Value,Potential Loyalists
65689,424,1,"156,5",4,1,1,6,Mid-Value,Potential Loyalists
65690,426,3,"55,2",4,1,1,6,Mid-Value,Potential Loyalists
65691,1199,2,"185,3",2,1,1,4,Low-Value,Can't Lose
65692,126,1,"38,3",5,1,1,7,Mid-Value,Potential Loyalists
65693,10,4,"138,25",5,1,1,7,Mid-Value,Potential Loyalists
65694,1523,1,"57,6",1,1,1,3,Low-Value,Lost
65695,99,3,"79,55",5,1,1,7,Mid-Value,Potential Loyalists
65697,1081,2,"111,6",3,1,1,5,Low-Value,At Risk Customers
65698,220,4,"311,1",5,1,1,7,Mid-Value,Potential Loyalists
65699,1816,1,"95,1",1,1,1,3,Low-Value,Lost
65700,167,1,"222,0",5,1,1,7,Mid-Value,Potential Loyalists
65701,182,3,"155,04999999999998",5,1,1,7,Mid-Value,Potential Loyalists
65702,1167,8,"626,6",2,2,1,5,Low-Value,At Risk Customers
65703,1587,1,"80,6",1,1,1,3,Low-Value,Lost
65704,183,20,"1151,2",5,4,2,11,High-Value,Champions
65705,40,1,"38,6",5,1,1,7,Mid-Value,Potential Loyalists
65706,938,2,"233,14999999999998",3,1,1,5,Low-Value,At Risk Customers
65707,295,7,"486,90000000000003",5,2,1,8,High-Value,Potential Loyalists
65708,903,1,"57,5",3,1,1,5,Low-Value,At Risk Customers
65709,290,2,"134,9",5,1,1,7,Mid-Value,Potential Loyalists
65710,416,6,"354,7",4,1,1,6,Mid-Value,Potential Loyalists
65713,7,6,"360,0",5,1,1,7,Mid-Value,Potential Loyalists
65715,1394,1,"3,5",2,1,1,4,Low-Value,Can't Lose
65716,175,1,"22,4",5,1,1,7,Mid-Value,Potential Loyalists
65717,120,3,"195,2",5,1,1,7,Mid-Value,Potential Loyalists
65718,1165,2,"100,3",2,1,1,4,Low-Value,Can't Lose
65719,740,11,"599,3",3,2,1,6,Mid-Value,Potential Loyalists
65721,24,4,"194,20000000000002",5,1,1,7,Mid-Value,Potential Loyalists
65725,134,1,"129,9",5,1,1,7,Mid-Value,Potential Loyalists
65727,242,6,"367,85",5,1,1,7,Mid-Value,Potential Loyalists
65728,1463,9,"507,1",1,2,1,4,Low-Value,Can't Lose
65731,95,7,"315,50000000000006",5,2,1,8,High-Value,Potential Loyalists
65733,187,5,"368,05",5,1,1,7,Mid-Value,Potential Loyalists
65735,1001,1,"38,35",3,1,1,5,Low-Value,At Risk Customers
65736,360,1,"62,550000000000004",5,1,1,7,Mid-Value,Potential Loyalists
65737,1151,1,"47,05",2,1,1,4,Low-Value,Can't Lose
65738,11,8,"446,65000000000003",5,2,1,8,High-Value,Potential Loyalists
65739,794,1,"313,9",3,1,1,5,Low-Value,At Risk Customers
65741,40,2,"69,10000000000001",5,1,1,7,Mid-Value,Potential Loyalists
65742,23,5,"207,45",5,1,1,7,Mid-Value,Potential Loyalists
65743,21,7,"379,55",5,2,1,8,High-Value,Potential Loyalists
65744,111,4,"316,2",5,1,1,7,Mid-Value,Potential Loyalists
65746,274,1,"6,6",5,1,1,7,Mid-Value,Potential Loyalists
65748,1134,7,"488,15000000000003",2,2,1,5,Low-Value,At Risk Customers
65750,511,4,"243,05",4,1,1,6,Mid-Value,Potential Loyalists
65751,946,4,"134,5",3,1,1,5,Low-Value,At Risk Customers
65754,166,7,"222,0",5,2,1,8,High-Value,Potential Loyalists
65755,1228,3,"452,54999999999995",2,1,1,4,Low-Value,Can't Lose
65757,101,1,"49,6",5,1,1,7,Mid-Value,Potential Loyalists
65759,245,2,"16,9",5,1,1,7,Mid-Value,Potential Loyalists
65760,40,7,"197,05",5,2,1,8,High-Value,Potential Loyalists
65761,195,1,"41,3",5,1,1,7,Mid-Value,Potential Loyalists
65762,173,5,"204,6",5,1,1,7,Mid-Value,Potential Loyalists
65764,25,7,"230,5",5,2,1,8,High-Value,Potential Loyalists
65765,1230,1,"78,5",2,1,1,4,Low-Value,Can't Lose
65769,290,7,"900,45",5,2,2,9,High-Value,Champions
65770,12,6,"318,75",5,1,1,7,Mid-Value,Potential Loyalists
65771,400,4,"155,70000000000002",4,1,1,6,Mid-Value,Potential Loyalists
65772,859,2,"33,0",3,1,1,5,Low-Value,At Risk Customers
65773,172,5,"342,4",5,1,1,7,Mid-Value,Potential Loyalists
65774,330,3,"117,8",5,1,1,7,Mid-Value,Potential Loyalists
65775,816,1,"43,4",3,1,1,5,Low-Value,At Risk Customers
65776,973,4,"148,9",3,1,1,5,Low-Value,At Risk Customers
65777,33,3,"888,1500000000001",5,1,2,8,High-Value,Potential Loyalists
65779,70,2,"244,5",5,1,1,7,Mid-Value,Potential Loyalists
65780,297,1,"6,95",5,1,1,7,Mid-Value,Potential Loyalists
65781,96,2,"33,45",5,1,1,7,Mid-Value,Potential Loyalists
65782,45,17,"1017,0999999999999",5,4,2,11,High-Value,Champions
65784,472,4,"734,8499999999999",4,1,2,7,Mid-Value,Potential Loyalists
65785,63,13,"1235,35",5,3,2,10,High-Value,Champions
65786,1515,2,"219,85",1,1,1,3,Low-Value,Lost
65787,222,5,"359,0",5,1,1,7,Mid-Value,Potential Loyalists
65788,312,4,"66,65",5,1,1,7,Mid-Value,Potential Loyalists
65789,1302,2,"170,35",2,1,1,4,Low-Value,Can't Lose
65793,928,8,"621,1",3,2,1,6,Mid-Value,Potential Loyalists
65794,172,2,"104,7",5,1,1,7,Mid-Value,Potential Loyalists
65795,1138,1,"12,8",2,1,1,4,Low-Value,Can't Lose
65796,88,4,"299,0",5,1,1,7,Mid-Value,Potential Loyalists
65797,14,1,"8,7",5,1,1,7,Mid-Value,Potential Loyalists
65798,64,2,"132,85000000000002",5,1,1,7,Mid-Value,Potential Loyalists
70003,20,4,"187,79999999999998",5,1,1,7,Mid-Value,Potential Loyalists
70004,790,2,"35,150000000000006",3,1,1,5,Low-Value,At Risk Customers
70005,28,3,"388,35",5,1,1,7,Mid-Value,Potential Loyalists
70007,50,6,"560,1500000000001",5,1,1,7,Mid-Value,Potential Loyalists
70008,1405,1,"57,85",2,1,1,4,Low-Value,Can't Lose
70010,146,1,"54,9",5,1,1,7,Mid-Value,Potential Loyalists
70011,19,7,"965,5500000000001",5,2,2,9,High-Value,Champions
70012,114,1,"39,1",5,1,1,7,Mid-Value,Potential Loyalists
70016,641,2,"136,2",4,1,1,6,Mid-Value,Potential Loyalists
70017,346,2,"352,95",5,1,1,7,Mid-Value,Potential Loyalists
70018,473,5,"161,9",4,1,1,6,Mid-Value,Potential Loyalists
70020,92,4,"326,45",5,1,1,7,Mid-Value,Potential Loyalists
70021,113,4,"342,6",5,1,1,7,Mid-Value,Potential Loyalists
70022,417,1,"10,6",4,1,1,6,Mid-Value,Potential Loyalists
70023,34,1,"50,05",5,1,1,7,Mid-Value,Potential Loyalists
70024,673,2,"56,15",4,1,1,6,Mid-Value,Potential Loyalists
70025,442,2,"324,40000000000003",4,1,1,6,Mid-Value,Potential Loyalists
70026,1030,3,"80,75",3,1,1,5,Low-Value,At Risk Customers
70031,1623,1,"109,6",1,1,1,3,Low-Value,Lost
70034,29,2,"279,7",5,1,1,7,Mid-Value,Potential Loyalists
70038,958,1,"155,7",3,1,1,5,Low-Value,At Risk Customers
70039,481,5,"225,95",4,1,1,6,Mid-Value,Potential Loyalists
70041,197,3,"480,25000000000006",5,1,1,7,Mid-Value,Potential Loyalists
70042,334,6,"237,45",5,1,1,7,Mid-Value,Potential Loyalists
70043,139,3,"135,04999999999998",5,1,1,7,Mid-Value,Potential Loyalists
70044,222,2,"284,6",5,1,1,7,Mid-Value,Potential Loyalists
70045,446,2,"140,9",4,1,1,6,Mid-Value,Potential Loyalists
70046,1425,2,"33,9",2,1,1,4,Low-Value,Can't Lose
70047,870,4,"151,45",3,1,1,5,Low-Value,At Risk Customers
70049,161,2,"36,2",5,1,1,7,Mid-Value,Potential Loyalists
70051,411,2,"26,150000000000002",4,1,1,6,Mid-Value,Potential Loyalists
70052,810,6,"338,85",3,1,1,5,Low-Value,At Risk Customers
70053,462,12,"512,55",4,3,1,8,High-Value,Potential Loyalists
70054,10,6,"465,0",5,1,1,7,Mid-Value,Potential Loyalists
70056,598,2,"271,95000000000005",4,1,1,6,Mid-Value,Potential Loyalists
70060,186,1,"51,8",5,1,1,7,Mid-Value,Potential Loyalists
70061,658,6,"554,8000000000001",4,1,1,6,Mid-Value,Potential Loyalists
70064,1173,1,"72,75",2,1,1,4,Low-Value,Can't Lose
70065,405,2,"68,8",4,1,1,6,Mid-Value,Potential Loyalists
70068,24,3,"216,10000000000002",5,1,1,7,Mid-Value,Potential Loyalists
70070,1480,1,"22,8",1,1,1,3,Low-Value,Lost
70072,544,1,"19,05",4,1,1,6,Mid-Value,Potential Loyalists
70073,629,1,"152,05",4,1,1,6,Mid-Value,Potential Loyalists
70074,384,5,"531,7",4,1,1,6,Mid-Value,Potential Loyalists
70075,25,5,"334,75",5,1,1,7,Mid-Value,Potential Loyalists
70076,838,3,"51,2",3,1,1,5,Low-Value,At Risk Customers
70077,136,1,"5,8",5,1,1,7,Mid-Value,Potential Loyalists
70078,1441,4,"555,15",2,1,1,4,Low-Value,Can't Lose
70080,1041,2,"93,35",3,1,1,5,Low-Value,At Risk Customers
70082,763,3,"216,2",3,1,1,5,Low-Value,At Risk Customers
70083,390,2,"295,5",4,1,1,6,Mid-Value,Potential Loyalists
70084,595,8,"1207,3",4,2,2,8,High-Value,Potential Loyalists
70085,629,4,"86,55",4,1,1,6,Mid-Value,Potential Loyalists
70086,284,1,"48,9",5,1,1,7,Mid-Value,Potential Loyalists
70088,1145,2,"52,349999999999994",2,1,1,4,Low-Value,Can't Lose
70089,42,1,"15,4",5,1,1,7,Mid-Value,Potential Loyalists
70090,460,9,"507,3",4,2,1,7,Mid-Value,Potential Loyalists
70092,551,1,"144,6",4,1,1,6,Mid-Value,Potential Loyalists
70093,557,2,"142,3",4,1,1,6,Mid-Value,Potential Loyalists
70095,727,1,"33,6",4,1,1,6,Mid-Value,Potential Loyalists
70097,578,1,"19,8",4,1,1,6,Mid-Value,Potential Loyalists
70099,1648,1,"7,0",1,1,1,3,Low-Value,Lost
70101,263,1,"231,9",5,1,1,7,Mid-Value,Potential Loyalists
70104,545,3,"236,5",4,1,1,6,Mid-Value,Potential Loyalists
70105,1450,1,"18,5",2,1,1,4,Low-Value,Can't Lose
70106,1708,1,"27,4",1,1,1,3,Low-Value,Lost
70107,49,9,"1189,5500000000002",5,2,2,9,High-Value,Champions
70108,1641,1,"17,6",1,1,1,3,Low-Value,Lost
70109,276,4,"135,8",5,1,1,7,Mid-Value,Potential Loyalists
70111,20,2,"272,6",5,1,1,7,Mid-Value,Potential Loyalists
70113,190,7,"367,9",5,2,1,8,High-Value,Potential Loyalists
70115,734,1,"26,2",3,1,1,5,Low-Value,At Risk Customers
70116,144,3,"121,3",5,1,1,7,Mid-Value,Potential Loyalists
70119,5,10,"1411,1",5,2,3,10,High-Value,Champions
70120,783,5,"474,2",3,1,1,5,Low-Value,At Risk Customers
70121,356,1,"25,05",5,1,1,7,Mid-Value,Potential Loyalists
70123,1133,2,"93,55",2,1,1,4,Low-Value,Can't Lose
70125,246,2,"40,9",5,1,1,7,Mid-Value,Potential Loyalists
70126,573,3,"331,25",4,1,1,6,Mid-Value,Potential Loyalists
70128,969,1,"19,5",3,1,1,5,Low-Value,At Risk Customers
70129,296,1,"31,4",5,1,1,7,Mid-Value,Potential Loyalists
70130,1596,3,"127,05000000000001",1,1,1,3,Low-Value,Lost
70131,186,2,"82,80000000000001",5,1,1,7,Mid-Value,Potential Loyalists
70140,880,1,"46,9",3,1,1,5,Low-Value,At Risk Customers
70141,154,1,"152,6",5,1,1,7,Mid-Value,Potential Loyalists
70142,855,1,"26,3",3,1,1,5,Low-Value,At Risk Customers
70143,1597,3,"325,9",1,1,1,3,Low-Value,Lost
70144,576,1,"88,5",4,1,1,6,Mid-Value,Potential Loyalists
70146,39,1,"8,25",5,1,1,7,Mid-Value,Potential Loyalists
70147,1432,2,"57,1",2,1,1,4,Low-Value,Can't Lose
70148,139,3,"775,0",5,1,2,8,High-Value,Potential Loyalists
70149,397,2,"30,55",4,1,1,6,Mid-Value,Potential Loyalists
70151,41,8,"291,35",5,2,1,8,High-Value,Potential Loyalists
70152,29,3,"95,60000000000001",5,1,1,7,Mid-Value,Potential Loyalists
70153,1295,1,"62,8",2,1,1,4,Low-Value,Can't Lose
70155,1726,1,"4,85",1,1,1,3,Low-Value,Lost
70157,26,10,"398,55",5,2,1,8,High-Value,Potential Loyalists
70159,151,2,"74,3",5,1,1,7,Mid-Value,Potential Loyalists
70160,1276,2,"49,39999999999999",2,1,1,4,Low-Value,Can't Lose
70161,1518,1,"135,0",1,1,1,3,Low-Value,Lost
70162,1267,1,"88,6",2,1,1,4,Low-Value,Can't Lose
70164,131,3,"126,95",5,1,1,7,Mid-Value,Potential Loyalists
70166,1597,1,"40,9",1,1,1,3,Low-Value,Lost
70169,494,2,"184,89999999999998",4,1,1,6,Mid-Value,Potential Loyalists
70171,110,8,"1124,8500000000001",5,2,2,9,High-Value,Champions
70172,735,3,"108,6",3,1,1,5,Low-Value,At Risk Customers
70174,452,1,"45,0",4,1,1,6,Mid-Value,Potential Loyalists
70175,1343,4,"210,64999999999998",2,1,1,4,Low-Value,Can't Lose
70177,741,3,"360,0",3,1,1,5,Low-Value,At Risk Customers
70180,1541,1,"45,4",1,1,1,3,Low-Value,Lost
70181,819,2,"120,25",3,1,1,5,Low-Value,At Risk Customers
70183,197,3,"353,6",5,1,1,7,Mid-Value,Potential Loyalists
70186,740,3,"238,29999999999998",3,1,1,5,Low-Value,At Risk Customers
70187,38,1,"4,15",5,1,1,7,Mid-Value,Potential Loyalists
70188,535,4,"135,3",4,1,1,6,Mid-Value,Potential Loyalists
70191,17,3,"119,75",5,1,1,7,Mid-Value,Potential Loyalists
70193,46,1,"162,0",5,1,1,7,Mid-Value,Potential Loyalists
70194,1099,9,"582,5500000000001",2,2,1,5,Low-Value,At Risk Customers
70195,258,3,"214,25",5,1,1,7,Mid-Value,Potential Loyalists
70197,508,4,"178,5",4,1,1,6,Mid-Value,Potential Loyalists
70199,1010,1,"15,6",3,1,1,5,Low-Value,At Risk Customers
70200,384,1,"14,5",4,1,1,6,Mid-Value,Potential Loyalists
70204,867,1,"32,1",3,1,1,5,Low-Value,At Risk Customers
70205,1086,4,"363,25",3,1,1,5,Low-Value,At Risk Customers
70206,1245,2,"538,0",2,1,1,4,Low-Value,Can't Lose
70209,894,3,"326,5",3,1,1,5,Low-Value,At Risk Customers
70210,1112,1,"20,6",2,1,1,4,Low-Value,Can't Lose
70211,29,3,"199,29999999999998",5,1,1,7,Mid-Value,Potential Loyalists
70212,1138,2,"25,7",2,1,1,4,Low-Value,Can't Lose
70213,942,2,"70,25",3,1,1,5,Low-Value,At Risk Customers
70215,92,12,"453,4",5,3,1,9,High-Value,Champions
70220,1219,1,"9,9",2,1,1,4,Low-Value,Can't Lose
70224,3,2,"128,2",5,1,1,7,Mid-Value,Potential Loyalists
70226,70,8,"306,45",5,2,1,8,High-Value,Potential Loyalists
70229,634,2,"29,15",4,1,1,6,Mid-Value,Potential Loyalists
70230,477,4,"260,45",4,1,1,6,Mid-Value,Potential Loyalists
70231,1698,1,"5,65",1,1,1,3,Low-Value,Lost
70236,238,11,"919,9499999999999",5,2,2,9,High-Value,Champions
70238,734,4,"220,04999999999998",3,1,1,5,Low-Value,At Risk Customers
70239,264,8,"411,35",5,2,1,8,High-Value,Potential Loyalists
70242,786,3,"269,0",3,1,1,5,Low-Value,At Risk Customers
70243,4,6,"271,5",5,1,1,7,Mid-Value,Potential Loyalists
70245,27,6,"325,95",5,1,1,7,Mid-Value,Potential Loyalists
70249,390,7,"611,25",4,2,1,7,Mid-Value,Potential Loyalists
70251,814,4,"319,8",3,1,1,5,Low-Value,At Risk Customers
70252,122,8,"830,95",5,2,2,9,High-Value,Champions
70255,479,1,"94,2",4,1,1,6,Mid-Value,Potential Loyalists
70256,1168,3,"188,7",2,1,1,4,Low-Value,Can't Lose
70257,424,2,"90,94999999999999",4,1,1,6,Mid-Value,Potential Loyalists
70258,157,1,"209,2",5,1,1,7,Mid-Value,Potential Loyalists
70260,626,2,"482,0",4,1,1,6,Mid-Value,Potential Loyalists
70261,11,1,"44,9",5,1,1,7,Mid-Value,Potential Loyalists
70262,194,3,"53,95",5,1,1,7,Mid-Value,Potential Loyalists
70264,1539,1,"6,5",1,1,1,3,Low-Value,Lost
70266,224,1,"9,9",5,1,1,7,Mid-Value,Potential Loyalists
70268,1805,1,"436,9",1,1,1,3,Low-Value,Lost
70269,1770,1,"97,4",1,1,1,3,Low-Value,Lost
70273,460,6,"534,9",4,1,1,6,Mid-Value,Potential Loyalists
70274,925,2,"108,65",3,1,1,5,Low-Value,At Risk Customers
70275,848,4,"218,75",3,1,1,5,Low-Value,At Risk Customers
70278,787,3,"209,15",3,1,1,5,Low-Value,At Risk Customers
70279,975,2,"94,7",3,1,1,5,Low-Value,At Risk Customers
70280,555,1,"17,35",4,1,1,6,Mid-Value,Potential Loyalists
70282,746,3,"226,45",3,1,1,5,Low-Value,At Risk Customers
70283,1588,1,"35,7",1,1,1,3,Low-Value,Lost
70284,335,1,"24,8",5,1,1,7,Mid-Value,Potential Loyalists
70285,218,5,"437,85",5,1,1,7,Mid-Value,Potential Loyalists
70286,756,3,"379,0",3,1,1,5,Low-Value,At Risk Customers
70287,7,15,"994,6",5,3,2,10,High-Value,Champions
70288,165,8,"728,2",5,2,2,9,High-Value,Champions
70289,242,2,"177,35000000000002",5,1,1,7,Mid-Value,Potential Loyalists
70290,757,2,"114,4",3,1,1,5,Low-Value,At Risk Customers
70291,1461,2,"232,64999999999998",1,1,1,3,Low-Value,Lost
70292,417,8,"278,45",4,2,1,7,Mid-Value,Potential Loyalists
70296,1255,1,"49,6",2,1,1,4,Low-Value,Can't Lose
70297,1166,3,"153,95",2,1,1,4,Low-Value,Can't Lose
70304,305,1,"21,15",5,1,1,7,Mid-Value,Potential Loyalists
70305,1142,1,"6,5",2,1,1,4,Low-Value,Can't Lose
70308,1179,1,"89,0",2,1,1,4,Low-Value,Can't Lose
70309,248,2,"185,1",5,1,1,7,Mid-Value,Potential Loyalists
70310,190,5,"367,8",5,1,1,7,Mid-Value,Potential Loyalists
70311,814,7,"307,3",3,2,1,6,Mid-Value,Potential Loyalists
70313,1044,2,"174,25",3,1,1,5,Low-Value,At Risk Customers
70315,263,4,"261,55",5,1,1,7,Mid-Value,Potential Loyalists
70317,404,8,"321,75",4,2,1,7,Mid-Value,Potential Loyalists
70318,623,3,"70,1",4,1,1,6,Mid-Value,Potential Loyalists
70320,10,3,"212,25",5,1,1,7,Mid-Value,Potential Loyalists
70322,5,3,"300,55",5,1,1,7,Mid-Value,Potential Loyalists
70324,784,1,"17,3",3,1,1,5,Low-Value,At Risk Customers
70325,1334,3,"444,4",2,1,1,4,Low-Value,Can't Lose
70326,28,5,"248,3",5,1,1,7,Mid-Value,Potential Loyalists
70327,193,6,"106,9",5,1,1,7,Mid-Value,Potential Loyalists
70330,980,1,"18,45",3,1,1,5,Low-Value,At Risk Customers
70331,4,3,"241,7",5,1,1,7,Mid-Value,Potential Loyalists
70332,476,10,"848,65",4,2,2,8,High-Value,Potential Loyalists
70333,1105,1,"114,1",2,1,1,4,Low-Value,Can't Lose
70334,1468,1,"272,0",1,1,1,3,Low-Value,Lost
70335,900,1,"87,9",3,1,1,5,Low-Value,At Risk Customers
70337,1079,1,"11,15",3,1,1,5,Low-Value,At Risk Customers
70339,563,7,"554,1",4,2,1,7,Mid-Value,Potential Loyalists
70340,757,3,"167,1",3,1,1,5,Low-Value,At Risk Customers
70341,414,6,"292,5",4,1,1,6,Mid-Value,Potential Loyalists
70343,3,7,"746,15",5,2,2,9,High-Value,Champions
70345,449,1,"53,6",4,1,1,6,Mid-Value,Potential Loyalists
70346,372,12,"725,4",4,3,2,9,High-Value,Champions
70347,1123,3,"134,55",2,1,1,4,Low-Value,Can't Lose
70348,302,2,"590,5",5,1,1,7,Mid-Value,Potential Loyalists
70349,777,2,"286,75",3,1,1,5,Low-Value,At Risk Customers
70350,99,14,"1033,75",5,3,2,10,High-Value,Champions
70351,14,4,"62,95",5,1,1,7,Mid-Value,Potential Loyalists
70355,733,5,"202,18",3,1,1,5,Low-Value,At Risk Customers
70357,1343,3,"198,7",2,1,1,4,Low-Value,Can't Lose
70359,424,1,"34,35",4,1,1,6,Mid-Value,Potential Loyalists
70361,1616,1,"57,95",1,1,1,3,Low-Value,Lost
70362,500,2,"348,9",4,1,1,6,Mid-Value,Potential Loyalists
70364,137,6,"517,85",5,1,1,7,Mid-Value,Potential Loyalists
70370,375,3,"161,85",4,1,1,6,Mid-Value,Potential Loyalists
70372,455,1,"11,0",4,1,1,6,Mid-Value,Potential Loyalists
70373,1649,2,"39,45",1,1,1,3,Low-Value,Lost
70377,605,1,"50,3",4,1,1,6,Mid-Value,Potential Loyalists
70378,374,1,"10,8",4,1,1,6,Mid-Value,Potential Loyalists
70379,797,1,"18,7",3,1,1,5,Low-Value,At Risk Customers
70380,692,5,"463,59999999999997",4,1,1,6,Mid-Value,Potential Loyalists
70381,129,2,"133,95",5,1,1,7,Mid-Value,Potential Loyalists
70384,0,8,"538,55",5,2,1,8,High-Value,Potential Loyalists
70385,701,1,"44,95",4,1,1,6,Mid-Value,Potential Loyalists
70386,862,2,"114,8",3,1,1,5,Low-Value,At Risk Customers
70388,1098,1,"114,1",2,1,1,4,Low-Value,Can't Lose
70391,878,2,"176,7",3,1,1,5,Low-Value,At Risk Customers
70392,20,5,"531,45",5,1,1,7,Mid-Value,Potential Loyalists
70393,426,2,"86,65",4,1,1,6,Mid-Value,Potential Loyalists
70394,797,4,"715,95",3,1,2,6,Mid-Value,Potential Loyalists
70395,454,1,"29,1",4,1,1,6,Mid-Value,Potential Loyalists
70396,1517,2,"126,45",1,1,1,3,Low-Value,Lost
70397,166,2,"48,95",5,1,1,7,Mid-Value,Potential Loyalists
70400,684,2,"49,8",4,1,1,6,Mid-Value,Potential Loyalists
70402,1547,1,"92,05",1,1,1,3,Low-Value,Lost
70404,450,3,"64,25",4,1,1,6,Mid-Value,Potential Loyalists
70405,503,2,"132,1",4,1,1,6,Mid-Value,Potential Loyalists
70406,10,4,"356,5",5,1,1,7,Mid-Value,Potential Loyalists
70410,559,7,"317,2",4,2,1,7,Mid-Value,Potential Loyalists
70412,31,3,"352,0",5,1,1,7,Mid-Value,Potential Loyalists
70413,485,1,"34,7",4,1,1,6,Mid-Value,Potential Loyalists
70414,1722,2,"113,75",1,1,1,3,Low-Value,Lost
70415,11,3,"251,8",5,1,1,7,Mid-Value,Potential Loyalists
70416,792,2,"19,5",3,1,1,5,Low-Value,At Risk Customers
70418,399,5,"123,7",4,1,1,6,Mid-Value,Potential Loyalists
70419,13,3,"347,54999999999995",5,1,1,7,Mid-Value,Potential Loyalists
70421,255,5,"460,45",5,1,1,7,Mid-Value,Potential Loyalists
70422,28,4,"291,2",5,1,1,7,Mid-Value,Potential Loyalists
70423,247,1,"51,3",5,1,1,7,Mid-Value,Potential Loyalists
70424,149,7,"495,84999999999997",5,2,1,8,High-Value,Potential Loyalists
70425,868,2,"12,45",3,1,1,5,Low-Value,At Risk Customers
70426,39,6,"105,2",5,1,1,7,Mid-Value,Potential Loyalists
70427,84,7,"179,4",5,2,1,8,High-Value,Potential Loyalists
70430,1489,1,"75,8",1,1,1,3,Low-Value,Lost
70431,1599,1,"88,6",1,1,1,3,Low-Value,Lost
70432,393,1,"75,6",4,1,1,6,Mid-Value,Potential Loyalists
70433,23,6,"625,85",5,1,1,7,Mid-Value,Potential Loyalists
70434,273,2,"29,9",5,1,1,7,Mid-Value,Potential Loyalists
70435,350,7,"536,5",5,2,1,8,High-Value,Potential Loyalists
70436,756,3,"221,45",3,1,1,5,Low-Value,At Risk Customers
70437,1680,1,"270,15",1,1,1,3,Low-Value,Lost
70438,1279,1,"110,85000000000001",2,1,1,4,Low-Value,Can't Lose
70439,1578,1,"115,95",1,1,1,3,Low-Value,Lost
70441,262,3,"103,75",5,1,1,7,Mid-Value,Potential Loyalists
70444,45,4,"190,9",5,1,1,7,Mid-Value,Potential Loyalists
70448,858,4,"267,54999999999995",3,1,1,5,Low-Value,At Risk Customers
70450,810,4,"494,55",3,1,1,5,Low-Value,At Risk Customers
70452,48,7,"332,15",5,2,1,8,High-Value,Potential Loyalists
70453,405,2,"21,15",4,1,1,6,Mid-Value,Potential Loyalists
70454,308,1,"25,5",5,1,1,7,Mid-Value,Potential Loyalists
70455,73,4,"197,8",5,1,1,7,Mid-Value,Potential Loyalists
70456,1547,1,"5,5",1,1,1,3,Low-Value,Lost
70457,402,1,"24,1",4,1,1,6,Mid-Value,Potential Loyalists
70458,39,2,"49,95",5,1,1,7,Mid-Value,Potential Loyalists
70459,382,2,"91,5",4,1,1,6,Mid-Value,Potential Loyalists
70460,0,5,"326,95000000000005",5,1,1,7,Mid-Value,Potential Loyalists
70463,15,4,"357,15",5,1,1,7,Mid-Value,Potential Loyalists
70464,155,3,"166,2",5,1,1,7,Mid-Value,Potential Loyalists
70467,1695,1,"34,4",1,1,1,3,Low-Value,Lost
70473,721,4,"90,55",4,1,1,6,Mid-Value,Potential Loyalists
70476,104,7,"344,95",5,2,1,8,High-Value,Potential Loyalists
70477,496,1,"0,7",4,1,1,6,Mid-Value,Potential Loyalists
70478,337,5,"119,05",5,1,1,7,Mid-Value,Potential Loyalists
70479,33,5,"351,0",5,1,1,7,Mid-Value,Potential Loyalists
70480,781,9,"526,4",3,2,1,6,Mid-Value,Potential Loyalists
70481,60,1,"20,95",5,1,1,7,Mid-Value,Potential Loyalists
70482,94,9,"344,5",5,2,1,8,High-Value,Potential Loyalists
70483,586,5,"222,39999999999998",4,1,1,6,Mid-Value,Potential Loyalists
70484,1392,3,"353,75000000000006",2,1,1,4,Low-Value,Can't Lose
70485,470,2,"94,75",4,1,1,6,Mid-Value,Potential Loyalists
70487,660,3,"154,0",4,1,1,6,Mid-Value,Potential Loyalists
70488,1164,1,"23,25",2,1,1,4,Low-Value,Can't Lose
70489,48,3,"318,40000000000003",5,1,1,7,Mid-Value,Potential Loyalists
70490,793,5,"303,0",3,1,1,5,Low-Value,At Risk Customers
70492,499,3,"330,30000000000007",4,1,1,6,Mid-Value,Potential Loyalists
70493,1228,1,"276,0",2,1,1,4,Low-Value,Can't Lose
70495,513,6,"435,6",4,1,1,6,Mid-Value,Potential Loyalists
70496,2,5,"315,6",5,1,1,7,Mid-Value,Potential Loyalists
70497,1104,4,"83,89999999999999",2,1,1,4,Low-Value,Can't Lose
70498,299,2,"17,450000000000003",5,1,1,7,Mid-Value,Potential Loyalists
70499,40,3,"287,4",5,1,1,7,Mid-Value,Potential Loyalists
70501,27,1,"40,8",5,1,1,7,Mid-Value,Potential Loyalists
70503,281,2,"188,25",5,1,1,7,Mid-Value,Potential Loyalists
70504,1116,1,"25,6",2,1,1,4,Low-Value,Can't Lose
70506,271,2,"52,05",5,1,1,7,Mid-Value,Potential Loyalists
70508,396,2,"114,2",4,1,1,6,Mid-Value,Potential Loyalists
70509,171,7,"412,85",5,2,1,8,High-Value,Potential Loyalists
70510,359,3,"54,55",5,1,1,7,Mid-Value,Potential Loyalists
70512,968,2,"56,5",3,1,1,5,Low-Value,At Risk Customers
70518,53,7,"464,65",5,2,1,8,High-Value,Potential Loyalists
70520,937,2,"62,8",3,1,1,5,Low-Value,At Risk Customers
70523,1525,1,"28,9",1,1,1,3,Low-Value,Lost
70524,550,6,"412,75",4,1,1,6,Mid-Value,Potential Loyalists
70526,23,12,"785,8",5,3,2,10,High-Value,Champions
70528,212,2,"185,75",5,1,1,7,Mid-Value,Potential Loyalists
70529,1676,1,"8,25",1,1,1,3,Low-Value,Lost
70530,8,2,"51,85",5,1,1,7,Mid-Value,Potential Loyalists
70531,764,5,"468,6",3,1,1,5,Low-Value,At Risk Customers
70533,26,5,"174,75",5,1,1,7,Mid-Value,Potential Loyalists
70534,671,2,"57,55",4,1,1,6,Mid-Value,Potential Loyalists
70535,170,3,"211,7",5,1,1,7,Mid-Value,Potential Loyalists
70536,314,1,"18,25",5,1,1,7,Mid-Value,Potential Loyalists
70540,591,4,"127,5",4,1,1,6,Mid-Value,Potential Loyalists
70542,42,4,"343,35",5,1,1,7,Mid-Value,Potential Loyalists
70544,100,2,"65,7",5,1,1,7,Mid-Value,Potential Loyalists
70545,1318,1,"32,3",2,1,1,4,Low-Value,Can't Lose
70546,53,5,"190,15",5,1,1,7,Mid-Value,Potential Loyalists
70548,1174,2,"29,8",2,1,1,4,Low-Value,Can't Lose
70553,498,1,"181,4",4,1,1,6,Mid-Value,Potential Loyalists
70556,795,1,"4,85",3,1,1,5,Low-Value,At Risk Customers
70557,129,3,"405,70000000000005",5,1,1,7,Mid-Value,Potential Loyalists
70558,74,2,"32,699999999999996",5,1,1,7,Mid-Value,Potential Loyalists
70564,17,3,"220,7",5,1,1,7,Mid-Value,Potential Loyalists
70566,382,9,"432,55",4,2,1,7,Mid-Value,Potential Loyalists
70570,934,2,"30,299999999999997",3,1,1,5,Low-Value,At Risk Customers
70572,28,5,"540,85",5,1,1,7,Mid-Value,Potential Loyalists
70573,599,5,"118,0",4,1,1,6,Mid-Value,Potential Loyalists
70575,1163,4,"191,1",2,1,1,4,Low-Value,Can't Lose
70576,1096,4,"94,65",2,1,1,4,Low-Value,Can't Lose
70578,39,4,"184,39999999999998",5,1,1,7,Mid-Value,Potential Loyalists
70579,1416,1,"81,0",2,1,1,4,Low-Value,Can't Lose
70583,1338,1,"8,75",2,1,1,4,Low-Value,Can't Lose
70584,286,2,"32,1",5,1,1,7,Mid-Value,Potential Loyalists
70587,489,2,"325,95",4,1,1,6,Mid-Value,Potential Loyalists
70589,1027,1,"59,8",3,1,1,5,Low-Value,At Risk Customers
70590,156,4,"283,5",5,1,1,7,Mid-Value,Potential Loyalists
70591,14,10,"781,6",5,2,2,9,High-Value,Champions
70593,933,2,"45,2",3,1,1,5,Low-Value,At Risk Customers
70594,156,3,"84,94999999999999",5,1,1,7,Mid-Value,Potential Loyalists
70595,1300,1,"82,8",2,1,1,4,Low-Value,Can't Lose
70596,475,4,"107,75",4,1,1,6,Mid-Value,Potential Loyalists
70601,370,3,"124,1",4,1,1,6,Mid-Value,Potential Loyalists
70603,1084,3,"406,15000000000003",3,1,1,5,Low-Value,At Risk Customers
70604,18,1,"8,8",5,1,1,7,Mid-Value,Potential Loyalists
70605,325,2,"51,45",5,1,1,7,Mid-Value,Potential Loyalists
70606,197,3,"305,75",5,1,1,7,Mid-Value,Potential Loyalists
70609,20,5,"400,45000000000005",5,1,1,7,Mid-Value,Potential Loyalists
70612,294,1,"15,5",5,1,1,7,Mid-Value,Potential Loyalists
70613,960,1,"93,8",3,1,1,5,Low-Value,At Risk Customers
70614,84,3,"285,40000000000003",5,1,1,7,Mid-Value,Potential Loyalists
70615,857,1,"16,0",3,1,1,5,Low-Value,At Risk Customers
70616,199,5,"272,20000000000005",5,1,1,7,Mid-Value,Potential Loyalists
70619,1545,1,"125,85",1,1,1,3,Low-Value,Lost
70622,193,7,"188,54999999999998",5,2,1,8,High-Value,Potential Loyalists
70624,1121,2,"256,2",2,1,1,4,Low-Value,Can't Lose
70626,895,1,"17,5",3,1,1,5,Low-Value,At Risk Customers
70628,92,4,"94,55",5,1,1,7,Mid-Value,Potential Loyalists
70629,620,3,"86,8",4,1,1,6,Mid-Value,Potential Loyalists
70630,39,4,"140,7",5,1,1,7,Mid-Value,Potential Loyalists
70632,875,1,"79,9",3,1,1,5,Low-Value,At Risk Customers
70634,742,1,"39,0",3,1,1,5,Low-Value,At Risk Customers
70637,1055,1,"27,55",3,1,1,5,Low-Value,At Risk Customers
70638,1483,1,"19,9",1,1,1,3,Low-Value,Lost
70639,334,3,"412,55",5,1,1,7,Mid-Value,Potential Loyalists
70641,999,1,"9,05",3,1,1,5,Low-Value,At Risk Customers
70642,174,9,"532,6",5,2,1,8,High-Value,Potential Loyalists
70643,813,1,"26,55",3,1,1,5,Low-Value,At Risk Customers
70647,1402,6,"238,75",2,1,1,4,Low-Value,Can't Lose
70648,267,1,"75,0",5,1,1,7,Mid-Value,Potential Loyalists
70649,154,7,"202,85000000000002",5,2,1,8,High-Value,Potential Loyalists
70650,149,4,"217,55",5,1,1,7,Mid-Value,Potential Loyalists
70654,250,4,"452,90000000000003",5,1,1,7,Mid-Value,Potential Loyalists
70656,181,5,"353,3",5,1,1,7,Mid-Value,Potential Loyalists
70657,12,8,"840,9000000000001",5,2,2,9,High-Value,Champions
70659,926,1,"4,8",3,1,1,5,Low-Value,At Risk Customers
70660,41,2,"13,85",5,1,1,7,Mid-Value,Potential Loyalists
70661,10,4,"205,35",5,1,1,7,Mid-Value,Potential Loyalists
70662,1660,1,"237,0",1,1,1,3,Low-Value,Lost
70663,128,1,"4,6",5,1,1,7,Mid-Value,Potential Loyalists
70666,73,3,"102,30000000000001",5,1,1,7,Mid-Value,Potential Loyalists
70667,123,3,"118,55",5,1,1,7,Mid-Value,Potential Loyalists
70668,48,3,"123,95",5,1,1,7,Mid-Value,Potential Loyalists
70670,974,6,"256,2",3,1,1,5,Low-Value,At Risk Customers
70671,416,4,"205,15",4,1,1,6,Mid-Value,Potential Loyalists
70672,959,1,"108,0",3,1,1,5,Low-Value,At Risk Customers
70674,636,2,"138,35",4,1,1,6,Mid-Value,Potential Loyalists
70676,122,3,"253,75",5,1,1,7,Mid-Value,Potential Loyalists
70678,40,6,"331,55",5,1,1,7,Mid-Value,Potential Loyalists
70679,964,2,"20,4",3,1,1,5,Low-Value,At Risk Customers
70681,192,4,"658,4000000000001",5,1,1,7,Mid-Value,Potential Loyalists
70682,129,6,"348,1",5,1,1,7,Mid-Value,Potential Loyalists
70684,791,2,"50,2",3,1,1,5,Low-Value,At Risk Customers
70687,1482,1,"109,5",1,1,1,3,Low-Value,Lost
70688,8,15,"1137,4",5,3,2,10,High-Value,Champions
70689,60,3,"369,45",5,1,1,7,Mid-Value,Potential Loyalists
70690,137,4,"85,3",5,1,1,7,Mid-Value,Potential Loyalists
70691,398,2,"250,54999999999998",4,1,1,6,Mid-Value,Potential Loyalists
70692,208,5,"231,85",5,1,1,7,Mid-Value,Potential Loyalists
70695,189,12,"789,4",5,3,2,10,High-Value,Champions
70696,534,8,"341,34999999999997",4,2,1,7,Mid-Value,Potential Loyalists
70697,1176,1,"55,25",2,1,1,4,Low-Value,Can't Lose
70699,446,1,"50,6",4,1,1,6,Mid-Value,Potential Loyalists
70700,359,4,"386,75",5,1,1,7,Mid-Value,Potential Loyalists
70703,859,3,"111,69999999999999",3,1,1,5,Low-Value,At Risk Customers
70707,150,7,"1008,85",5,2,2,9,High-Value,Champions
70708,1373,4,"130,95",2,1,1,4,Low-Value,Can't Lose
70709,50,4,"137,95",5,1,1,7,Mid-Value,Potential Loyalists
70711,417,3,"96,25",4,1,1,6,Mid-Value,Potential Loyalists
70712,30,13,"722,2",5,3,2,10,High-Value,Champions
70713,140,1,"26,65",5,1,1,7,Mid-Value,Potential Loyalists
70714,103,8,"427,7",5,2,1,8,High-Value,Potential Loyalists
70715,669,2,"213,29999999999998",4,1,1,6,Mid-Value,Potential Loyalists
70718,1629,2,"73,15",1,1,1,3,Low-Value,Lost
70720,831,5,"255,39999999999998",3,1,1,5,Low-Value,At Risk Customers
70722,564,4,"98,14999999999999",4,1,1,6,Mid-Value,Potential Loyalists
70724,1140,3,"154,25",2,1,1,4,Low-Value,Can't Lose
70726,1317,1,"117,14999999999999",2,1,1,4,Low-Value,Can't Lose
70727,23,4,"101,8",5,1,1,7,Mid-Value,Potential Loyalists
70729,791,1,"2,75",3,1,1,5,Low-Value,At Risk Customers
70734,166,5,"257,54999999999995",5,1,1,7,Mid-Value,Potential Loyalists
70735,7,5,"149,15",5,1,1,7,Mid-Value,Potential Loyalists
70737,10,3,"516,7",5,1,1,7,Mid-Value,Potential Loyalists
70738,716,3,"253,95000000000002",4,1,1,6,Mid-Value,Potential Loyalists
70739,1278,2,"46,15",2,1,1,4,Low-Value,Can't Lose
70740,495,2,"137,1",4,1,1,6,Mid-Value,Potential Loyalists
70742,845,2,"50,45",3,1,1,5,Low-Value,At Risk Customers
70743,580,2,"91,35",4,1,1,6,Mid-Value,Potential Loyalists
70744,747,3,"107,15",3,1,1,5,Low-Value,At Risk Customers
70745,1544,2,"24,75",1,1,1,3,Low-Value,Lost
70746,357,1,"30,25",5,1,1,7,Mid-Value,Potential Loyalists
70747,759,5,"377,5",3,1,1,5,Low-Value,At Risk Customers
70748,1732,1,"3,4",1,1,1,3,Low-Value,Lost
70751,315,3,"412,85",5,1,1,7,Mid-Value,Potential Loyalists
70752,49,3,"151,75",5,1,1,7,Mid-Value,Potential Loyalists
70754,24,1,"13,1",5,1,1,7,Mid-Value,Potential Loyalists
70755,1100,1,"44,9",2,1,1,4,Low-Value,Can't Lose
70756,495,3,"79,2",4,1,1,6,Mid-Value,Potential Loyalists
70757,236,2,"36,0",5,1,1,7,Mid-Value,Potential Loyalists
70758,148,3,"180,49999999999997",5,1,1,7,Mid-Value,Potential Loyalists
70759,1798,1,"41,0",1,1,1,3,Low-Value,Lost
70760,118,3,"408,8",5,1,1,7,Mid-Value,Potential Loyalists
70761,715,1,"2,3",4,1,1,6,Mid-Value,Potential Loyalists
70763,1177,2,"66,5",2,1,1,4,Low-Value,Can't Lose
70765,708,1,"21,3",4,1,1,6,Mid-Value,Potential Loyalists
70768,225,2,"16,9",5,1,1,7,Mid-Value,Potential Loyalists
70771,266,3,"149,4",5,1,1,7,Mid-Value,Potential Loyalists
70773,564,2,"529,5",4,1,1,6,Mid-Value,Potential Loyalists
70775,643,2,"62,6",4,1,1,6,Mid-Value,Potential Loyalists
70776,1079,1,"199,0",3,1,1,5,Low-Value,At Risk Customers
70778,759,1,"195,7",3,1,1,5,Low-Value,At Risk Customers
70779,1727,1,"124,19999999999999",1,1,1,3,Low-Value,Lost
70781,99,3,"66,35",5,1,1,7,Mid-Value,Potential Loyalists
70785,10,2,"52,650000000000006",5,1,1,7,Mid-Value,Potential Loyalists
70786,16,6,"694,9",5,1,2,8,High-Value,Potential Loyalists
70789,1516,1,"18,05",1,1,1,3,Low-Value,Lost
70792,672,1,"16,8",4,1,1,6,Mid-Value,Potential Loyalists
70795,17,6,"399,05",5,1,1,7,Mid-Value,Potential Loyalists
70796,359,1,"162,5",5,1,1,7,Mid-Value,Potential Loyalists
70799,413,12,"364,15",4,3,1,8,High-Value,Potential Loyalists
70800,472,1,"48,0",4,1,1,6,Mid-Value,Potential Loyalists
70801,421,1,"23,45",4,1,1,6,Mid-Value,Potential Loyalists
70806,1415,1,"66,7",2,1,1,4,Low-Value,Can't Lose
70807,633,3,"410,5",4,1,1,6,Mid-Value,Potential Loyalists
70808,138,3,"231,60000000000002",5,1,1,7,Mid-Value,Potential Loyalists
70809,1013,1,"110,65",3,1,1,5,Low-Value,At Risk Customers
70812,1493,2,"23,950000000000003",1,1,1,3,Low-Value,Lost
70813,408,6,"538,6",4,1,1,6,Mid-Value,Potential Loyalists
70815,746,1,"124,94999999999999",3,1,1,5,Low-Value,At Risk Customers
70816,385,2,"97,55",4,1,1,6,Mid-Value,Potential Loyalists
70817,426,2,"23,15",4,1,1,6,Mid-Value,Potential Loyalists
70818,584,8,"235,35",4,2,1,7,Mid-Value,Potential Loyalists
70819,595,2,"61,0",4,1,1,6,Mid-Value,Potential Loyalists
70821,1190,1,"12,3",2,1,1,4,Low-Value,Can't Lose
70823,184,3,"86,19999999999999",5,1,1,7,Mid-Value,Potential Loyalists
70827,654,1,"16,3",4,1,1,6,Mid-Value,Potential Loyalists
70828,1232,1,"44,8",2,1,1,4,Low-Value,Can't Lose
70829,1550,4,"191,04999999999998",1,1,1,3,Low-Value,Lost
70830,1273,1,"47,9",2,1,1,4,Low-Value,Can't Lose
70837,385,3,"172,7",4,1,1,6,Mid-Value,Potential Loyalists
70839,216,3,"115,30000000000001",5,1,1,7,Mid-Value,Potential Loyalists
70840,379,1,"11,9",4,1,1,6,Mid-Value,Potential Loyalists
70842,183,2,"64,6",5,1,1,7,Mid-Value,Potential Loyalists
70843,55,6,"257,7",5,1,1,7,Mid-Value,Potential Loyalists
70844,146,4,"237,20000000000002",5,1,1,7,Mid-Value,Potential Loyalists
70851,949,3,"140,5",3,1,1,5,Low-Value,At Risk Customers
70852,1395,1,"43,5",2,1,1,4,Low-Value,Can't Lose
70853,31,4,"233,15",5,1,1,7,Mid-Value,Potential Loyalists
70854,117,2,"116,0",5,1,1,7,Mid-Value,Potential Loyalists
70855,1040,1,"13,2",3,1,1,5,Low-Value,At Risk Customers
70856,497,3,"65,15",4,1,1,6,Mid-Value,Potential Loyalists
70859,31,11,"579,55",5,2,1,8,High-Value,Potential Loyalists
70860,395,1,"72,75",4,1,1,6,Mid-Value,Potential Loyalists
70861,479,1,"16,95",4,1,1,6,Mid-Value,Potential Loyalists
70863,124,2,"117,8",5,1,1,7,Mid-Value,Potential Loyalists
70866,46,11,"472,35",5,2,1,8,High-Value,Potential Loyalists
70868,257,5,"267,55",5,1,1,7,Mid-Value,Potential Loyalists
70869,863,2,"21,0",3,1,1,5,Low-Value,At Risk Customers
70870,108,3,"151,79999999999998",5,1,1,7,Mid-Value,Potential Loyalists
70871,343,6,"410,7",5,1,1,7,Mid-Value,Potential Loyalists
70872,152,4,"576,7",5,1,1,7,Mid-Value,Potential Loyalists
70876,70,6,"466,65",5,1,1,7,Mid-Value,Potential Loyalists
70877,1000,3,"242,04999999999998",3,1,1,5,Low-Value,At Risk Customers
70879,335,5,"273,4",5,1,1,7,Mid-Value,Potential Loyalists
70880,195,10,"1096,8",5,2,2,9,High-Value,Champions
70881,45,4,"143,45",5,1,1,7,Mid-Value,Potential Loyalists
70883,8,5,"136,15",5,1,1,7,Mid-Value,Potential Loyalists
70885,122,6,"743,4000000000001",5,1,2,8,High-Value,Potential Loyalists
70886,1110,2,"32,400000000000006",2,1,1,4,Low-Value,Can't Lose
70892,1104,1,"14,5",2,1,1,4,Low-Value,Can't Lose
70893,504,1,"158,0",4,1,1,6,Mid-Value,Potential Loyalists
70894,511,2,"358,4",4,1,1,6,Mid-Value,Potential Loyalists
70895,182,1,"94,1",5,1,1,7,Mid-Value,Potential Loyalists
70896,131,8,"582,9499999999999",5,2,1,8,High-Value,Potential Loyalists
70899,1249,1,"56,0",2,1,1,4,Low-Value,Can't Lose
70900,45,3,"337,65",5,1,1,7,Mid-Value,Potential Loyalists
70901,1629,1,"75,9",1,1,1,3,Low-Value,Lost
70902,854,2,"107,10000000000001",3,1,1,5,Low-Value,At Risk Customers
70903,42,5,"117,6",5,1,1,7,Mid-Value,Potential Loyalists
70904,18,4,"295,3",5,1,1,7,Mid-Value,Potential Loyalists
70905,53,2,"62,099999999999994",5,1,1,7,Mid-Value,Potential Loyalists
70906,455,3,"126,45",4,1,1,6,Mid-Value,Potential Loyalists
70907,1232,3,"182,7",2,1,1,4,Low-Value,Can't Lose
70908,741,2,"100,8",3,1,1,5,Low-Value,At Risk Customers
70910,372,2,"77,4",4,1,1,6,Mid-Value,Potential Loyalists
70913,1097,2,"231,65",2,1,1,4,Low-Value,Can't Lose
70915,32,5,"212,55",5,1,1,7,Mid-Value,Potential Loyalists
70917,531,7,"417,20000000000005",4,2,1,7,Mid-Value,Potential Loyalists
70918,1131,5,"272,65",2,1,1,4,Low-Value,Can't Lose
70919,1672,1,"55,7",1,1,1,3,Low-Value,Lost
70924,814,1,"11,75",3,1,1,5,Low-Value,At Risk Customers
70927,21,3,"147,25",5,1,1,7,Mid-Value,Potential Loyalists
70928,370,2,"379,6",4,1,1,6,Mid-Value,Potential Loyalists
70929,774,8,"531,3",3,2,1,6,Mid-Value,Potential Loyalists
70930,390,3,"131,25",4,1,1,6,Mid-Value,Potential Loyalists
70931,379,1,"25,0",4,1,1,6,Mid-Value,Potential Loyalists
70932,229,8,"494,79999999999995",5,2,1,8,High-Value,Potential Loyalists
70933,229,6,"317,55",5,1,1,7,Mid-Value,Potential Loyalists
70935,600,2,"59,0",4,1,1,6,Mid-Value,Potential Loyalists
70936,781,1,"13,2",3,1,1,5,Low-Value,At Risk Customers
70938,158,3,"149,75",5,1,1,7,Mid-Value,Potential Loyalists
70940,210,5,"221,7",5,1,1,7,Mid-Value,Potential Loyalists
70941,1761,1,"12,1",1,1,1,3,Low-Value,Lost
70945,607,3,"182,2",4,1,1,6,Mid-Value,Potential Loyalists
70948,1078,4,"238,8",3,1,1,5,Low-Value,At Risk Customers
70950,933,1,"34,2",3,1,1,5,Low-Value,At Risk Customers
70951,126,3,"232,95000000000002",5,1,1,7,Mid-Value,Potential Loyalists
70952,46,5,"247,65",5,1,1,7,Mid-Value,Potential Loyalists
70953,697,4,"459,5",4,1,1,6,Mid-Value,Potential Loyalists
70954,23,5,"331,35",5,1,1,7,Mid-Value,Potential Loyalists
70955,242,2,"42,5",5,1,1,7,Mid-Value,Potential Loyalists
70956,232,3,"192,70000000000002",5,1,1,7,Mid-Value,Potential Loyalists
70958,144,1,"104,1",5,1,1,7,Mid-Value,Potential Loyalists
70959,1609,5,"194,1",1,1,1,3,Low-Value,Lost
70961,1409,1,"71,9",2,1,1,4,Low-Value,Can't Lose
70962,431,4,"225,7",4,1,1,6,Mid-Value,Potential Loyalists
70965,1358,3,"86,9",2,1,1,4,Low-Value,Can't Lose
70967,1109,3,"133,5",2,1,1,4,Low-Value,Can't Lose
70971,425,2,"126,0",4,1,1,6,Mid-Value,Potential Loyalists
70973,274,2,"99,89999999999999",5,1,1,7,Mid-Value,Potential Loyalists
70974,140,10,"707,25",5,2,2,9,High-Value,Champions
70975,1045,2,"113,75",3,1,1,5,Low-Value,At Risk Customers
70976,9,6,"531,8",5,1,1,7,Mid-Value,Potential Loyalists
70977,84,11,"1192,8",5,2,2,9,High-Value,Champions
70978,440,3,"76,6",4,1,1,6,Mid-Value,Potential Loyalists
70980,526,1,"141,0",4,1,1,6,Mid-Value,Potential Loyalists
70983,841,1,"90,75",3,1,1,5,Low-Value,At Risk Customers
70989,439,3,"186,55",4,1,1,6,Mid-Value,Potential Loyalists
70990,26,6,"496,4",5,1,1,7,Mid-Value,Potential Loyalists
70991,876,6,"263,0",3,1,1,5,Low-Value,At Risk Customers
70994,11,2,"417,75",5,1,1,7,Mid-Value,Potential Loyalists
70996,762,1,"72,4",3,1,1,5,Low-Value,At Risk Customers
70998,3,2,"34,45",5,1,1,7,Mid-Value,Potential Loyalists
71003,1156,1,"30,15",2,1,1,4,Low-Value,Can't Lose
71007,347,1,"51,65",5,1,1,7,Mid-Value,Potential Loyalists
71008,9,2,"190,15",5,1,1,7,Mid-Value,Potential Loyalists
71011,178,2,"219,15",5,1,1,7,Mid-Value,Potential Loyalists
71014,1505,1,"26,6",1,1,1,3,Low-Value,Lost
71015,687,9,"473,15",4,2,1,7,Mid-Value,Potential Loyalists
71016,258,1,"85,4",5,1,1,7,Mid-Value,Potential Loyalists
71018,188,1,"110,10000000000001",5,1,1,7,Mid-Value,Potential Loyalists
71019,820,3,"223,7",3,1,1,5,Low-Value,At Risk Customers
71020,339,3,"140,10000000000002",5,1,1,7,Mid-Value,Potential Loyalists
71023,8,2,"399,8",5,1,1,7,Mid-Value,Potential Loyalists
71024,424,3,"73,65",4,1,1,6,Mid-Value,Potential Loyalists
71026,416,2,"35,8",4,1,1,6,Mid-Value,Potential Loyalists
71028,732,1,"22,7",3,1,1,5,Low-Value,At Risk Customers
71029,1292,2,"119,9",2,1,1,4,Low-Value,Can't Lose
71030,596,1,"19,45",4,1,1,6,Mid-Value,Potential Loyalists
71033,1150,1,"61,8",2,1,1,4,Low-Value,Can't Lose
71035,439,4,"256,1",4,1,1,6,Mid-Value,Potential Loyalists
71037,1394,1,"30,25",2,1,1,4,Low-Value,Can't Lose
71038,444,8,"213,34999999999997",4,2,1,7,Mid-Value,Potential Loyalists
71039,454,1,"7,35",4,1,1,6,Mid-Value,Potential Loyalists
71040,43,4,"114,4",5,1,1,7,Mid-Value,Potential Loyalists
71044,127,3,"218,10000000000002",5,1,1,7,Mid-Value,Potential Loyalists
71045,210,4,"287,0",5,1,1,7,Mid-Value,Potential Loyalists
71046,974,1,"29,25",3,1,1,5,Low-Value,At Risk Customers
71050,35,5,"159,25",5,1,1,7,Mid-Value,Potential Loyalists
71053,911,4,"570,1999999999999",3,1,1,5,Low-Value,At Risk Customers
71054,16,6,"336,15",5,1,1,7,Mid-Value,Potential Loyalists
71055,1466,1,"43,8",1,1,1,3,Low-Value,Lost
71058,716,3,"101,50000000000001",4,1,1,6,Mid-Value,Potential Loyalists
71061,41,2,"43,650000000000006",5,1,1,7,Mid-Value,Potential Loyalists
71062,199,5,"372,3",5,1,1,7,Mid-Value,Potential Loyalists
71064,727,1,"50,25",4,1,1,6,Mid-Value,Potential Loyalists
71065,1281,2,"63,650000000000006",2,1,1,4,Low-Value,Can't Lose
71068,914,2,"33,45",3,1,1,5,Low-Value,At Risk Customers
71069,57,14,"900,5",5,3,2,10,High-Value,Champions
71070,560,2,"88,2",4,1,1,6,Mid-Value,Potential Loyalists
71071,512,3,"106,4",4,1,1,6,Mid-Value,Potential Loyalists
71072,586,1,"17,85",4,1,1,6,Mid-Value,Potential Loyalists
71073,125,5,"589,9",5,1,1,7,Mid-Value,Potential Loyalists
71074,1142,3,"249,1",2,1,1,4,Low-Value,Can't Lose
71076,861,2,"421,09999999999997",3,1,1,5,Low-Value,At Risk Customers
71077,223,1,"238,3",5,1,1,7,Mid-Value,Potential Loyalists
71078,843,2,"66,55",3,1,1,5,Low-Value,At Risk Customers
71079,89,4,"302,35",5,1,1,7,Mid-Value,Potential Loyalists
71082,561,1,"45,8",4,1,1,6,Mid-Value,Potential Loyalists
71083,52,2,"42,3",5,1,1,7,Mid-Value,Potential Loyalists
71084,297,1,"97,95",5,1,1,7,Mid-Value,Potential Loyalists
71085,1,12,"861,25",5,3,2,10,High-Value,Champions
71088,1116,1,"45,3",2,1,1,4,Low-Value,Can't Lose
71089,338,2,"47,2",5,1,1,7,Mid-Value,Potential Loyalists
71091,961,5,"388,6",3,1,1,5,Low-Value,At Risk Customers
71092,898,3,"190,1",3,1,1,5,Low-Value,At Risk Customers
71093,5,2,"73,7",5,1,1,7,Mid-Value,Potential Loyalists
71095,503,2,"25,0",4,1,1,6,Mid-Value,Potential Loyalists
71097,1049,1,"9,4",3,1,1,5,Low-Value,At Risk Customers
71098,1147,2,"29,45",2,1,1,4,Low-Value,Can't Lose
71099,20,1,"73,3",5,1,1,7,Mid-Value,Potential Loyalists
71100,1341,1,"8,75",2,1,1,4,Low-Value,Can't Lose
71102,913,6,"204,2",3,1,1,5,Low-Value,At Risk Customers
71106,245,8,"627,5",5,2,1,8,High-Value,Potential Loyalists
71108,504,4,"47,75",4,1,1,6,Mid-Value,Potential Loyalists
71109,1103,1,"110,5",2,1,1,4,Low-Value,Can't Lose
71110,1447,2,"61,6",2,1,1,4,Low-Value,Can't Lose
71112,1349,1,"28,7",2,1,1,4,Low-Value,Can't Lose
71115,73,2,"58,85",5,1,1,7,Mid-Value,Potential Loyalists
71116,897,3,"221,45",3,1,1,5,Low-Value,At Risk Customers
71118,1627,2,"49,599999999999994",1,1,1,3,Low-Value,Lost
71119,780,1,"17,5",3,1,1,5,Low-Value,At Risk Customers
71122,1310,2,"18,45",2,1,1,4,Low-Value,Can't Lose
71123,226,5,"102,9",5,1,1,7,Mid-Value,Potential Loyalists
71125,922,2,"106,15",3,1,1,5,Low-Value,At Risk Customers
71129,27,7,"467,95",5,2,1,8,High-Value,Potential Loyalists
71131,86,3,"204,7",5,1,1,7,Mid-Value,Potential Loyalists
71132,691,2,"126,0",4,1,1,6,Mid-Value,Potential Loyalists
71133,212,6,"416,6",5,1,1,7,Mid-Value,Potential Loyalists
71135,560,4,"206,05",4,1,1,6,Mid-Value,Potential Loyalists
71137,1629,1,"115,7",1,1,1,3,Low-Value,Lost
71138,71,3,"53,55",5,1,1,7,Mid-Value,Potential Loyalists
71140,755,1,"10,7",3,1,1,5,Low-Value,At Risk Customers
71141,423,6,"272,25",4,1,1,6,Mid-Value,Potential Loyalists
71142,1624,2,"116,1",1,1,1,3,Low-Value,Lost
71143,79,3,"75,0",5,1,1,7,Mid-Value,Potential Loyalists
71144,844,5,"424,54999999999995",3,1,1,5,Low-Value,At Risk Customers
71145,1464,1,"22,1",1,1,1,3,Low-Value,Lost
71146,89,7,"451,65",5,2,1,8,High-Value,Potential Loyalists
71148,678,1,"10,0",4,1,1,6,Mid-Value,Potential Loyalists
71149,48,11,"999,3",5,2,2,9,High-Value,Champions
71150,1370,1,"7,5",2,1,1,4,Low-Value,Can't Lose
71151,642,7,"425,55",4,2,1,7,Mid-Value,Potential Loyalists
71153,841,2,"56,6",3,1,1,5,Low-Value,At Risk Customers
71155,549,1,"55,7",4,1,1,6,Mid-Value,Potential Loyalists
71156,1167,1,"125,65",2,1,1,4,Low-Value,Can't Lose
71157,81,9,"956,2",5,2,2,9,High-Value,Champions
71158,237,2,"155,10000000000002",5,1,1,7,Mid-Value,Potential Loyalists
71159,670,1,"50,15",4,1,1,6,Mid-Value,Potential Loyalists
71161,127,2,"62,8",5,1,1,7,Mid-Value,Potential Loyalists
71163,168,6,"432,75",5,1,1,7,Mid-Value,Potential Loyalists
71169,242,4,"85,19999999999999",5,1,1,7,Mid-Value,Potential Loyalists
71170,41,8,"344,25",5,2,1,8,High-Value,Potential Loyalists
71171,360,5,"358,05",5,1,1,7,Mid-Value,Potential Loyalists
71172,772,2,"193,8",3,1,1,5,Low-Value,At Risk Customers
71173,830,1,"18,9",3,1,1,5,Low-Value,At Risk Customers
71176,456,5,"324,9",4,1,1,6,Mid-Value,Potential Loyalists
71177,1604,2,"83,55",1,1,1,3,Low-Value,Lost
71179,336,5,"165,1",5,1,1,7,Mid-Value,Potential Loyalists
71180,283,1,"13,9",5,1,1,7,Mid-Value,Potential Loyalists
71181,20,9,"1388,95",5,2,3,10,High-Value,Champions
71182,686,2,"81,95",4,1,1,6,Mid-Value,Potential Loyalists
71184,447,6,"921,65",4,1,2,7,Mid-Value,Potential Loyalists
71185,672,5,"210,15",4,1,1,6,Mid-Value,Potential Loyalists
71186,38,7,"451,8",5,2,1,8,High-Value,Potential Loyalists
71187,1191,1,"61,0",2,1,1,4,Low-Value,Can't Lose
71190,827,2,"46,25",3,1,1,5,Low-Value,At Risk Customers
71192,406,2,"65,45",4,1,1,6,Mid-Value,Potential Loyalists
71194,73,3,"216,5",5,1,1,7,Mid-Value,Potential Loyalists
71195,473,8,"1179,85",4,2,2,8,High-Value,Potential Loyalists
71197,998,1,"10,5",3,1,1,5,Low-Value,At Risk Customers
71198,3,3,"159,85",5,1,1,7,Mid-Value,Potential Loyalists
71201,872,4,"473,00000000000006",3,1,1,5,Low-Value,At Risk Customers
71202,257,1,"56,95",5,1,1,7,Mid-Value,Potential Loyalists
71203,1721,1,"41,6",1,1,1,3,Low-Value,Lost
71206,80,4,"147,0",5,1,1,7,Mid-Value,Potential Loyalists
71207,1240,3,"104,2",2,1,1,4,Low-Value,Can't Lose
71211,499,1,"19,9",4,1,1,6,Mid-Value,Potential Loyalists
71212,302,2,"78,1",5,1,1,7,Mid-Value,Potential Loyalists
71215,233,6,"483,25",5,1,1,7,Mid-Value,Potential Loyalists
71222,754,8,"494,5",3,2,1,6,Mid-Value,Potential Loyalists
71223,27,2,"63,4",5,1,1,7,Mid-Value,Potential Loyalists
71224,1643,2,"66,85",1,1,1,3,Low-Value,Lost
71225,537,2,"144,5",4,1,1,6,Mid-Value,Potential Loyalists
71226,368,6,"324,6",4,1,1,6,Mid-Value,Potential Loyalists
71227,1586,2,"49,95",1,1,1,3,Low-Value,Lost
71228,115,6,"489,1",5,1,1,7,Mid-Value,Potential Loyalists
71231,26,4,"310,7",5,1,1,7,Mid-Value,Potential Loyalists
71232,232,5,"303,15",5,1,1,7,Mid-Value,Potential Loyalists
71233,21,10,"709,45",5,2,2,9,High-Value,Champions
71234,153,5,"366,55",5,1,1,7,Mid-Value,Potential Loyalists
71235,516,2,"70,85",4,1,1,6,Mid-Value,Potential Loyalists
71236,320,1,"24,3",5,1,1,7,Mid-Value,Potential Loyalists
71237,1519,1,"236,9",1,1,1,3,Low-Value,Lost
71239,183,3,"217,95",5,1,1,7,Mid-Value,Potential Loyalists
71243,218,3,"237,10000000000002",5,1,1,7,Mid-Value,Potential Loyalists
71244,548,2,"288,05",4,1,1,6,Mid-Value,Potential Loyalists
71245,159,2,"106,5",5,1,1,7,Mid-Value,Potential Loyalists
71246,91,10,"435,85",5,2,1,8,High-Value,Potential Loyalists
71248,463,3,"202,40000000000003",4,1,1,6,Mid-Value,Potential Loyalists
71249,67,4,"162,1",5,1,1,7,Mid-Value,Potential Loyalists
71250,765,2,"162,2",3,1,1,5,Low-Value,At Risk Customers
71252,132,4,"171,3",5,1,1,7,Mid-Value,Potential Loyalists
71253,134,3,"96,0",5,1,1,7,Mid-Value,Potential Loyalists
71255,351,12,"1287,21",5,3,2,10,High-Value,Champions
71256,39,4,"351,65",5,1,1,7,Mid-Value,Potential Loyalists
71258,859,4,"188,60000000000002",3,1,1,5,Low-Value,At Risk Customers
71260,298,3,"134,85",5,1,1,7,Mid-Value,Potential Loyalists
71263,676,1,"22,65",4,1,1,6,Mid-Value,Potential Loyalists
71264,12,12,"1448,25",5,3,3,11,High-Value,Champions
71267,781,6,"239,7",3,1,1,5,Low-Value,At Risk Customers
71269,27,4,"265,4",5,1,1,7,Mid-Value,Potential Loyalists
71270,157,4,"129,89999999999998",5,1,1,7,Mid-Value,Potential Loyalists
71271,558,3,"229,14999999999998",4,1,1,6,Mid-Value,Potential Loyalists
71274,486,2,"152,7",4,1,1,6,Mid-Value,Potential Loyalists
71277,1593,1,"70,3",1,1,1,3,Low-Value,Lost
71278,118,5,"415,55",5,1,1,7,Mid-Value,Potential Loyalists
71279,626,1,"61,3",4,1,1,6,Mid-Value,Potential Loyalists
71280,498,7,"966,75",4,2,2,8,High-Value,Potential Loyalists
71281,715,2,"24,6",4,1,1,6,Mid-Value,Potential Loyalists
71283,793,9,"582,75",3,2,1,6,Mid-Value,Potential Loyalists
71284,20,7,"369,3",5,2,1,8,High-Value,Potential Loyalists
71286,537,2,"26,9",4,1,1,6,Mid-Value,Potential Loyalists
71287,460,8,"315,8",4,2,1,7,Mid-Value,Potential Loyalists
71289,807,6,"168,85",3,1,1,5,Low-Value,At Risk Customers
71291,440,2,"57,4",4,1,1,6,Mid-Value,Potential Loyalists
71292,757,9,"580,6",3,2,1,6,Mid-Value,Potential Loyalists
71294,1605,1,"37,95",1,1,1,3,Low-Value,Lost
71296,103,4,"187,45",5,1,1,7,Mid-Value,Potential Loyalists
71298,155,2,"81,1",5,1,1,7,Mid-Value,Potential Loyalists
71302,85,5,"192,8",5,1,1,7,Mid-Value,Potential Loyalists
71306,612,1,"27,8",4,1,1,6,Mid-Value,Potential Loyalists
71307,599,1,"27,3",4,1,1,6,Mid-Value,Potential Loyalists
71308,10,3,"174,64999999999998",5,1,1,7,Mid-Value,Potential Loyalists
71314,733,4,"371,75",3,1,1,5,Low-Value,At Risk Customers
71315,274,2,"58,35",5,1,1,7,Mid-Value,Potential Loyalists
71316,73,3,"202,35",5,1,1,7,Mid-Value,Potential Loyalists
71318,885,1,"361,5",3,1,1,5,Low-Value,At Risk Customers
71321,54,2,"57,1",5,1,1,7,Mid-Value,Potential Loyalists
71325,32,2,"29,450000000000003",5,1,1,7,Mid-Value,Potential Loyalists
71326,100,4,"315,8",5,1,1,7,Mid-Value,Potential Loyalists
71327,60,7,"193,35",5,2,1,8,High-Value,Potential Loyalists
71328,539,1,"102,3",4,1,1,6,Mid-Value,Potential Loyalists
71331,1371,1,"71,6",2,1,1,4,Low-Value,Can't Lose
71332,966,1,"39,2",3,1,1,5,Low-Value,At Risk Customers
71336,245,1,"233,2",5,1,1,7,Mid-Value,Potential Loyalists
71337,95,5,"169,75",5,1,1,7,Mid-Value,Potential Loyalists
71338,379,1,"202,4",4,1,1,6,Mid-Value,Potential Loyalists
71340,39,8,"649,3000000000001",5,2,1,8,High-Value,Potential Loyalists
71342,735,6,"354,65",3,1,1,5,Low-Value,At Risk Customers
71343,752,5,"609,6",3,1,1,5,Low-Value,At Risk Customers
71345,859,1,"20,5",3,1,1,5,Low-Value,At Risk Customers
71348,348,4,"175,54999999999998",5,1,1,7,Mid-Value,Potential Loyalists
71351,132,2,"75,9",5,1,1,7,Mid-Value,Potential Loyalists
71352,143,1,"155,5",5,1,1,7,Mid-Value,Potential Loyalists
71354,972,1,"49,75",3,1,1,5,Low-Value,At Risk Customers
71355,1097,1,"158,0",2,1,1,4,Low-Value,Can't Lose
71356,166,4,"204,64999999999998",5,1,1,7,Mid-Value,Potential Loyalists
71357,1362,1,"9,5",2,1,1,4,Low-Value,Can't Lose
71361,131,3,"137,45000000000002",5,1,1,7,Mid-Value,Potential Loyalists
71364,208,6,"341,55",5,1,1,7,Mid-Value,Potential Loyalists
71365,1015,1,"55,2",3,1,1,5,Low-Value,At Risk Customers
71366,7,7,"650,35",5,2,1,8,High-Value,Potential Loyalists
71367,233,5,"305,5",5,1,1,7,Mid-Value,Potential Loyalists
71368,1300,1,"85,5",2,1,1,4,Low-Value,Can't Lose
71369,70,2,"20,8",5,1,1,7,Mid-Value,Potential Loyalists
71371,18,1,"39,6",5,1,1,7,Mid-Value,Potential Loyalists
71372,819,3,"46,5",3,1,1,5,Low-Value,At Risk Customers
71376,945,2,"86,05",3,1,1,5,Low-Value,At Risk Customers
71377,619,5,"281,2",4,1,1,6,Mid-Value,Potential Loyalists
71379,740,7,"1005,3",3,2,2,7,Mid-Value,Potential Loyalists
71380,1310,2,"45,449999999999996",2,1,1,4,Low-Value,Can't Lose
71381,242,3,"282,2",5,1,1,7,Mid-Value,Potential Loyalists
71382,5,5,"293,5",5,1,1,7,Mid-Value,Potential Loyalists
71383,822,6,"375,35",3,1,1,5,Low-Value,At Risk Customers
71385,416,3,"25,65",4,1,1,6,Mid-Value,Potential Loyalists
71386,1331,1,"46,5",2,1,1,4,Low-Value,Can't Lose
71387,168,11,"383,1",5,2,1,8,High-Value,Potential Loyalists
71388,480,1,"12,25",4,1,1,6,Mid-Value,Potential Loyalists
71389,725,2,"100,6",4,1,1,6,Mid-Value,Potential Loyalists
71391,402,4,"96,15",4,1,1,6,Mid-Value,Potential Loyalists
71393,499,3,"347,5",4,1,1,6,Mid-Value,Potential Loyalists
71394,38,3,"378,15000000000003",5,1,1,7,Mid-Value,Potential Loyalists
71395,26,6,"386,3",5,1,1,7,Mid-Value,Potential Loyalists
71397,64,4,"196,4",5,1,1,7,Mid-Value,Potential Loyalists
71398,739,5,"399,25",3,1,1,5,Low-Value,At Risk Customers
71399,341,2,"86,75",5,1,1,7,Mid-Value,Potential Loyalists
71401,363,8,"248,1",5,2,1,8,High-Value,Potential Loyalists
71403,120,1,"17,0",5,1,1,7,Mid-Value,Potential Loyalists
71404,11,2,"97,19999999999999",5,1,1,7,Mid-Value,Potential Loyalists
71406,200,2,"44,75",5,1,1,7,Mid-Value,Potential Loyalists
71407,43,6,"454,4",5,1,1,7,Mid-Value,Potential Loyalists
71410,211,3,"139,1",5,1,1,7,Mid-Value,Potential Loyalists
71412,83,4,"128,70000000000002",5,1,1,7,Mid-Value,Potential Loyalists
71413,38,10,"357,05",5,2,1,8,High-Value,Potential Loyalists
71416,682,1,"14,35",4,1,1,6,Mid-Value,Potential Loyalists
71417,643,6,"431,6",4,1,1,6,Mid-Value,Potential Loyalists
71418,381,5,"219,1",4,1,1,6,Mid-Value,Potential Loyalists
71421,861,7,"357,0",3,2,1,6,Mid-Value,Potential Loyalists
71422,1137,3,"123,75",2,1,1,4,Low-Value,Can't Lose
71423,29,3,"89,5",5,1,1,7,Mid-Value,Potential Loyalists
71424,81,1,"61,15",5,1,1,7,Mid-Value,Potential Loyalists
71425,501,5,"557,95",4,1,1,6,Mid-Value,Potential Loyalists
71426,776,5,"264,45",3,1,1,5,Low-Value,At Risk Customers
71427,1042,1,"182,0",3,1,1,5,Low-Value,At Risk Customers
71428,1218,2,"108,0",2,1,1,4,Low-Value,Can't Lose
71429,40,3,"258,84999999999997",5,1,1,7,Mid-Value,Potential Loyalists
71430,1523,1,"15,8",1,1,1,3,Low-Value,Lost
71431,1529,1,"22,95",1,1,1,3,Low-Value,Lost
71433,234,3,"208,5",5,1,1,7,Mid-Value,Potential Loyalists
71436,14,5,"414,59999999999997",5,1,1,7,Mid-Value,Potential Loyalists
71437,25,4,"139,1",5,1,1,7,Mid-Value,Potential Loyalists
71438,261,1,"23,75",5,1,1,7,Mid-Value,Potential Loyalists
71440,26,10,"495,75",5,2,1,8,High-Value,Potential Loyalists
71442,1238,1,"37,4",2,1,1,4,Low-Value,Can't Lose
71443,760,3,"364,85",3,1,1,5,Low-Value,At Risk Customers
71444,239,7,"172,9",5,2,1,8,High-Value,Potential Loyalists
71445,59,2,"254,85",5,1,1,7,Mid-Value,Potential Loyalists
71446,45,2,"17,9",5,1,1,7,Mid-Value,Potential Loyalists
71447,1213,2,"36,650000000000006",2,1,1,4,Low-Value,Can't Lose
71448,1562,1,"199,0",1,1,1,3,Low-Value,Lost
71451,480,9,"484,1",4,2,1,7,Mid-Value,Potential Loyalists
71452,1670,1,"51,4",1,1,1,3,Low-Value,Lost
71453,1482,1,"147,7",1,1,1,3,Low-Value,Lost
71454,560,7,"292,05",4,2,1,7,Mid-Value,Potential Loyalists
71455,190,2,"72,25",5,1,1,7,Mid-Value,Potential Loyalists
71456,913,1,"175,2",3,1,1,5,Low-Value,At Risk Customers
71457,109,2,"110,15",5,1,1,7,Mid-Value,Potential Loyalists
71461,753,2,"26,1",3,1,1,5,Low-Value,At Risk Customers
71462,883,2,"75,55000000000001",3,1,1,5,Low-Value,At Risk Customers
71464,59,2,"68,9",5,1,1,7,Mid-Value,Potential Loyalists
71465,25,3,"326,25",5,1,1,7,Mid-Value,Potential Loyalists
71466,528,2,"138,89999999999998",4,1,1,6,Mid-Value,Potential Loyalists
71467,696,1,"5,9",4,1,1,6,Mid-Value,Potential Loyalists
71468,1295,1,"101,1",2,1,1,4,Low-Value,Can't Lose
71470,1279,1,"54,2",2,1,1,4,Low-Value,Can't Lose
71475,83,7,"1300,5",5,2,2,9,High-Value,Champions
71476,112,2,"15,3",5,1,1,7,Mid-Value,Potential Loyalists
71481,34,11,"695,0",5,2,2,9,High-Value,Champions
71482,1470,3,"723,1",1,1,2,4,Low-Value,Can't Lose
71483,84,2,"69,0",5,1,1,7,Mid-Value,Potential Loyalists
71485,751,2,"70,64999999999999",3,1,1,5,Low-Value,At Risk Customers
71488,732,5,"280,8",3,1,1,5,Low-Value,At Risk Customers
71490,121,5,"303,75",5,1,1,7,Mid-Value,Potential Loyalists
71492,490,2,"481,25",4,1,1,6,Mid-Value,Potential Loyalists
71493,276,2,"37,75",5,1,1,7,Mid-Value,Potential Loyalists
71494,250,4,"211,15",5,1,1,7,Mid-Value,Potential Loyalists
71497,1439,3,"131,3",2,1,1,4,Low-Value,Can't Lose
71501,39,5,"139,6",5,1,1,7,Mid-Value,Potential Loyalists
71502,1382,1,"25,2",2,1,1,4,Low-Value,Can't Lose
71503,565,4,"230,9",4,1,1,6,Mid-Value,Potential Loyalists
71504,891,1,"38,2",3,1,1,5,Low-Value,At Risk Customers
71505,871,1,"18,1",3,1,1,5,Low-Value,At Risk Customers
71506,98,1,"77,85",5,1,1,7,Mid-Value,Potential Loyalists
71508,1553,2,"162,05",1,1,1,3,Low-Value,Lost
71510,291,4,"122,30000000000001",5,1,1,7,Mid-Value,Potential Loyalists
71511,97,8,"350,6",5,2,1,8,High-Value,Potential Loyalists
71513,1263,1,"3,1500000000000004",2,1,1,4,Low-Value,Can't Lose
71516,1678,2,"83,9",1,1,1,3,Low-Value,Lost
71517,26,4,"256,79999999999995",5,1,1,7,Mid-Value,Potential Loyalists
71518,145,5,"195,95",5,1,1,7,Mid-Value,Potential Loyalists
71521,791,5,"374,85",3,1,1,5,Low-Value,At Risk Customers
71522,678,3,"122,55",4,1,1,6,Mid-Value,Potential Loyalists
71523,182,2,"117,8",5,1,1,7,Mid-Value,Potential Loyalists
71524,575,4,"297,7",4,1,1,6,Mid-Value,Potential Loyalists
71525,1486,2,"234,65",1,1,1,3,Low-Value,Lost
71526,380,1,"38,6",4,1,1,6,Mid-Value,Potential Loyalists
71527,40,2,"140,3",5,1,1,7,Mid-Value,Potential Loyalists
71529,27,1,"20,6",5,1,1,7,Mid-Value,Potential Loyalists
71531,104,2,"78,55",5,1,1,7,Mid-Value,Potential Loyalists
71532,5,2,"24,5",5,1,1,7,Mid-Value,Potential Loyalists
71535,88,4,"315,7",5,1,1,7,Mid-Value,Potential Loyalists
71537,321,2,"58,699999999999996",5,1,1,7,Mid-Value,Potential Loyalists
71538,379,8,"379,85",4,2,1,7,Mid-Value,Potential Loyalists
71540,135,3,"312,5",5,1,1,7,Mid-Value,Potential Loyalists
71541,1349,4,"214,0",2,1,1,4,Low-Value,Can't Lose
71543,379,1,"126,44999999999999",4,1,1,6,Mid-Value,Potential Loyalists
71545,1212,1,"66,5",2,1,1,4,Low-Value,Can't Lose
71547,1405,2,"15,9",2,1,1,4,Low-Value,Can't Lose
71551,287,2,"153,5",5,1,1,7,Mid-Value,Potential Loyalists
71553,809,2,"15,25",3,1,1,5,Low-Value,At Risk Customers
71554,703,7,"519,8499999999999",4,2,1,7,Mid-Value,Potential Loyalists
71555,1494,2,"159,89999999999998",1,1,1,3,Low-Value,Lost
71557,181,5,"116,19999999999999",5,1,1,7,Mid-Value,Potential Loyalists
71558,44,4,"232,45",5,1,1,7,Mid-Value,Potential Loyalists
71563,452,5,"433,69999999999993",4,1,1,6,Mid-Value,Potential Loyalists
71567,323,2,"91,15",5,1,1,7,Mid-Value,Potential Loyalists
71568,1392,2,"84,0",2,1,1,4,Low-Value,Can't Lose
71570,981,1,"24,85",3,1,1,5,Low-Value,At Risk Customers
71572,428,2,"57,75",4,1,1,6,Mid-Value,Potential Loyalists
71574,623,3,"51,7",4,1,1,6,Mid-Value,Potential Loyalists
71575,173,6,"594,85",5,1,1,7,Mid-Value,Potential Loyalists
71577,1194,1,"37,5",2,1,1,4,Low-Value,Can't Lose
71579,222,1,"45,6",5,1,1,7,Mid-Value,Potential Loyalists
71580,20,4,"60,4",5,1,1,7,Mid-Value,Potential Loyalists
71581,248,1,"97,85",5,1,1,7,Mid-Value,Potential Loyalists
71582,427,2,"53,0",4,1,1,6,Mid-Value,Potential Loyalists
71584,408,10,"494,5",4,2,1,7,Mid-Value,Potential Loyalists
71585,564,3,"224,8",4,1,1,6,Mid-Value,Potential Loyalists
71586,439,3,"87,9",4,1,1,6,Mid-Value,Potential Loyalists
71588,379,4,"164,64999999999998",4,1,1,6,Mid-Value,Potential Loyalists
71589,968,1,"21,45",3,1,1,5,Low-Value,At Risk Customers
71590,514,1,"146,10000000000002",4,1,1,6,Mid-Value,Potential Loyalists
71591,424,4,"115,9",4,1,1,6,Mid-Value,Potential Loyalists
71592,517,1,"39,0",4,1,1,6,Mid-Value,Potential Loyalists
71594,1438,1,"56,95",2,1,1,4,Low-Value,Can't Lose
71599,160,3,"94,1",5,1,1,7,Mid-Value,Potential Loyalists
71601,719,1,"32,5",4,1,1,6,Mid-Value,Potential Loyalists
71603,1708,1,"110,39999999999999",1,1,1,3,Low-Value,Lost
71604,367,4,"137,25",4,1,1,6,Mid-Value,Potential Loyalists
71605,53,9,"667,8",5,2,2,9,High-Value,Champions
71607,755,2,"136,70000000000002",3,1,1,5,Low-Value,At Risk Customers
71608,124,2,"41,2",5,1,1,7,Mid-Value,Potential Loyalists
71609,541,4,"184,35",4,1,1,6,Mid-Value,Potential Loyalists
71610,424,4,"245,85",4,1,1,6,Mid-Value,Potential Loyalists
71613,238,2,"33,45",5,1,1,7,Mid-Value,Potential Loyalists
71614,1180,2,"188,45000000000002",2,1,1,4,Low-Value,Can't Lose
71615,29,6,"215,95",5,1,1,7,Mid-Value,Potential Loyalists
71616,1523,3,"98,55000000000001",1,1,1,3,Low-Value,Lost
71617,185,8,"289,34999999999997",5,2,1,8,High-Value,Potential Loyalists
71619,126,3,"247,10000000000002",5,1,1,7,Mid-Value,Potential Loyalists
71621,1223,1,"5,4",2,1,1,4,Low-Value,Can't Lose
71623,1344,1,"94,19999999999999",2,1,1,4,Low-Value,Can't Lose
71624,124,4,"140,75",5,1,1,7,Mid-Value,Potential Loyalists
71625,198,5,"259,3",5,1,1,7,Mid-Value,Potential Loyalists
71629,1288,2,"72,35",2,1,1,4,Low-Value,Can't Lose
71631,369,1,"630,3",4,1,1,6,Mid-Value,Potential Loyalists
71632,559,6,"596,15",4,1,1,6,Mid-Value,Potential Loyalists
71634,221,3,"75,1",5,1,1,7,Mid-Value,Potential Loyalists
71638,237,2,"54,0",5,1,1,7,Mid-Value,Potential Loyalists
71639,337,5,"266,09999999999997",5,1,1,7,Mid-Value,Potential Loyalists
71641,27,7,"380,15",5,2,1,8,High-Value,Potential Loyalists
71642,509,3,"251,25",4,1,1,6,Mid-Value,Potential Loyalists
71643,1,4,"185,2",5,1,1,7,Mid-Value,Potential Loyalists
71644,566,2,"162,65",4,1,1,6,Mid-Value,Potential Loyalists
71645,49,7,"419,1",5,2,1,8,High-Value,Potential Loyalists
71646,400,6,"112,35",4,1,1,6,Mid-Value,Potential Loyalists
71651,395,2,"142,75",4,1,1,6,Mid-Value,Potential Loyalists
71652,1599,1,"136,25",1,1,1,3,Low-Value,Lost
71653,1299,1,"46,5",2,1,1,4,Low-Value,Can't Lose
71656,271,1,"291,0",5,1,1,7,Mid-Value,Potential Loyalists
71658,110,4,"590,7",5,1,1,7,Mid-Value,Potential Loyalists
71659,345,4,"244,45",5,1,1,7,Mid-Value,Potential Loyalists
71660,502,4,"205,25",4,1,1,6,Mid-Value,Potential Loyalists
71662,738,5,"434,25",3,1,1,5,Low-Value,At Risk Customers
71663,520,2,"208,9",4,1,1,6,Mid-Value,Potential Loyalists
71667,1338,1,"84,9",2,1,1,4,Low-Value,Can't Lose
71668,1040,1,"105,55",3,1,1,5,Low-Value,At Risk Customers
71669,315,4,"460,2",5,1,1,7,Mid-Value,Potential Loyalists
71671,381,4,"69,4",4,1,1,6,Mid-Value,Potential Loyalists
71676,846,1,"72,6",3,1,1,5,Low-Value,At Risk Customers
71678,411,2,"124,9",4,1,1,6,Mid-Value,Potential Loyalists
71679,187,7,"512,1",5,2,1,8,High-Value,Potential Loyalists
71680,811,2,"25,3",3,1,1,5,Low-Value,At Risk Customers
71681,432,1,"43,4",4,1,1,6,Mid-Value,Potential Loyalists
71683,383,6,"844,6",4,1,2,7,Mid-Value,Potential Loyalists
71686,1389,1,"78,5",2,1,1,4,Low-Value,Can't Lose
71687,1546,3,"148,55",1,1,1,3,Low-Value,Lost
71694,633,7,"397,9",4,2,1,7,Mid-Value,Potential Loyalists
71695,1329,1,"7,2",2,1,1,4,Low-Value,Can't Lose
71698,753,1,"250,5",3,1,1,5,Low-Value,At Risk Customers
71699,375,3,"219,8",4,1,1,6,Mid-Value,Potential Loyalists
71703,912,2,"203,5",3,1,1,5,Low-Value,At Risk Customers
71704,187,1,"271,0",5,1,1,7,Mid-Value,Potential Loyalists
71705,241,6,"263,85",5,1,1,7,Mid-Value,Potential Loyalists
71707,711,1,"32,1",4,1,1,6,Mid-Value,Potential Loyalists
71708,738,7,"449,65",3,2,1,6,Mid-Value,Potential Loyalists
71710,774,4,"303,8",3,1,1,5,Low-Value,At Risk Customers
71713,169,1,"15,4",5,1,1,7,Mid-Value,Potential Loyalists
71716,700,1,"33,15",4,1,1,6,Mid-Value,Potential Loyalists
71718,1151,1,"217,0",2,1,1,4,Low-Value,Can't Lose
71719,208,1,"23,8",5,1,1,7,Mid-Value,Potential Loyalists
71723,732,2,"96,6",3,1,1,5,Low-Value,At Risk Customers
71724,637,3,"1263,55",4,1,2,7,Mid-Value,Potential Loyalists
71727,223,7,"368,65",5,2,1,8,High-Value,Potential Loyalists
71729,207,2,"62,1",5,1,1,7,Mid-Value,Potential Loyalists
71731,468,2,"70,6",4,1,1,6,Mid-Value,Potential Loyalists
71733,324,1,"318,0",5,1,1,7,Mid-Value,Potential Loyalists
71737,190,4,"79,25",5,1,1,7,Mid-Value,Potential Loyalists
71738,380,3,"217,64999999999998",4,1,1,6,Mid-Value,Potential Loyalists
71739,1279,3,"160,2",2,1,1,4,Low-Value,Can't Lose
71742,430,4,"28,6",4,1,1,6,Mid-Value,Potential Loyalists
71744,371,2,"110,65",4,1,1,6,Mid-Value,Potential Loyalists
71745,342,2,"124,9",5,1,1,7,Mid-Value,Potential Loyalists
71746,148,5,"313,95",5,1,1,7,Mid-Value,Potential Loyalists
71747,21,9,"653,3000000000001",5,2,1,8,High-Value,Potential Loyalists
71749,1158,1,"28,0",2,1,1,4,Low-Value,Can't Lose
71753,107,3,"284,04999999999995",5,1,1,7,Mid-Value,Potential Loyalists
71754,115,8,"530,15",5,2,1,8,High-Value,Potential Loyalists
71755,1286,1,"116,2",2,1,1,4,Low-Value,Can't Lose
71756,86,5,"678,9",5,1,2,8,High-Value,Potential Loyalists
71758,1187,1,"13,35",2,1,1,4,Low-Value,Can't Lose
71759,1617,1,"15,6",1,1,1,3,Low-Value,Lost
71761,156,1,"62,25",5,1,1,7,Mid-Value,Potential Loyalists
71763,396,4,"36,0",4,1,1,6,Mid-Value,Potential Loyalists
71767,379,4,"204,9",4,1,1,6,Mid-Value,Potential Loyalists
71768,730,1,"46,8",4,1,1,6,Mid-Value,Potential Loyalists
71771,414,1,"17,7",4,1,1,6,Mid-Value,Potential Loyalists
71773,57,4,"306,9",5,1,1,7,Mid-Value,Potential Loyalists
71774,7,3,"376,5",5,1,1,7,Mid-Value,Potential Loyalists
71777,281,1,"19,7",5,1,1,7,Mid-Value,Potential Loyalists
71778,229,8,"1404,9499999999998",5,2,3,10,High-Value,Champions
71780,702,1,"4,85",4,1,1,6,Mid-Value,Potential Loyalists
71782,1281,3,"189,4",2,1,1,4,Low-Value,Can't Lose
71784,232,5,"243,9",5,1,1,7,Mid-Value,Potential Loyalists
71785,157,8,"585,5",5,2,1,8,High-Value,Potential Loyalists
71787,201,3,"742,75",5,1,2,8,High-Value,Potential Loyalists
71790,243,4,"111,45",5,1,1,7,Mid-Value,Potential Loyalists
71791,248,5,"267,2",5,1,1,7,Mid-Value,Potential Loyalists
71792,1671,1,"82,9",1,1,1,3,Low-Value,Lost
71794,197,3,"211,64999999999998",5,1,1,7,Mid-Value,Potential Loyalists
71795,110,6,"352,0",5,1,1,7,Mid-Value,Potential Loyalists
71800,109,5,"330,9",5,1,1,7,Mid-Value,Potential Loyalists
71804,799,3,"76,8",3,1,1,5,Low-Value,At Risk Customers
71808,1110,1,"93,8",2,1,1,4,Low-Value,Can't Lose
71809,1099,2,"44,0",2,1,1,4,Low-Value,Can't Lose
71813,443,8,"354,0",4,2,1,7,Mid-Value,Potential Loyalists
71816,235,2,"118,35",5,1,1,7,Mid-Value,Potential Loyalists
71817,28,7,"500,04999999999995",5,2,1,8,High-Value,Potential Loyalists
71819,908,2,"243,39999999999998",3,1,1,5,Low-Value,At Risk Customers
71823,10,2,"350,3",5,1,1,7,Mid-Value,Potential Loyalists
71826,49,8,"418,35",5,2,1,8,High-Value,Potential Loyalists
71827,421,2,"74,75",4,1,1,6,Mid-Value,Potential Loyalists
71828,934,2,"41,650000000000006",3,1,1,5,Low-Value,At Risk Customers
71830,205,5,"225,15",5,1,1,7,Mid-Value,Potential Loyalists
71831,92,1,"49,45",5,1,1,7,Mid-Value,Potential Loyalists
71832,31,4,"205,8",5,1,1,7,Mid-Value,Potential Loyalists
71835,43,5,"345,55",5,1,1,7,Mid-Value,Potential Loyalists
71836,489,5,"255,85",4,1,1,6,Mid-Value,Potential Loyalists
71838,545,4,"204,35000000000002",4,1,1,6,Mid-Value,Potential Loyalists
71839,48,2,"445,7",5,1,1,7,Mid-Value,Potential Loyalists
71840,326,1,"100,1",5,1,1,7,Mid-Value,Potential Loyalists
71842,13,7,"1033,85",5,2,2,9,High-Value,Champions
71843,1097,1,"83,0",2,1,1,4,Low-Value,Can't Lose
71845,277,1,"30,75",5,1,1,7,Mid-Value,Potential Loyalists
71846,1562,2,"163,1",1,1,1,3,Low-Value,Lost
71847,157,4,"178,2",5,1,1,7,Mid-Value,Potential Loyalists
71848,201,4,"205,39999999999998",5,1,1,7,Mid-Value,Potential Loyalists
71850,551,2,"39,85",4,1,1,6,Mid-Value,Potential Loyalists
71852,292,1,"24,0",5,1,1,7,Mid-Value,Potential Loyalists
71853,113,2,"57,0",5,1,1,7,Mid-Value,Potential Loyalists
71854,848,3,"136,15",3,1,1,5,Low-Value,At Risk Customers
71855,331,1,"449,70000000000005",5,1,1,7,Mid-Value,Potential Loyalists
71856,5,8,"537,5",5,2,1,8,High-Value,Potential Loyalists
71858,13,5,"330,9",5,1,1,7,Mid-Value,Potential Loyalists
71859,11,4,"171,45",5,1,1,7,Mid-Value,Potential Loyalists
71863,741,4,"280,5",3,1,1,5,Low-Value,At Risk Customers
71864,780,1,"7,5",3,1,1,5,Low-Value,At Risk Customers
71866,137,1,"80,9",5,1,1,7,Mid-Value,Potential Loyalists
71867,1115,2,"121,60000000000001",2,1,1,4,Low-Value,Can't Lose
71870,1517,1,"3,3",1,1,1,3,Low-Value,Lost
71871,66,3,"34,1",5,1,1,7,Mid-Value,Potential Loyalists
71872,1621,1,"24,3",1,1,1,3,Low-Value,Lost
71874,451,3,"139,35",4,1,1,6,Mid-Value,Potential Loyalists
71876,1096,3,"88,55",2,1,1,4,Low-Value,Can't Lose
71877,976,1,"22,35",3,1,1,5,Low-Value,At Risk Customers
71878,396,9,"460,4",4,2,1,7,Mid-Value,Potential Loyalists
71879,771,3,"82,64999999999999",3,1,1,5,Low-Value,At Risk Customers
71880,752,2,"31,75",3,1,1,5,Low-Value,At Risk Customers
71881,324,3,"130,3",5,1,1,7,Mid-Value,Potential Loyalists
71883,667,1,"18,5",4,1,1,6,Mid-Value,Potential Loyalists
71884,364,3,"151,04999999999998",5,1,1,7,Mid-Value,Potential Loyalists
71885,1284,2,"29,35",2,1,1,4,Low-Value,Can't Lose
71888,153,6,"159,8",5,1,1,7,Mid-Value,Potential Loyalists
71889,783,1,"30,2",3,1,1,5,Low-Value,At Risk Customers
71891,95,5,"350,95",5,1,1,7,Mid-Value,Potential Loyalists
71892,1398,3,"132,65",2,1,1,4,Low-Value,Can't Lose
71893,824,3,"469,35",3,1,1,5,Low-Value,At Risk Customers
71894,1550,1,"17,85",1,1,1,3,Low-Value,Lost
71895,521,4,"267,6",4,1,1,6,Mid-Value,Potential Loyalists
71896,999,2,"192,45",3,1,1,5,Low-Value,At Risk Customers
71897,502,2,"142,15",4,1,1,6,Mid-Value,Potential Loyalists
71898,128,7,"101,45",5,2,1,8,High-Value,Potential Loyalists
71899,434,4,"289,95",4,1,1,6,Mid-Value,Potential Loyalists
71901,1175,1,"13,35",2,1,1,4,Low-Value,Can't Lose
71903,626,2,"50,25",4,1,1,6,Mid-Value,Potential Loyalists
71905,1118,1,"30,95",2,1,1,4,Low-Value,Can't Lose
71907,19,8,"1563,55",5,2,3,10,High-Value,Champions
71909,964,1,"28,4",3,1,1,5,Low-Value,At Risk Customers
71910,73,2,"764,75",5,1,2,8,High-Value,Potential Loyalists
71912,1727,1,"40,4",1,1,1,3,Low-Value,Lost
71917,322,3,"105,65",5,1,1,7,Mid-Value,Potential Loyalists
71918,340,2,"250,3",5,1,1,7,Mid-Value,Potential Loyalists
71919,31,12,"917,6500000000001",5,3,2,10,High-Value,Champions
71920,333,3,"62,35",5,1,1,7,Mid-Value,Potential Loyalists
71922,634,5,"170,8",4,1,1,6,Mid-Value,Potential Loyalists
71923,522,3,"727,8",4,1,2,7,Mid-Value,Potential Loyalists
71926,1090,1,"122,75",3,1,1,5,Low-Value,At Risk Customers
71927,143,1,"73,25",5,1,1,7,Mid-Value,Potential Loyalists
71929,504,4,"237,95",4,1,1,6,Mid-Value,Potential Loyalists
71931,125,3,"207,85",5,1,1,7,Mid-Value,Potential Loyalists
71933,295,4,"118,69999999999999",5,1,1,7,Mid-Value,Potential Loyalists
71934,15,5,"107,1",5,1,1,7,Mid-Value,Potential Loyalists
71935,159,2,"88,65",5,1,1,7,Mid-Value,Potential Loyalists
71936,670,1,"21,2",4,1,1,6,Mid-Value,Potential Loyalists
71942,630,2,"197,2",4,1,1,6,Mid-Value,Potential Loyalists
71943,593,2,"51,550000000000004",4,1,1,6,Mid-Value,Potential Loyalists
71944,1,13,"622,3",5,3,1,9,High-Value,Champions
71945,385,1,"29,5",4,1,1,6,Mid-Value,Potential Loyalists
71946,28,2,"51,0",5,1,1,7,Mid-Value,Potential Loyalists
71947,1404,1,"52,25",2,1,1,4,Low-Value,Can't Lose
71948,1260,3,"166,7",2,1,1,4,Low-Value,Can't Lose
71949,22,7,"370,75",5,2,1,8,High-Value,Potential Loyalists
71950,1001,1,"672,2",3,1,2,6,Mid-Value,Potential Loyalists
71951,75,2,"194,75",5,1,1,7,Mid-Value,Potential Loyalists
71953,1558,1,"50,4",1,1,1,3,Low-Value,Lost
71954,2,5,"301,65",5,1,1,7,Mid-Value,Potential Loyalists
71955,1606,4,"122,95",1,1,1,3,Low-Value,Lost
71956,52,4,"390,15",5,1,1,7,Mid-Value,Potential Loyalists
71960,482,8,"442,45",4,2,1,7,Mid-Value,Potential Loyalists
71964,22,11,"731,1",5,2,2,9,High-Value,Champions
71966,1090,1,"42,15",3,1,1,5,Low-Value,At Risk Customers
71968,437,3,"223,3",4,1,1,6,Mid-Value,Potential Loyalists
71970,75,3,"61,900000000000006",5,1,1,7,Mid-Value,Potential Loyalists
71974,32,1,"37,95",5,1,1,7,Mid-Value,Potential Loyalists
71976,317,8,"654,8",5,2,1,8,High-Value,Potential Loyalists
71977,295,1,"19,65",5,1,1,7,Mid-Value,Potential Loyalists
71980,91,1,"52,8",5,1,1,7,Mid-Value,Potential Loyalists
71982,405,2,"40,0",4,1,1,6,Mid-Value,Potential Loyalists
71986,936,4,"175,35",3,1,1,5,Low-Value,At Risk Customers
71988,774,1,"16,8",3,1,1,5,Low-Value,At Risk Customers
71989,184,5,"430,0",5,1,1,7,Mid-Value,Potential Loyalists
71990,188,2,"29,5",5,1,1,7,Mid-Value,Potential Loyalists
71992,1144,5,"225,15",2,1,1,4,Low-Value,Can't Lose
71993,1168,1,"19,35",2,1,1,4,Low-Value,Can't Lose
71997,488,4,"324,0",4,1,1,6,Mid-Value,Potential Loyalists
71999,1449,1,"25,45",2,1,1,4,Low-Value,Can't Lose
72000,361,3,"187,95000000000002",5,1,1,7,Mid-Value,Potential Loyalists
72001,17,3,"266,9",5,1,1,7,Mid-Value,Potential Loyalists
72004,1112,1,"7,8",2,1,1,4,Low-Value,Can't Lose
72006,838,5,"211,95",3,1,1,5,Low-Value,At Risk Customers
72008,1076,1,"29,85",3,1,1,5,Low-Value,At Risk Customers
72010,28,5,"463,15000000000003",5,1,1,7,Mid-Value,Potential Loyalists
72011,73,5,"170,65",5,1,1,7,Mid-Value,Potential Loyalists
72012,31,8,"426,1",5,2,1,8,High-Value,Potential Loyalists
72014,737,2,"84,1",3,1,1,5,Low-Value,At Risk Customers
72017,914,6,"382,65",3,1,1,5,Low-Value,At Risk Customers
72019,324,3,"119,9",5,1,1,7,Mid-Value,Potential Loyalists
72020,560,1,"88,35",4,1,1,6,Mid-Value,Potential Loyalists
72021,499,2,"248,4",4,1,1,6,Mid-Value,Potential Loyalists
72023,705,1,"19,65",4,1,1,6,Mid-Value,Potential Loyalists
72024,1170,2,"29,05",2,1,1,4,Low-Value,Can't Lose
72026,816,1,"17,2",3,1,1,5,Low-Value,At Risk Customers
72027,24,1,"23,45",5,1,1,7,Mid-Value,Potential Loyalists
72028,367,1,"56,4",4,1,1,6,Mid-Value,Potential Loyalists
72030,342,1,"85,5",5,1,1,7,Mid-Value,Potential Loyalists
72031,556,2,"140,15",4,1,1,6,Mid-Value,Potential Loyalists
72037,948,2,"186,7",3,1,1,5,Low-Value,At Risk Customers
72038,176,3,"131,8",5,1,1,7,Mid-Value,Potential Loyalists
72039,320,4,"319,5",5,1,1,7,Mid-Value,Potential Loyalists
72040,192,4,"186,65",5,1,1,7,Mid-Value,Potential Loyalists
72041,1333,4,"377,45",2,1,1,4,Low-Value,Can't Lose
72044,1120,3,"242,65",2,1,1,4,Low-Value,Can't Lose
72045,1246,2,"57,5",2,1,1,4,Low-Value,Can't Lose
72047,18,6,"641,9",5,1,1,7,Mid-Value,Potential Loyalists
72049,78,5,"410,59999999999997",5,1,1,7,Mid-Value,Potential Loyalists
72051,391,1,"90,4",4,1,1,6,Mid-Value,Potential Loyalists
72055,610,2,"73,35",4,1,1,6,Mid-Value,Potential Loyalists
72056,221,1,"160,2",5,1,1,7,Mid-Value,Potential Loyalists
72058,759,2,"481,1",3,1,1,5,Low-Value,At Risk Customers
72059,954,2,"26,8",3,1,1,5,Low-Value,At Risk Customers
72060,498,7,"624,7",4,2,1,7,Mid-Value,Potential Loyalists
72061,59,3,"64,0",5,1,1,7,Mid-Value,Potential Loyalists
72062,935,2,"187,39999999999998",3,1,1,5,Low-Value,At Risk Customers
72063,822,10,"792,95",3,2,2,7,Mid-Value,Potential Loyalists
72066,137,2,"249,85",5,1,1,7,Mid-Value,Potential Loyalists
72068,282,3,"39,05",5,1,1,7,Mid-Value,Potential Loyalists
72070,1059,2,"50,949999999999996",3,1,1,5,Low-Value,At Risk Customers
72073,594,2,"20,1",4,1,1,6,Mid-Value,Potential Loyalists
72076,27,2,"93,2",5,1,1,7,Mid-Value,Potential Loyalists
72077,67,4,"380,65",5,1,1,7,Mid-Value,Potential Loyalists
72078,872,4,"460,55",3,1,1,5,Low-Value,At Risk Customers
72079,906,2,"147,75",3,1,1,5,Low-Value,At Risk Customers
72081,375,15,"1068,35",4,3,2,9,High-Value,Champions
72082,163,9,"394,05",5,2,1,8,High-Value,Potential Loyalists
72083,372,3,"250,95",4,1,1,6,Mid-Value,Potential Loyalists
72085,550,1,"99,8",4,1,1,6,Mid-Value,Potential Loyalists
72086,10,9,"1242,0",5,2,2,9,High-Value,Champions
72087,451,3,"61,65",4,1,1,6,Mid-Value,Potential Loyalists
72088,202,6,"281,9",5,1,1,7,Mid-Value,Potential Loyalists
72089,138,5,"834,75",5,1,2,8,High-Value,Potential Loyalists
72090,1282,3,"169,95",2,1,1,4,Low-Value,Can't Lose
72092,1466,2,"64,0",1,1,1,3,Low-Value,Lost
72093,918,1,"310,6",3,1,1,5,Low-Value,At Risk Customers
72094,361,2,"87,4",5,1,1,7,Mid-Value,Potential Loyalists
72096,1161,5,"275,5",2,1,1,4,Low-Value,Can't Lose
72097,17,2,"91,30000000000001",5,1,1,7,Mid-Value,Potential Loyalists
72098,688,2,"141,0",4,1,1,6,Mid-Value,Potential Loyalists
72099,919,2,"38,7",3,1,1,5,Low-Value,At Risk Customers
72100,267,4,"313,90000000000003",5,1,1,7,Mid-Value,Potential Loyalists
72101,999,7,"408,25",3,2,1,6,Mid-Value,Potential Loyalists
72104,1203,3,"199,95",2,1,1,4,Low-Value,Can't Lose
72105,1485,2,"120,6",1,1,1,3,Low-Value,Lost
72107,1266,1,"291,0",2,1,1,4,Low-Value,Can't Lose
72108,71,2,"105,45",5,1,1,7,Mid-Value,Potential Loyalists
72109,455,6,"400,6",4,1,1,6,Mid-Value,Potential Loyalists
72111,463,6,"376,15",4,1,1,6,Mid-Value,Potential Loyalists
72112,1112,2,"46,65",2,1,1,4,Low-Value,Can't Lose
72113,397,4,"76,95",4,1,1,6,Mid-Value,Potential Loyalists
72116,1097,1,"19,2",2,1,1,4,Low-Value,Can't Lose
72117,272,5,"119,30000000000001",5,1,1,7,Mid-Value,Potential Loyalists
72119,36,1,"48,45",5,1,1,7,Mid-Value,Potential Loyalists
72121,889,4,"139,10000000000002",3,1,1,5,Low-Value,At Risk Customers
72123,1674,1,"114,0",1,1,1,3,Low-Value,Lost
72124,511,2,"43,1",4,1,1,6,Mid-Value,Potential Loyalists
72125,593,4,"245,2",4,1,1,6,Mid-Value,Potential Loyalists
72126,25,6,"294,3",5,1,1,7,Mid-Value,Potential Loyalists
72128,152,3,"224,65",5,1,1,7,Mid-Value,Potential Loyalists
72131,13,5,"596,9",5,1,1,7,Mid-Value,Potential Loyalists
72134,41,5,"299,05",5,1,1,7,Mid-Value,Potential Loyalists
72135,937,3,"137,0",3,1,1,5,Low-Value,At Risk Customers
72137,1706,1,"41,85",1,1,1,3,Low-Value,Lost
72138,497,3,"91,15",4,1,1,6,Mid-Value,Potential Loyalists
72144,359,3,"135,6",5,1,1,7,Mid-Value,Potential Loyalists
72145,358,2,"136,6",5,1,1,7,Mid-Value,Potential Loyalists
72146,784,1,"328,65",3,1,1,5,Low-Value,At Risk Customers
72147,27,16,"975,6",5,3,2,10,High-Value,Champions
72150,738,3,"143,65",3,1,1,5,Low-Value,At Risk Customers
72153,543,3,"270,2",4,1,1,6,Mid-Value,Potential Loyalists
72155,64,3,"234,3",5,1,1,7,Mid-Value,Potential Loyalists
72156,384,3,"58,7",4,1,1,6,Mid-Value,Potential Loyalists
72157,951,1,"91,7",3,1,1,5,Low-Value,At Risk Customers
72158,215,3,"102,19999999999999",5,1,1,7,Mid-Value,Potential Loyalists
72159,367,15,"539,3199999999999",4,3,1,8,High-Value,Potential Loyalists
72161,225,5,"301,5",5,1,1,7,Mid-Value,Potential Loyalists
72162,13,5,"751,9",5,1,2,8,High-Value,Potential Loyalists
72166,24,5,"254,15",5,1,1,7,Mid-Value,Potential Loyalists
72168,758,3,"125,8",3,1,1,5,Low-Value,At Risk Customers
72172,465,1,"239,6",4,1,1,6,Mid-Value,Potential Loyalists
72174,139,5,"273,3",5,1,1,7,Mid-Value,Potential Loyalists
72175,338,4,"263,1",5,1,1,7,Mid-Value,Potential Loyalists
72176,82,8,"409,85",5,2,1,8,High-Value,Potential Loyalists
72177,886,1,"45,8",3,1,1,5,Low-Value,At Risk Customers
72180,1206,4,"199,95000000000002",2,1,1,4,Low-Value,Can't Lose
72181,50,10,"242,35",5,2,1,8,High-Value,Potential Loyalists
72182,10,5,"210,14999999999998",5,1,1,7,Mid-Value,Potential Loyalists
72183,468,3,"165,35",4,1,1,6,Mid-Value,Potential Loyalists
72184,812,2,"130,2",3,1,1,5,Low-Value,At Risk Customers
72186,59,1,"17,25",5,1,1,7,Mid-Value,Potential Loyalists
72188,487,4,"176,45",4,1,1,6,Mid-Value,Potential Loyalists
72189,800,2,"37,8",3,1,1,5,Low-Value,At Risk Customers
72191,390,3,"86,5",4,1,1,6,Mid-Value,Potential Loyalists
72192,431,3,"283,2",4,1,1,6,Mid-Value,Potential Loyalists
72194,708,3,"297,1",4,1,1,6,Mid-Value,Potential Loyalists
72195,625,2,"60,05",4,1,1,6,Mid-Value,Potential Loyalists
72196,375,5,"171,55",4,1,1,6,Mid-Value,Potential Loyalists
72198,395,2,"43,2",4,1,1,6,Mid-Value,Potential Loyalists
72199,168,3,"50,35",5,1,1,7,Mid-Value,Potential Loyalists
72201,859,1,"7,9",3,1,1,5,Low-Value,At Risk Customers
72204,11,4,"223,60000000000002",5,1,1,7,Mid-Value,Potential Loyalists
72205,11,6,"659,6",5,1,1,7,Mid-Value,Potential Loyalists
72206,412,6,"424,59999999999997",4,1,1,6,Mid-Value,Potential Loyalists
72207,56,2,"16,95",5,1,1,7,Mid-Value,Potential Loyalists
72208,1151,4,"401,35",2,1,1,4,Low-Value,Can't Lose
72209,1079,3,"138,25",3,1,1,5,Low-Value,At Risk Customers
72211,383,3,"361,85",4,1,1,6,Mid-Value,Potential Loyalists
72212,1351,1,"115,0",2,1,1,4,Low-Value,Can't Lose
72213,721,1,"62,9",4,1,1,6,Mid-Value,Potential Loyalists
72215,577,1,"24,450000000000003",4,1,1,6,Mid-Value,Potential Loyalists
72216,32,6,"579,55",5,1,1,7,Mid-Value,Potential Loyalists
72218,222,6,"182,45000000000002",5,1,1,7,Mid-Value,Potential Loyalists
72219,145,2,"40,3",5,1,1,7,Mid-Value,Potential Loyalists
72220,64,2,"178,15",5,1,1,7,Mid-Value,Potential Loyalists
72224,347,1,"102,8",5,1,1,7,Mid-Value,Potential Loyalists
72225,207,5,"375,95",5,1,1,7,Mid-Value,Potential Loyalists
72226,5,1,"7,5",5,1,1,7,Mid-Value,Potential Loyalists
72227,19,1,"26,5",5,1,1,7,Mid-Value,Potential Loyalists
72229,221,3,"286,6",5,1,1,7,Mid-Value,Potential Loyalists
72230,578,2,"351,7",4,1,1,6,Mid-Value,Potential Loyalists
72231,19,3,"111,5",5,1,1,7,Mid-Value,Potential Loyalists
72233,29,4,"307,35",5,1,1,7,Mid-Value,Potential Loyalists
72237,953,2,"83,95",3,1,1,5,Low-Value,At Risk Customers
72238,412,1,"10,3",4,1,1,6,Mid-Value,Potential Loyalists
72241,916,4,"186,64999999999998",3,1,1,5,Low-Value,At Risk Customers
72242,897,1,"102,6",3,1,1,5,Low-Value,At Risk Customers
72243,654,5,"235,4",4,1,1,6,Mid-Value,Potential Loyalists
72244,680,2,"39,45",4,1,1,6,Mid-Value,Potential Loyalists
72247,416,9,"585,7",4,2,1,7,Mid-Value,Potential Loyalists
72248,123,2,"171,55",5,1,1,7,Mid-Value,Potential Loyalists
72251,1305,1,"46,7",2,1,1,4,Low-Value,Can't Lose
72252,113,3,"148,25",5,1,1,7,Mid-Value,Potential Loyalists
72253,777,1,"21,55",3,1,1,5,Low-Value,At Risk Customers
72254,10,4,"239,55",5,1,1,7,Mid-Value,Potential Loyalists
72255,205,8,"479,2",5,2,1,8,High-Value,Potential Loyalists
72256,497,7,"239,45000000000002",4,2,1,7,Mid-Value,Potential Loyalists
72257,931,1,"121,4",3,1,1,5,Low-Value,At Risk Customers
72260,657,3,"130,95",4,1,1,6,Mid-Value,Potential Loyalists
72261,84,3,"84,94999999999999",5,1,1,7,Mid-Value,Potential Loyalists
72262,756,7,"242,65",3,2,1,6,Mid-Value,Potential Loyalists
72264,377,5,"605,6500000000001",4,1,1,6,Mid-Value,Potential Loyalists
72265,435,2,"46,8",4,1,1,6,Mid-Value,Potential Loyalists
72266,130,3,"87,2",5,1,1,7,Mid-Value,Potential Loyalists
72267,759,6,"461,3",3,1,1,5,Low-Value,At Risk Customers
72268,25,7,"226,55",5,2,1,8,High-Value,Potential Loyalists
72270,67,11,"803,45",5,2,2,9,High-Value,Champions
72271,51,5,"153,7",5,1,1,7,Mid-Value,Potential Loyalists
72273,125,3,"48,05",5,1,1,7,Mid-Value,Potential Loyalists
72274,204,5,"412,29999999999995",5,1,1,7,Mid-Value,Potential Loyalists
72282,376,2,"245,65",4,1,1,6,Mid-Value,Potential Loyalists
72283,1154,1,"112,2",2,1,1,4,Low-Value,Can't Lose
72284,56,6,"233,4",5,1,1,7,Mid-Value,Potential Loyalists
72285,33,4,"512,35",5,1,1,7,Mid-Value,Potential Loyalists
72286,290,3,"221,4",5,1,1,7,Mid-Value,Potential Loyalists
72288,1206,3,"34,15",2,1,1,4,Low-Value,Can't Lose
72289,1070,2,"115,94999999999999",3,1,1,5,Low-Value,At Risk Customers
72290,479,1,"37,8",4,1,1,6,Mid-Value,Potential Loyalists
72291,705,2,"71,7",4,1,1,6,Mid-Value,Potential Loyalists
72292,1642,1,"89,55",1,1,1,3,Low-Value,Lost
72295,83,5,"207,29999999999998",5,1,1,7,Mid-Value,Potential Loyalists
72298,397,11,"243,5",4,2,1,7,Mid-Value,Potential Loyalists
72302,656,3,"201,4",4,1,1,6,Mid-Value,Potential Loyalists
72304,1012,6,"165,8",3,1,1,5,Low-Value,At Risk Customers
72306,375,5,"284,7",4,1,1,6,Mid-Value,Potential Loyalists
72307,55,6,"309,05000000000007",5,1,1,7,Mid-Value,Potential Loyalists
72309,18,6,"377,55",5,1,1,7,Mid-Value,Potential Loyalists
72310,380,2,"482,9",4,1,1,6,Mid-Value,Potential Loyalists
72311,222,3,"32,3",5,1,1,7,Mid-Value,Potential Loyalists
72313,1524,1,"19,75",1,1,1,3,Low-Value,Lost
72314,963,2,"347,55",3,1,1,5,Low-Value,At Risk Customers
72315,987,1,"13,5",3,1,1,5,Low-Value,At Risk Customers
72317,668,3,"215,65",4,1,1,6,Mid-Value,Potential Loyalists
72318,22,9,"273,85",5,2,1,8,High-Value,Potential Loyalists
72319,200,5,"316,25",5,1,1,7,Mid-Value,Potential Loyalists
72320,1022,1,"30,05",3,1,1,5,Low-Value,At Risk Customers
72321,932,3,"131,05",3,1,1,5,Low-Value,At Risk Customers
72322,87,3,"70,95",5,1,1,7,Mid-Value,Potential Loyalists
72327,1389,2,"119,25",2,1,1,4,Low-Value,Can't Lose
72330,1,9,"748,4499999999999",5,2,2,9,High-Value,Champions
72331,851,2,"72,6",3,1,1,5,Low-Value,At Risk Customers
72332,882,2,"40,650000000000006",3,1,1,5,Low-Value,At Risk Customers
72333,943,7,"827,75",3,2,2,7,Mid-Value,Potential Loyalists
72336,1477,1,"78,8",1,1,1,3,Low-Value,Lost
72337,59,1,"44,9",5,1,1,7,Mid-Value,Potential Loyalists
72339,618,5,"771,3",4,1,2,7,Mid-Value,Potential Loyalists
72343,1217,4,"336,4",2,1,1,4,Low-Value,Can't Lose
72344,411,2,"79,75",4,1,1,6,Mid-Value,Potential Loyalists
72345,419,1,"22,7",4,1,1,6,Mid-Value,Potential Loyalists
72346,759,4,"204,9",3,1,1,5,Low-Value,At Risk Customers
72347,1006,1,"38,35",3,1,1,5,Low-Value,At Risk Customers
72348,57,4,"209,85",5,1,1,7,Mid-Value,Potential Loyalists
72350,70,3,"100,95",5,1,1,7,Mid-Value,Potential Loyalists
72351,11,6,"717,65",5,1,2,8,High-Value,Potential Loyalists
72352,1230,2,"123,0",2,1,1,4,Low-Value,Can't Lose
72353,561,3,"398,95000000000005",4,1,1,6,Mid-Value,Potential Loyalists
72354,1028,1,"18,25",3,1,1,5,Low-Value,At Risk Customers
72356,453,3,"245,10000000000002",4,1,1,6,Mid-Value,Potential Loyalists
72357,102,4,"173,14999999999998",5,1,1,7,Mid-Value,Potential Loyalists
72359,628,3,"188,8",4,1,1,6,Mid-Value,Potential Loyalists
72365,5,2,"71,55",5,1,1,7,Mid-Value,Potential Loyalists
72367,732,6,"300,95",3,1,1,5,Low-Value,At Risk Customers
72369,939,1,"495,4",3,1,1,5,Low-Value,At Risk Customers
72370,234,5,"436,8500000000001",5,1,1,7,Mid-Value,Potential Loyalists
72371,35,3,"92,55",5,1,1,7,Mid-Value,Potential Loyalists
72372,10,5,"529,6",5,1,1,7,Mid-Value,Potential Loyalists
72373,914,2,"125,85",3,1,1,5,Low-Value,At Risk Customers
72374,223,4,"83,0",5,1,1,7,Mid-Value,Potential Loyalists
72375,59,10,"437,8",5,2,1,8,High-Value,Potential Loyalists
72376,11,5,"175,05",5,1,1,7,Mid-Value,Potential Loyalists
72377,837,2,"437,4",3,1,1,5,Low-Value,At Risk Customers
72378,1678,1,"484,9",1,1,1,3,Low-Value,Lost
72379,456,7,"318,0",4,2,1,7,Mid-Value,Potential Loyalists
72383,219,5,"286,4",5,1,1,7,Mid-Value,Potential Loyalists
72384,160,3,"265,7",5,1,1,7,Mid-Value,Potential Loyalists
72385,489,3,"209,2",4,1,1,6,Mid-Value,Potential Loyalists
72387,87,2,"57,65",5,1,1,7,Mid-Value,Potential Loyalists
72391,533,5,"685,4",4,1,2,7,Mid-Value,Potential Loyalists
72392,209,2,"28,7",5,1,1,7,Mid-Value,Potential Loyalists
72393,147,1,"251,4",5,1,1,7,Mid-Value,Potential Loyalists
72394,25,10,"454,65",5,2,1,8,High-Value,Potential Loyalists
72395,1489,1,"28,6",1,1,1,3,Low-Value,Lost
72396,555,4,"119,4",4,1,1,6,Mid-Value,Potential Loyalists
72397,916,1,"31,349999999999998",3,1,1,5,Low-Value,At Risk Customers
72398,136,3,"183,5",5,1,1,7,Mid-Value,Potential Loyalists
72399,591,2,"62,349999999999994",4,1,1,6,Mid-Value,Potential Loyalists
72400,1471,1,"10,75",1,1,1,3,Low-Value,Lost
72402,2,7,"458,59999999999997",5,2,1,8,High-Value,Potential Loyalists
72403,306,7,"199,7",5,2,1,8,High-Value,Potential Loyalists
72404,1480,1,"44,5",1,1,1,3,Low-Value,Lost
72406,417,3,"104,05",4,1,1,6,Mid-Value,Potential Loyalists
72407,322,4,"105,69999999999999",5,1,1,7,Mid-Value,Potential Loyalists
72410,1540,2,"75,15",1,1,1,3,Low-Value,Lost
72411,1082,1,"17,5",3,1,1,5,Low-Value,At Risk Customers
72413,1642,2,"38,2",1,1,1,3,Low-Value,Lost
72414,501,5,"143,2",4,1,1,6,Mid-Value,Potential Loyalists
72415,1621,1,"35,8",1,1,1,3,Low-Value,Lost
72416,400,5,"131,15",4,1,1,6,Mid-Value,Potential Loyalists
72417,718,3,"230,85",4,1,1,6,Mid-Value,Potential Loyalists
72418,1678,2,"17,85",1,1,1,3,Low-Value,Lost
72420,1596,3,"240,54999999999998",1,1,1,3,Low-Value,Lost
72421,1079,2,"136,55",3,1,1,5,Low-Value,At Risk Customers
72427,879,2,"94,2",3,1,1,5,Low-Value,At Risk Customers
72428,921,2,"74,19999999999999",3,1,1,5,Low-Value,At Risk Customers
72429,691,1,"17,8",4,1,1,6,Mid-Value,Potential Loyalists
72430,55,6,"285,35",5,1,1,7,Mid-Value,Potential Loyalists
72431,1611,1,"59,9",1,1,1,3,Low-Value,Lost
72433,61,16,"578,9",5,3,1,9,High-Value,Champions
72434,110,3,"178,45",5,1,1,7,Mid-Value,Potential Loyalists
72435,110,1,"174,8",5,1,1,7,Mid-Value,Potential Loyalists
72436,507,1,"76,7",4,1,1,6,Mid-Value,Potential Loyalists
72437,805,1,"35,8",3,1,1,5,Low-Value,At Risk Customers
72439,66,6,"998,75",5,1,2,8,High-Value,Potential Loyalists
72440,732,1,"95,5",3,1,1,5,Low-Value,At Risk Customers
72442,317,2,"73,3",5,1,1,7,Mid-Value,Potential Loyalists
72444,732,6,"594,5",3,1,1,5,Low-Value,At Risk Customers
72445,463,1,"14,4",4,1,1,6,Mid-Value,Potential Loyalists
72447,405,3,"63,05",4,1,1,6,Mid-Value,Potential Loyalists
72448,338,2,"66,05",5,1,1,7,Mid-Value,Potential Loyalists
72449,1155,2,"23,200000000000003",2,1,1,4,Low-Value,Can't Lose
72450,14,7,"459,2",5,2,1,8,High-Value,Potential Loyalists
72452,197,7,"343,45",5,2,1,8,High-Value,Potential Loyalists
72453,17,9,"978,65",5,2,2,9,High-Value,Champions
72454,74,5,"600,5500000000001",5,1,1,7,Mid-Value,Potential Loyalists
72455,484,4,"182,45",4,1,1,6,Mid-Value,Potential Loyalists
72456,115,1,"88,80000000000001",5,1,1,7,Mid-Value,Potential Loyalists
72457,17,14,"740,55",5,3,2,10,High-Value,Champions
72458,132,3,"301,1",5,1,1,7,Mid-Value,Potential Loyalists
72462,443,3,"335,55",4,1,1,6,Mid-Value,Potential Loyalists
72463,220,5,"339,54999999999995",5,1,1,7,Mid-Value,Potential Loyalists
72464,1320,1,"124,80000000000001",2,1,1,4,Low-Value,Can't Lose
72465,29,10,"324,3",5,2,1,8,High-Value,Potential Loyalists
72466,649,3,"37,05",4,1,1,6,Mid-Value,Potential Loyalists
72467,1282,1,"23,3",2,1,1,4,Low-Value,Can't Lose
72470,21,2,"51,8",5,1,1,7,Mid-Value,Potential Loyalists
72471,971,1,"170,85000000000002",3,1,1,5,Low-Value,At Risk Customers
72472,5,7,"318,25",5,2,1,8,High-Value,Potential Loyalists
72473,875,1,"1236,25",3,1,2,6,Mid-Value,Potential Loyalists
72476,1337,2,"32,7",2,1,1,4,Low-Value,Can't Lose
72478,615,3,"77,4",4,1,1,6,Mid-Value,Potential Loyalists
72483,1662,1,"25,6",1,1,1,3,Low-Value,Lost
72484,28,14,"750,15",5,3,2,10,High-Value,Champions
72485,446,3,"319,45",4,1,1,6,Mid-Value,Potential Loyalists
72486,193,4,"104,8",5,1,1,7,Mid-Value,Potential Loyalists
72487,458,5,"621,0999999999999",4,1,1,6,Mid-Value,Potential Loyalists
72492,1329,2,"97,05000000000001",2,1,1,4,Low-Value,Can't Lose
72493,381,2,"187,1",4,1,1,6,Mid-Value,Potential Loyalists
72499,619,8,"564,5",4,2,1,7,Mid-Value,Potential Loyalists
72500,167,4,"173,10000000000002",5,1,1,7,Mid-Value,Potential Loyalists
72501,38,4,"328,25",5,1,1,7,Mid-Value,Potential Loyalists
72506,688,4,"202,6",4,1,1,6,Mid-Value,Potential Loyalists
72508,593,4,"264,45",4,1,1,6,Mid-Value,Potential Loyalists
72509,20,12,"1142,75",5,3,2,10,High-Value,Champions
72510,622,8,"282,0",4,2,1,7,Mid-Value,Potential Loyalists
72511,1359,3,"64,3",2,1,1,4,Low-Value,Can't Lose
72514,432,5,"244,95",4,1,1,6,Mid-Value,Potential Loyalists
72515,817,1,"36,8",3,1,1,5,Low-Value,At Risk Customers
72516,1581,4,"613,5",1,1,1,3,Low-Value,Lost
72518,237,3,"434,40000000000003",5,1,1,7,Mid-Value,Potential Loyalists
72519,316,7,"577,5500000000001",5,2,1,8,High-Value,Potential Loyalists
72522,1158,2,"53,6",2,1,1,4,Low-Value,Can't Lose
72524,17,2,"107,15",5,1,1,7,Mid-Value,Potential Loyalists
72525,770,2,"112,4",3,1,1,5,Low-Value,At Risk Customers
72526,528,4,"222,7",4,1,1,6,Mid-Value,Potential Loyalists
72527,122,2,"98,35",5,1,1,7,Mid-Value,Potential Loyalists
72528,59,4,"103,45",5,1,1,7,Mid-Value,Potential Loyalists
72529,1823,1,"27,45",1,1,1,3,Low-Value,Lost
72531,1047,1,"6,9",3,1,1,5,Low-Value,At Risk Customers
72532,409,5,"329,65",4,1,1,6,Mid-Value,Potential Loyalists
72533,487,4,"199,95",4,1,1,6,Mid-Value,Potential Loyalists
72534,115,4,"162,79999999999998",5,1,1,7,Mid-Value,Potential Loyalists
72537,243,5,"364,09999999999997",5,1,1,7,Mid-Value,Potential Loyalists
72538,31,4,"271,9",5,1,1,7,Mid-Value,Potential Loyalists
72539,474,6,"345,2",4,1,1,6,Mid-Value,Potential Loyalists
72542,1610,1,"66,15",1,1,1,3,Low-Value,Lost
72544,230,2,"261,75",5,1,1,7,Mid-Value,Potential Loyalists
72545,561,2,"136,4",4,1,1,6,Mid-Value,Potential Loyalists
72547,93,7,"577,7",5,2,1,8,High-Value,Potential Loyalists
72548,179,2,"181,25",5,1,1,7,Mid-Value,Potential Loyalists
72550,195,3,"150,35",5,1,1,7,Mid-Value,Potential Loyalists
72552,940,3,"77,95",3,1,1,5,Low-Value,At Risk Customers
72553,975,2,"19,5",3,1,1,5,Low-Value,At Risk Customers
72554,1606,1,"111,5",1,1,1,3,Low-Value,Lost
72555,121,6,"910,1",5,1,2,8,High-Value,Potential Loyalists
72558,206,6,"352,25",5,1,1,7,Mid-Value,Potential Loyalists
72559,134,7,"513,25",5,2,1,8,High-Value,Potential Loyalists
72561,144,7,"548,45",5,2,1,8,High-Value,Potential Loyalists
72562,1179,1,"56,3",2,1,1,4,Low-Value,Can't Lose
72564,150,2,"86,0",5,1,1,7,Mid-Value,Potential Loyalists
72565,32,4,"195,15",5,1,1,7,Mid-Value,Potential Loyalists
72567,916,1,"20,95",3,1,1,5,Low-Value,At Risk Customers
72568,473,4,"656,85",4,1,1,6,Mid-Value,Potential Loyalists
72569,607,3,"203,25",4,1,1,6,Mid-Value,Potential Loyalists
72570,453,2,"29,95",4,1,1,6,Mid-Value,Potential Loyalists
72571,1033,1,"11,5",3,1,1,5,Low-Value,At Risk Customers
72572,52,4,"102,55000000000001",5,1,1,7,Mid-Value,Potential Loyalists
72579,860,3,"178,60000000000002",3,1,1,5,Low-Value,At Risk Customers
72581,12,2,"18,15",5,1,1,7,Mid-Value,Potential Loyalists
72583,214,1,"186,75",5,1,1,7,Mid-Value,Potential Loyalists
72584,728,1,"45,8",4,1,1,6,Mid-Value,Potential Loyalists
72586,1301,2,"115,85",2,1,1,4,Low-Value,Can't Lose
72587,119,5,"205,79999999999998",5,1,1,7,Mid-Value,Potential Loyalists
72589,45,9,"706,95",5,2,2,9,High-Value,Champions
72590,63,6,"220,1",5,1,1,7,Mid-Value,Potential Loyalists
72592,152,5,"619,0",5,1,1,7,Mid-Value,Potential Loyalists
72593,533,3,"93,2",4,1,1,6,Mid-Value,Potential Loyalists
72594,627,2,"213,50000000000003",4,1,1,6,Mid-Value,Potential Loyalists
72595,672,6,"736,45",4,1,2,7,Mid-Value,Potential Loyalists
72598,1162,1,"11,85",2,1,1,4,Low-Value,Can't Lose
72599,445,8,"300,8",4,2,1,7,Mid-Value,Potential Loyalists
72600,63,7,"150,05",5,2,1,8,High-Value,Potential Loyalists
72601,234,10,"554,6",5,2,1,8,High-Value,Potential Loyalists
72605,947,3,"111,35000000000001",3,1,1,5,Low-Value,At Risk Customers
72606,41,13,"459,15",5,3,1,9,High-Value,Champions
72607,227,5,"245,5",5,1,1,7,Mid-Value,Potential Loyalists
72608,559,3,"191,85",4,1,1,6,Mid-Value,Potential Loyalists
72609,403,4,"157,35000000000002",4,1,1,6,Mid-Value,Potential Loyalists
72610,1,1,"35,1",5,1,1,7,Mid-Value,Potential Loyalists
72611,81,3,"374,75",5,1,1,7,Mid-Value,Potential Loyalists
72612,79,3,"213,65",5,1,1,7,Mid-Value,Potential Loyalists
72613,632,3,"316,7",4,1,1,6,Mid-Value,Potential Loyalists
72614,96,3,"175,35",5,1,1,7,Mid-Value,Potential Loyalists
72615,78,6,"338,35",5,1,1,7,Mid-Value,Potential Loyalists
72616,1634,1,"70,1",1,1,1,3,Low-Value,Lost
72617,1463,4,"165,55",1,1,1,3,Low-Value,Lost
72618,389,5,"619,25",4,1,1,6,Mid-Value,Potential Loyalists
72619,5,6,"211,95",5,1,1,7,Mid-Value,Potential Loyalists
72620,726,5,"492,65",4,1,1,6,Mid-Value,Potential Loyalists
72621,854,1,"47,3",3,1,1,5,Low-Value,At Risk Customers
72624,1481,1,"5,6",1,1,1,3,Low-Value,Lost
72625,1149,1,"48,65",2,1,1,4,Low-Value,Can't Lose
72629,853,1,"34,25",3,1,1,5,Low-Value,At Risk Customers
72630,229,5,"95,25",5,1,1,7,Mid-Value,Potential Loyalists
72633,1372,1,"6,1",2,1,1,4,Low-Value,Can't Lose
72636,544,2,"33,3",4,1,1,6,Mid-Value,Potential Loyalists
72638,613,3,"142,5",4,1,1,6,Mid-Value,Potential Loyalists
72639,1271,2,"67,45",2,1,1,4,Low-Value,Can't Lose
72640,920,4,"193,2",3,1,1,5,Low-Value,At Risk Customers
72641,55,2,"191,39999999999998",5,1,1,7,Mid-Value,Potential Loyalists
72642,322,1,"11,8",5,1,1,7,Mid-Value,Potential Loyalists
72644,146,1,"174,8",5,1,1,7,Mid-Value,Potential Loyalists
72645,77,2,"194,70000000000002",5,1,1,7,Mid-Value,Potential Loyalists
72646,1163,2,"54,9",2,1,1,4,Low-Value,Can't Lose
72648,1809,1,"1,9",1,1,1,3,Low-Value,Lost
72649,12,5,"171,3",5,1,1,7,Mid-Value,Potential Loyalists
72651,437,12,"980,3",4,3,2,9,High-Value,Champions
72652,180,2,"74,5",5,1,1,7,Mid-Value,Potential Loyalists
72654,135,8,"350,15",5,2,1,8,High-Value,Potential Loyalists
72655,234,6,"253,95",5,1,1,7,Mid-Value,Potential Loyalists
72656,404,2,"59,0",4,1,1,6,Mid-Value,Potential Loyalists
72658,1724,1,"43,3",1,1,1,3,Low-Value,Lost
72659,1266,2,"162,05",2,1,1,4,Low-Value,Can't Lose
72660,85,5,"382,05",5,1,1,7,Mid-Value,Potential Loyalists
72661,817,7,"726,85",3,2,2,7,Mid-Value,Potential Loyalists
72663,620,2,"211,85",4,1,1,6,Mid-Value,Potential Loyalists
72665,614,1,"26,5",4,1,1,6,Mid-Value,Potential Loyalists
72666,503,1,"115,05000000000001",4,1,1,6,Mid-Value,Potential Loyalists
72667,1220,2,"103,3",2,1,1,4,Low-Value,Can't Lose
72668,147,2,"117,45",5,1,1,7,Mid-Value,Potential Loyalists
72669,470,9,"430,59999999999997",4,2,1,7,Mid-Value,Potential Loyalists
72671,603,1,"18,05",4,1,1,6,Mid-Value,Potential Loyalists
72675,31,8,"616,9",5,2,1,8,High-Value,Potential Loyalists
72678,24,2,"27,0",5,1,1,7,Mid-Value,Potential Loyalists
72679,37,6,"242,3",5,1,1,7,Mid-Value,Potential Loyalists
72681,17,4,"775,05",5,1,2,8,High-Value,Potential Loyalists
72683,1310,3,"63,15",2,1,1,4,Low-Value,Can't Lose
72687,1195,3,"119,1",2,1,1,4,Low-Value,Can't Lose
72691,838,3,"229,85",3,1,1,5,Low-Value,At Risk Customers
72694,82,5,"246,04999999999998",5,1,1,7,Mid-Value,Potential Loyalists
72695,833,2,"52,8",3,1,1,5,Low-Value,At Risk Customers
72698,153,3,"84,1",5,1,1,7,Mid-Value,Potential Loyalists
72701,29,2,"134,85",5,1,1,7,Mid-Value,Potential Loyalists
72703,197,1,"20,4",5,1,1,7,Mid-Value,Potential Loyalists
72704,449,3,"228,25",4,1,1,6,Mid-Value,Potential Loyalists
72706,42,5,"851,4499999999999",5,1,2,8,High-Value,Potential Loyalists
72708,712,2,"41,15",4,1,1,6,Mid-Value,Potential Loyalists
72709,1093,2,"233,15",3,1,1,5,Low-Value,At Risk Customers
72712,898,1,"5,45",3,1,1,5,Low-Value,At Risk Customers
72713,1163,1,"62,5",2,1,1,4,Low-Value,Can't Lose
72714,164,4,"112,1",5,1,1,7,Mid-Value,Potential Loyalists
72715,97,3,"121,44999999999999",5,1,1,7,Mid-Value,Potential Loyalists
72716,161,1,"12,1",5,1,1,7,Mid-Value,Potential Loyalists
72717,439,4,"273,9",4,1,1,6,Mid-Value,Potential Loyalists
72718,88,11,"591,95",5,2,1,8,High-Value,Potential Loyalists
72719,165,5,"624,2",5,1,1,7,Mid-Value,Potential Loyalists
72720,586,1,"9,25",4,1,1,6,Mid-Value,Potential Loyalists
72721,33,4,"234,2",5,1,1,7,Mid-Value,Potential Loyalists
72724,510,3,"106,6",4,1,1,6,Mid-Value,Potential Loyalists
72726,881,2,"26,05",3,1,1,5,Low-Value,At Risk Customers
72727,868,3,"460,59999999999997",3,1,1,5,Low-Value,At Risk Customers
72729,159,4,"324,05",5,1,1,7,Mid-Value,Potential Loyalists
72730,28,3,"421,05000000000007",5,1,1,7,Mid-Value,Potential Loyalists
72731,215,2,"173,89999999999998",5,1,1,7,Mid-Value,Potential Loyalists
72733,259,2,"27,45",5,1,1,7,Mid-Value,Potential Loyalists
72734,231,1,"8,85",5,1,1,7,Mid-Value,Potential Loyalists
72736,794,2,"156,9",3,1,1,5,Low-Value,At Risk Customers
72737,293,6,"387,55",5,1,1,7,Mid-Value,Potential Loyalists
72738,1284,1,"64,5",2,1,1,4,Low-Value,Can't Lose
72739,447,2,"148,15",4,1,1,6,Mid-Value,Potential Loyalists
72741,1109,3,"125,6",2,1,1,4,Low-Value,Can't Lose
72742,1110,1,"50,2",2,1,1,4,Low-Value,Can't Lose
72743,131,5,"280,05",5,1,1,7,Mid-Value,Potential Loyalists
72748,57,6,"351,45",5,1,1,7,Mid-Value,Potential Loyalists
72749,103,3,"129,65",5,1,1,7,Mid-Value,Potential Loyalists
72750,189,5,"327,7",5,1,1,7,Mid-Value,Potential Loyalists
72752,1467,1,"3,5",1,1,1,3,Low-Value,Lost
72753,202,4,"200,2",5,1,1,7,Mid-Value,Potential Loyalists
72755,50,5,"148,6",5,1,1,7,Mid-Value,Potential Loyalists
72756,369,3,"343,15000000000003",4,1,1,6,Mid-Value,Potential Loyalists
72757,383,2,"170,6",4,1,1,6,Mid-Value,Potential Loyalists
72760,175,5,"496,7",5,1,1,7,Mid-Value,Potential Loyalists
72765,267,2,"114,6",5,1,1,7,Mid-Value,Potential Loyalists
72767,104,2,"37,0",5,1,1,7,Mid-Value,Potential Loyalists
72769,196,2,"390,3",5,1,1,7,Mid-Value,Potential Loyalists
72771,711,3,"79,8",4,1,1,6,Mid-Value,Potential Loyalists
72772,528,4,"149,4",4,1,1,6,Mid-Value,Potential Loyalists
72773,2,2,"159,1",5,1,1,7,Mid-Value,Potential Loyalists
72776,24,5,"230,14999999999998",5,1,1,7,Mid-Value,Potential Loyalists
72777,303,10,"435,59999999999997",5,2,1,8,High-Value,Potential Loyalists
72778,366,7,"944,4100000000001",4,2,2,8,High-Value,Potential Loyalists
72779,76,1,"10,75",5,1,1,7,Mid-Value,Potential Loyalists
72781,361,9,"655,95",5,2,1,8,High-Value,Potential Loyalists
72784,136,1,"5,4",5,1,1,7,Mid-Value,Potential Loyalists
72788,1569,1,"76,7",1,1,1,3,Low-Value,Lost
72789,1250,1,"37,5",2,1,1,4,Low-Value,Can't Lose
72791,553,4,"26,349999999999998",4,1,1,6,Mid-Value,Potential Loyalists
72792,1696,1,"63,2",1,1,1,3,Low-Value,Lost
72794,1222,5,"340,0",2,1,1,4,Low-Value,Can't Lose
72795,568,3,"786,0999999999999",4,1,2,7,Mid-Value,Potential Loyalists
72797,23,1,"31,2",5,1,1,7,Mid-Value,Potential Loyalists
72798,76,5,"192,14999999999998",5,1,1,7,Mid-Value,Potential Loyalists
72801,179,5,"716,2",5,1,2,8,High-Value,Potential Loyalists
72802,131,3,"143,25",5,1,1,7,Mid-Value,Potential Loyalists
72804,618,2,"55,0",4,1,1,6,Mid-Value,Potential Loyalists
72805,747,2,"55,5",3,1,1,5,Low-Value,At Risk Customers
72806,212,3,"117,94999999999999",5,1,1,7,Mid-Value,Potential Loyalists
72808,774,7,"291,3",3,2,1,6,Mid-Value,Potential Loyalists
72813,915,2,"52,89999999999999",3,1,1,5,Low-Value,At Risk Customers
72815,1325,2,"50,85",2,1,1,4,Low-Value,Can't Lose
72816,109,4,"621,6",5,1,1,7,Mid-Value,Potential Loyalists
72817,543,1,"80,55000000000001",4,1,1,6,Mid-Value,Potential Loyalists
72818,1034,2,"190,0",3,1,1,5,Low-Value,At Risk Customers
72819,374,4,"130,05",4,1,1,6,Mid-Value,Potential Loyalists
72821,1036,1,"23,5",3,1,1,5,Low-Value,At Risk Customers
72823,740,5,"436,85",3,1,1,5,Low-Value,At Risk Customers
72824,9,3,"256,3",5,1,1,7,Mid-Value,Potential Loyalists
72825,211,6,"264,35",5,1,1,7,Mid-Value,Potential Loyalists
72827,49,11,"654,6999999999999",5,2,1,8,High-Value,Potential Loyalists
72829,191,3,"108,05",5,1,1,7,Mid-Value,Potential Loyalists
72830,661,1,"43,7",4,1,1,6,Mid-Value,Potential Loyalists
72831,1211,4,"415,1",2,1,1,4,Low-Value,Can't Lose
72832,140,2,"279,0",5,1,1,7,Mid-Value,Potential Loyalists
72834,761,7,"244,05",3,2,1,6,Mid-Value,Potential Loyalists
72835,40,1,"7,5",5,1,1,7,Mid-Value,Potential Loyalists
72836,304,1,"38,35",5,1,1,7,Mid-Value,Potential Loyalists
72837,21,3,"70,35",5,1,1,7,Mid-Value,Potential Loyalists
72839,839,2,"70,95",3,1,1,5,Low-Value,At Risk Customers
72842,1138,3,"63,60000000000001",2,1,1,4,Low-Value,Can't Lose
72844,1400,2,"110,15",2,1,1,4,Low-Value,Can't Lose
72846,194,6,"301,65",5,1,1,7,Mid-Value,Potential Loyalists
72847,593,2,"128,4",4,1,1,6,Mid-Value,Potential Loyalists
72848,8,3,"208,04999999999998",5,1,1,7,Mid-Value,Potential Loyalists
72849,337,2,"131,55",5,1,1,7,Mid-Value,Potential Loyalists
72850,218,1,"23,6",5,1,1,7,Mid-Value,Potential Loyalists
72851,1105,1,"34,1",2,1,1,4,Low-Value,Can't Lose
72852,511,1,"80,1",4,1,1,6,Mid-Value,Potential Loyalists
72853,124,2,"126,6",5,1,1,7,Mid-Value,Potential Loyalists
72854,652,2,"122,19999999999999",4,1,1,6,Mid-Value,Potential Loyalists
72855,267,5,"279,05",5,1,1,7,Mid-Value,Potential Loyalists
72857,757,3,"716,8",3,1,2,6,Mid-Value,Potential Loyalists
72860,1591,1,"48,9",1,1,1,3,Low-Value,Lost
72861,434,4,"98,4",4,1,1,6,Mid-Value,Potential Loyalists
72862,1508,2,"41,650000000000006",1,1,1,3,Low-Value,Lost
72865,131,6,"289,35",5,1,1,7,Mid-Value,Potential Loyalists
72866,24,7,"464,24999999999994",5,2,1,8,High-Value,Potential Loyalists
72867,22,2,"62,1",5,1,1,7,Mid-Value,Potential Loyalists
72869,26,6,"303,15",5,1,1,7,Mid-Value,Potential Loyalists
72870,757,2,"15,75",3,1,1,5,Low-Value,At Risk Customers
72871,1117,1,"5,9",2,1,1,4,Low-Value,Can't Lose
72872,235,3,"52,5",5,1,1,7,Mid-Value,Potential Loyalists
72873,713,2,"47,0",4,1,1,6,Mid-Value,Potential Loyalists
72874,31,4,"44,099999999999994",5,1,1,7,Mid-Value,Potential Loyalists
72876,227,1,"23,75",5,1,1,7,Mid-Value,Potential Loyalists
72877,420,3,"52,9",4,1,1,6,Mid-Value,Potential Loyalists
72878,908,2,"75,1",3,1,1,5,Low-Value,At Risk Customers
72879,799,3,"88,3",3,1,1,5,Low-Value,At Risk Customers
72880,0,11,"1672,55",5,2,3,10,High-Value,Champions
72881,1176,3,"211,75",2,1,1,4,Low-Value,Can't Lose
72882,1405,1,"2,7",2,1,1,4,Low-Value,Can't Lose
72883,47,8,"215,8",5,2,1,8,High-Value,Potential Loyalists
72884,176,5,"118,0",5,1,1,7,Mid-Value,Potential Loyalists
72886,1033,2,"67,45",3,1,1,5,Low-Value,At Risk Customers
72887,145,9,"905,5",5,2,2,9,High-Value,Champions
72890,1093,1,"124,9",3,1,1,5,Low-Value,At Risk Customers
72891,36,3,"415,2",5,1,1,7,Mid-Value,Potential Loyalists
72893,1740,3,"321,25",1,1,1,3,Low-Value,Lost
72895,1491,3,"258,4",1,1,1,3,Low-Value,Lost
72896,1432,2,"471,8",2,1,1,4,Low-Value,Can't Lose
72897,393,5,"165,5",4,1,1,6,Mid-Value,Potential Loyalists
72899,622,2,"115,6",4,1,1,6,Mid-Value,Potential Loyalists
72900,650,1,"19,9",4,1,1,6,Mid-Value,Potential Loyalists
72902,1134,1,"64,5",2,1,1,4,Low-Value,Can't Lose
72903,49,8,"1249,7",5,2,2,9,High-Value,Champions
72904,116,11,"573,15",5,2,1,8,High-Value,Potential Loyalists
72905,30,2,"54,349999999999994",5,1,1,7,Mid-Value,Potential Loyalists
72907,953,1,"23,9",3,1,1,5,Low-Value,At Risk Customers
72908,66,2,"83,35",5,1,1,7,Mid-Value,Potential Loyalists
72910,1152,1,"48,15",2,1,1,4,Low-Value,Can't Lose
72911,24,7,"368,65000000000003",5,2,1,8,High-Value,Potential Loyalists
72912,1030,1,"24,5",3,1,1,5,Low-Value,At Risk Customers
72913,1617,1,"98,7",1,1,1,3,Low-Value,Lost
72914,774,2,"118,0",3,1,1,5,Low-Value,At Risk Customers
72915,702,4,"240,6",4,1,1,6,Mid-Value,Potential Loyalists
72916,1503,1,"9,1",1,1,1,3,Low-Value,Lost
72917,57,6,"565,45",5,1,1,7,Mid-Value,Potential Loyalists
72918,70,2,"112,1",5,1,1,7,Mid-Value,Potential Loyalists
72925,1659,3,"110,55",1,1,1,3,Low-Value,Lost
72927,25,4,"104,25",5,1,1,7,Mid-Value,Potential Loyalists
72928,346,7,"147,2",5,2,1,8,High-Value,Potential Loyalists
72931,686,3,"60,5",4,1,1,6,Mid-Value,Potential Loyalists
72933,284,1,"20,0",5,1,1,7,Mid-Value,Potential Loyalists
72934,394,3,"167,8",4,1,1,6,Mid-Value,Potential Loyalists
72935,386,2,"87,3",4,1,1,6,Mid-Value,Potential Loyalists
72936,1204,2,"276,25",2,1,1,4,Low-Value,Can't Lose
72939,84,3,"55,75",5,1,1,7,Mid-Value,Potential Loyalists
72940,177,2,"119,5",5,1,1,7,Mid-Value,Potential Loyalists
72941,637,3,"126,45",4,1,1,6,Mid-Value,Potential Loyalists
72942,15,4,"130,6",5,1,1,7,Mid-Value,Potential Loyalists
72943,1123,2,"73,0",2,1,1,4,Low-Value,Can't Lose
72945,1138,2,"250,9",2,1,1,4,Low-Value,Can't Lose
72947,1611,1,"30,3",1,1,1,3,Low-Value,Lost
72948,1823,1,"74,9",1,1,1,3,Low-Value,Lost
72949,915,3,"77,7",3,1,1,5,Low-Value,At Risk Customers
72950,129,5,"166,45",5,1,1,7,Mid-Value,Potential Loyalists
72953,36,8,"453,35",5,2,1,8,High-Value,Potential Loyalists
72954,49,3,"83,55",5,1,1,7,Mid-Value,Potential Loyalists
72955,363,1,"28,75",5,1,1,7,Mid-Value,Potential Loyalists
72956,148,2,"167,9",5,1,1,7,Mid-Value,Potential Loyalists
72957,368,3,"132,05",4,1,1,6,Mid-Value,Potential Loyalists
72961,137,2,"233,3",5,1,1,7,Mid-Value,Potential Loyalists
72962,866,3,"88,45",3,1,1,5,Low-Value,At Risk Customers
72963,1450,1,"86,65",2,1,1,4,Low-Value,Can't Lose
72964,1009,2,"141,1",3,1,1,5,Low-Value,At Risk Customers
72966,524,3,"77,15",4,1,1,6,Mid-Value,Potential Loyalists
72968,239,4,"160,3",5,1,1,7,Mid-Value,Potential Loyalists
72972,773,1,"8,85",3,1,1,5,Low-Value,At Risk Customers
72973,169,1,"33,5",5,1,1,7,Mid-Value,Potential Loyalists
72974,607,3,"305,20000000000005",4,1,1,6,Mid-Value,Potential Loyalists
72978,802,2,"93,9",3,1,1,5,Low-Value,At Risk Customers
72979,51,2,"52,449999999999996",5,1,1,7,Mid-Value,Potential Loyalists
72980,16,8,"554,6",5,2,1,8,High-Value,Potential Loyalists
72981,291,7,"366,8",5,2,1,8,High-Value,Potential Loyalists
72984,386,5,"152,7",4,1,1,6,Mid-Value,Potential Loyalists
72985,2,1,"51,75",5,1,1,7,Mid-Value,Potential Loyalists
72986,889,1,"6,1",3,1,1,5,Low-Value,At Risk Customers
72987,173,6,"360,2",5,1,1,7,Mid-Value,Potential Loyalists
72988,84,2,"37,349999999999994",5,1,1,7,Mid-Value,Potential Loyalists
72991,790,2,"102,0",3,1,1,5,Low-Value,At Risk Customers
72992,21,5,"226,2",5,1,1,7,Mid-Value,Potential Loyalists
72995,1090,6,"373,75",3,1,1,5,Low-Value,At Risk Customers
72996,971,1,"80,9",3,1,1,5,Low-Value,At Risk Customers
72997,137,5,"272,4",5,1,1,7,Mid-Value,Potential Loyalists
73000,135,3,"211,95",5,1,1,7,Mid-Value,Potential Loyalists
73001,146,2,"96,95",5,1,1,7,Mid-Value,Potential Loyalists
73002,412,3,"44,9",4,1,1,6,Mid-Value,Potential Loyalists
73006,416,2,"74,3",4,1,1,6,Mid-Value,Potential Loyalists
73007,716,2,"121,5",4,1,1,6,Mid-Value,Potential Loyalists
73009,133,3,"270,9",5,1,1,7,Mid-Value,Potential Loyalists
73010,1365,1,"13,8",2,1,1,4,Low-Value,Can't Lose
73011,80,8,"310,0",5,2,1,8,High-Value,Potential Loyalists
73015,44,1,"95,65",5,1,1,7,Mid-Value,Potential Loyalists
73016,195,4,"101,1",5,1,1,7,Mid-Value,Potential Loyalists
73017,207,2,"43,3",5,1,1,7,Mid-Value,Potential Loyalists
73019,877,4,"522,5",3,1,1,5,Low-Value,At Risk Customers
73021,120,3,"91,15",5,1,1,7,Mid-Value,Potential Loyalists
73023,1421,1,"72,35",2,1,1,4,Low-Value,Can't Lose
73024,1341,3,"286,15000000000003",2,1,1,4,Low-Value,Can't Lose
73026,150,5,"403,40000000000003",5,1,1,7,Mid-Value,Potential Loyalists
73027,280,2,"161,75",5,1,1,7,Mid-Value,Potential Loyalists
73028,139,4,"119,85000000000001",5,1,1,7,Mid-Value,Potential Loyalists
73031,982,2,"100,8",3,1,1,5,Low-Value,At Risk Customers
73033,612,2,"75,25",4,1,1,6,Mid-Value,Potential Loyalists
73035,419,7,"316,1",4,2,1,7,Mid-Value,Potential Loyalists
73036,469,2,"301,5",4,1,1,6,Mid-Value,Potential Loyalists
73037,395,2,"45,75",4,1,1,6,Mid-Value,Potential Loyalists
73038,334,1,"93,4",5,1,1,7,Mid-Value,Potential Loyalists
73039,1397,2,"84,75",2,1,1,4,Low-Value,Can't Lose
73041,133,3,"128,05",5,1,1,7,Mid-Value,Potential Loyalists
73043,420,2,"164,75",4,1,1,6,Mid-Value,Potential Loyalists
73044,572,2,"330,84999999999997",4,1,1,6,Mid-Value,Potential Loyalists
73046,204,7,"367,5",5,2,1,8,High-Value,Potential Loyalists
73047,1821,1,"8,2",1,1,1,3,Low-Value,Lost
73050,104,9,"955,55",5,2,2,9,High-Value,Champions
73053,1334,2,"85,85",2,1,1,4,Low-Value,Can't Lose
73059,242,1,"84,0",5,1,1,7,Mid-Value,Potential Loyalists
73060,805,1,"13,85",3,1,1,5,Low-Value,At Risk Customers
73062,851,3,"117,0",3,1,1,5,Low-Value,At Risk Customers
73066,1281,1,"17,1",2,1,1,4,Low-Value,Can't Lose
73072,309,4,"119,6",5,1,1,7,Mid-Value,Potential Loyalists
73073,215,2,"161,15",5,1,1,7,Mid-Value,Potential Loyalists
73075,1621,1,"78,9",1,1,1,3,Low-Value,Lost
73076,252,1,"59,05",5,1,1,7,Mid-Value,Potential Loyalists
73081,377,7,"497,35",4,2,1,7,Mid-Value,Potential Loyalists
73082,1,3,"347,7",5,1,1,7,Mid-Value,Potential Loyalists
73083,976,1,"85,5",3,1,1,5,Low-Value,At Risk Customers
73085,1676,1,"63,9",1,1,1,3,Low-Value,Lost
73087,385,2,"70,05",4,1,1,6,Mid-Value,Potential Loyalists
73091,206,5,"579,75",5,1,1,7,Mid-Value,Potential Loyalists
73094,1166,1,"79,0",2,1,1,4,Low-Value,Can't Lose
73095,537,5,"652,35",4,1,1,6,Mid-Value,Potential Loyalists
73097,1101,1,"11,3",2,1,1,4,Low-Value,Can't Lose
73098,1629,1,"118,75",1,1,1,3,Low-Value,Lost
73099,22,2,"152,14999999999998",5,1,1,7,Mid-Value,Potential Loyalists
73101,770,2,"58,99999999999999",3,1,1,5,Low-Value,At Risk Customers
73102,1114,3,"87,39999999999999",2,1,1,4,Low-Value,Can't Lose
73103,138,2,"96,6",5,1,1,7,Mid-Value,Potential Loyalists
73104,87,2,"40,95",5,1,1,7,Mid-Value,Potential Loyalists
73106,440,3,"136,55",4,1,1,6,Mid-Value,Potential Loyalists
73107,737,3,"270,15",3,1,1,5,Low-Value,At Risk Customers
73108,591,2,"63,300000000000004",4,1,1,6,Mid-Value,Potential Loyalists
73110,92,6,"276,65",5,1,1,7,Mid-Value,Potential Loyalists
73111,33,4,"303,2",5,1,1,7,Mid-Value,Potential Loyalists
73112,374,5,"359,25",4,1,1,6,Mid-Value,Potential Loyalists
73114,1636,1,"143,2",1,1,1,3,Low-Value,Lost
73116,778,4,"667,35",3,1,2,6,Mid-Value,Potential Loyalists
73117,1190,1,"68,7",2,1,1,4,Low-Value,Can't Lose
73121,889,4,"165,85",3,1,1,5,Low-Value,At Risk Customers
73122,637,2,"303,2",4,1,1,6,Mid-Value,Potential Loyalists
73125,173,2,"38,5",5,1,1,7,Mid-Value,Potential Loyalists
73126,956,3,"218,2",3,1,1,5,Low-Value,At Risk Customers
73128,270,2,"94,45",5,1,1,7,Mid-Value,Potential Loyalists
73133,154,2,"271,09999999999997",5,1,1,7,Mid-Value,Potential Loyalists
73137,1266,2,"35,95",2,1,1,4,Low-Value,Can't Lose
73138,217,1,"111,1",5,1,1,7,Mid-Value,Potential Loyalists
73139,17,3,"357,8",5,1,1,7,Mid-Value,Potential Loyalists
73140,446,2,"227,95",4,1,1,6,Mid-Value,Potential Loyalists
73142,3,3,"54,15",5,1,1,7,Mid-Value,Potential Loyalists
73144,41,1,"26,849999999999998",5,1,1,7,Mid-Value,Potential Loyalists
73145,851,2,"93,94999999999999",3,1,1,5,Low-Value,At Risk Customers
73147,577,4,"109,45",4,1,1,6,Mid-Value,Potential Loyalists
73148,419,6,"136,3",4,1,1,6,Mid-Value,Potential Loyalists
73151,177,5,"485,9",5,1,1,7,Mid-Value,Potential Loyalists
73153,4,4,"354,35",5,1,1,7,Mid-Value,Potential Loyalists
73156,5,1,"145,2",5,1,1,7,Mid-Value,Potential Loyalists
73158,283,2,"75,7",5,1,1,7,Mid-Value,Potential Loyalists
73159,445,2,"181,39999999999998",4,1,1,6,Mid-Value,Potential Loyalists
73160,263,5,"145,55",5,1,1,7,Mid-Value,Potential Loyalists
73163,457,8,"318,05",4,2,1,7,Mid-Value,Potential Loyalists
73165,1398,1,"9,65",2,1,1,4,Low-Value,Can't Lose
73166,739,1,"45,9",3,1,1,5,Low-Value,At Risk Customers
73167,195,5,"332,40000000000003",5,1,1,7,Mid-Value,Potential Loyalists
73169,1468,1,"81,7",1,1,1,3,Low-Value,Lost
73171,548,1,"18,2",4,1,1,6,Mid-Value,Potential Loyalists
73174,41,8,"555,85",5,2,1,8,High-Value,Potential Loyalists
73178,1,6,"410,1",5,1,1,7,Mid-Value,Potential Loyalists
73182,26,6,"408,04999999999995",5,1,1,7,Mid-Value,Potential Loyalists
73183,1414,1,"7,85",2,1,1,4,Low-Value,Can't Lose
73184,1261,1,"114,6",2,1,1,4,Low-Value,Can't Lose
73185,48,2,"99,0",5,1,1,7,Mid-Value,Potential Loyalists
73186,487,5,"176,15",4,1,1,6,Mid-Value,Potential Loyalists
73187,42,3,"130,95",5,1,1,7,Mid-Value,Potential Loyalists
73188,999,1,"23,65",3,1,1,5,Low-Value,At Risk Customers
73189,149,11,"615,65",5,2,1,8,High-Value,Potential Loyalists
73190,1490,1,"170,4",1,1,1,3,Low-Value,Lost
73193,19,5,"183,1",5,1,1,7,Mid-Value,Potential Loyalists
73194,632,1,"143,25",4,1,1,6,Mid-Value,Potential Loyalists
73195,571,1,"168,8",4,1,1,6,Mid-Value,Potential Loyalists
73196,1338,1,"55,0",2,1,1,4,Low-Value,Can't Lose
73197,42,15,"695,6999999999999",5,3,2,10,High-Value,Champions
73198,193,1,"70,35",5,1,1,7,Mid-Value,Potential Loyalists
73200,398,4,"119,69999999999999",4,1,1,6,Mid-Value,Potential Loyalists
73202,144,2,"35,95",5,1,1,7,Mid-Value,Potential Loyalists
73203,191,8,"480,5",5,2,1,8,High-Value,Potential Loyalists
73204,672,3,"85,1",4,1,1,6,Mid-Value,Potential Loyalists
73205,665,2,"108,9",4,1,1,6,Mid-Value,Potential Loyalists
73206,1478,2,"991,75",1,1,2,4,Low-Value,Can't Lose
73207,82,6,"183,5",5,1,1,7,Mid-Value,Potential Loyalists
73210,1128,2,"74,45",2,1,1,4,Low-Value,Can't Lose
73211,96,2,"85,3",5,1,1,7,Mid-Value,Potential Loyalists
73212,232,2,"167,10000000000002",5,1,1,7,Mid-Value,Potential Loyalists
73213,1785,1,"14,7",1,1,1,3,Low-Value,Lost
73214,981,1,"58,0",3,1,1,5,Low-Value,At Risk Customers
73216,512,1,"99,1",4,1,1,6,Mid-Value,Potential Loyalists
73217,1074,1,"9,4",3,1,1,5,Low-Value,At Risk Customers
73218,1747,2,"160,35",1,1,1,3,Low-Value,Lost
73222,3,5,"426,4",5,1,1,7,Mid-Value,Potential Loyalists
73226,530,1,"21,0",4,1,1,6,Mid-Value,Potential Loyalists
73228,917,1,"49,5",3,1,1,5,Low-Value,At Risk Customers
73230,181,2,"79,7",5,1,1,7,Mid-Value,Potential Loyalists
73232,186,7,"464,65",5,2,1,8,High-Value,Potential Loyalists
73233,832,1,"10,45",3,1,1,5,Low-Value,At Risk Customers
73235,435,1,"251,35",4,1,1,6,Mid-Value,Potential Loyalists
73236,1308,1,"206,15",2,1,1,4,Low-Value,Can't Lose
73237,1154,2,"333,9",2,1,1,4,Low-Value,Can't Lose
73239,101,10,"1016,15",5,2,2,9,High-Value,Champions
73240,564,2,"222,1",4,1,1,6,Mid-Value,Potential Loyalists
73241,367,5,"179,5",4,1,1,6,Mid-Value,Potential Loyalists
73242,534,3,"136,95",4,1,1,6,Mid-Value,Potential Loyalists
73243,94,3,"717,0",5,1,2,8,High-Value,Potential Loyalists
73244,122,7,"193,95",5,2,1,8,High-Value,Potential Loyalists
73245,342,1,"62,6",5,1,1,7,Mid-Value,Potential Loyalists
73246,121,4,"298,6",5,1,1,7,Mid-Value,Potential Loyalists
73247,1074,1,"17,8",3,1,1,5,Low-Value,At Risk Customers
73249,1710,1,"56,3",1,1,1,3,Low-Value,Lost
73251,67,3,"153,5",5,1,1,7,Mid-Value,Potential Loyalists
73253,858,5,"83,05",3,1,1,5,Low-Value,At Risk Customers
73256,606,5,"203,3",4,1,1,6,Mid-Value,Potential Loyalists
73257,231,6,"360,5",5,1,1,7,Mid-Value,Potential Loyalists
73260,250,6,"125,85",5,1,1,7,Mid-Value,Potential Loyalists
73261,11,9,"431,55",5,2,1,8,High-Value,Potential Loyalists
73262,78,5,"470,05",5,1,1,7,Mid-Value,Potential Loyalists
73264,52,5,"179,0",5,1,1,7,Mid-Value,Potential Loyalists
73265,305,4,"287,79999999999995",5,1,1,7,Mid-Value,Potential Loyalists
73266,417,3,"159,7",4,1,1,6,Mid-Value,Potential Loyalists
73267,26,9,"689,3",5,2,2,9,High-Value,Champions
73268,166,2,"96,1",5,1,1,7,Mid-Value,Potential Loyalists
73270,1013,3,"160,25",3,1,1,5,Low-Value,At Risk Customers
73272,383,8,"629,4",4,2,1,7,Mid-Value,Potential Loyalists
73273,166,8,"457,75",5,2,1,8,High-Value,Potential Loyalists
73275,407,2,"48,7",4,1,1,6,Mid-Value,Potential Loyalists
73276,69,3,"101,2",5,1,1,7,Mid-Value,Potential Loyalists
73279,952,1,"36,4",3,1,1,5,Low-Value,At Risk Customers
73280,604,4,"712,6",4,1,2,7,Mid-Value,Potential Loyalists
73282,835,5,"134,70000000000002",3,1,1,5,Low-Value,At Risk Customers
73283,413,1,"11,0",4,1,1,6,Mid-Value,Potential Loyalists
73284,39,6,"371,5",5,1,1,7,Mid-Value,Potential Loyalists
73285,349,2,"29,849999999999998",5,1,1,7,Mid-Value,Potential Loyalists
73286,355,5,"83,55",5,1,1,7,Mid-Value,Potential Loyalists
73288,609,3,"146,2",4,1,1,6,Mid-Value,Potential Loyalists
73290,39,5,"197,65",5,1,1,7,Mid-Value,Potential Loyalists
73292,92,2,"91,15",5,1,1,7,Mid-Value,Potential Loyalists
73294,27,5,"403,45",5,1,1,7,Mid-Value,Potential Loyalists
73295,1306,2,"36,85",2,1,1,4,Low-Value,Can't Lose
73297,340,2,"80,45",5,1,1,7,Mid-Value,Potential Loyalists
73298,471,2,"33,0",4,1,1,6,Mid-Value,Potential Loyalists
73299,304,2,"320,6",5,1,1,7,Mid-Value,Potential Loyalists
73300,841,3,"435,1",3,1,1,5,Low-Value,At Risk Customers
73301,45,6,"460,95000000000005",5,1,1,7,Mid-Value,Potential Loyalists
73302,766,4,"161,6",3,1,1,5,Low-Value,At Risk Customers
73303,133,1,"34,2",5,1,1,7,Mid-Value,Potential Loyalists
73304,208,3,"364,95",5,1,1,7,Mid-Value,Potential Loyalists
73305,744,4,"229,9",3,1,1,5,Low-Value,At Risk Customers
73307,70,2,"56,5",5,1,1,7,Mid-Value,Potential Loyalists
73308,106,5,"133,6",5,1,1,7,Mid-Value,Potential Loyalists
73309,545,3,"51,15",4,1,1,6,Mid-Value,Potential Loyalists
73310,502,1,"207,29999999999998",4,1,1,6,Mid-Value,Potential Loyalists
73314,1773,1,"11,35",1,1,1,3,Low-Value,Lost
73315,509,3,"21,0",4,1,1,6,Mid-Value,Potential Loyalists
73317,737,2,"121,35",3,1,1,5,Low-Value,At Risk Customers
73318,891,3,"81,95",3,1,1,5,Low-Value,At Risk Customers
73319,384,3,"454,45000000000005",4,1,1,6,Mid-Value,Potential Loyalists
73320,771,2,"84,6",3,1,1,5,Low-Value,At Risk Customers
73323,777,1,"5,7",3,1,1,5,Low-Value,At Risk Customers
73325,130,1,"75,6",5,1,1,7,Mid-Value,Potential Loyalists
73329,1324,2,"98,0",2,1,1,4,Low-Value,Can't Lose
73331,18,9,"438,75",5,2,1,8,High-Value,Potential Loyalists
73333,88,5,"277,40000000000003",5,1,1,7,Mid-Value,Potential Loyalists
73334,1593,1,"48,1",1,1,1,3,Low-Value,Lost
73336,157,2,"121,5",5,1,1,7,Mid-Value,Potential Loyalists
73337,904,2,"263,35",3,1,1,5,Low-Value,At Risk Customers
73338,22,3,"98,25",5,1,1,7,Mid-Value,Potential Loyalists
73339,461,2,"147,25",4,1,1,6,Mid-Value,Potential Loyalists
73340,34,2,"29,15",5,1,1,7,Mid-Value,Potential Loyalists
73341,629,2,"116,8",4,1,1,6,Mid-Value,Potential Loyalists
73342,1052,2,"68,5",3,1,1,5,Low-Value,At Risk Customers
73345,628,3,"179,1",4,1,1,6,Mid-Value,Potential Loyalists
73346,1692,1,"2,85",1,1,1,3,Low-Value,Lost
73347,404,5,"271,65",4,1,1,6,Mid-Value,Potential Loyalists
73351,99,10,"443,0",5,2,1,8,High-Value,Potential Loyalists
73353,582,10,"744,35",4,2,2,8,High-Value,Potential Loyalists
73354,788,3,"1037,8",3,1,2,6,Mid-Value,Potential Loyalists
73357,446,7,"426,90000000000003",4,2,1,7,Mid-Value,Potential Loyalists
73361,1411,1,"90,7",2,1,1,4,Low-Value,Can't Lose
73367,366,6,"341,85",4,1,1,6,Mid-Value,Potential Loyalists
73369,641,1,"9,25",4,1,1,6,Mid-Value,Potential Loyalists
73371,1605,1,"156,5",1,1,1,3,Low-Value,Lost
73372,201,6,"415,75",5,1,1,7,Mid-Value,Potential Loyalists
73374,155,3,"144,65",5,1,1,7,Mid-Value,Potential Loyalists
73375,1103,5,"773,55",2,1,2,5,Low-Value,At Risk Customers
73377,270,1,"247,25",5,1,1,7,Mid-Value,Potential Loyalists
73378,1047,3,"109,15",3,1,1,5,Low-Value,At Risk Customers
73381,808,1,"100,75",3,1,1,5,Low-Value,At Risk Customers
73383,36,5,"391,3",5,1,1,7,Mid-Value,Potential Loyalists
73385,1762,2,"25,55",1,1,1,3,Low-Value,Lost
73386,307,1,"18,9",5,1,1,7,Mid-Value,Potential Loyalists
73387,1388,1,"49,0",2,1,1,4,Low-Value,Can't Lose
73390,283,1,"95,1",5,1,1,7,Mid-Value,Potential Loyalists
73393,59,4,"220,20000000000002",5,1,1,7,Mid-Value,Potential Loyalists
73394,1209,2,"71,45",2,1,1,4,Low-Value,Can't Lose
73395,883,1,"84,4",3,1,1,5,Low-Value,At Risk Customers
73399,129,1,"1,2",5,1,1,7,Mid-Value,Potential Loyalists
73400,1678,2,"105,5",1,1,1,3,Low-Value,Lost
73403,209,4,"390,7",5,1,1,7,Mid-Value,Potential Loyalists
73404,304,1,"50,4",5,1,1,7,Mid-Value,Potential Loyalists
73405,353,1,"14,55",5,1,1,7,Mid-Value,Potential Loyalists
73407,385,3,"196,45",4,1,1,6,Mid-Value,Potential Loyalists
73408,1131,4,"630,45",2,1,1,4,Low-Value,Can't Lose
73411,1541,2,"61,199999999999996",1,1,1,3,Low-Value,Lost
73414,30,3,"118,60000000000001",5,1,1,7,Mid-Value,Potential Loyalists
73415,165,2,"40,0",5,1,1,7,Mid-Value,Potential Loyalists
73416,591,3,"134,35",4,1,1,6,Mid-Value,Potential Loyalists
73418,293,3,"79,75",5,1,1,7,Mid-Value,Potential Loyalists
73419,382,2,"188,3",4,1,1,6,Mid-Value,Potential Loyalists
73421,1114,5,"1023,9000000000001",2,1,2,5,Low-Value,At Risk Customers
73423,741,2,"144,3",3,1,1,5,Low-Value,At Risk Customers
73425,1575,1,"32,3",1,1,1,3,Low-Value,Lost
73426,1161,1,"18,299999999999997",2,1,1,4,Low-Value,Can't Lose
73428,17,7,"1113,2",5,2,2,9,High-Value,Champions
73430,588,3,"156,4",4,1,1,6,Mid-Value,Potential Loyalists
73432,437,5,"217,54999999999998",4,1,1,6,Mid-Value,Potential Loyalists
73433,150,1,"46,2",5,1,1,7,Mid-Value,Potential Loyalists
73435,146,3,"62,699999999999996",5,1,1,7,Mid-Value,Potential Loyalists
73436,166,6,"238,55",5,1,1,7,Mid-Value,Potential Loyalists
73438,534,1,"252,2",4,1,1,6,Mid-Value,Potential Loyalists
73439,795,1,"118,55",3,1,1,5,Low-Value,At Risk Customers
73440,26,15,"1104,5",5,3,2,10,High-Value,Champions
73441,742,7,"544,0",3,2,1,6,Mid-Value,Potential Loyalists
73443,269,7,"237,6",5,2,1,8,High-Value,Potential Loyalists
73446,294,1,"9,1",5,1,1,7,Mid-Value,Potential Loyalists
73447,1241,1,"33,1",2,1,1,4,Low-Value,Can't Lose
73449,630,3,"61,599999999999994",4,1,1,6,Mid-Value,Potential Loyalists
73450,722,1,"28,75",4,1,1,6,Mid-Value,Potential Loyalists
73455,401,2,"55,7",4,1,1,6,Mid-Value,Potential Loyalists
73456,1543,3,"202,2",1,1,1,3,Low-Value,Lost
73458,77,2,"481,15",5,1,1,7,Mid-Value,Potential Loyalists
73462,965,3,"252,54999999999998",3,1,1,5,Low-Value,At Risk Customers
73465,103,3,"91,35",5,1,1,7,Mid-Value,Potential Loyalists
73468,783,3,"148,3",3,1,1,5,Low-Value,At Risk Customers
73472,198,6,"94,55",5,1,1,7,Mid-Value,Potential Loyalists
73473,804,3,"110,25",3,1,1,5,Low-Value,At Risk Customers
73474,495,2,"274,35",4,1,1,6,Mid-Value,Potential Loyalists
73475,639,4,"272,8",4,1,1,6,Mid-Value,Potential Loyalists
73476,761,4,"218,75",3,1,1,5,Low-Value,At Risk Customers
73477,852,1,"251,39999999999998",3,1,1,5,Low-Value,At Risk Customers
73478,66,2,"138,9",5,1,1,7,Mid-Value,Potential Loyalists
73480,443,2,"34,0",4,1,1,6,Mid-Value,Potential Loyalists
73482,205,5,"180,7",5,1,1,7,Mid-Value,Potential Loyalists
73483,411,5,"260,9",4,1,1,6,Mid-Value,Potential Loyalists
73484,163,1,"143,9",5,1,1,7,Mid-Value,Potential Loyalists
73485,1195,5,"266,25",2,1,1,4,Low-Value,Can't Lose
73486,1736,1,"17,25",1,1,1,3,Low-Value,Lost
73488,412,3,"68,6",4,1,1,6,Mid-Value,Potential Loyalists
73489,922,1,"52,9",3,1,1,5,Low-Value,At Risk Customers
73490,620,4,"246,1",4,1,1,6,Mid-Value,Potential Loyalists
73491,151,7,"532,9",5,2,1,8,High-Value,Potential Loyalists
73493,883,2,"85,8",3,1,1,5,Low-Value,At Risk Customers
73494,797,5,"689,0",3,1,2,6,Mid-Value,Potential Loyalists
73497,1175,2,"82,15",2,1,1,4,Low-Value,Can't Lose
73499,1107,2,"21,4",2,1,1,4,Low-Value,Can't Lose
73500,1293,1,"33,6",2,1,1,4,Low-Value,Can't Lose
73502,342,2,"42,5",5,1,1,7,Mid-Value,Potential Loyalists
73503,89,2,"216,9",5,1,1,7,Mid-Value,Potential Loyalists
73504,544,6,"814,5999999999999",4,1,2,7,Mid-Value,Potential Loyalists
73505,261,3,"333,3",5,1,1,7,Mid-Value,Potential Loyalists
73508,49,6,"196,75",5,1,1,7,Mid-Value,Potential Loyalists
73509,1391,1,"37,5",2,1,1,4,Low-Value,Can't Lose
73510,393,6,"216,8",4,1,1,6,Mid-Value,Potential Loyalists
73511,152,2,"51,15",5,1,1,7,Mid-Value,Potential Loyalists
73512,575,2,"94,15",4,1,1,6,Mid-Value,Potential Loyalists
73513,181,4,"131,0",5,1,1,7,Mid-Value,Potential Loyalists
73514,700,1,"12,1",4,1,1,6,Mid-Value,Potential Loyalists
73515,249,8,"218,85000000000002",5,2,1,8,High-Value,Potential Loyalists
73516,45,3,"545,85",5,1,1,7,Mid-Value,Potential Loyalists
73520,1706,1,"296,6",1,1,1,3,Low-Value,Lost
73521,945,1,"80,9",3,1,1,5,Low-Value,At Risk Customers
73522,1122,2,"127,1",2,1,1,4,Low-Value,Can't Lose
73525,732,4,"866,1500000000001",3,1,2,6,Mid-Value,Potential Loyalists
73527,337,10,"731,05",5,2,2,9,High-Value,Champions
73528,178,1,"11,1",5,1,1,7,Mid-Value,Potential Loyalists
73530,110,7,"189,75",5,2,1,8,High-Value,Potential Loyalists
73531,1722,1,"70,2",1,1,1,3,Low-Value,Lost
73532,163,3,"1360,45",5,1,3,9,High-Value,Champions
73533,862,3,"387,15",3,1,1,5,Low-Value,At Risk Customers
73534,543,2,"108,8",4,1,1,6,Mid-Value,Potential Loyalists
73536,80,2,"144,15",5,1,1,7,Mid-Value,Potential Loyalists
73537,278,1,"87,15",5,1,1,7,Mid-Value,Potential Loyalists
73538,422,8,"675,5",4,2,2,8,High-Value,Potential Loyalists
73539,245,3,"157,45",5,1,1,7,Mid-Value,Potential Loyalists
73541,798,1,"203,2",3,1,1,5,Low-Value,At Risk Customers
73543,1228,3,"225,24999999999997",2,1,1,4,Low-Value,Can't Lose
73545,335,4,"301,70000000000005",5,1,1,7,Mid-Value,Potential Loyalists
73546,84,4,"596,1",5,1,1,7,Mid-Value,Potential Loyalists
73547,233,2,"33,3",5,1,1,7,Mid-Value,Potential Loyalists
73548,611,5,"524,6999999999999",4,1,1,6,Mid-Value,Potential Loyalists
73549,740,4,"144,55",3,1,1,5,Low-Value,At Risk Customers
73550,232,8,"529,05",5,2,1,8,High-Value,Potential Loyalists
73551,929,2,"175,1",3,1,1,5,Low-Value,At Risk Customers
73552,769,2,"27,8",3,1,1,5,Low-Value,At Risk Customers
73553,1472,1,"159,7",1,1,1,3,Low-Value,Lost
73559,258,1,"7,05",5,1,1,7,Mid-Value,Potential Loyalists
73560,378,10,"1320,7",4,2,2,8,High-Value,Potential Loyalists
73561,266,3,"118,1",5,1,1,7,Mid-Value,Potential Loyalists
73566,829,1,"189,14999999999998",3,1,1,5,Low-Value,At Risk Customers
73572,183,3,"598,8499999999999",5,1,1,7,Mid-Value,Potential Loyalists
73573,101,4,"97,4",5,1,1,7,Mid-Value,Potential Loyalists
73575,512,1,"167,55",4,1,1,6,Mid-Value,Potential Loyalists
73581,32,4,"251,05",5,1,1,7,Mid-Value,Potential Loyalists
73582,579,9,"1386,15",4,2,3,9,High-Value,Champions
73583,486,6,"292,0",4,1,1,6,Mid-Value,Potential Loyalists
73585,316,5,"208,05",5,1,1,7,Mid-Value,Potential Loyalists
73586,529,2,"157,3",4,1,1,6,Mid-Value,Potential Loyalists
73587,1244,2,"114,05",2,1,1,4,Low-Value,Can't Lose
73591,1715,1,"96,75",1,1,1,3,Low-Value,Lost
73592,540,1,"314,0",4,1,1,6,Mid-Value,Potential Loyalists
73595,288,1,"40,25",5,1,1,7,Mid-Value,Potential Loyalists
73596,372,6,"545,55",4,1,1,6,Mid-Value,Potential Loyalists
73597,663,5,"165,8",4,1,1,6,Mid-Value,Potential Loyalists
73598,1223,1,"20,0",2,1,1,4,Low-Value,Can't Lose
73599,762,1,"17,95",3,1,1,5,Low-Value,At Risk Customers
73600,46,2,"61,599999999999994",5,1,1,7,Mid-Value,Potential Loyalists
73601,1280,4,"200,65",2,1,1,4,Low-Value,Can't Lose
73602,127,5,"290,15",5,1,1,7,Mid-Value,Potential Loyalists
73605,84,4,"232,45",5,1,1,7,Mid-Value,Potential Loyalists
73606,1615,1,"350,4",1,1,1,3,Low-Value,Lost
73607,269,2,"61,3",5,1,1,7,Mid-Value,Potential Loyalists
73608,1314,1,"35,099999999999994",2,1,1,4,Low-Value,Can't Lose
73611,1317,1,"101,6",2,1,1,4,Low-Value,Can't Lose
73612,1287,2,"255,25",2,1,1,4,Low-Value,Can't Lose
73613,232,2,"35,5",5,1,1,7,Mid-Value,Potential Loyalists
73614,1262,1,"140,0",2,1,1,4,Low-Value,Can't Lose
73615,298,2,"72,0",5,1,1,7,Mid-Value,Potential Loyalists
73617,345,3,"353,95",5,1,1,7,Mid-Value,Potential Loyalists
73618,434,5,"686,4",4,1,2,7,Mid-Value,Potential Loyalists
73619,1321,1,"111,7",2,1,1,4,Low-Value,Can't Lose
73620,1743,1,"57,9",1,1,1,3,Low-Value,Lost
73621,1099,1,"41,6",2,1,1,4,Low-Value,Can't Lose
73626,680,3,"19,4",4,1,1,6,Mid-Value,Potential Loyalists
73627,1800,1,"56,1",1,1,1,3,Low-Value,Lost
73629,1212,1,"16,65",2,1,1,4,Low-Value,Can't Lose
73631,55,4,"54,35",5,1,1,7,Mid-Value,Potential Loyalists
73632,173,2,"31,9",5,1,1,7,Mid-Value,Potential Loyalists
73633,139,3,"120,1",5,1,1,7,Mid-Value,Potential Loyalists
73635,142,6,"196,65",5,1,1,7,Mid-Value,Potential Loyalists
73636,118,7,"400,7",5,2,1,8,High-Value,Potential Loyalists
73639,455,4,"263,65",4,1,1,6,Mid-Value,Potential Loyalists
73640,154,1,"86,3",5,1,1,7,Mid-Value,Potential Loyalists
73641,285,3,"147,14999999999998",5,1,1,7,Mid-Value,Potential Loyalists
73642,71,1,"12,25",5,1,1,7,Mid-Value,Potential Loyalists
73643,751,1,"119,9",3,1,1,5,Low-Value,At Risk Customers
73646,105,4,"202,1",5,1,1,7,Mid-Value,Potential Loyalists
73647,512,4,"407,54999999999995",4,1,1,6,Mid-Value,Potential Loyalists
73649,1498,1,"33,6",1,1,1,3,Low-Value,Lost
73652,1156,1,"71,55",2,1,1,4,Low-Value,Can't Lose
73653,487,1,"14,9",4,1,1,6,Mid-Value,Potential Loyalists
73654,749,2,"252,1",3,1,1,5,Low-Value,At Risk Customers
73655,15,2,"40,9",5,1,1,7,Mid-Value,Potential Loyalists
73662,225,1,"50,849999999999994",5,1,1,7,Mid-Value,Potential Loyalists
73663,306,1,"41,6",5,1,1,7,Mid-Value,Potential Loyalists
73664,33,3,"87,3",5,1,1,7,Mid-Value,Potential Loyalists
73665,235,1,"19,15",5,1,1,7,Mid-Value,Potential Loyalists
73667,1234,4,"505,25",2,1,1,4,Low-Value,Can't Lose
73668,798,1,"15,35",3,1,1,5,Low-Value,At Risk Customers
73669,492,2,"225,25",4,1,1,6,Mid-Value,Potential Loyalists
73670,1525,1,"60,65",1,1,1,3,Low-Value,Lost
73673,59,4,"532,6",5,1,1,7,Mid-Value,Potential Loyalists
73677,1116,1,"205,4",2,1,1,4,Low-Value,Can't Lose
73678,242,1,"23,0",5,1,1,7,Mid-Value,Potential Loyalists
73679,377,3,"430,7",4,1,1,6,Mid-Value,Potential Loyalists
73680,44,4,"152,8",5,1,1,7,Mid-Value,Potential Loyalists
73681,200,1,"21,299999999999997",5,1,1,7,Mid-Value,Potential Loyalists
73683,245,2,"121,64999999999999",5,1,1,7,Mid-Value,Potential Loyalists
73688,69,8,"443,75000000000006",5,2,1,8,High-Value,Potential Loyalists
73689,740,1,"20,1",3,1,1,5,Low-Value,At Risk Customers
73691,1273,1,"136,2",2,1,1,4,Low-Value,Can't Lose
73692,969,1,"57,05",3,1,1,5,Low-Value,At Risk Customers
73700,1244,4,"206,25",2,1,1,4,Low-Value,Can't Lose
73701,47,5,"757,55",5,1,2,8,High-Value,Potential Loyalists
73702,862,2,"57,65",3,1,1,5,Low-Value,At Risk Customers
73703,29,9,"875,35",5,2,2,9,High-Value,Champions
73704,3,2,"90,2",5,1,1,7,Mid-Value,Potential Loyalists
73705,1,4,"569,1",5,1,1,7,Mid-Value,Potential Loyalists
73706,843,2,"348,8",3,1,1,5,Low-Value,At Risk Customers
73709,0,2,"62,449999999999996",5,1,1,7,Mid-Value,Potential Loyalists
73710,579,1,"405,0",4,1,1,6,Mid-Value,Potential Loyalists
73713,53,2,"24,25",5,1,1,7,Mid-Value,Potential Loyalists
73715,983,2,"68,10000000000001",3,1,1,5,Low-Value,At Risk Customers
73716,43,2,"31,65",5,1,1,7,Mid-Value,Potential Loyalists
73718,1665,1,"55,4",1,1,1,3,Low-Value,Lost
73720,866,4,"114,14999999999999",3,1,1,5,Low-Value,At Risk Customers
73721,60,11,"614,2",5,2,1,8,High-Value,Potential Loyalists
73724,350,5,"336,05",5,1,1,7,Mid-Value,Potential Loyalists
73727,1065,2,"17,15",3,1,1,5,Low-Value,At Risk Customers
73728,428,4,"160,55",4,1,1,6,Mid-Value,Potential Loyalists
73729,297,2,"155,75",5,1,1,7,Mid-Value,Potential Loyalists
73730,52,3,"293,2",5,1,1,7,Mid-Value,Potential Loyalists
73733,67,3,"138,1",5,1,1,7,Mid-Value,Potential Loyalists
73735,207,6,"437,2",5,1,1,7,Mid-Value,Potential Loyalists
73736,1824,1,"18,05",1,1,1,3,Low-Value,Lost
73738,41,4,"175,54999999999998",5,1,1,7,Mid-Value,Potential Loyalists
73739,1423,1,"64,95",2,1,1,4,Low-Value,Can't Lose
73741,1088,1,"9,4",3,1,1,5,Low-Value,At Risk Customers
73743,17,3,"210,65",5,1,1,7,Mid-Value,Potential Loyalists
73746,1651,1,"50,2",1,1,1,3,Low-Value,Lost
73747,560,3,"144,75",4,1,1,6,Mid-Value,Potential Loyalists
73749,71,1,"27,5",5,1,1,7,Mid-Value,Potential Loyalists
73751,671,2,"58,849999999999994",4,1,1,6,Mid-Value,Potential Loyalists
73752,1298,1,"51,0",2,1,1,4,Low-Value,Can't Lose
73753,59,3,"119,4",5,1,1,7,Mid-Value,Potential Loyalists
73754,1102,3,"590,8000000000001",2,1,1,4,Low-Value,Can't Lose
73755,147,2,"264,4",5,1,1,7,Mid-Value,Potential Loyalists
73760,1694,1,"5,7",1,1,1,3,Low-Value,Lost
73762,535,1,"16,1",4,1,1,6,Mid-Value,Potential Loyalists
73764,122,4,"135,7",5,1,1,7,Mid-Value,Potential Loyalists
73765,655,1,"23,45",4,1,1,6,Mid-Value,Potential Loyalists
73766,766,1,"50,4",3,1,1,5,Low-Value,At Risk Customers
73767,1348,1,"85,6",2,1,1,4,Low-Value,Can't Lose
73769,79,3,"93,95",5,1,1,7,Mid-Value,Potential Loyalists
73770,14,8,"413,8",5,2,1,8,High-Value,Potential Loyalists
73772,1019,1,"35,9",3,1,1,5,Low-Value,At Risk Customers
73773,193,4,"141,05",5,1,1,7,Mid-Value,Potential Loyalists
73774,410,3,"126,1",4,1,1,6,Mid-Value,Potential Loyalists
73777,45,8,"281,3",5,2,1,8,High-Value,Potential Loyalists
73779,287,2,"66,45",5,1,1,7,Mid-Value,Potential Loyalists
73780,222,2,"34,95",5,1,1,7,Mid-Value,Potential Loyalists
73783,154,2,"31,650000000000002",5,1,1,7,Mid-Value,Potential Loyalists
73784,97,6,"316,55",5,1,1,7,Mid-Value,Potential Loyalists
73786,717,3,"32,800000000000004",4,1,1,6,Mid-Value,Potential Loyalists
73788,1281,1,"16,950000000000003",2,1,1,4,Low-Value,Can't Lose
73789,1175,2,"6,9",2,1,1,4,Low-Value,Can't Lose
73790,1715,1,"4,15",1,1,1,3,Low-Value,Lost
73791,1546,2,"154,6",1,1,1,3,Low-Value,Lost
73792,383,3,"375,4",4,1,1,6,Mid-Value,Potential Loyalists
73795,170,6,"198,4",5,1,1,7,Mid-Value,Potential Loyalists
73796,1361,1,"22,45",2,1,1,4,Low-Value,Can't Lose
73798,478,1,"8,3",4,1,1,6,Mid-Value,Potential Loyalists
73800,5,5,"322,2",5,1,1,7,Mid-Value,Potential Loyalists
73802,1557,1,"6,7",1,1,1,3,Low-Value,Lost
73803,523,6,"448,95",4,1,1,6,Mid-Value,Potential Loyalists
73805,29,4,"827,05",5,1,2,8,High-Value,Potential Loyalists
73806,223,3,"117,95000000000002",5,1,1,7,Mid-Value,Potential Loyalists
73808,9,9,"360,65",5,2,1,8,High-Value,Potential Loyalists
73809,454,3,"34,75",4,1,1,6,Mid-Value,Potential Loyalists
73810,1252,3,"204,39999999999998",2,1,1,4,Low-Value,Can't Lose
73811,1513,1,"31,95",1,1,1,3,Low-Value,Lost
73815,867,3,"111,5",3,1,1,5,Low-Value,At Risk Customers
73818,38,3,"37,0",5,1,1,7,Mid-Value,Potential Loyalists
73819,86,8,"483,85",5,2,1,8,High-Value,Potential Loyalists
73820,998,1,"124,19999999999999",3,1,1,5,Low-Value,At Risk Customers
73821,1363,5,"127,3",2,1,1,4,Low-Value,Can't Lose
73823,160,3,"242,9",5,1,1,7,Mid-Value,Potential Loyalists
73825,18,9,"769,5",5,2,2,9,High-Value,Champions
73826,645,1,"7,8",4,1,1,6,Mid-Value,Potential Loyalists
73827,132,3,"310,0",5,1,1,7,Mid-Value,Potential Loyalists
73829,70,4,"334,95000000000005",5,1,1,7,Mid-Value,Potential Loyalists
73830,263,3,"290,9",5,1,1,7,Mid-Value,Potential Loyalists
73832,315,4,"244,9",5,1,1,7,Mid-Value,Potential Loyalists
73833,335,8,"413,25",5,2,1,8,High-Value,Potential Loyalists
73834,678,5,"268,05",4,1,1,6,Mid-Value,Potential Loyalists
73837,240,2,"169,85000000000002",5,1,1,7,Mid-Value,Potential Loyalists
73841,1224,1,"33,599999999999994",2,1,1,4,Low-Value,Can't Lose
73842,677,2,"271,8",4,1,1,6,Mid-Value,Potential Loyalists
73843,302,1,"67,8",5,1,1,7,Mid-Value,Potential Loyalists
73844,21,3,"232,05",5,1,1,7,Mid-Value,Potential Loyalists
73845,334,8,"854,5",5,2,2,9,High-Value,Champions
73846,237,3,"84,1",5,1,1,7,Mid-Value,Potential Loyalists
73847,439,2,"225,95",4,1,1,6,Mid-Value,Potential Loyalists
73851,218,1,"36,3",5,1,1,7,Mid-Value,Potential Loyalists
73852,102,6,"1426,65",5,1,3,9,High-Value,Champions
73855,107,5,"818,9499999999999",5,1,2,8,High-Value,Potential Loyalists
73857,301,3,"77,1",5,1,1,7,Mid-Value,Potential Loyalists
73859,294,5,"593,9",5,1,1,7,Mid-Value,Potential Loyalists
73860,594,4,"170,55",4,1,1,6,Mid-Value,Potential Loyalists
73863,43,3,"65,98",5,1,1,7,Mid-Value,Potential Loyalists
73864,101,2,"67,8",5,1,1,7,Mid-Value,Potential Loyalists
73866,34,5,"617,85",5,1,1,7,Mid-Value,Potential Loyalists
73867,42,10,"502,05",5,2,1,8,High-Value,Potential Loyalists
73868,1702,3,"81,10000000000001",1,1,1,3,Low-Value,Lost
73872,1217,1,"76,6",2,1,1,4,Low-Value,Can't Lose
73873,1126,2,"254,0",2,1,1,4,Low-Value,Can't Lose
73874,201,2,"180,9",5,1,1,7,Mid-Value,Potential Loyalists
73875,570,3,"92,95",4,1,1,6,Mid-Value,Potential Loyalists
73876,431,4,"202,85",4,1,1,6,Mid-Value,Potential Loyalists
73877,717,1,"83,55",4,1,1,6,Mid-Value,Potential Loyalists
73878,450,3,"144,1",4,1,1,6,Mid-Value,Potential Loyalists
73879,117,5,"241,7",5,1,1,7,Mid-Value,Potential Loyalists
73880,558,3,"269,65",4,1,1,6,Mid-Value,Potential Loyalists
73881,44,6,"268,75",5,1,1,7,Mid-Value,Potential Loyalists
73884,99,7,"547,75",5,2,1,8,High-Value,Potential Loyalists
73885,447,1,"23,45",4,1,1,6,Mid-Value,Potential Loyalists
73887,0,5,"1320,3",5,1,2,8,High-Value,Potential Loyalists
73888,160,2,"62,650000000000006",5,1,1,7,Mid-Value,Potential Loyalists
73889,6,7,"251,75",5,2,1,8,High-Value,Potential Loyalists
73890,11,3,"122,9",5,1,1,7,Mid-Value,Potential Loyalists
73892,1276,1,"27,6",2,1,1,4,Low-Value,Can't Lose
73893,896,1,"35,1",3,1,1,5,Low-Value,At Risk Customers
73896,1781,1,"51,85",1,1,1,3,Low-Value,Lost
73897,1325,1,"18,2",2,1,1,4,Low-Value,Can't Lose
73898,1330,1,"126,4",2,1,1,4,Low-Value,Can't Lose
73899,5,2,"155,65",5,1,1,7,Mid-Value,Potential Loyalists
73901,57,1,"10,0",5,1,1,7,Mid-Value,Potential Loyalists
73903,368,6,"378,1",4,1,1,6,Mid-Value,Potential Loyalists
73905,1707,1,"67,55",1,1,1,3,Low-Value,Lost
73907,360,4,"207,45",5,1,1,7,Mid-Value,Potential Loyalists
73910,493,3,"171,5",4,1,1,6,Mid-Value,Potential Loyalists
73913,566,1,"276,4",4,1,1,6,Mid-Value,Potential Loyalists
73914,15,11,"365,35",5,2,1,8,High-Value,Potential Loyalists
73915,1025,1,"155,3",3,1,1,5,Low-Value,At Risk Customers
73916,333,3,"145,05",5,1,1,7,Mid-Value,Potential Loyalists
73918,515,2,"227,3",4,1,1,6,Mid-Value,Potential Loyalists
73919,29,6,"386,7",5,1,1,7,Mid-Value,Potential Loyalists
73920,1,4,"105,80000000000001",5,1,1,7,Mid-Value,Potential Loyalists
73922,452,1,"8,55",4,1,1,6,Mid-Value,Potential Loyalists
73923,1000,1,"41,1",3,1,1,5,Low-Value,At Risk Customers
73924,1490,1,"63,9",1,1,1,3,Low-Value,Lost
73927,165,3,"820,6",5,1,2,8,High-Value,Potential Loyalists
73928,108,5,"197,55",5,1,1,7,Mid-Value,Potential Loyalists
73929,903,3,"245,9",3,1,1,5,Low-Value,At Risk Customers
73931,118,1,"15,6",5,1,1,7,Mid-Value,Potential Loyalists
73940,903,3,"172,55",3,1,1,5,Low-Value,At Risk Customers
73942,163,8,"215,55",5,2,1,8,High-Value,Potential Loyalists
73946,538,1,"26,5",4,1,1,6,Mid-Value,Potential Loyalists
73949,1340,2,"229,85",2,1,1,4,Low-Value,Can't Lose
73951,1294,2,"18,85",2,1,1,4,Low-Value,Can't Lose
73952,544,3,"102,55",4,1,1,6,Mid-Value,Potential Loyalists
73954,55,5,"186,55",5,1,1,7,Mid-Value,Potential Loyalists
73955,85,4,"193,8",5,1,1,7,Mid-Value,Potential Loyalists
73957,359,6,"270,9",5,1,1,7,Mid-Value,Potential Loyalists
73958,1410,1,"17,35",2,1,1,4,Low-Value,Can't Lose
73959,10,7,"654,1",5,2,1,8,High-Value,Potential Loyalists
73960,574,2,"106,5",4,1,1,6,Mid-Value,Potential Loyalists
73961,304,3,"228,54999999999998",5,1,1,7,Mid-Value,Potential Loyalists
73963,332,6,"398,15",5,1,1,7,Mid-Value,Potential Loyalists
73964,1305,1,"48,4",2,1,1,4,Low-Value,Can't Lose
73965,692,4,"167,15",4,1,1,6,Mid-Value,Potential Loyalists
73967,739,6,"436,55",3,1,1,5,Low-Value,At Risk Customers
73968,136,8,"380,0",5,2,1,8,High-Value,Potential Loyalists
73969,11,2,"206,95",5,1,1,7,Mid-Value,Potential Loyalists
73970,405,2,"248,35",4,1,1,6,Mid-Value,Potential Loyalists
73972,794,3,"134,7",3,1,1,5,Low-Value,At Risk Customers
73973,915,2,"106,3",3,1,1,5,Low-Value,At Risk Customers
73974,1627,1,"136,9",1,1,1,3,Low-Value,Lost
73975,137,1,"56,550000000000004",5,1,1,7,Mid-Value,Potential Loyalists
73976,1647,1,"8,25",1,1,1,3,Low-Value,Lost
73977,1100,2,"66,4",2,1,1,4,Low-Value,Can't Lose
73978,123,2,"361,1",5,1,1,7,Mid-Value,Potential Loyalists
73979,582,1,"28,7",4,1,1,6,Mid-Value,Potential Loyalists
73982,267,1,"39,1",5,1,1,7,Mid-Value,Potential Loyalists
73986,137,3,"190,0",5,1,1,7,Mid-Value,Potential Loyalists
73987,1615,1,"22,9",1,1,1,3,Low-Value,Lost
73988,98,11,"541,05",5,2,1,8,High-Value,Potential Loyalists
73989,182,2,"409,75",5,1,1,7,Mid-Value,Potential Loyalists
73991,3,3,"561,45",5,1,1,7,Mid-Value,Potential Loyalists
73992,79,5,"671,4",5,1,2,8,High-Value,Potential Loyalists
73993,424,4,"263,95",4,1,1,6,Mid-Value,Potential Loyalists
73994,167,2,"109,94999999999999",5,1,1,7,Mid-Value,Potential Loyalists
73996,1614,1,"58,050000000000004",1,1,1,3,Low-Value,Lost
73997,807,3,"295,75",3,1,1,5,Low-Value,At Risk Customers
73999,497,3,"51,3",4,1,1,6,Mid-Value,Potential Loyalists
74003,384,3,"115,55",4,1,1,6,Mid-Value,Potential Loyalists
74007,156,7,"497,45",5,2,1,8,High-Value,Potential Loyalists
74010,153,12,"1469,15",5,3,3,11,High-Value,Champions
74016,3,14,"752,15",5,3,2,10,High-Value,Champions
74018,122,8,"613,95",5,2,1,8,High-Value,Potential Loyalists
74019,691,2,"72,8",4,1,1,6,Mid-Value,Potential Loyalists
74022,55,7,"362,00000000000006",5,2,1,8,High-Value,Potential Loyalists
74023,270,2,"189,45000000000002",5,1,1,7,Mid-Value,Potential Loyalists
74026,183,4,"373,65",5,1,1,7,Mid-Value,Potential Loyalists
74027,743,3,"264,34999999999997",3,1,1,5,Low-Value,At Risk Customers
74029,712,2,"150,1",4,1,1,6,Mid-Value,Potential Loyalists
74030,77,16,"1151,25",5,3,2,10,High-Value,Champions
74033,721,7,"417,5",4,2,1,7,Mid-Value,Potential Loyalists
74035,598,3,"162,79999999999998",4,1,1,6,Mid-Value,Potential Loyalists
74037,798,2,"117,64999999999999",3,1,1,5,Low-Value,At Risk Customers
74039,738,5,"706,05",3,1,2,6,Mid-Value,Potential Loyalists
74041,1314,4,"168,60000000000002",2,1,1,4,Low-Value,Can't Lose
74043,362,2,"113,60000000000001",5,1,1,7,Mid-Value,Potential Loyalists
74044,197,9,"410,6",5,2,1,8,High-Value,Potential Loyalists
74045,36,3,"182,25",5,1,1,7,Mid-Value,Potential Loyalists
74046,493,6,"758,75",4,1,2,7,Mid-Value,Potential Loyalists
74047,66,10,"771,6",5,2,2,9,High-Value,Champions
74048,587,3,"191,65",4,1,1,6,Mid-Value,Potential Loyalists
74049,30,4,"278,5",5,1,1,7,Mid-Value,Potential Loyalists
74051,969,1,"23,85",3,1,1,5,Low-Value,At Risk Customers
74052,376,6,"622,2",4,1,1,6,Mid-Value,Potential Loyalists
74053,1012,4,"181,4",3,1,1,5,Low-Value,At Risk Customers
74054,68,4,"373,65",5,1,1,7,Mid-Value,Potential Loyalists
74055,295,2,"136,29999999999998",5,1,1,7,Mid-Value,Potential Loyalists
74056,882,4,"172,0",3,1,1,5,Low-Value,At Risk Customers
74058,54,13,"1820,15",5,3,3,11,High-Value,Champions
74059,43,4,"398,90000000000003",5,1,1,7,Mid-Value,Potential Loyalists
74060,433,4,"167,4",4,1,1,6,Mid-Value,Potential Loyalists
74061,407,3,"140,65",4,1,1,6,Mid-Value,Potential Loyalists
74063,24,4,"156,5",5,1,1,7,Mid-Value,Potential Loyalists
74065,7,11,"373,4",5,2,1,8,High-Value,Potential Loyalists
74067,346,1,"24,3",5,1,1,7,Mid-Value,Potential Loyalists
74069,664,1,"135,4",4,1,1,6,Mid-Value,Potential Loyalists
74072,190,3,"244,95",5,1,1,7,Mid-Value,Potential Loyalists
74073,1046,1,"24,2",3,1,1,5,Low-Value,At Risk Customers
74075,1330,1,"81,6",2,1,1,4,Low-Value,Can't Lose
74077,550,4,"122,80000000000001",4,1,1,6,Mid-Value,Potential Loyalists
74078,1623,1,"362,8",1,1,1,3,Low-Value,Lost
74079,857,4,"93,4",3,1,1,5,Low-Value,At Risk Customers
74080,7,6,"334,9",5,1,1,7,Mid-Value,Potential Loyalists
74081,866,1,"66,30000000000001",3,1,1,5,Low-Value,At Risk Customers
74082,878,2,"152,0",3,1,1,5,Low-Value,At Risk Customers
74083,268,3,"437,09999999999997",5,1,1,7,Mid-Value,Potential Loyalists
74084,929,2,"81,75",3,1,1,5,Low-Value,At Risk Customers
74087,74,3,"213,8",5,1,1,7,Mid-Value,Potential Loyalists
74088,35,3,"147,45000000000002",5,1,1,7,Mid-Value,Potential Loyalists
74089,213,3,"573,15",5,1,1,7,Mid-Value,Potential Loyalists
74090,1381,2,"137,2",2,1,1,4,Low-Value,Can't Lose
74092,573,2,"93,3",4,1,1,6,Mid-Value,Potential Loyalists
74094,515,1,"43,4",4,1,1,6,Mid-Value,Potential Loyalists
74096,399,3,"296,45",4,1,1,6,Mid-Value,Potential Loyalists
74097,11,8,"630,0",5,2,1,8,High-Value,Potential Loyalists
74099,48,4,"266,85",5,1,1,7,Mid-Value,Potential Loyalists
74100,348,2,"192,5",5,1,1,7,Mid-Value,Potential Loyalists
74101,211,2,"76,55",5,1,1,7,Mid-Value,Potential Loyalists
74102,719,1,"11,0",4,1,1,6,Mid-Value,Potential Loyalists
74103,54,6,"98,75",5,1,1,7,Mid-Value,Potential Loyalists
74106,75,4,"209,4",5,1,1,7,Mid-Value,Potential Loyalists
74107,1487,1,"89,1",1,1,1,3,Low-Value,Lost
74108,458,5,"242,5",4,1,1,6,Mid-Value,Potential Loyalists
74109,891,2,"30,200000000000003",3,1,1,5,Low-Value,At Risk Customers
74110,473,1,"23,9",4,1,1,6,Mid-Value,Potential Loyalists
74112,430,2,"67,8",4,1,1,6,Mid-Value,Potential Loyalists
74115,473,5,"104,0",4,1,1,6,Mid-Value,Potential Loyalists
74117,588,1,"216,0",4,1,1,6,Mid-Value,Potential Loyalists
74118,54,4,"368,35",5,1,1,7,Mid-Value,Potential Loyalists
74119,1128,2,"170,6",2,1,1,4,Low-Value,Can't Lose
74120,15,6,"641,15",5,1,1,7,Mid-Value,Potential Loyalists
74121,389,1,"31,8",4,1,1,6,Mid-Value,Potential Loyalists
74124,73,3,"54,0",5,1,1,7,Mid-Value,Potential Loyalists
74125,467,5,"848,5999999999999",4,1,2,7,Mid-Value,Potential Loyalists
74128,760,4,"118,75",3,1,1,5,Low-Value,At Risk Customers
74129,681,1,"31,1",4,1,1,6,Mid-Value,Potential Loyalists
74132,242,1,"187,8",5,1,1,7,Mid-Value,Potential Loyalists
74136,914,1,"107,7",3,1,1,5,Low-Value,At Risk Customers
74138,1052,1,"12,7",3,1,1,5,Low-Value,At Risk Customers
74139,732,5,"162,5",3,1,1,5,Low-Value,At Risk Customers
74141,9,4,"344,09999999999997",5,1,1,7,Mid-Value,Potential Loyalists
74144,510,1,"175,64999999999998",4,1,1,6,Mid-Value,Potential Loyalists
74146,206,4,"135,2",5,1,1,7,Mid-Value,Potential Loyalists
74147,31,4,"176,85",5,1,1,7,Mid-Value,Potential Loyalists
74148,516,5,"190,64999999999998",4,1,1,6,Mid-Value,Potential Loyalists
74150,737,8,"284,84999999999997",3,2,1,6,Mid-Value,Potential Loyalists
74153,892,2,"61,599999999999994",3,1,1,5,Low-Value,At Risk Customers
74156,105,3,"292,4",5,1,1,7,Mid-Value,Potential Loyalists
74158,503,6,"340,05",4,1,1,6,Mid-Value,Potential Loyalists
74160,500,2,"117,6",4,1,1,6,Mid-Value,Potential Loyalists
74163,31,1,"3,85",5,1,1,7,Mid-Value,Potential Loyalists
74164,457,2,"108,4",4,1,1,6,Mid-Value,Potential Loyalists
74165,109,1,"9,55",5,1,1,7,Mid-Value,Potential Loyalists
74166,819,2,"96,9",3,1,1,5,Low-Value,At Risk Customers
74167,394,5,"684,3",4,1,2,7,Mid-Value,Potential Loyalists
74168,694,2,"122,19999999999999",4,1,1,6,Mid-Value,Potential Loyalists
74170,141,3,"170,05",5,1,1,7,Mid-Value,Potential Loyalists
74172,942,1,"44,5",3,1,1,5,Low-Value,At Risk Customers
74173,1050,2,"86,05",3,1,1,5,Low-Value,At Risk Customers
74174,1266,4,"351,2",2,1,1,4,Low-Value,Can't Lose
74176,414,6,"387,9",4,1,1,6,Mid-Value,Potential Loyalists
74177,789,2,"86,95",3,1,1,5,Low-Value,At Risk Customers
74179,12,5,"492,65000000000003",5,1,1,7,Mid-Value,Potential Loyalists
74181,955,2,"136,55",3,1,1,5,Low-Value,At Risk Customers
74183,311,2,"47,45",5,1,1,7,Mid-Value,Potential Loyalists
74184,750,3,"218,35000000000002",3,1,1,5,Low-Value,At Risk Customers
74185,244,1,"71,55",5,1,1,7,Mid-Value,Potential Loyalists
74186,1502,1,"16,55",1,1,1,3,Low-Value,Lost
74187,645,2,"83,9",4,1,1,6,Mid-Value,Potential Loyalists
74188,269,3,"919,5",5,1,2,8,High-Value,Potential Loyalists
74189,1267,1,"13,75",2,1,1,4,Low-Value,Can't Lose
74190,3,1,"95,5",5,1,1,7,Mid-Value,Potential Loyalists
74193,789,2,"53,900000000000006",3,1,1,5,Low-Value,At Risk Customers
74194,1452,2,"85,0",2,1,1,4,Low-Value,Can't Lose
74198,812,3,"137,7",3,1,1,5,Low-Value,At Risk Customers
74199,1,6,"156,45",5,1,1,7,Mid-Value,Potential Loyalists
74200,212,1,"9,2",5,1,1,7,Mid-Value,Potential Loyalists
74201,1532,1,"6,55",1,1,1,3,Low-Value,Lost
74202,305,5,"286,90000000000003",5,1,1,7,Mid-Value,Potential Loyalists
74204,772,1,"11,8",3,1,1,5,Low-Value,At Risk Customers
74205,112,8,"1407,2",5,2,3,10,High-Value,Champions
74208,573,2,"86,8",4,1,1,6,Mid-Value,Potential Loyalists
74209,488,1,"61,8",4,1,1,6,Mid-Value,Potential Loyalists
74211,590,2,"61,4",4,1,1,6,Mid-Value,Potential Loyalists
74213,1482,1,"27,4",1,1,1,3,Low-Value,Lost
74216,758,3,"121,65",3,1,1,5,Low-Value,At Risk Customers
74217,478,1,"4,75",4,1,1,6,Mid-Value,Potential Loyalists
74219,258,1,"19,15",5,1,1,7,Mid-Value,Potential Loyalists
74222,344,2,"51,9",5,1,1,7,Mid-Value,Potential Loyalists
74224,509,2,"155,5",4,1,1,6,Mid-Value,Potential Loyalists
74226,1135,1,"11,85",2,1,1,4,Low-Value,Can't Lose
74227,1088,1,"7,65",3,1,1,5,Low-Value,At Risk Customers
74228,1491,3,"144,5",1,1,1,3,Low-Value,Lost
74229,899,1,"39,8",3,1,1,5,Low-Value,At Risk Customers
74233,19,7,"535,35",5,2,1,8,High-Value,Potential Loyalists
74235,63,3,"115,8",5,1,1,7,Mid-Value,Potential Loyalists
74238,16,5,"635,15",5,1,1,7,Mid-Value,Potential Loyalists
74241,515,5,"322,54999999999995",4,1,1,6,Mid-Value,Potential Loyalists
74244,228,7,"388,40000000000003",5,2,1,8,High-Value,Potential Loyalists
74245,166,4,"332,4",5,1,1,7,Mid-Value,Potential Loyalists
74246,149,4,"84,7",5,1,1,7,Mid-Value,Potential Loyalists
74247,48,5,"300,65",5,1,1,7,Mid-Value,Potential Loyalists
74248,1788,1,"41,9",1,1,1,3,Low-Value,Lost
74253,537,1,"68,0",4,1,1,6,Mid-Value,Potential Loyalists
74256,9,6,"507,55",5,1,1,7,Mid-Value,Potential Loyalists
74257,1589,1,"125,39999999999999",1,1,1,3,Low-Value,Lost
74258,160,5,"286,0",5,1,1,7,Mid-Value,Potential Loyalists
74262,1523,1,"18,0",1,1,1,3,Low-Value,Lost
74264,266,7,"416,15000000000003",5,2,1,8,High-Value,Potential Loyalists
74266,1470,1,"154,2",1,1,1,3,Low-Value,Lost
74267,708,4,"60,0",4,1,1,6,Mid-Value,Potential Loyalists
74269,1109,4,"148,14999999999998",2,1,1,4,Low-Value,Can't Lose
74270,1391,4,"174,1",2,1,1,4,Low-Value,Can't Lose
74272,1335,1,"21,25",2,1,1,4,Low-Value,Can't Lose
74273,111,7,"237,20000000000002",5,2,1,8,High-Value,Potential Loyalists
74274,682,4,"120,30000000000001",4,1,1,6,Mid-Value,Potential Loyalists
74275,1151,4,"52,7",2,1,1,4,Low-Value,Can't Lose
74276,439,4,"194,25000000000003",4,1,1,6,Mid-Value,Potential Loyalists
74277,900,1,"240,60000000000002",3,1,1,5,Low-Value,At Risk Customers
74278,279,3,"84,1",5,1,1,7,Mid-Value,Potential Loyalists
74279,26,6,"258,7",5,1,1,7,Mid-Value,Potential Loyalists
74280,4,2,"161,7",5,1,1,7,Mid-Value,Potential Loyalists
74282,18,7,"343,0",5,2,1,8,High-Value,Potential Loyalists
74283,7,6,"358,8",5,1,1,7,Mid-Value,Potential Loyalists
74284,561,4,"370,54999999999995",4,1,1,6,Mid-Value,Potential Loyalists
74285,858,3,"198,1",3,1,1,5,Low-Value,At Risk Customers
74286,99,5,"188,35",5,1,1,7,Mid-Value,Potential Loyalists
74287,1614,1,"34,5",1,1,1,3,Low-Value,Lost
74290,1297,2,"81,4",2,1,1,4,Low-Value,Can't Lose
74293,1746,1,"53,6",1,1,1,3,Low-Value,Lost
74295,471,2,"89,39999999999999",4,1,1,6,Mid-Value,Potential Loyalists
74297,1617,2,"91,39999999999999",1,1,1,3,Low-Value,Lost
74298,1161,3,"34,45",2,1,1,4,Low-Value,Can't Lose
74299,120,7,"388,1",5,2,1,8,High-Value,Potential Loyalists
74300,196,5,"301,75",5,1,1,7,Mid-Value,Potential Loyalists
74301,99,3,"153,4",5,1,1,7,Mid-Value,Potential Loyalists
74302,1508,1,"1,35",1,1,1,3,Low-Value,Lost
74303,1708,1,"24,2",1,1,1,3,Low-Value,Lost
74304,230,3,"525,1999999999999",5,1,1,7,Mid-Value,Potential Loyalists
74307,631,1,"20,9",4,1,1,6,Mid-Value,Potential Loyalists
74310,1004,1,"55,1",3,1,1,5,Low-Value,At Risk Customers
74311,748,3,"167,85",3,1,1,5,Low-Value,At Risk Customers
74312,1170,3,"83,15",2,1,1,4,Low-Value,Can't Lose
74313,24,4,"216,75",5,1,1,7,Mid-Value,Potential Loyalists
74317,55,6,"234,5",5,1,1,7,Mid-Value,Potential Loyalists
74318,1158,3,"736,35",2,1,2,5,Low-Value,At Risk Customers
74319,62,5,"251,75",5,1,1,7,Mid-Value,Potential Loyalists
74320,528,2,"342,3",4,1,1,6,Mid-Value,Potential Loyalists
74322,740,2,"94,94999999999999",3,1,1,5,Low-Value,At Risk Customers
74323,23,8,"340,45",5,2,1,8,High-Value,Potential Loyalists
74325,353,2,"165,45",5,1,1,7,Mid-Value,Potential Loyalists
74326,74,4,"211,4",5,1,1,7,Mid-Value,Potential Loyalists
74331,40,2,"36,0",5,1,1,7,Mid-Value,Potential Loyalists
74332,375,6,"725,7",4,1,2,7,Mid-Value,Potential Loyalists
74333,18,6,"494,1",5,1,1,7,Mid-Value,Potential Loyalists
74334,29,5,"904,15",5,1,2,8,High-Value,Potential Loyalists
74335,1352,1,"28,3",2,1,1,4,Low-Value,Can't Lose
74340,686,2,"76,75",4,1,1,6,Mid-Value,Potential Loyalists
74345,705,6,"471,09999999999997",4,1,1,6,Mid-Value,Potential Loyalists
74346,850,2,"375,65",3,1,1,5,Low-Value,At Risk Customers
74347,327,8,"323,2",5,2,1,8,High-Value,Potential Loyalists
74348,334,2,"20,35",5,1,1,7,Mid-Value,Potential Loyalists
74349,320,4,"101,1",5,1,1,7,Mid-Value,Potential Loyalists
74352,1622,1,"158,1",1,1,1,3,Low-Value,Lost
74353,1151,1,"2,45",2,1,1,4,Low-Value,Can't Lose
74354,752,1,"11,5",3,1,1,5,Low-Value,At Risk Customers
74355,124,4,"150,0",5,1,1,7,Mid-Value,Potential Loyalists
74357,175,4,"161,3",5,1,1,7,Mid-Value,Potential Loyalists
74358,1548,1,"21,5",1,1,1,3,Low-Value,Lost
74361,874,1,"102,9",3,1,1,5,Low-Value,At Risk Customers
74365,918,2,"14,4",3,1,1,5,Low-Value,At Risk Customers
74366,1546,1,"6,05",1,1,1,3,Low-Value,Lost
74367,360,1,"69,6",5,1,1,7,Mid-Value,Potential Loyalists
74370,200,3,"210,95",5,1,1,7,Mid-Value,Potential Loyalists
74372,249,7,"176,85000000000002",5,2,1,8,High-Value,Potential Loyalists
74373,59,6,"237,55",5,1,1,7,Mid-Value,Potential Loyalists
74374,1143,1,"39,55",2,1,1,4,Low-Value,Can't Lose
74376,382,5,"356,4",4,1,1,6,Mid-Value,Potential Loyalists
74378,300,2,"136,3",5,1,1,7,Mid-Value,Potential Loyalists
74380,650,1,"2,7",4,1,1,6,Mid-Value,Potential Loyalists
74381,65,8,"184,45",5,2,1,8,High-Value,Potential Loyalists
74382,762,11,"897,3000000000001",3,2,2,7,Mid-Value,Potential Loyalists
74384,423,2,"150,1",4,1,1,6,Mid-Value,Potential Loyalists
74385,1103,2,"76,8",2,1,1,4,Low-Value,Can't Lose
74386,1080,1,"11,3",3,1,1,5,Low-Value,At Risk Customers
74387,1128,4,"46,05",2,1,1,4,Low-Value,Can't Lose
74390,408,1,"36,8",4,1,1,6,Mid-Value,Potential Loyalists
74395,413,3,"48,95",4,1,1,6,Mid-Value,Potential Loyalists
74397,1660,1,"38,4",1,1,1,3,Low-Value,Lost
74399,69,3,"53,75",5,1,1,7,Mid-Value,Potential Loyalists
74400,526,3,"91,04999999999998",4,1,1,6,Mid-Value,Potential Loyalists
74401,23,17,"1024,5",5,4,2,11,High-Value,Champions
74403,640,1,"49,95",4,1,1,6,Mid-Value,Potential Loyalists
74404,359,2,"207,64999999999998",5,1,1,7,Mid-Value,Potential Loyalists
74405,130,9,"415,6",5,2,1,8,High-Value,Potential Loyalists
74409,577,1,"92,1",4,1,1,6,Mid-Value,Potential Loyalists
74413,748,2,"64,9",3,1,1,5,Low-Value,At Risk Customers
74414,856,4,"174,05",3,1,1,5,Low-Value,At Risk Customers
74415,264,6,"372,65",5,1,1,7,Mid-Value,Potential Loyalists
74418,1218,3,"104,55",2,1,1,4,Low-Value,Can't Lose
74420,553,2,"281,75",4,1,1,6,Mid-Value,Potential Loyalists
74422,104,2,"244,1",5,1,1,7,Mid-Value,Potential Loyalists
74423,311,4,"561,65",5,1,1,7,Mid-Value,Potential Loyalists
74425,13,2,"186,2",5,1,1,7,Mid-Value,Potential Loyalists
74426,403,5,"229,65",4,1,1,6,Mid-Value,Potential Loyalists
74428,80,4,"263,35",5,1,1,7,Mid-Value,Potential Loyalists
74429,98,3,"346,05",5,1,1,7,Mid-Value,Potential Loyalists
74432,282,1,"21,7",5,1,1,7,Mid-Value,Potential Loyalists
74434,298,5,"254,4",5,1,1,7,Mid-Value,Potential Loyalists
74435,435,1,"23,35",4,1,1,6,Mid-Value,Potential Loyalists
74436,951,1,"29,6",3,1,1,5,Low-Value,At Risk Customers
74437,413,2,"46,55",4,1,1,6,Mid-Value,Potential Loyalists
74438,806,6,"322,04999999999995",3,1,1,5,Low-Value,At Risk Customers
74439,1228,2,"170,65",2,1,1,4,Low-Value,Can't Lose
74440,386,2,"155,40000000000003",4,1,1,6,Mid-Value,Potential Loyalists
74442,480,2,"129,1",4,1,1,6,Mid-Value,Potential Loyalists
74443,920,1,"114,0",3,1,1,5,Low-Value,At Risk Customers
74445,249,8,"442,65",5,2,1,8,High-Value,Potential Loyalists
74447,1131,2,"131,15",2,1,1,4,Low-Value,Can't Lose
74448,152,7,"568,15",5,2,1,8,High-Value,Potential Loyalists
74449,180,5,"190,45",5,1,1,7,Mid-Value,Potential Loyalists
74450,1282,1,"100,5",2,1,1,4,Low-Value,Can't Lose
74454,1111,1,"44,9",2,1,1,4,Low-Value,Can't Lose
74455,1353,5,"231,25",2,1,1,4,Low-Value,Can't Lose
74456,761,2,"8,399999999999999",3,1,1,5,Low-Value,At Risk Customers
74457,500,5,"303,0",4,1,1,6,Mid-Value,Potential Loyalists
74458,263,3,"206,15",5,1,1,7,Mid-Value,Potential Loyalists
74459,663,1,"3,9",4,1,1,6,Mid-Value,Potential Loyalists
74462,184,5,"510,94999999999993",5,1,1,7,Mid-Value,Potential Loyalists
74463,17,4,"268,1",5,1,1,7,Mid-Value,Potential Loyalists
74464,1771,1,"76,8",1,1,1,3,Low-Value,Lost
74467,246,5,"118,85000000000001",5,1,1,7,Mid-Value,Potential Loyalists
74469,536,2,"60,2",4,1,1,6,Mid-Value,Potential Loyalists
74470,229,6,"558,9499999999999",5,1,1,7,Mid-Value,Potential Loyalists
74474,1337,1,"56,9",2,1,1,4,Low-Value,Can't Lose
74476,148,5,"144,05",5,1,1,7,Mid-Value,Potential Loyalists
74477,132,1,"124,9",5,1,1,7,Mid-Value,Potential Loyalists
74478,434,3,"40,95",4,1,1,6,Mid-Value,Potential Loyalists
74479,148,3,"169,55",5,1,1,7,Mid-Value,Potential Loyalists
74480,27,13,"919,6",5,3,2,10,High-Value,Champions
74482,143,9,"463,55",5,2,1,8,High-Value,Potential Loyalists
74484,636,2,"103,75",4,1,1,6,Mid-Value,Potential Loyalists
74485,505,1,"99,75",4,1,1,6,Mid-Value,Potential Loyalists
74488,233,2,"71,25",5,1,1,7,Mid-Value,Potential Loyalists
74489,484,4,"134,75",4,1,1,6,Mid-Value,Potential Loyalists
74490,441,4,"153,65",4,1,1,6,Mid-Value,Potential Loyalists
74491,995,3,"187,45",3,1,1,5,Low-Value,At Risk Customers
74492,395,1,"67,8",4,1,1,6,Mid-Value,Potential Loyalists
74495,72,1,"44,25",5,1,1,7,Mid-Value,Potential Loyalists
74498,691,1,"36,45",4,1,1,6,Mid-Value,Potential Loyalists
74500,228,7,"419,45",5,2,1,8,High-Value,Potential Loyalists
74501,1379,1,"168,05",2,1,1,4,Low-Value,Can't Lose
74503,816,3,"189,20000000000002",3,1,1,5,Low-Value,At Risk Customers
74504,114,7,"232,95",5,2,1,8,High-Value,Potential Loyalists
74505,948,3,"265,15",3,1,1,5,Low-Value,At Risk Customers
74506,1627,1,"73,0",1,1,1,3,Low-Value,Lost
74507,892,4,"94,05",3,1,1,5,Low-Value,At Risk Customers
74508,35,4,"107,75",5,1,1,7,Mid-Value,Potential Loyalists
74509,194,3,"206,25",5,1,1,7,Mid-Value,Potential Loyalists
74511,332,2,"75,95",5,1,1,7,Mid-Value,Potential Loyalists
74513,22,14,"765,2",5,3,2,10,High-Value,Champions
74514,497,2,"31,950000000000003",4,1,1,6,Mid-Value,Potential Loyalists
74516,141,12,"1031,0",5,3,2,10,High-Value,Champions
74518,647,5,"542,45",4,1,1,6,Mid-Value,Potential Loyalists
74519,667,6,"516,1999999999999",4,1,1,6,Mid-Value,Potential Loyalists
74520,1594,1,"31,0",1,1,1,3,Low-Value,Lost
74521,833,2,"113,95",3,1,1,5,Low-Value,At Risk Customers
74523,68,9,"545,5500000000001",5,2,1,8,High-Value,Potential Loyalists
74525,1714,1,"6,2",1,1,1,3,Low-Value,Lost
74526,291,6,"257,0",5,1,1,7,Mid-Value,Potential Loyalists
74527,785,8,"412,8",3,2,1,6,Mid-Value,Potential Loyalists
74529,245,2,"19,4",5,1,1,7,Mid-Value,Potential Loyalists
74530,133,2,"139,6",5,1,1,7,Mid-Value,Potential Loyalists
74531,738,3,"405,90000000000003",3,1,1,5,Low-Value,At Risk Customers
74533,321,8,"284,85",5,2,1,8,High-Value,Potential Loyalists
74534,929,1,"43,7",3,1,1,5,Low-Value,At Risk Customers
74535,769,3,"459,0",3,1,1,5,Low-Value,At Risk Customers
74536,106,2,"519,4",5,1,1,7,Mid-Value,Potential Loyalists
74538,33,5,"441,29999999999995",5,1,1,7,Mid-Value,Potential Loyalists
74539,573,1,"255,5",4,1,1,6,Mid-Value,Potential Loyalists
74540,255,2,"18,2",5,1,1,7,Mid-Value,Potential Loyalists
74542,1216,1,"45,0",2,1,1,4,Low-Value,Can't Lose
74545,182,1,"35,0",5,1,1,7,Mid-Value,Potential Loyalists
74547,1292,3,"165,6",2,1,1,4,Low-Value,Can't Lose
74549,21,5,"189,5",5,1,1,7,Mid-Value,Potential Loyalists
74550,269,9,"471,8",5,2,1,8,High-Value,Potential Loyalists
74553,519,8,"597,8",4,2,1,7,Mid-Value,Potential Loyalists
74557,123,4,"527,9499999999999",5,1,1,7,Mid-Value,Potential Loyalists
74559,50,1,"10,35",5,1,1,7,Mid-Value,Potential Loyalists
74562,1373,1,"9,85",2,1,1,4,Low-Value,Can't Lose
74563,374,2,"152,75",4,1,1,6,Mid-Value,Potential Loyalists
74565,644,7,"386,55",4,2,1,7,Mid-Value,Potential Loyalists
74567,136,2,"160,89999999999998",5,1,1,7,Mid-Value,Potential Loyalists
74569,116,9,"568,9",5,2,1,8,High-Value,Potential Loyalists
74571,773,2,"75,44999999999999",3,1,1,5,Low-Value,At Risk Customers
74572,881,2,"41,699999999999996",3,1,1,5,Low-Value,At Risk Customers
74573,1654,1,"74,0",1,1,1,3,Low-Value,Lost
74574,466,3,"338,5",4,1,1,6,Mid-Value,Potential Loyalists
74576,47,4,"137,45",5,1,1,7,Mid-Value,Potential Loyalists
74577,199,1,"80,2",5,1,1,7,Mid-Value,Potential Loyalists
74579,781,2,"135,6",3,1,1,5,Low-Value,At Risk Customers
74580,71,5,"248,95",5,1,1,7,Mid-Value,Potential Loyalists
74582,48,4,"87,10000000000001",5,1,1,7,Mid-Value,Potential Loyalists
74583,756,2,"57,5",3,1,1,5,Low-Value,At Risk Customers
74584,1409,2,"56,4",2,1,1,4,Low-Value,Can't Lose
74585,373,1,"183,4",4,1,1,6,Mid-Value,Potential Loyalists
74586,149,3,"184,04999999999998",5,1,1,7,Mid-Value,Potential Loyalists
74587,1094,1,"17,4",3,1,1,5,Low-Value,At Risk Customers
74589,1099,5,"199,4",2,1,1,4,Low-Value,Can't Lose
74590,1219,1,"245,6",2,1,1,4,Low-Value,Can't Lose
74593,946,1,"11,399999999999999",3,1,1,5,Low-Value,At Risk Customers
74594,745,2,"134,6",3,1,1,5,Low-Value,At Risk Customers
74595,36,4,"268,05",5,1,1,7,Mid-Value,Potential Loyalists
74597,1337,1,"28,4",2,1,1,4,Low-Value,Can't Lose
74598,511,3,"67,0",4,1,1,6,Mid-Value,Potential Loyalists
74604,532,1,"111,0",4,1,1,6,Mid-Value,Potential Loyalists
74605,97,6,"191,65",5,1,1,7,Mid-Value,Potential Loyalists
74607,1337,2,"119,75",2,1,1,4,Low-Value,Can't Lose
74609,57,12,"511,1",5,3,1,9,High-Value,Champions
74613,382,2,"200,8",4,1,1,6,Mid-Value,Potential Loyalists
74618,1086,4,"195,45",3,1,1,5,Low-Value,At Risk Customers
74619,1188,1,"23,75",2,1,1,4,Low-Value,Can't Lose
74621,821,1,"74,6",3,1,1,5,Low-Value,At Risk Customers
74623,143,3,"62,599999999999994",5,1,1,7,Mid-Value,Potential Loyalists
74627,457,3,"186,6",4,1,1,6,Mid-Value,Potential Loyalists
74628,248,1,"48,7",5,1,1,7,Mid-Value,Potential Loyalists
74629,1245,1,"218,2",2,1,1,4,Low-Value,Can't Lose
74630,762,3,"83,19999999999999",3,1,1,5,Low-Value,At Risk Customers
74633,1255,1,"128,39999999999998",2,1,1,4,Low-Value,Can't Lose
74634,764,1,"20,6",3,1,1,5,Low-Value,At Risk Customers
74637,68,5,"328,15",5,1,1,7,Mid-Value,Potential Loyalists
74639,699,2,"89,55",4,1,1,6,Mid-Value,Potential Loyalists
74640,1790,1,"32,75",1,1,1,3,Low-Value,Lost
74641,43,10,"542,6",5,2,1,8,High-Value,Potential Loyalists
74645,1119,5,"223,2",2,1,1,4,Low-Value,Can't Lose
74646,68,4,"78,65",5,1,1,7,Mid-Value,Potential Loyalists
74647,990,1,"62,3",3,1,1,5,Low-Value,At Risk Customers
74648,918,1,"19,8",3,1,1,5,Low-Value,At Risk Customers
74651,112,4,"104,30000000000001",5,1,1,7,Mid-Value,Potential Loyalists
74655,26,4,"241,25",5,1,1,7,Mid-Value,Potential Loyalists
74658,141,2,"114,35",5,1,1,7,Mid-Value,Potential Loyalists
74659,323,3,"164,5",5,1,1,7,Mid-Value,Potential Loyalists
74660,157,3,"205,95",5,1,1,7,Mid-Value,Potential Loyalists
74662,536,2,"77,25",4,1,1,6,Mid-Value,Potential Loyalists
74663,1450,2,"201,95",2,1,1,4,Low-Value,Can't Lose
74665,1439,3,"103,85000000000001",2,1,1,4,Low-Value,Can't Lose
74666,372,5,"262,45",4,1,1,6,Mid-Value,Potential Loyalists
74667,13,8,"344,3",5,2,1,8,High-Value,Potential Loyalists
74668,355,5,"338,5",5,1,1,7,Mid-Value,Potential Loyalists
74671,896,1,"85,25",3,1,1,5,Low-Value,At Risk Customers
74674,24,3,"152,35",5,1,1,7,Mid-Value,Potential Loyalists
74676,517,2,"271,8",4,1,1,6,Mid-Value,Potential Loyalists
74677,786,2,"30,05",3,1,1,5,Low-Value,At Risk Customers
74678,990,4,"100,6",3,1,1,5,Low-Value,At Risk Customers
74679,366,6,"279,1",4,1,1,6,Mid-Value,Potential Loyalists
74680,1148,2,"65,75",2,1,1,4,Low-Value,Can't Lose
74681,1599,1,"177,6",1,1,1,3,Low-Value,Lost
74682,11,1,"165,75",5,1,1,7,Mid-Value,Potential Loyalists
74683,822,4,"1056,85",3,1,2,6,Mid-Value,Potential Loyalists
74684,495,3,"235,55",4,1,1,6,Mid-Value,Potential Loyalists
74685,1175,1,"30,8",2,1,1,4,Low-Value,Can't Lose
74687,46,6,"404,75",5,1,1,7,Mid-Value,Potential Loyalists
74688,35,11,"666,2",5,2,2,9,High-Value,Champions
74690,1385,1,"235,5",2,1,1,4,Low-Value,Can't Lose
74691,543,3,"205,89999999999998",4,1,1,6,Mid-Value,Potential Loyalists
74692,1088,1,"11,8",3,1,1,5,Low-Value,At Risk Customers
74693,412,5,"195,45000000000002",4,1,1,6,Mid-Value,Potential Loyalists
74694,417,10,"383,59999999999997",4,2,1,7,Mid-Value,Potential Loyalists
74695,45,5,"148,5",5,1,1,7,Mid-Value,Potential Loyalists
74696,1049,1,"6,4",3,1,1,5,Low-Value,At Risk Customers
74697,2,10,"721,5",5,2,2,9,High-Value,Champions
74699,501,1,"17,6",4,1,1,6,Mid-Value,Potential Loyalists
74701,657,3,"64,9",4,1,1,6,Mid-Value,Potential Loyalists
74702,516,5,"581,05",4,1,1,6,Mid-Value,Potential Loyalists
74703,759,5,"178,05",3,1,1,5,Low-Value,At Risk Customers
74704,1221,1,"67,2",2,1,1,4,Low-Value,Can't Lose
74708,6,5,"1101,3",5,1,2,8,High-Value,Potential Loyalists
74709,377,1,"15,0",4,1,1,6,Mid-Value,Potential Loyalists
74711,230,6,"268,95",5,1,1,7,Mid-Value,Potential Loyalists
74712,1200,1,"5,6",2,1,1,4,Low-Value,Can't Lose
74715,82,3,"246,94999999999996",5,1,1,7,Mid-Value,Potential Loyalists
74717,24,4,"99,8",5,1,1,7,Mid-Value,Potential Loyalists
74719,185,4,"287,95000000000005",5,1,1,7,Mid-Value,Potential Loyalists
74720,214,4,"359,25",5,1,1,7,Mid-Value,Potential Loyalists
74723,775,1,"69,0",3,1,1,5,Low-Value,At Risk Customers
74725,848,3,"192,05",3,1,1,5,Low-Value,At Risk Customers
74728,586,3,"56,6",4,1,1,6,Mid-Value,Potential Loyalists
74729,1078,2,"89,0",3,1,1,5,Low-Value,At Risk Customers
74730,1282,3,"423,85",2,1,1,4,Low-Value,Can't Lose
74732,58,6,"403,4",5,1,1,7,Mid-Value,Potential Loyalists
74734,426,2,"115,5",4,1,1,6,Mid-Value,Potential Loyalists
74735,92,2,"28,0",5,1,1,7,Mid-Value,Potential Loyalists
74738,1742,1,"57,8",1,1,1,3,Low-Value,Lost
74739,1642,1,"55,1",1,1,1,3,Low-Value,Lost
74740,251,3,"199,35",5,1,1,7,Mid-Value,Potential Loyalists
74742,136,2,"82,0",5,1,1,7,Mid-Value,Potential Loyalists
74743,1374,1,"33,9",2,1,1,4,Low-Value,Can't Lose
74744,220,6,"523,6",5,1,1,7,Mid-Value,Potential Loyalists
74745,1002,1,"79,9",3,1,1,5,Low-Value,At Risk Customers
74748,857,1,"12,7",3,1,1,5,Low-Value,At Risk Customers
74749,34,7,"226,34999999999997",5,2,1,8,High-Value,Potential Loyalists
74750,1005,2,"54,25",3,1,1,5,Low-Value,At Risk Customers
74751,175,6,"303,90000000000003",5,1,1,7,Mid-Value,Potential Loyalists
74753,389,8,"714,4499999999999",4,2,2,8,High-Value,Potential Loyalists
74754,1336,1,"63,150000000000006",2,1,1,4,Low-Value,Can't Lose
74755,164,3,"236,25",5,1,1,7,Mid-Value,Potential Loyalists
74766,764,3,"158,35",3,1,1,5,Low-Value,At Risk Customers
74767,520,2,"113,5",4,1,1,6,Mid-Value,Potential Loyalists
74769,75,4,"108,9",5,1,1,7,Mid-Value,Potential Loyalists
74770,93,5,"258,55",5,1,1,7,Mid-Value,Potential Loyalists
74772,404,2,"131,3",4,1,1,6,Mid-Value,Potential Loyalists
74773,1377,1,"26,1",2,1,1,4,Low-Value,Can't Lose
74774,326,4,"78,75",5,1,1,7,Mid-Value,Potential Loyalists
74775,0,1,"214,64999999999998",5,1,1,7,Mid-Value,Potential Loyalists
74776,224,1,"8,15",5,1,1,7,Mid-Value,Potential Loyalists
74778,1244,3,"190,95000000000002",2,1,1,4,Low-Value,Can't Lose
74779,745,1,"19,7",3,1,1,5,Low-Value,At Risk Customers
74780,26,5,"286,3",5,1,1,7,Mid-Value,Potential Loyalists
74781,385,1,"48,2",4,1,1,6,Mid-Value,Potential Loyalists
74782,138,9,"642,95",5,2,1,8,High-Value,Potential Loyalists
74784,0,7,"671,35",5,2,2,9,High-Value,Champions
74785,77,3,"191,04999999999998",5,1,1,7,Mid-Value,Potential Loyalists
74788,43,1,"28,6",5,1,1,7,Mid-Value,Potential Loyalists
74789,395,4,"206,0",4,1,1,6,Mid-Value,Potential Loyalists
74790,304,1,"59,2",5,1,1,7,Mid-Value,Potential Loyalists
74792,1721,1,"29,3",1,1,1,3,Low-Value,Lost
74795,750,4,"162,0",3,1,1,5,Low-Value,At Risk Customers
74796,1352,1,"45,6",2,1,1,4,Low-Value,Can't Lose
74798,442,3,"100,85",4,1,1,6,Mid-Value,Potential Loyalists
74800,46,8,"1515,3000000000002",5,2,3,10,High-Value,Champions
74802,844,2,"49,15",3,1,1,5,Low-Value,At Risk Customers
74805,346,2,"205,89999999999998",5,1,1,7,Mid-Value,Potential Loyalists
74807,950,1,"44,25",3,1,1,5,Low-Value,At Risk Customers
74809,1382,1,"15,4",2,1,1,4,Low-Value,Can't Lose
74812,211,3,"127,9",5,1,1,7,Mid-Value,Potential Loyalists
74813,437,6,"539,1",4,1,1,6,Mid-Value,Potential Loyalists
74814,1624,3,"46,3",1,1,1,3,Low-Value,Lost
74815,112,3,"97,8",5,1,1,7,Mid-Value,Potential Loyalists
74817,311,3,"139,4",5,1,1,7,Mid-Value,Potential Loyalists
74818,1615,1,"75,7",1,1,1,3,Low-Value,Lost
74819,241,1,"33,7",5,1,1,7,Mid-Value,Potential Loyalists
74823,47,4,"914,05",5,1,2,8,High-Value,Potential Loyalists
74824,1188,1,"87,1",2,1,1,4,Low-Value,Can't Lose
74826,1552,1,"39,0",1,1,1,3,Low-Value,Lost
74827,288,4,"191,14999999999998",5,1,1,7,Mid-Value,Potential Loyalists
74828,692,1,"62,9",4,1,1,6,Mid-Value,Potential Loyalists
74830,38,8,"773,25",5,2,2,9,High-Value,Champions
74831,1405,1,"245,8",2,1,1,4,Low-Value,Can't Lose
74833,389,3,"78,75",4,1,1,6,Mid-Value,Potential Loyalists
74834,1149,1,"96,6",2,1,1,4,Low-Value,Can't Lose
74835,22,4,"230,70000000000002",5,1,1,7,Mid-Value,Potential Loyalists
74837,1548,1,"22,25",1,1,1,3,Low-Value,Lost
74838,385,3,"186,25",4,1,1,6,Mid-Value,Potential Loyalists
74839,798,3,"319,15",3,1,1,5,Low-Value,At Risk Customers
74845,476,4,"130,15",4,1,1,6,Mid-Value,Potential Loyalists
74846,1316,1,"60,05",2,1,1,4,Low-Value,Can't Lose
74847,154,2,"71,65",5,1,1,7,Mid-Value,Potential Loyalists
74849,434,3,"40,75",4,1,1,6,Mid-Value,Potential Loyalists
74850,184,1,"22,950000000000003",5,1,1,7,Mid-Value,Potential Loyalists
74852,354,1,"33,9",5,1,1,7,Mid-Value,Potential Loyalists
74854,755,3,"97,89999999999999",3,1,1,5,Low-Value,At Risk Customers
74857,815,1,"1,15",3,1,1,5,Low-Value,At Risk Customers
74858,1126,4,"407,44999999999993",2,1,1,4,Low-Value,Can't Lose
74864,156,10,"801,0",5,2,2,9,High-Value,Champions
74866,80,3,"177,35",5,1,1,7,Mid-Value,Potential Loyalists
74868,38,4,"201,5",5,1,1,7,Mid-Value,Potential Loyalists
74870,420,3,"226,25",4,1,1,6,Mid-Value,Potential Loyalists
74871,5,7,"493,79999999999995",5,2,1,8,High-Value,Potential Loyalists
74872,348,2,"112,1",5,1,1,7,Mid-Value,Potential Loyalists
74873,435,1,"13,9",4,1,1,6,Mid-Value,Potential Loyalists
74874,7,8,"620,85",5,2,1,8,High-Value,Potential Loyalists
74875,1078,1,"5,45",3,1,1,5,Low-Value,At Risk Customers
74876,505,3,"63,25",4,1,1,6,Mid-Value,Potential Loyalists
74877,445,5,"228,54999999999998",4,1,1,6,Mid-Value,Potential Loyalists
74878,427,2,"196,25",4,1,1,6,Mid-Value,Potential Loyalists
74881,12,4,"151,9",5,1,1,7,Mid-Value,Potential Loyalists
74885,13,2,"193,4",5,1,1,7,Mid-Value,Potential Loyalists
74887,1172,1,"4,75",2,1,1,4,Low-Value,Can't Lose
74889,1744,1,"12,4",1,1,1,3,Low-Value,Lost
74895,20,12,"754,75",5,3,2,10,High-Value,Champions
74896,337,2,"66,6",5,1,1,7,Mid-Value,Potential Loyalists
74897,3,9,"337,09999999999997",5,2,1,8,High-Value,Potential Loyalists
74900,920,2,"458,8",3,1,1,5,Low-Value,At Risk Customers
74901,641,1,"8,9",4,1,1,6,Mid-Value,Potential Loyalists
74903,972,1,"23,65",3,1,1,5,Low-Value,At Risk Customers
74904,129,2,"99,35000000000001",5,1,1,7,Mid-Value,Potential Loyalists
74905,21,8,"364,70000000000005",5,2,1,8,High-Value,Potential Loyalists
74907,340,5,"648,0500000000001",5,1,1,7,Mid-Value,Potential Loyalists
74908,61,7,"424,1",5,2,1,8,High-Value,Potential Loyalists
74911,456,4,"119,65",4,1,1,6,Mid-Value,Potential Loyalists
74912,1520,1,"37,15",1,1,1,3,Low-Value,Lost
74913,804,4,"116,75",3,1,1,5,Low-Value,At Risk Customers
74914,307,6,"264,2",5,1,1,7,Mid-Value,Potential Loyalists
74916,123,3,"235,5",5,1,1,7,Mid-Value,Potential Loyalists
74917,649,1,"22,65",4,1,1,6,Mid-Value,Potential Loyalists
74918,90,2,"99,9",5,1,1,7,Mid-Value,Potential Loyalists
74920,31,2,"32,3",5,1,1,7,Mid-Value,Potential Loyalists
74921,1433,1,"15,65",2,1,1,4,Low-Value,Can't Lose
74922,443,4,"81,7",4,1,1,6,Mid-Value,Potential Loyalists
74923,156,4,"142,55",5,1,1,7,Mid-Value,Potential Loyalists
74924,300,3,"512,5",5,1,1,7,Mid-Value,Potential Loyalists
74925,25,6,"503,5",5,1,1,7,Mid-Value,Potential Loyalists
74926,66,6,"358,1",5,1,1,7,Mid-Value,Potential Loyalists
74928,1012,1,"14,8",3,1,1,5,Low-Value,At Risk Customers
74930,77,3,"125,80000000000001",5,1,1,7,Mid-Value,Potential Loyalists
74931,311,2,"118,85",5,1,1,7,Mid-Value,Potential Loyalists
74932,1655,1,"77,1",1,1,1,3,Low-Value,Lost
74933,836,2,"96,15",3,1,1,5,Low-Value,At Risk Customers
74934,947,2,"65,95",3,1,1,5,Low-Value,At Risk Customers
74935,43,1,"27,8",5,1,1,7,Mid-Value,Potential Loyalists
74936,855,3,"147,0",3,1,1,5,Low-Value,At Risk Customers
74939,418,6,"508,65",4,1,1,6,Mid-Value,Potential Loyalists
74940,516,2,"118,5",4,1,1,6,Mid-Value,Potential Loyalists
74945,883,2,"73,9",3,1,1,5,Low-Value,At Risk Customers
74946,247,2,"82,4",5,1,1,7,Mid-Value,Potential Loyalists
74948,335,3,"489,85",5,1,1,7,Mid-Value,Potential Loyalists
74950,82,2,"121,5",5,1,1,7,Mid-Value,Potential Loyalists
74951,328,3,"148,3",5,1,1,7,Mid-Value,Potential Loyalists
74952,1016,1,"115,0",3,1,1,5,Low-Value,At Risk Customers
74954,355,5,"376,75",5,1,1,7,Mid-Value,Potential Loyalists
74955,699,1,"5,15",4,1,1,6,Mid-Value,Potential Loyalists
74958,13,6,"235,1",5,1,1,7,Mid-Value,Potential Loyalists
74960,874,3,"208,39999999999998",3,1,1,5,Low-Value,At Risk Customers
74961,435,3,"125,35",4,1,1,6,Mid-Value,Potential Loyalists
74963,1018,1,"67,8",3,1,1,5,Low-Value,At Risk Customers
74965,479,2,"60,65",4,1,1,6,Mid-Value,Potential Loyalists
74966,1486,1,"149,8",1,1,1,3,Low-Value,Lost
74967,166,5,"427,75",5,1,1,7,Mid-Value,Potential Loyalists
74970,194,4,"263,6",5,1,1,7,Mid-Value,Potential Loyalists
74971,833,6,"404,1",3,1,1,5,Low-Value,At Risk Customers
74973,158,8,"340,45",5,2,1,8,High-Value,Potential Loyalists
74974,77,4,"278,25",5,1,1,7,Mid-Value,Potential Loyalists
74976,134,11,"731,9499999999999",5,2,2,9,High-Value,Champions
74978,690,3,"237,40000000000003",4,1,1,6,Mid-Value,Potential Loyalists
74979,59,4,"171,60000000000002",5,1,1,7,Mid-Value,Potential Loyalists
74980,392,2,"51,900000000000006",4,1,1,6,Mid-Value,Potential Loyalists
74984,385,2,"355,9",4,1,1,6,Mid-Value,Potential Loyalists
74986,30,9,"411,0",5,2,1,8,High-Value,Potential Loyalists
74987,140,3,"230,85",5,1,1,7,Mid-Value,Potential Loyalists
74988,89,7,"395,0",5,2,1,8,High-Value,Potential Loyalists
74989,209,5,"175,75",5,1,1,7,Mid-Value,Potential Loyalists
74991,457,2,"57,6",4,1,1,6,Mid-Value,Potential Loyalists
74993,304,5,"223,0",5,1,1,7,Mid-Value,Potential Loyalists
74994,366,7,"240,25",4,2,1,7,Mid-Value,Potential Loyalists
74995,477,3,"556,7",4,1,1,6,Mid-Value,Potential Loyalists
75001,1642,1,"43,6",1,1,1,3,Low-Value,Lost
75002,28,5,"368,8",5,1,1,7,Mid-Value,Potential Loyalists
75003,1631,1,"295,4",1,1,1,3,Low-Value,Lost
75008,1594,1,"51,7",1,1,1,3,Low-Value,Lost
75009,472,8,"346,35",4,2,1,7,Mid-Value,Potential Loyalists
75010,397,10,"1390,8",4,2,3,9,High-Value,Champions
75012,311,3,"127,5",5,1,1,7,Mid-Value,Potential Loyalists
75013,504,2,"85,85000000000001",4,1,1,6,Mid-Value,Potential Loyalists
75015,821,1,"36,8",3,1,1,5,Low-Value,At Risk Customers
75016,406,1,"5,5",4,1,1,6,Mid-Value,Potential Loyalists
75018,1672,1,"221,25",1,1,1,3,Low-Value,Lost
75019,273,4,"337,35",5,1,1,7,Mid-Value,Potential Loyalists
75020,458,3,"345,5",4,1,1,6,Mid-Value,Potential Loyalists
75021,651,5,"208,75",4,1,1,6,Mid-Value,Potential Loyalists
75022,501,3,"191,09999999999997",4,1,1,6,Mid-Value,Potential Loyalists
75023,817,3,"213,0",3,1,1,5,Low-Value,At Risk Customers
75026,132,7,"860,1",5,2,2,9,High-Value,Champions
75029,207,1,"155,6",5,1,1,7,Mid-Value,Potential Loyalists
75030,1314,3,"482,15",2,1,1,4,Low-Value,Can't Lose
75031,257,3,"294,90000000000003",5,1,1,7,Mid-Value,Potential Loyalists
75035,985,3,"104,4",3,1,1,5,Low-Value,At Risk Customers
75036,1334,1,"41,4",2,1,1,4,Low-Value,Can't Lose
75037,371,3,"204,4",4,1,1,6,Mid-Value,Potential Loyalists
75039,19,5,"366,05",5,1,1,7,Mid-Value,Potential Loyalists
75040,33,3,"56,25",5,1,1,7,Mid-Value,Potential Loyalists
75044,1689,2,"115,65",1,1,1,3,Low-Value,Lost
75046,144,9,"621,0",5,2,1,8,High-Value,Potential Loyalists
75048,1779,1,"221,25",1,1,1,3,Low-Value,Lost
75049,208,2,"247,1",5,1,1,7,Mid-Value,Potential Loyalists
75050,341,2,"128,3",5,1,1,7,Mid-Value,Potential Loyalists
75052,237,1,"24,7",5,1,1,7,Mid-Value,Potential Loyalists
75053,1322,1,"42,85",2,1,1,4,Low-Value,Can't Lose
75054,1701,1,"15,0",1,1,1,3,Low-Value,Lost
75056,665,2,"39,0",4,1,1,6,Mid-Value,Potential Loyalists
75058,102,3,"169,54999999999998",5,1,1,7,Mid-Value,Potential Loyalists
75059,1375,1,"48,45",2,1,1,4,Low-Value,Can't Lose
75061,22,10,"473,95",5,2,1,8,High-Value,Potential Loyalists
75063,23,4,"171,65",5,1,1,7,Mid-Value,Potential Loyalists
75065,402,1,"90,6",4,1,1,6,Mid-Value,Potential Loyalists
75066,1356,1,"11,7",2,1,1,4,Low-Value,Can't Lose
75067,893,4,"140,05",3,1,1,5,Low-Value,At Risk Customers
75068,1210,3,"155,1",2,1,1,4,Low-Value,Can't Lose
75069,142,3,"417,2",5,1,1,7,Mid-Value,Potential Loyalists
75072,1751,1,"22,8",1,1,1,3,Low-Value,Lost
75073,148,6,"110,05",5,1,1,7,Mid-Value,Potential Loyalists
75075,142,3,"515,7",5,1,1,7,Mid-Value,Potential Loyalists
75076,225,5,"235,2",5,1,1,7,Mid-Value,Potential Loyalists
75079,407,5,"194,65",4,1,1,6,Mid-Value,Potential Loyalists
75080,514,3,"296,5",4,1,1,6,Mid-Value,Potential Loyalists
75082,773,3,"84,15",3,1,1,5,Low-Value,At Risk Customers
75084,1124,2,"75,6",2,1,1,4,Low-Value,Can't Lose
75085,910,5,"498,20000000000005",3,1,1,5,Low-Value,At Risk Customers
75086,608,1,"18,3",4,1,1,6,Mid-Value,Potential Loyalists
75088,131,4,"185,5",5,1,1,7,Mid-Value,Potential Loyalists
75089,1107,2,"68,2",2,1,1,4,Low-Value,Can't Lose
75090,1343,1,"15,0",2,1,1,4,Low-Value,Can't Lose
75091,180,2,"223,0",5,1,1,7,Mid-Value,Potential Loyalists
75092,101,7,"534,4",5,2,1,8,High-Value,Potential Loyalists
75094,14,10,"548,75",5,2,1,8,High-Value,Potential Loyalists
75095,941,2,"267,7",3,1,1,5,Low-Value,At Risk Customers
75096,483,5,"97,05",4,1,1,6,Mid-Value,Potential Loyalists
75097,387,3,"344,65",4,1,1,6,Mid-Value,Potential Loyalists
75098,559,2,"186,85000000000002",4,1,1,6,Mid-Value,Potential Loyalists
75099,86,3,"223,05",5,1,1,7,Mid-Value,Potential Loyalists
75101,449,2,"39,7",4,1,1,6,Mid-Value,Potential Loyalists
75103,1627,1,"7,0",1,1,1,3,Low-Value,Lost
75104,5,5,"295,35",5,1,1,7,Mid-Value,Potential Loyalists
75105,620,4,"285,35",4,1,1,6,Mid-Value,Potential Loyalists
75106,333,3,"147,10000000000002",5,1,1,7,Mid-Value,Potential Loyalists
75108,1693,1,"96,3",1,1,1,3,Low-Value,Lost
75111,809,2,"116,14999999999999",3,1,1,5,Low-Value,At Risk Customers
75112,821,2,"26,3",3,1,1,5,Low-Value,At Risk Customers
75113,1251,2,"80,19999999999999",2,1,1,4,Low-Value,Can't Lose
75114,636,6,"205,39999999999998",4,1,1,6,Mid-Value,Potential Loyalists
75115,1752,1,"15,2",1,1,1,3,Low-Value,Lost
75116,601,4,"129,45",4,1,1,6,Mid-Value,Potential Loyalists
75117,918,2,"32,95",3,1,1,5,Low-Value,At Risk Customers
75118,1695,1,"12,1",1,1,1,3,Low-Value,Lost
75119,635,2,"91,30000000000001",4,1,1,6,Mid-Value,Potential Loyalists
75120,1359,1,"118,55",2,1,1,4,Low-Value,Can't Lose
75121,259,3,"218,79999999999998",5,1,1,7,Mid-Value,Potential Loyalists
75126,100,4,"286,05",5,1,1,7,Mid-Value,Potential Loyalists
75127,34,3,"127,85",5,1,1,7,Mid-Value,Potential Loyalists
75128,455,5,"182,6",4,1,1,6,Mid-Value,Potential Loyalists
75130,1322,3,"209,25",2,1,1,4,Low-Value,Can't Lose
75131,43,20,"1860,35",5,4,3,12,High-Value,Champions
75132,1432,4,"168,15",2,1,1,4,Low-Value,Can't Lose
75133,116,2,"347,65",5,1,1,7,Mid-Value,Potential Loyalists
75134,138,10,"578,15",5,2,1,8,High-Value,Potential Loyalists
75136,571,1,"131,2",4,1,1,6,Mid-Value,Potential Loyalists
75137,970,2,"255,55",3,1,1,5,Low-Value,At Risk Customers
75140,1350,1,"48,6",2,1,1,4,Low-Value,Can't Lose
75141,1240,1,"37,7",2,1,1,4,Low-Value,Can't Lose
75142,383,2,"91,8",4,1,1,6,Mid-Value,Potential Loyalists
75145,1,4,"378,45",5,1,1,7,Mid-Value,Potential Loyalists
75146,1051,1,"107,2",3,1,1,5,Low-Value,At Risk Customers
75147,85,2,"57,849999999999994",5,1,1,7,Mid-Value,Potential Loyalists
75148,463,1,"8,7",4,1,1,6,Mid-Value,Potential Loyalists
75149,74,6,"252,39999999999998",5,1,1,7,Mid-Value,Potential Loyalists
75151,1424,1,"315,6",2,1,1,4,Low-Value,Can't Lose
75152,343,1,"133,5",5,1,1,7,Mid-Value,Potential Loyalists
75156,18,6,"541,0",5,1,1,7,Mid-Value,Potential Loyalists
75157,1534,1,"125,65",1,1,1,3,Low-Value,Lost
75158,972,2,"253,9",3,1,1,5,Low-Value,At Risk Customers
75159,541,7,"242,9",4,2,1,7,Mid-Value,Potential Loyalists
75160,153,1,"69,6",5,1,1,7,Mid-Value,Potential Loyalists
75161,658,4,"389,49999999999994",4,1,1,6,Mid-Value,Potential Loyalists
75162,426,2,"428,09999999999997",4,1,1,6,Mid-Value,Potential Loyalists
75163,963,1,"19,5",3,1,1,5,Low-Value,At Risk Customers
75165,424,3,"61,45",4,1,1,6,Mid-Value,Potential Loyalists
75166,786,2,"918,25",3,1,2,6,Mid-Value,Potential Loyalists
75167,810,3,"189,5",3,1,1,5,Low-Value,At Risk Customers
75168,103,2,"74,6",5,1,1,7,Mid-Value,Potential Loyalists
75171,398,2,"40,1",4,1,1,6,Mid-Value,Potential Loyalists
75172,280,4,"177,25",5,1,1,7,Mid-Value,Potential Loyalists
75173,1291,2,"416,34999999999997",2,1,1,4,Low-Value,Can't Lose
75174,102,4,"199,0",5,1,1,7,Mid-Value,Potential Loyalists
75175,168,2,"121,7",5,1,1,7,Mid-Value,Potential Loyalists
75177,231,2,"123,2",5,1,1,7,Mid-Value,Potential Loyalists
75178,139,6,"518,3",5,1,1,7,Mid-Value,Potential Loyalists
75180,451,1,"1,6",4,1,1,6,Mid-Value,Potential Loyalists
75182,745,11,"592,95",3,2,1,6,Mid-Value,Potential Loyalists
75183,854,3,"129,8",3,1,1,5,Low-Value,At Risk Customers
75184,802,3,"112,35",3,1,1,5,Low-Value,At Risk Customers
75185,1482,2,"98,5",1,1,1,3,Low-Value,Lost
75187,45,8,"541,75",5,2,1,8,High-Value,Potential Loyalists
75189,416,4,"347,65",4,1,1,6,Mid-Value,Potential Loyalists
75192,258,8,"769,9",5,2,2,9,High-Value,Champions
75193,911,3,"77,15",3,1,1,5,Low-Value,At Risk Customers
75194,224,5,"406,65",5,1,1,7,Mid-Value,Potential Loyalists
75196,172,4,"357,75",5,1,1,7,Mid-Value,Potential Loyalists
75198,593,2,"80,2",4,1,1,6,Mid-Value,Potential Loyalists
75200,1124,1,"59,7",2,1,1,4,Low-Value,Can't Lose
75202,1077,4,"339,45",3,1,1,5,Low-Value,At Risk Customers
75203,236,1,"13,25",5,1,1,7,Mid-Value,Potential Loyalists
75204,319,8,"313,7",5,2,1,8,High-Value,Potential Loyalists
75206,554,1,"55,800000000000004",4,1,1,6,Mid-Value,Potential Loyalists
75207,601,2,"82,25",4,1,1,6,Mid-Value,Potential Loyalists
75210,419,2,"385,7",4,1,1,6,Mid-Value,Potential Loyalists
75211,25,6,"522,3",5,1,1,7,Mid-Value,Potential Loyalists
75212,574,1,"8,4",4,1,1,6,Mid-Value,Potential Loyalists
75214,857,4,"307,05",3,1,1,5,Low-Value,At Risk Customers
75215,520,2,"138,8",4,1,1,6,Mid-Value,Potential Loyalists
75216,730,1,"87,9",4,1,1,6,Mid-Value,Potential Loyalists
75218,596,9,"401,0",4,2,1,7,Mid-Value,Potential Loyalists
75219,36,10,"794,8",5,2,2,9,High-Value,Champions
75221,328,3,"169,79999999999998",5,1,1,7,Mid-Value,Potential Loyalists
75222,250,1,"200,10000000000002",5,1,1,7,Mid-Value,Potential Loyalists
75223,327,2,"26,0",5,1,1,7,Mid-Value,Potential Loyalists
75224,587,2,"69,05",4,1,1,6,Mid-Value,Potential Loyalists
75225,513,1,"103,1",4,1,1,6,Mid-Value,Potential Loyalists
75227,1167,2,"282,75",2,1,1,4,Low-Value,Can't Lose
75229,505,15,"1244,05",4,3,2,9,High-Value,Champions
75231,875,2,"37,550000000000004",3,1,1,5,Low-Value,At Risk Customers
75232,1671,1,"18,8",1,1,1,3,Low-Value,Lost
75234,82,3,"73,19999999999999",5,1,1,7,Mid-Value,Potential Loyalists
75236,58,5,"273,5",5,1,1,7,Mid-Value,Potential Loyalists
75237,264,4,"340,8",5,1,1,7,Mid-Value,Potential Loyalists
75238,1066,1,"35,9",3,1,1,5,Low-Value,At Risk Customers
75239,25,4,"813,9499999999999",5,1,2,8,High-Value,Potential Loyalists
75240,868,2,"266,55",3,1,1,5,Low-Value,At Risk Customers
75241,1331,2,"26,7",2,1,1,4,Low-Value,Can't Lose
75242,1323,2,"217,6",2,1,1,4,Low-Value,Can't Lose
75243,553,3,"78,35000000000001",4,1,1,6,Mid-Value,Potential Loyalists
75252,567,2,"173,60000000000002",4,1,1,6,Mid-Value,Potential Loyalists
75254,101,7,"909,2",5,2,2,9,High-Value,Champions
75255,403,13,"624,5",4,3,1,8,High-Value,Potential Loyalists
75256,522,3,"420,2",4,1,1,6,Mid-Value,Potential Loyalists
75257,228,1,"59,4",5,1,1,7,Mid-Value,Potential Loyalists
75258,418,13,"546,55",4,3,1,8,High-Value,Potential Loyalists
75259,863,3,"115,05",3,1,1,5,Low-Value,At Risk Customers
75260,211,9,"652,25",5,2,1,8,High-Value,Potential Loyalists
75261,799,9,"302,75",3,2,1,6,Mid-Value,Potential Loyalists
75262,399,10,"372,8",4,2,1,7,Mid-Value,Potential Loyalists
75264,2,7,"358,34999999999997",5,2,1,8,High-Value,Potential Loyalists
75268,29,11,"931,5",5,2,2,9,High-Value,Champions
75269,205,4,"277,7",5,1,1,7,Mid-Value,Potential Loyalists
75271,707,1,"13,4",4,1,1,6,Mid-Value,Potential Loyalists
75272,501,4,"484,7",4,1,1,6,Mid-Value,Potential Loyalists
75273,113,5,"251,5",5,1,1,7,Mid-Value,Potential Loyalists
75274,162,2,"38,6",5,1,1,7,Mid-Value,Potential Loyalists
75275,374,5,"495,15",4,1,1,6,Mid-Value,Potential Loyalists
75278,623,1,"15,95",4,1,1,6,Mid-Value,Potential Loyalists
75279,425,5,"348,0",4,1,1,6,Mid-Value,Potential Loyalists
75280,185,2,"68,5",5,1,1,7,Mid-Value,Potential Loyalists
75281,687,4,"99,89999999999999",4,1,1,6,Mid-Value,Potential Loyalists
75282,109,3,"256,9",5,1,1,7,Mid-Value,Potential Loyalists
75286,1221,1,"134,55",2,1,1,4,Low-Value,Can't Lose
75287,1494,1,"69,4",1,1,1,3,Low-Value,Lost
75288,769,1,"38,25",3,1,1,5,Low-Value,At Risk Customers
75289,127,8,"168,35",5,2,1,8,High-Value,Potential Loyalists
75290,1612,1,"17,1",1,1,1,3,Low-Value,Lost
75291,280,3,"120,0",5,1,1,7,Mid-Value,Potential Loyalists
75292,421,3,"39,7",4,1,1,6,Mid-Value,Potential Loyalists
75293,952,5,"121,3",3,1,1,5,Low-Value,At Risk Customers
75295,542,3,"40,6",4,1,1,6,Mid-Value,Potential Loyalists
75296,532,9,"574,4499999999999",4,2,1,7,Mid-Value,Potential Loyalists
75297,942,1,"58,5",3,1,1,5,Low-Value,At Risk Customers
75298,491,15,"1356,1",4,3,3,10,High-Value,Champions
75300,1148,1,"58,8",2,1,1,4,Low-Value,Can't Lose
75302,11,3,"123,19999999999999",5,1,1,7,Mid-Value,Potential Loyalists
75303,347,1,"49,0",5,1,1,7,Mid-Value,Potential Loyalists
75304,118,2,"124,64999999999999",5,1,1,7,Mid-Value,Potential Loyalists
75305,1074,1,"76,7",3,1,1,5,Low-Value,At Risk Customers
75308,825,2,"57,1",3,1,1,5,Low-Value,At Risk Customers
75309,368,6,"716,1500000000001",4,1,2,7,Mid-Value,Potential Loyalists
75311,636,6,"303,2",4,1,1,6,Mid-Value,Potential Loyalists
75314,67,8,"422,35",5,2,1,8,High-Value,Potential Loyalists
75315,250,2,"22,849999999999998",5,1,1,7,Mid-Value,Potential Loyalists
75317,105,4,"126,9",5,1,1,7,Mid-Value,Potential Loyalists
75318,700,5,"350,65",4,1,1,6,Mid-Value,Potential Loyalists
75321,157,4,"460,2",5,1,1,7,Mid-Value,Potential Loyalists
75322,1223,2,"112,85",2,1,1,4,Low-Value,Can't Lose
75323,44,3,"149,75",5,1,1,7,Mid-Value,Potential Loyalists
75324,931,4,"722,8499999999999",3,1,2,6,Mid-Value,Potential Loyalists
75325,1595,1,"20,0",1,1,1,3,Low-Value,Lost
75326,1438,1,"85,6",2,1,1,4,Low-Value,Can't Lose
75327,727,1,"33,25",4,1,1,6,Mid-Value,Potential Loyalists
75329,410,4,"197,25000000000003",4,1,1,6,Mid-Value,Potential Loyalists
75330,1226,1,"51,6",2,1,1,4,Low-Value,Can't Lose
75331,608,1,"8,6",4,1,1,6,Mid-Value,Potential Loyalists
75332,42,4,"491,54999999999995",5,1,1,7,Mid-Value,Potential Loyalists
75333,131,6,"435,5",5,1,1,7,Mid-Value,Potential Loyalists
75334,222,1,"21,2",5,1,1,7,Mid-Value,Potential Loyalists
75335,5,2,"36,0",5,1,1,7,Mid-Value,Potential Loyalists
75338,272,2,"278,85",5,1,1,7,Mid-Value,Potential Loyalists
75340,1,4,"705,3",5,1,2,8,High-Value,Potential Loyalists
75341,1542,1,"18,65",1,1,1,3,Low-Value,Lost
75342,1728,1,"50,9",1,1,1,3,Low-Value,Lost
75343,43,1,"58,6",5,1,1,7,Mid-Value,Potential Loyalists
75345,238,7,"458,4",5,2,1,8,High-Value,Potential Loyalists
75348,938,3,"168,3",3,1,1,5,Low-Value,At Risk Customers
75349,152,4,"162,25",5,1,1,7,Mid-Value,Potential Loyalists
75351,949,1,"38,65",3,1,1,5,Low-Value,At Risk Customers
75358,183,2,"45,6",5,1,1,7,Mid-Value,Potential Loyalists
75359,401,11,"570,7",4,2,1,7,Mid-Value,Potential Loyalists
75360,153,8,"270,75",5,2,1,8,High-Value,Potential Loyalists
75362,39,3,"202,9",5,1,1,7,Mid-Value,Potential Loyalists
75364,442,1,"135,0",4,1,1,6,Mid-Value,Potential Loyalists
75365,894,1,"18,299999999999997",3,1,1,5,Low-Value,At Risk Customers
75366,89,3,"236,60000000000002",5,1,1,7,Mid-Value,Potential Loyalists
75368,25,2,"206,35",5,1,1,7,Mid-Value,Potential Loyalists
75369,1179,3,"751,0",2,1,2,5,Low-Value,At Risk Customers
75370,1224,3,"93,75",2,1,1,4,Low-Value,Can't Lose
75372,1496,1,"7,95",1,1,1,3,Low-Value,Lost
75379,1021,1,"10,3",3,1,1,5,Low-Value,At Risk Customers
75383,1713,1,"7,6",1,1,1,3,Low-Value,Lost
75384,210,8,"570,6",5,2,1,8,High-Value,Potential Loyalists
75386,635,2,"239,75",4,1,1,6,Mid-Value,Potential Loyalists
75387,417,3,"50,85",4,1,1,6,Mid-Value,Potential Loyalists
75391,1105,3,"105,0",2,1,1,4,Low-Value,Can't Lose
75393,1542,4,"281,5",1,1,1,3,Low-Value,Lost
75394,694,2,"32,3",4,1,1,6,Mid-Value,Potential Loyalists
75397,1024,3,"120,4",3,1,1,5,Low-Value,At Risk Customers
75399,22,5,"368,35",5,1,1,7,Mid-Value,Potential Loyalists
75400,246,1,"142,95",5,1,1,7,Mid-Value,Potential Loyalists
75404,905,2,"494,15",3,1,1,5,Low-Value,At Risk Customers
75410,29,2,"120,0",5,1,1,7,Mid-Value,Potential Loyalists
75411,81,6,"465,75",5,1,1,7,Mid-Value,Potential Loyalists
75412,742,2,"107,85000000000001",3,1,1,5,Low-Value,At Risk Customers
75414,10,5,"281,20000000000005",5,1,1,7,Mid-Value,Potential Loyalists
75415,962,1,"31,5",3,1,1,5,Low-Value,At Risk Customers
75416,945,1,"21,4",3,1,1,5,Low-Value,At Risk Customers
75417,431,14,"505,6",4,3,1,8,High-Value,Potential Loyalists
75418,772,2,"220,7",3,1,1,5,Low-Value,At Risk Customers
75425,84,4,"251,45",5,1,1,7,Mid-Value,Potential Loyalists
75426,784,2,"30,5",3,1,1,5,Low-Value,At Risk Customers
75427,360,5,"377,65000000000003",5,1,1,7,Mid-Value,Potential Loyalists
75428,60,4,"197,55",5,1,1,7,Mid-Value,Potential Loyalists
75432,368,3,"356,0",4,1,1,6,Mid-Value,Potential Loyalists
75433,799,2,"202,25",3,1,1,5,Low-Value,At Risk Customers
75434,318,1,"15,0",5,1,1,7,Mid-Value,Potential Loyalists
75435,1364,2,"113,15",2,1,1,4,Low-Value,Can't Lose
75436,389,1,"94,0",4,1,1,6,Mid-Value,Potential Loyalists
75441,127,3,"278,5",5,1,1,7,Mid-Value,Potential Loyalists
75442,1332,1,"49,15",2,1,1,4,Low-Value,Can't Lose
75443,199,5,"191,45",5,1,1,7,Mid-Value,Potential Loyalists
75444,141,15,"1739,75",5,3,3,11,High-Value,Champions
75446,1340,1,"4,35",2,1,1,4,Low-Value,Can't Lose
75450,366,7,"264,7",4,2,1,7,Mid-Value,Potential Loyalists
75452,160,1,"88,6",5,1,1,7,Mid-Value,Potential Loyalists
75453,418,2,"54,05",4,1,1,6,Mid-Value,Potential Loyalists
75454,810,5,"294,8",3,1,1,5,Low-Value,At Risk Customers
75455,784,2,"19,8",3,1,1,5,Low-Value,At Risk Customers
75458,67,6,"298,95",5,1,1,7,Mid-Value,Potential Loyalists
75459,385,2,"124,6",4,1,1,6,Mid-Value,Potential Loyalists
75460,0,5,"160,05",5,1,1,7,Mid-Value,Potential Loyalists
75462,152,5,"878,95",5,1,2,8,High-Value,Potential Loyalists
75463,1735,1,"21,3",1,1,1,3,Low-Value,Lost
75464,1379,1,"16,8",2,1,1,4,Low-Value,Can't Lose
75465,920,2,"243,7",3,1,1,5,Low-Value,At Risk Customers
75466,12,9,"590,65",5,2,1,8,High-Value,Potential Loyalists
75467,1054,1,"32,9",3,1,1,5,Low-Value,At Risk Customers
75468,66,4,"121,85",5,1,1,7,Mid-Value,Potential Loyalists
75473,561,2,"34,15",4,1,1,6,Mid-Value,Potential Loyalists
75477,529,4,"351,85",4,1,1,6,Mid-Value,Potential Loyalists
75478,435,1,"19,35",4,1,1,6,Mid-Value,Potential Loyalists
75479,683,1,"34,05",4,1,1,6,Mid-Value,Potential Loyalists
75481,29,12,"738,7",5,3,2,10,High-Value,Champions
75485,796,1,"34,9",3,1,1,5,Low-Value,At Risk Customers
75487,246,5,"593,25",5,1,1,7,Mid-Value,Potential Loyalists
75488,914,1,"494,5",3,1,1,5,Low-Value,At Risk Customers
75490,500,7,"261,1",4,2,1,7,Mid-Value,Potential Loyalists
75492,90,3,"101,5",5,1,1,7,Mid-Value,Potential Loyalists
75495,209,7,"693,75",5,2,2,9,High-Value,Champions
75497,142,3,"226,8",5,1,1,7,Mid-Value,Potential Loyalists
75499,605,3,"51,9",4,1,1,6,Mid-Value,Potential Loyalists
75501,23,4,"314,8",5,1,1,7,Mid-Value,Potential Loyalists
75504,1706,1,"9,45",1,1,1,3,Low-Value,Lost
75507,759,4,"397,85",3,1,1,5,Low-Value,At Risk Customers
75509,120,2,"66,85",5,1,1,7,Mid-Value,Potential Loyalists
75510,425,5,"235,9",4,1,1,6,Mid-Value,Potential Loyalists
75514,552,1,"75,9",4,1,1,6,Mid-Value,Potential Loyalists
75516,1019,1,"60,05",3,1,1,5,Low-Value,At Risk Customers
75517,235,3,"237,95",5,1,1,7,Mid-Value,Potential Loyalists
75518,808,1,"20,1",3,1,1,5,Low-Value,At Risk Customers
75519,525,4,"122,95",4,1,1,6,Mid-Value,Potential Loyalists
75522,144,4,"234,5",5,1,1,7,Mid-Value,Potential Loyalists
75523,65,6,"275,0",5,1,1,7,Mid-Value,Potential Loyalists
75525,176,4,"93,10000000000001",5,1,1,7,Mid-Value,Potential Loyalists
75527,97,4,"163,89999999999998",5,1,1,7,Mid-Value,Potential Loyalists
75528,990,1,"51,15",3,1,1,5,Low-Value,At Risk Customers
75529,167,4,"373,35",5,1,1,7,Mid-Value,Potential Loyalists
75532,823,1,"23,7",3,1,1,5,Low-Value,At Risk Customers
75533,84,7,"939,65",5,2,2,9,High-Value,Champions
75534,143,2,"189,0",5,1,1,7,Mid-Value,Potential Loyalists
75538,246,1,"32,2",5,1,1,7,Mid-Value,Potential Loyalists
75539,887,3,"170,5",3,1,1,5,Low-Value,At Risk Customers
75542,1801,1,"6,5",1,1,1,3,Low-Value,Lost
75543,632,1,"23,4",4,1,1,6,Mid-Value,Potential Loyalists
75545,900,2,"70,7",3,1,1,5,Low-Value,At Risk Customers
75546,752,3,"189,0",3,1,1,5,Low-Value,At Risk Customers
75548,1774,1,"103,95",1,1,1,3,Low-Value,Lost
75549,652,4,"325,4",4,1,1,6,Mid-Value,Potential Loyalists
75552,576,6,"260,2",4,1,1,6,Mid-Value,Potential Loyalists
75554,200,1,"79,0",5,1,1,7,Mid-Value,Potential Loyalists
75555,121,8,"324,5",5,2,1,8,High-Value,Potential Loyalists
75556,1201,3,"121,65",2,1,1,4,Low-Value,Can't Lose
75557,15,15,"1424,6499999999999",5,3,3,11,High-Value,Champions
75559,328,1,"1,75",5,1,1,7,Mid-Value,Potential Loyalists
75561,75,4,"461,2",5,1,1,7,Mid-Value,Potential Loyalists
75562,149,6,"353,65",5,1,1,7,Mid-Value,Potential Loyalists
75563,403,2,"20,049999999999997",4,1,1,6,Mid-Value,Potential Loyalists
75564,652,4,"297,05",4,1,1,6,Mid-Value,Potential Loyalists
75565,282,2,"28,95",5,1,1,7,Mid-Value,Potential Loyalists
75568,796,3,"109,6",3,1,1,5,Low-Value,At Risk Customers
75569,1064,3,"200,79999999999998",3,1,1,5,Low-Value,At Risk Customers
75571,28,5,"369,6",5,1,1,7,Mid-Value,Potential Loyalists
75572,410,1,"31,95",4,1,1,6,Mid-Value,Potential Loyalists
75573,53,3,"244,35000000000002",5,1,1,7,Mid-Value,Potential Loyalists
75574,436,4,"58,9",4,1,1,6,Mid-Value,Potential Loyalists
75577,53,10,"413,79999999999995",5,2,1,8,High-Value,Potential Loyalists
75579,1273,1,"46,5",2,1,1,4,Low-Value,Can't Lose
75581,10,5,"335,45000000000005",5,1,1,7,Mid-Value,Potential Loyalists
75583,250,6,"192,60000000000002",5,1,1,7,Mid-Value,Potential Loyalists
75585,342,4,"190,6",5,1,1,7,Mid-Value,Potential Loyalists
75586,496,2,"28,4",4,1,1,6,Mid-Value,Potential Loyalists
75589,970,2,"478,25",3,1,1,5,Low-Value,At Risk Customers
75590,547,6,"342,9",4,1,1,6,Mid-Value,Potential Loyalists
75594,870,2,"129,95",3,1,1,5,Low-Value,At Risk Customers
75595,1143,2,"134,3",2,1,1,4,Low-Value,Can't Lose
75598,622,1,"9,85",4,1,1,6,Mid-Value,Potential Loyalists
75599,510,3,"52,4",4,1,1,6,Mid-Value,Potential Loyalists
75601,407,2,"230,29999999999998",4,1,1,6,Mid-Value,Potential Loyalists
75602,169,3,"114,85",5,1,1,7,Mid-Value,Potential Loyalists
75603,5,10,"1396,85",5,2,3,10,High-Value,Champions
75604,1319,2,"59,15",2,1,1,4,Low-Value,Can't Lose
75605,173,2,"114,7",5,1,1,7,Mid-Value,Potential Loyalists
75606,841,3,"156,55",3,1,1,5,Low-Value,At Risk Customers
75609,73,2,"88,3",5,1,1,7,Mid-Value,Potential Loyalists
75610,701,1,"52,8",4,1,1,6,Mid-Value,Potential Loyalists
75612,41,5,"258,65",5,1,1,7,Mid-Value,Potential Loyalists
75615,85,3,"291,85",5,1,1,7,Mid-Value,Potential Loyalists
75616,59,12,"720,0",5,3,2,10,High-Value,Champions
75618,102,4,"370,7",5,1,1,7,Mid-Value,Potential Loyalists
75619,1466,1,"35,95",1,1,1,3,Low-Value,Lost
75620,917,2,"182,5",3,1,1,5,Low-Value,At Risk Customers
75621,15,6,"291,25",5,1,1,7,Mid-Value,Potential Loyalists
75624,636,2,"42,849999999999994",4,1,1,6,Mid-Value,Potential Loyalists
75625,24,6,"739,35",5,1,2,8,High-Value,Potential Loyalists
75629,1253,6,"356,09999999999997",2,1,1,4,Low-Value,Can't Lose
75630,382,3,"45,8",4,1,1,6,Mid-Value,Potential Loyalists
75632,751,8,"466,35",3,2,1,6,Mid-Value,Potential Loyalists
75633,130,3,"206,95",5,1,1,7,Mid-Value,Potential Loyalists
75634,1106,3,"127,25",2,1,1,4,Low-Value,Can't Lose
75637,789,2,"21,9",3,1,1,5,Low-Value,At Risk Customers
75640,85,5,"320,75",5,1,1,7,Mid-Value,Potential Loyalists
75642,150,5,"143,5",5,1,1,7,Mid-Value,Potential Loyalists
75645,110,2,"153,10000000000002",5,1,1,7,Mid-Value,Potential Loyalists
75648,760,1,"61,0",3,1,1,5,Low-Value,At Risk Customers
75649,955,2,"168,54999999999998",3,1,1,5,Low-Value,At Risk Customers
75650,1163,2,"29,7",2,1,1,4,Low-Value,Can't Lose
75651,283,6,"310,15",5,1,1,7,Mid-Value,Potential Loyalists
75652,114,1,"8,3",5,1,1,7,Mid-Value,Potential Loyalists
75653,1671,3,"375,1",1,1,1,3,Low-Value,Lost
75654,550,6,"226,25",4,1,1,6,Mid-Value,Potential Loyalists
75658,680,1,"16,5",4,1,1,6,Mid-Value,Potential Loyalists
75659,2,4,"230,15",5,1,1,7,Mid-Value,Potential Loyalists
75660,1681,1,"157,0",1,1,1,3,Low-Value,Lost
75662,935,1,"18,2",3,1,1,5,Low-Value,At Risk Customers
75663,868,1,"36,05",3,1,1,5,Low-Value,At Risk Customers
75664,608,3,"55,900000000000006",4,1,1,6,Mid-Value,Potential Loyalists
75665,1198,2,"82,25",2,1,1,4,Low-Value,Can't Lose
75666,180,7,"252,45000000000002",5,2,1,8,High-Value,Potential Loyalists
75667,374,2,"135,3",4,1,1,6,Mid-Value,Potential Loyalists
75668,181,1,"75,7",5,1,1,7,Mid-Value,Potential Loyalists
75672,1370,1,"54,150000000000006",2,1,1,4,Low-Value,Can't Lose
75673,635,6,"102,2",4,1,1,6,Mid-Value,Potential Loyalists
75674,21,4,"466,65000000000003",5,1,1,7,Mid-Value,Potential Loyalists
75675,28,4,"473,75",5,1,1,7,Mid-Value,Potential Loyalists
75678,448,3,"93,2",4,1,1,6,Mid-Value,Potential Loyalists
75679,346,3,"195,3",5,1,1,7,Mid-Value,Potential Loyalists
75680,1718,2,"298,8",1,1,1,3,Low-Value,Lost
75681,599,1,"6,35",4,1,1,6,Mid-Value,Potential Loyalists
75682,1037,1,"36,7",3,1,1,5,Low-Value,At Risk Customers
75683,144,3,"165,89999999999998",5,1,1,7,Mid-Value,Potential Loyalists
75684,554,2,"129,3",4,1,1,6,Mid-Value,Potential Loyalists
75685,541,4,"140,0",4,1,1,6,Mid-Value,Potential Loyalists
75686,388,4,"741,55",4,1,2,7,Mid-Value,Potential Loyalists
75689,155,1,"14,65",5,1,1,7,Mid-Value,Potential Loyalists
75693,149,6,"580,4",5,1,1,7,Mid-Value,Potential Loyalists
75694,124,4,"219,85000000000002",5,1,1,7,Mid-Value,Potential Loyalists
75695,584,2,"14,75",4,1,1,6,Mid-Value,Potential Loyalists
75699,66,7,"277,2",5,2,1,8,High-Value,Potential Loyalists
75700,9,2,"46,349999999999994",5,1,1,7,Mid-Value,Potential Loyalists
75701,7,1,"237,0",5,1,1,7,Mid-Value,Potential Loyalists
75702,116,5,"874,55",5,1,2,8,High-Value,Potential Loyalists
75705,1130,1,"23,4",2,1,1,4,Low-Value,Can't Lose
75709,426,5,"271,65",4,1,1,6,Mid-Value,Potential Loyalists
75711,1121,5,"211,45",2,1,1,4,Low-Value,Can't Lose
75714,127,4,"428,35",5,1,1,7,Mid-Value,Potential Loyalists
75716,131,2,"123,1",5,1,1,7,Mid-Value,Potential Loyalists
75717,417,1,"12,8",4,1,1,6,Mid-Value,Potential Loyalists
75719,1755,1,"67,7",1,1,1,3,Low-Value,Lost
75721,824,3,"180,29999999999998",3,1,1,5,Low-Value,At Risk Customers
75723,190,3,"199,4",5,1,1,7,Mid-Value,Potential Loyalists
75724,71,6,"987,3",5,1,2,8,High-Value,Potential Loyalists
75726,102,2,"52,9",5,1,1,7,Mid-Value,Potential Loyalists
75728,1497,1,"15,05",1,1,1,3,Low-Value,Lost
75730,183,4,"145,6",5,1,1,7,Mid-Value,Potential Loyalists
75731,745,3,"82,89999999999999",3,1,1,5,Low-Value,At Risk Customers
75732,70,2,"67,95",5,1,1,7,Mid-Value,Potential Loyalists
75735,493,5,"245,35000000000002",4,1,1,6,Mid-Value,Potential Loyalists
75737,15,5,"365,7",5,1,1,7,Mid-Value,Potential Loyalists
75743,408,2,"87,9",4,1,1,6,Mid-Value,Potential Loyalists
75744,59,2,"53,6",5,1,1,7,Mid-Value,Potential Loyalists
75746,183,4,"172,9",5,1,1,7,Mid-Value,Potential Loyalists
75747,616,1,"84,1",4,1,1,6,Mid-Value,Potential Loyalists
75748,75,3,"250,14999999999998",5,1,1,7,Mid-Value,Potential Loyalists
75750,125,2,"194,95000000000002",5,1,1,7,Mid-Value,Potential Loyalists
75752,1348,1,"100,4",2,1,1,4,Low-Value,Can't Lose
75754,519,4,"581,3",4,1,1,6,Mid-Value,Potential Loyalists
75756,454,3,"132,4",4,1,1,6,Mid-Value,Potential Loyalists
75758,170,5,"439,1",5,1,1,7,Mid-Value,Potential Loyalists
75759,394,1,"89,9",4,1,1,6,Mid-Value,Potential Loyalists
75761,1610,1,"34,1",1,1,1,3,Low-Value,Lost
75766,134,2,"91,5",5,1,1,7,Mid-Value,Potential Loyalists
75770,934,1,"26,6",3,1,1,5,Low-Value,At Risk Customers
75771,1637,1,"11,9",1,1,1,3,Low-Value,Lost
75774,35,3,"183,39999999999998",5,1,1,7,Mid-Value,Potential Loyalists
75779,326,2,"213,45",5,1,1,7,Mid-Value,Potential Loyalists
75782,558,4,"210,2",4,1,1,6,Mid-Value,Potential Loyalists
75783,421,4,"204,3",4,1,1,6,Mid-Value,Potential Loyalists
75786,938,3,"149,0",3,1,1,5,Low-Value,At Risk Customers
75787,225,3,"249,3",5,1,1,7,Mid-Value,Potential Loyalists
75790,1736,2,"35,0",1,1,1,3,Low-Value,Lost
75791,1191,2,"53,849999999999994",2,1,1,4,Low-Value,Can't Lose
75792,979,3,"478,45000000000005",3,1,1,5,Low-Value,At Risk Customers
75793,860,1,"1,3",3,1,1,5,Low-Value,At Risk Customers
75794,1601,1,"32,25",1,1,1,3,Low-Value,Lost
75795,619,4,"233,45",4,1,1,6,Mid-Value,Potential Loyalists
75796,22,5,"392,4",5,1,1,7,Mid-Value,Potential Loyalists
75797,368,4,"163,4",4,1,1,6,Mid-Value,Potential Loyalists
75800,1175,4,"117,35",2,1,1,4,Low-Value,Can't Lose
75801,6,4,"384,34999999999997",5,1,1,7,Mid-Value,Potential Loyalists
75802,218,4,"104,5",5,1,1,7,Mid-Value,Potential Loyalists
75803,77,2,"133,5",5,1,1,7,Mid-Value,Potential Loyalists
75804,774,2,"26,700000000000003",3,1,1,5,Low-Value,At Risk Customers
75805,804,5,"396,45000000000005",3,1,1,5,Low-Value,At Risk Customers
75806,808,1,"10,65",3,1,1,5,Low-Value,At Risk Customers
75809,1109,2,"178,5",2,1,1,4,Low-Value,Can't Lose
75810,773,2,"31,45",3,1,1,5,Low-Value,At Risk Customers
75815,81,1,"19,8",5,1,1,7,Mid-Value,Potential Loyalists
75819,891,2,"146,85",3,1,1,5,Low-Value,At Risk Customers
75822,411,4,"149,75",4,1,1,6,Mid-Value,Potential Loyalists
75823,1194,2,"124,80000000000001",2,1,1,4,Low-Value,Can't Lose
75824,400,6,"204,05",4,1,1,6,Mid-Value,Potential Loyalists
75825,924,1,"54,2",3,1,1,5,Low-Value,At Risk Customers
75827,101,4,"650,2",5,1,1,7,Mid-Value,Potential Loyalists
75828,639,2,"124,8",4,1,1,6,Mid-Value,Potential Loyalists
75829,877,2,"104,44999999999999",3,1,1,5,Low-Value,At Risk Customers
75830,104,4,"254,84999999999997",5,1,1,7,Mid-Value,Potential Loyalists
75831,870,1,"29,849999999999998",3,1,1,5,Low-Value,At Risk Customers
75832,1206,1,"42,25",2,1,1,4,Low-Value,Can't Lose
75833,104,7,"753,35",5,2,2,9,High-Value,Champions
75835,990,2,"202,0",3,1,1,5,Low-Value,At Risk Customers
75836,1376,4,"207,89999999999998",2,1,1,4,Low-Value,Can't Lose
75837,332,1,"7,25",5,1,1,7,Mid-Value,Potential Loyalists
75838,1084,1,"14,3",3,1,1,5,Low-Value,At Risk Customers
75839,109,3,"208,79999999999998",5,1,1,7,Mid-Value,Potential Loyalists
75840,1362,1,"293,54999999999995",2,1,1,4,Low-Value,Can't Lose
75844,316,2,"223,1",5,1,1,7,Mid-Value,Potential Loyalists
75848,30,2,"348,65000000000003",5,1,1,7,Mid-Value,Potential Loyalists
75849,1799,1,"19,75",1,1,1,3,Low-Value,Lost
75851,83,2,"70,6",5,1,1,7,Mid-Value,Potential Loyalists
75852,1427,1,"345,9",2,1,1,4,Low-Value,Can't Lose
75853,474,1,"13,95",4,1,1,6,Mid-Value,Potential Loyalists
75858,27,13,"682,0",5,3,2,10,High-Value,Champions
75860,236,3,"122,55000000000001",5,1,1,7,Mid-Value,Potential Loyalists
75864,141,5,"982,95",5,1,2,8,High-Value,Potential Loyalists
75866,659,2,"86,25",4,1,1,6,Mid-Value,Potential Loyalists
75869,20,7,"428,2",5,2,1,8,High-Value,Potential Loyalists
75872,45,3,"372,2",5,1,1,7,Mid-Value,Potential Loyalists
75873,1,2,"85,19999999999999",5,1,1,7,Mid-Value,Potential Loyalists
75874,9,14,"905,45",5,3,2,10,High-Value,Champions
75875,1204,1,"86,65",2,1,1,4,Low-Value,Can't Lose
75876,15,19,"980,9",5,4,2,11,High-Value,Champions
75878,1485,1,"132,4",1,1,1,3,Low-Value,Lost
75879,403,8,"626,25",4,2,1,7,Mid-Value,Potential Loyalists
75880,1527,1,"15,5",1,1,1,3,Low-Value,Lost
75881,330,4,"134,0",5,1,1,7,Mid-Value,Potential Loyalists
75882,40,4,"316,1",5,1,1,7,Mid-Value,Potential Loyalists
75883,384,6,"228,2",4,1,1,6,Mid-Value,Potential Loyalists
75888,8,3,"342,85",5,1,1,7,Mid-Value,Potential Loyalists
75889,757,2,"108,6",3,1,1,5,Low-Value,At Risk Customers
75890,168,8,"642,1",5,2,1,8,High-Value,Potential Loyalists
75891,684,1,"44,25",4,1,1,6,Mid-Value,Potential Loyalists
75893,139,1,"163,5",5,1,1,7,Mid-Value,Potential Loyalists
75894,141,5,"550,25",5,1,1,7,Mid-Value,Potential Loyalists
75895,754,5,"207,8",3,1,1,5,Low-Value,At Risk Customers
75897,842,4,"220,54999999999998",3,1,1,5,Low-Value,At Risk Customers
75899,746,3,"164,6",3,1,1,5,Low-Value,At Risk Customers
75900,171,3,"127,9",5,1,1,7,Mid-Value,Potential Loyalists
75901,244,3,"173,15",5,1,1,7,Mid-Value,Potential Loyalists
75904,1235,3,"116,15",2,1,1,4,Low-Value,Can't Lose
75905,760,4,"146,05",3,1,1,5,Low-Value,At Risk Customers
75906,1299,2,"48,0",2,1,1,4,Low-Value,Can't Lose
75909,534,1,"111,25",4,1,1,6,Mid-Value,Potential Loyalists
75910,367,4,"397,15",4,1,1,6,Mid-Value,Potential Loyalists
75912,261,2,"39,6",5,1,1,7,Mid-Value,Potential Loyalists
75913,223,1,"114,45",5,1,1,7,Mid-Value,Potential Loyalists
75914,763,1,"10,6",3,1,1,5,Low-Value,At Risk Customers
75915,457,3,"111,95",4,1,1,6,Mid-Value,Potential Loyalists
75916,176,6,"119,2",5,1,1,7,Mid-Value,Potential Loyalists
75918,386,1,"46,3",4,1,1,6,Mid-Value,Potential Loyalists
75919,783,1,"22,8",3,1,1,5,Low-Value,At Risk Customers
75920,701,5,"255,3",4,1,1,6,Mid-Value,Potential Loyalists
75921,1767,1,"23,75",1,1,1,3,Low-Value,Lost
75922,48,6,"210,3",5,1,1,7,Mid-Value,Potential Loyalists
75923,1340,1,"4,55",2,1,1,4,Low-Value,Can't Lose
75924,1469,4,"219,75",1,1,1,3,Low-Value,Lost
75925,1077,2,"60,95",3,1,1,5,Low-Value,At Risk Customers
75926,1188,6,"275,9",2,1,1,4,Low-Value,Can't Lose
75928,83,1,"58,6",5,1,1,7,Mid-Value,Potential Loyalists
75929,16,2,"144,45",5,1,1,7,Mid-Value,Potential Loyalists
75931,10,1,"34,6",5,1,1,7,Mid-Value,Potential Loyalists
75932,786,1,"29,95",3,1,1,5,Low-Value,At Risk Customers
75933,373,3,"117,15",4,1,1,6,Mid-Value,Potential Loyalists
75934,759,3,"265,65",3,1,1,5,Low-Value,At Risk Customers
75936,1154,2,"66,45",2,1,1,4,Low-Value,Can't Lose
75937,1553,1,"45,6",1,1,1,3,Low-Value,Lost
75939,1099,1,"28,2",2,1,1,4,Low-Value,Can't Lose
75940,146,15,"771,1",5,3,2,10,High-Value,Champions
75941,261,3,"482,0",5,1,1,7,Mid-Value,Potential Loyalists
75945,759,7,"636,35",3,2,1,6,Mid-Value,Potential Loyalists
75947,1082,1,"27,5",3,1,1,5,Low-Value,At Risk Customers
75948,401,1,"16,950000000000003",4,1,1,6,Mid-Value,Potential Loyalists
75949,794,1,"32,0",3,1,1,5,Low-Value,At Risk Customers
75952,926,3,"113,3",3,1,1,5,Low-Value,At Risk Customers
75954,389,1,"43,05",4,1,1,6,Mid-Value,Potential Loyalists
75956,110,4,"83,0",5,1,1,7,Mid-Value,Potential Loyalists
75957,21,2,"142,75",5,1,1,7,Mid-Value,Potential Loyalists
75959,427,3,"385,2",4,1,1,6,Mid-Value,Potential Loyalists
75960,613,1,"27,05",4,1,1,6,Mid-Value,Potential Loyalists
75962,549,2,"120,5",4,1,1,6,Mid-Value,Potential Loyalists
75963,75,2,"70,45",5,1,1,7,Mid-Value,Potential Loyalists
75964,1236,5,"242,85",2,1,1,4,Low-Value,Can't Lose
75966,584,1,"22,25",4,1,1,6,Mid-Value,Potential Loyalists
75967,60,1,"26,95",5,1,1,7,Mid-Value,Potential Loyalists
75968,383,1,"133,0",4,1,1,6,Mid-Value,Potential Loyalists
75970,307,1,"58,85",5,1,1,7,Mid-Value,Potential Loyalists
75971,226,4,"103,25",5,1,1,7,Mid-Value,Potential Loyalists
75973,27,5,"450,8",5,1,1,7,Mid-Value,Potential Loyalists
75975,5,3,"153,65",5,1,1,7,Mid-Value,Potential Loyalists
75976,631,3,"278,1",4,1,1,6,Mid-Value,Potential Loyalists
75978,376,5,"367,05",4,1,1,6,Mid-Value,Potential Loyalists
75981,1371,1,"36,7",2,1,1,4,Low-Value,Can't Lose
75982,924,1,"28,9",3,1,1,5,Low-Value,At Risk Customers
75983,137,2,"105,55",5,1,1,7,Mid-Value,Potential Loyalists
75984,95,5,"159,95",5,1,1,7,Mid-Value,Potential Loyalists
75985,8,13,"867,2",5,3,2,10,High-Value,Champions
75986,578,3,"396,05",4,1,1,6,Mid-Value,Potential Loyalists
75987,185,2,"42,3",5,1,1,7,Mid-Value,Potential Loyalists
75988,366,4,"263,75",4,1,1,6,Mid-Value,Potential Loyalists
75989,53,1,"18,55",5,1,1,7,Mid-Value,Potential Loyalists
75990,24,3,"160,05",5,1,1,7,Mid-Value,Potential Loyalists
75991,121,4,"491,0",5,1,1,7,Mid-Value,Potential Loyalists
75992,41,5,"77,75",5,1,1,7,Mid-Value,Potential Loyalists
75994,202,2,"161,39999999999998",5,1,1,7,Mid-Value,Potential Loyalists
75997,232,6,"263,5",5,1,1,7,Mid-Value,Potential Loyalists
75998,19,2,"93,94999999999999",5,1,1,7,Mid-Value,Potential Loyalists
75999,234,1,"42,8",5,1,1,7,Mid-Value,Potential Loyalists
76000,1489,1,"1,25",1,1,1,3,Low-Value,Lost
76002,1293,2,"75,85",2,1,1,4,Low-Value,Can't Lose
76003,13,3,"427,3",5,1,1,7,Mid-Value,Potential Loyalists
76004,780,3,"124,6",3,1,1,5,Low-Value,At Risk Customers
76005,976,1,"64,1",3,1,1,5,Low-Value,At Risk Customers
76006,1418,1,"14,55",2,1,1,4,Low-Value,Can't Lose
76007,89,2,"173,45",5,1,1,7,Mid-Value,Potential Loyalists
76012,454,2,"93,75",4,1,1,6,Mid-Value,Potential Loyalists
76013,420,4,"214,7",4,1,1,6,Mid-Value,Potential Loyalists
76018,919,1,"33,6",3,1,1,5,Low-Value,At Risk Customers
76019,362,1,"43,3",5,1,1,7,Mid-Value,Potential Loyalists
76020,246,3,"64,45",5,1,1,7,Mid-Value,Potential Loyalists
76022,1479,4,"170,85",1,1,1,3,Low-Value,Lost
76025,168,2,"404,1",5,1,1,7,Mid-Value,Potential Loyalists
76027,2,3,"392,35",5,1,1,7,Mid-Value,Potential Loyalists
76029,498,3,"95,1",4,1,1,6,Mid-Value,Potential Loyalists
76033,434,3,"177,0",4,1,1,6,Mid-Value,Potential Loyalists
76034,81,16,"883,6",5,3,2,10,High-Value,Champions
76035,1479,1,"16,1",1,1,1,3,Low-Value,Lost
76036,19,4,"351,84999999999997",5,1,1,7,Mid-Value,Potential Loyalists
76037,1449,1,"46,7",2,1,1,4,Low-Value,Can't Lose
76038,52,2,"124,69999999999999",5,1,1,7,Mid-Value,Potential Loyalists
76039,1071,2,"86,05",3,1,1,5,Low-Value,At Risk Customers
76041,425,5,"453,95",4,1,1,6,Mid-Value,Potential Loyalists
76044,1168,1,"135,0",2,1,1,4,Low-Value,Can't Lose
76045,228,7,"629,75",5,2,1,8,High-Value,Potential Loyalists
76046,238,1,"17,8",5,1,1,7,Mid-Value,Potential Loyalists
76048,1340,1,"99,75",2,1,1,4,Low-Value,Can't Lose
76049,54,3,"881,8999999999999",5,1,2,8,High-Value,Potential Loyalists
76050,271,2,"50,25",5,1,1,7,Mid-Value,Potential Loyalists
76051,614,1,"58,0",4,1,1,6,Mid-Value,Potential Loyalists
76054,459,4,"671,5",4,1,2,7,Mid-Value,Potential Loyalists
76055,587,5,"231,85000000000002",4,1,1,6,Mid-Value,Potential Loyalists
76056,347,3,"46,9",5,1,1,7,Mid-Value,Potential Loyalists
76057,875,1,"210,0",3,1,1,5,Low-Value,At Risk Customers
76059,554,7,"340,65",4,2,1,7,Mid-Value,Potential Loyalists
76060,1224,2,"72,3",2,1,1,4,Low-Value,Can't Lose
76061,863,2,"78,95",3,1,1,5,Low-Value,At Risk Customers
76063,139,4,"300,65",5,1,1,7,Mid-Value,Potential Loyalists
76066,313,4,"104,85",5,1,1,7,Mid-Value,Potential Loyalists
76070,7,4,"182,75",5,1,1,7,Mid-Value,Potential Loyalists
76072,540,2,"112,0",4,1,1,6,Mid-Value,Potential Loyalists
76074,780,2,"76,55000000000001",3,1,1,5,Low-Value,At Risk Customers
76075,69,2,"30,299999999999997",5,1,1,7,Mid-Value,Potential Loyalists
76082,84,8,"659,4",5,2,1,8,High-Value,Potential Loyalists
76083,47,3,"106,05",5,1,1,7,Mid-Value,Potential Loyalists
76084,365,3,"192,05",5,1,1,7,Mid-Value,Potential Loyalists
76085,75,8,"167,14999999999998",5,2,1,8,High-Value,Potential Loyalists
76088,151,4,"115,75",5,1,1,7,Mid-Value,Potential Loyalists
76089,91,4,"227,7",5,1,1,7,Mid-Value,Potential Loyalists
76090,999,2,"287,65",3,1,1,5,Low-Value,At Risk Customers
76093,91,7,"347,1",5,2,1,8,High-Value,Potential Loyalists
76094,1190,5,"166,8",2,1,1,4,Low-Value,Can't Lose
76095,39,4,"144,9",5,1,1,7,Mid-Value,Potential Loyalists
76096,28,5,"297,75",5,1,1,7,Mid-Value,Potential Loyalists
76097,1731,1,"17,15",1,1,1,3,Low-Value,Lost
76098,763,2,"101,6",3,1,1,5,Low-Value,At Risk Customers
76099,288,2,"44,150000000000006",5,1,1,7,Mid-Value,Potential Loyalists
76101,561,3,"73,3",4,1,1,6,Mid-Value,Potential Loyalists
76102,461,6,"364,45",4,1,1,6,Mid-Value,Potential Loyalists
76103,892,2,"41,75",3,1,1,5,Low-Value,At Risk Customers
76104,1075,6,"414,09999999999997",3,1,1,5,Low-Value,At Risk Customers
76113,92,4,"770,65",5,1,2,8,High-Value,Potential Loyalists
76115,383,2,"99,1",4,1,1,6,Mid-Value,Potential Loyalists
76120,473,6,"371,75",4,1,1,6,Mid-Value,Potential Loyalists
76122,215,6,"210,64999999999998",5,1,1,7,Mid-Value,Potential Loyalists
76123,480,1,"3,1",4,1,1,6,Mid-Value,Potential Loyalists
76124,20,3,"178,6",5,1,1,7,Mid-Value,Potential Loyalists
76125,362,3,"148,25",5,1,1,7,Mid-Value,Potential Loyalists
76126,407,3,"210,0",4,1,1,6,Mid-Value,Potential Loyalists
76128,29,6,"340,65",5,1,1,7,Mid-Value,Potential Loyalists
76129,1365,1,"54,150000000000006",2,1,1,4,Low-Value,Can't Lose
76132,714,2,"81,65",4,1,1,6,Mid-Value,Potential Loyalists
76135,522,5,"278,4",4,1,1,6,Mid-Value,Potential Loyalists
76136,325,5,"232,25",5,1,1,7,Mid-Value,Potential Loyalists
76137,172,6,"741,35",5,1,2,8,High-Value,Potential Loyalists
76138,768,4,"229,45",3,1,1,5,Low-Value,At Risk Customers
76144,817,2,"32,05",3,1,1,5,Low-Value,At Risk Customers
76145,78,5,"389,65",5,1,1,7,Mid-Value,Potential Loyalists
76146,675,3,"136,85",4,1,1,6,Mid-Value,Potential Loyalists
76148,67,4,"174,35",5,1,1,7,Mid-Value,Potential Loyalists
76149,943,2,"59,7",3,1,1,5,Low-Value,At Risk Customers
76150,272,1,"39,1",5,1,1,7,Mid-Value,Potential Loyalists
76152,632,1,"55,1",4,1,1,6,Mid-Value,Potential Loyalists
76154,281,5,"239,95000000000002",5,1,1,7,Mid-Value,Potential Loyalists
76155,119,3,"160,89999999999998",5,1,1,7,Mid-Value,Potential Loyalists
76157,349,1,"31,6",5,1,1,7,Mid-Value,Potential Loyalists
76158,1247,3,"176,0",2,1,1,4,Low-Value,Can't Lose
76159,608,1,"45,6",4,1,1,6,Mid-Value,Potential Loyalists
76161,668,1,"5,3",4,1,1,6,Mid-Value,Potential Loyalists
76164,117,3,"96,75",5,1,1,7,Mid-Value,Potential Loyalists
76165,70,6,"526,25",5,1,1,7,Mid-Value,Potential Loyalists
76168,56,6,"395,3",5,1,1,7,Mid-Value,Potential Loyalists
76169,141,4,"151,8",5,1,1,7,Mid-Value,Potential Loyalists
76171,493,8,"848,45",4,2,2,8,High-Value,Potential Loyalists
76172,1308,1,"189,3",2,1,1,4,Low-Value,Can't Lose
76173,235,4,"209,65",5,1,1,7,Mid-Value,Potential Loyalists
76175,123,3,"149,89999999999998",5,1,1,7,Mid-Value,Potential Loyalists
76177,269,7,"280,45",5,2,1,8,High-Value,Potential Loyalists
76178,1487,1,"235,6",1,1,1,3,Low-Value,Lost
76179,23,9,"593,65",5,2,1,8,High-Value,Potential Loyalists
76181,376,13,"478,9",4,3,1,8,High-Value,Potential Loyalists
76182,432,3,"225,29999999999998",4,1,1,6,Mid-Value,Potential Loyalists
76183,102,5,"448,2",5,1,1,7,Mid-Value,Potential Loyalists
76185,248,1,"8,8",5,1,1,7,Mid-Value,Potential Loyalists
76187,50,1,"67,55",5,1,1,7,Mid-Value,Potential Loyalists
76190,262,5,"236,05",5,1,1,7,Mid-Value,Potential Loyalists
76194,517,3,"106,5",4,1,1,6,Mid-Value,Potential Loyalists
76195,1327,1,"192,29999999999998",2,1,1,4,Low-Value,Can't Lose
76196,300,3,"571,65",5,1,1,7,Mid-Value,Potential Loyalists
76197,5,6,"693,7",5,1,2,8,High-Value,Potential Loyalists
76198,978,3,"48,050000000000004",3,1,1,5,Low-Value,At Risk Customers
76199,197,5,"212,70000000000002",5,1,1,7,Mid-Value,Potential Loyalists
76202,1406,1,"15,45",2,1,1,4,Low-Value,Can't Lose
76203,570,1,"41,0",4,1,1,6,Mid-Value,Potential Loyalists
76205,430,13,"497,75",4,3,1,8,High-Value,Potential Loyalists
76211,17,1,"20,6",5,1,1,7,Mid-Value,Potential Loyalists
76212,281,2,"118,35000000000001",5,1,1,7,Mid-Value,Potential Loyalists
76214,1268,1,"84,9",2,1,1,4,Low-Value,Can't Lose
76215,458,5,"296,85",4,1,1,6,Mid-Value,Potential Loyalists
76216,412,1,"37,8",4,1,1,6,Mid-Value,Potential Loyalists
76220,1704,1,"114,35",1,1,1,3,Low-Value,Lost
76221,294,4,"59,75",5,1,1,7,Mid-Value,Potential Loyalists
76224,1236,2,"355,29999999999995",2,1,1,4,Low-Value,Can't Lose
76225,340,4,"194,0",5,1,1,7,Mid-Value,Potential Loyalists
76227,983,4,"70,5",3,1,1,5,Low-Value,At Risk Customers
76230,262,1,"9,05",5,1,1,7,Mid-Value,Potential Loyalists
76231,551,4,"286,5",4,1,1,6,Mid-Value,Potential Loyalists
76232,395,5,"463,95",4,1,1,6,Mid-Value,Potential Loyalists
76233,293,4,"250,45",5,1,1,7,Mid-Value,Potential Loyalists
76234,291,6,"457,95",5,1,1,7,Mid-Value,Potential Loyalists
76235,178,3,"39,3",5,1,1,7,Mid-Value,Potential Loyalists
76236,489,2,"93,15",4,1,1,6,Mid-Value,Potential Loyalists
76242,29,2,"238,64999999999998",5,1,1,7,Mid-Value,Potential Loyalists
76244,859,3,"404,15",3,1,1,5,Low-Value,At Risk Customers
76245,57,3,"132,8",5,1,1,7,Mid-Value,Potential Loyalists
76248,710,5,"175,8",4,1,1,6,Mid-Value,Potential Loyalists
76250,468,4,"200,65",4,1,1,6,Mid-Value,Potential Loyalists
76251,245,3,"570,95",5,1,1,7,Mid-Value,Potential Loyalists
76252,507,1,"936,3",4,1,2,7,Mid-Value,Potential Loyalists
76254,47,4,"194,35",5,1,1,7,Mid-Value,Potential Loyalists
76256,416,8,"269,9",4,2,1,7,Mid-Value,Potential Loyalists
76258,1513,1,"11,85",1,1,1,3,Low-Value,Lost
76259,26,5,"183,6",5,1,1,7,Mid-Value,Potential Loyalists
76260,202,3,"325,25",5,1,1,7,Mid-Value,Potential Loyalists
76263,1540,3,"105,75",1,1,1,3,Low-Value,Lost
76266,680,2,"38,15",4,1,1,6,Mid-Value,Potential Loyalists
76267,3,6,"348,9",5,1,1,7,Mid-Value,Potential Loyalists
76268,671,1,"23,45",4,1,1,6,Mid-Value,Potential Loyalists
76269,1536,1,"130,55",1,1,1,3,Low-Value,Lost
76270,84,5,"296,09999999999997",5,1,1,7,Mid-Value,Potential Loyalists
76272,245,5,"279,09999999999997",5,1,1,7,Mid-Value,Potential Loyalists
76273,771,2,"80,10000000000001",3,1,1,5,Low-Value,At Risk Customers
76274,1072,1,"42,45",3,1,1,5,Low-Value,At Risk Customers
76275,37,6,"446,45",5,1,1,7,Mid-Value,Potential Loyalists
76276,28,6,"174,25",5,1,1,7,Mid-Value,Potential Loyalists
76277,382,4,"724,75",4,1,2,7,Mid-Value,Potential Loyalists
76279,544,2,"375,05",4,1,1,6,Mid-Value,Potential Loyalists
76280,379,6,"611,45",4,1,1,6,Mid-Value,Potential Loyalists
76283,270,1,"28,950000000000003",5,1,1,7,Mid-Value,Potential Loyalists
76286,470,1,"18,6",4,1,1,6,Mid-Value,Potential Loyalists
76290,507,3,"56,0",4,1,1,6,Mid-Value,Potential Loyalists
76291,366,3,"97,64999999999999",4,1,1,6,Mid-Value,Potential Loyalists
76294,850,1,"111,5",3,1,1,5,Low-Value,At Risk Customers
76295,199,4,"185,6",5,1,1,7,Mid-Value,Potential Loyalists
76297,1016,1,"11,45",3,1,1,5,Low-Value,At Risk Customers
76298,789,1,"6,8",3,1,1,5,Low-Value,At Risk Customers
76300,28,2,"652,35",5,1,1,7,Mid-Value,Potential Loyalists
76302,739,8,"752,95",3,2,2,7,Mid-Value,Potential Loyalists
76304,165,5,"728,55",5,1,2,8,High-Value,Potential Loyalists
76305,222,4,"163,8",5,1,1,7,Mid-Value,Potential Loyalists
76306,615,5,"189,4",4,1,1,6,Mid-Value,Potential Loyalists
76308,32,4,"109,0",5,1,1,7,Mid-Value,Potential Loyalists
76309,608,3,"303,5",4,1,1,6,Mid-Value,Potential Loyalists
76310,756,1,"61,4",3,1,1,5,Low-Value,At Risk Customers
76311,394,2,"45,0",4,1,1,6,Mid-Value,Potential Loyalists
76312,28,7,"334,5",5,2,1,8,High-Value,Potential Loyalists
76314,1047,7,"132,1",3,2,1,6,Mid-Value,Potential Loyalists
76315,662,1,"40,5",4,1,1,6,Mid-Value,Potential Loyalists
76316,1096,4,"358,45",2,1,1,4,Low-Value,Can't Lose
76317,885,5,"154,45",3,1,1,5,Low-Value,At Risk Customers
76318,68,4,"110,85",5,1,1,7,Mid-Value,Potential Loyalists
76321,124,1,"46,0",5,1,1,7,Mid-Value,Potential Loyalists
76322,927,2,"481,09999999999997",3,1,1,5,Low-Value,At Risk Customers
76323,843,4,"196,8",3,1,1,5,Low-Value,At Risk Customers
76324,104,3,"134,05",5,1,1,7,Mid-Value,Potential Loyalists
76326,1131,4,"124,65",2,1,1,4,Low-Value,Can't Lose
76330,330,6,"347,45000000000005",5,1,1,7,Mid-Value,Potential Loyalists
76333,1128,1,"7,75",2,1,1,4,Low-Value,Can't Lose
76334,47,4,"106,4",5,1,1,7,Mid-Value,Potential Loyalists
76335,85,2,"23,1",5,1,1,7,Mid-Value,Potential Loyalists
76338,578,1,"638,75",4,1,1,6,Mid-Value,Potential Loyalists
76339,160,1,"15,0",5,1,1,7,Mid-Value,Potential Loyalists
76340,989,2,"33,95",3,1,1,5,Low-Value,At Risk Customers
76341,94,5,"168,25",5,1,1,7,Mid-Value,Potential Loyalists
76342,1549,2,"87,75",1,1,1,3,Low-Value,Lost
76343,900,1,"125,0",3,1,1,5,Low-Value,At Risk Customers
76344,75,3,"180,3",5,1,1,7,Mid-Value,Potential Loyalists
76347,388,7,"397,4",4,2,1,7,Mid-Value,Potential Loyalists
76349,343,1,"12,5",5,1,1,7,Mid-Value,Potential Loyalists
76350,578,3,"217,65",4,1,1,6,Mid-Value,Potential Loyalists
76351,927,2,"336,2",3,1,1,5,Low-Value,At Risk Customers
76352,106,4,"291,0",5,1,1,7,Mid-Value,Potential Loyalists
76355,262,4,"362,15000000000003",5,1,1,7,Mid-Value,Potential Loyalists
76356,812,4,"460,0",3,1,1,5,Low-Value,At Risk Customers
76358,418,5,"841,15",4,1,2,7,Mid-Value,Potential Loyalists
76359,97,3,"312,15",5,1,1,7,Mid-Value,Potential Loyalists
76360,256,2,"56,1",5,1,1,7,Mid-Value,Potential Loyalists
76362,126,3,"177,05",5,1,1,7,Mid-Value,Potential Loyalists
76363,55,9,"304,55",5,2,1,8,High-Value,Potential Loyalists
76367,215,3,"110,1",5,1,1,7,Mid-Value,Potential Loyalists
76370,8,9,"573,0",5,2,1,8,High-Value,Potential Loyalists
76371,731,3,"138,15",3,1,1,5,Low-Value,At Risk Customers
76374,81,6,"529,9499999999999",5,1,1,7,Mid-Value,Potential Loyalists
76377,838,2,"32,55",3,1,1,5,Low-Value,At Risk Customers
76378,191,2,"120,45",5,1,1,7,Mid-Value,Potential Loyalists
76381,659,1,"9,55",4,1,1,6,Mid-Value,Potential Loyalists
76388,76,6,"510,44999999999993",5,1,1,7,Mid-Value,Potential Loyalists
76389,173,1,"19,3",5,1,1,7,Mid-Value,Potential Loyalists
76390,1221,1,"36,1",2,1,1,4,Low-Value,Can't Lose
76392,18,5,"164,2",5,1,1,7,Mid-Value,Potential Loyalists
76393,71,1,"16,8",5,1,1,7,Mid-Value,Potential Loyalists
76394,257,3,"75,5",5,1,1,7,Mid-Value,Potential Loyalists
76395,451,8,"469,6",4,2,1,7,Mid-Value,Potential Loyalists
76398,17,6,"367,25",5,1,1,7,Mid-Value,Potential Loyalists
76401,128,7,"626,05",5,2,1,8,High-Value,Potential Loyalists
76403,29,4,"157,2",5,1,1,7,Mid-Value,Potential Loyalists
76404,1681,1,"36,75",1,1,1,3,Low-Value,Lost
76405,1672,3,"129,35",1,1,1,3,Low-Value,Lost
76408,458,4,"147,35",4,1,1,6,Mid-Value,Potential Loyalists
76410,1243,2,"61,6",2,1,1,4,Low-Value,Can't Lose
76411,18,6,"289,45",5,1,1,7,Mid-Value,Potential Loyalists
76412,742,2,"81,44999999999999",3,1,1,5,Low-Value,At Risk Customers
76413,300,5,"689,15",5,1,2,8,High-Value,Potential Loyalists
76415,463,1,"17,35",4,1,1,6,Mid-Value,Potential Loyalists
76416,1103,1,"54,0",2,1,1,4,Low-Value,Can't Lose
76419,1313,1,"25,4",2,1,1,4,Low-Value,Can't Lose
76420,742,1,"31,6",3,1,1,5,Low-Value,At Risk Customers
76424,29,7,"446,1",5,2,1,8,High-Value,Potential Loyalists
76425,1223,3,"324,55",2,1,1,4,Low-Value,Can't Lose
76426,134,4,"332,15",5,1,1,7,Mid-Value,Potential Loyalists
76427,242,3,"189,25",5,1,1,7,Mid-Value,Potential Loyalists
76429,123,1,"101,2",5,1,1,7,Mid-Value,Potential Loyalists
76431,30,5,"476,09999999999997",5,1,1,7,Mid-Value,Potential Loyalists
76432,282,4,"285,85",5,1,1,7,Mid-Value,Potential Loyalists
76433,1453,1,"9,5",2,1,1,4,Low-Value,Can't Lose
76436,180,3,"163,9",5,1,1,7,Mid-Value,Potential Loyalists
76437,1639,1,"55,9",1,1,1,3,Low-Value,Lost
76438,96,2,"126,5",5,1,1,7,Mid-Value,Potential Loyalists
76439,23,8,"410,6",5,2,1,8,High-Value,Potential Loyalists
76440,160,9,"935,85",5,2,2,9,High-Value,Champions
76441,58,4,"180,25",5,1,1,7,Mid-Value,Potential Loyalists
76444,336,2,"127,39999999999999",5,1,1,7,Mid-Value,Potential Loyalists
76445,260,3,"125,35",5,1,1,7,Mid-Value,Potential Loyalists
76446,983,1,"23,65",3,1,1,5,Low-Value,At Risk Customers
76447,414,4,"254,35",4,1,1,6,Mid-Value,Potential Loyalists
76449,399,5,"356,5",4,1,1,6,Mid-Value,Potential Loyalists
76450,160,3,"189,9",5,1,1,7,Mid-Value,Potential Loyalists
76453,822,1,"19,7",3,1,1,5,Low-Value,At Risk Customers
76454,483,5,"336,15",4,1,1,6,Mid-Value,Potential Loyalists
76455,1427,1,"17,15",2,1,1,4,Low-Value,Can't Lose
76456,1019,1,"48,15",3,1,1,5,Low-Value,At Risk Customers
76457,154,4,"261,2",5,1,1,7,Mid-Value,Potential Loyalists
76458,129,4,"323,8",5,1,1,7,Mid-Value,Potential Loyalists
76462,350,2,"137,2",5,1,1,7,Mid-Value,Potential Loyalists
76463,475,5,"289,25",4,1,1,6,Mid-Value,Potential Loyalists
76464,458,5,"293,35",4,1,1,6,Mid-Value,Potential Loyalists
76465,1177,1,"13,15",2,1,1,4,Low-Value,Can't Lose
76467,1428,1,"603,2",2,1,1,4,Low-Value,Can't Lose
76468,137,3,"277,4",5,1,1,7,Mid-Value,Potential Loyalists
76470,159,7,"589,25",5,2,1,8,High-Value,Potential Loyalists
76472,568,1,"45,2",4,1,1,6,Mid-Value,Potential Loyalists
76473,7,6,"739,6999999999999",5,1,2,8,High-Value,Potential Loyalists
76475,357,9,"484,84999999999997",5,2,1,8,High-Value,Potential Loyalists
76476,87,4,"137,0",5,1,1,7,Mid-Value,Potential Loyalists
76477,538,4,"70,25",4,1,1,6,Mid-Value,Potential Loyalists
76480,142,3,"290,75",5,1,1,7,Mid-Value,Potential Loyalists
76481,37,1,"13,15",5,1,1,7,Mid-Value,Potential Loyalists
76482,278,5,"262,79999999999995",5,1,1,7,Mid-Value,Potential Loyalists
76483,1378,1,"5,75",2,1,1,4,Low-Value,Can't Lose
76485,1560,1,"9,35",1,1,1,3,Low-Value,Lost
76486,1605,3,"232,9",1,1,1,3,Low-Value,Lost
76490,1042,4,"301,09999999999997",3,1,1,5,Low-Value,At Risk Customers
76493,1160,1,"19,5",2,1,1,4,Low-Value,Can't Lose
76494,253,3,"94,85000000000001",5,1,1,7,Mid-Value,Potential Loyalists
76495,1,10,"588,65",5,2,1,8,High-Value,Potential Loyalists
76497,421,2,"312,65",4,1,1,6,Mid-Value,Potential Loyalists
76498,1281,2,"80,14999999999999",2,1,1,4,Low-Value,Can't Lose
76501,63,6,"292,9",5,1,1,7,Mid-Value,Potential Loyalists
76502,95,3,"98,0",5,1,1,7,Mid-Value,Potential Loyalists
76505,808,2,"110,64999999999999",3,1,1,5,Low-Value,At Risk Customers
76506,1614,1,"108,0",1,1,1,3,Low-Value,Lost
76508,61,3,"213,35",5,1,1,7,Mid-Value,Potential Loyalists
76509,10,2,"36,85",5,1,1,7,Mid-Value,Potential Loyalists
76510,1285,2,"181,4",2,1,1,4,Low-Value,Can't Lose
76511,1,5,"450,45",5,1,1,7,Mid-Value,Potential Loyalists
76515,1709,2,"124,35",1,1,1,3,Low-Value,Lost
76516,1074,1,"14,3",3,1,1,5,Low-Value,At Risk Customers
76517,564,2,"127,5",4,1,1,6,Mid-Value,Potential Loyalists
76520,574,2,"277,45",4,1,1,6,Mid-Value,Potential Loyalists
76526,118,1,"168,2",5,1,1,7,Mid-Value,Potential Loyalists
76528,1574,3,"118,55",1,1,1,3,Low-Value,Lost
76529,321,3,"74,55000000000001",5,1,1,7,Mid-Value,Potential Loyalists
76531,151,3,"59,45",5,1,1,7,Mid-Value,Potential Loyalists
76533,1018,1,"43,55",3,1,1,5,Low-Value,At Risk Customers
76534,157,3,"132,6",5,1,1,7,Mid-Value,Potential Loyalists
76535,749,2,"579,35",3,1,1,5,Low-Value,At Risk Customers
76537,238,5,"235,7",5,1,1,7,Mid-Value,Potential Loyalists
76539,58,3,"153,2",5,1,1,7,Mid-Value,Potential Loyalists
76540,43,5,"104,35",5,1,1,7,Mid-Value,Potential Loyalists
76541,1284,1,"37,7",2,1,1,4,Low-Value,Can't Lose
76542,130,3,"330,6",5,1,1,7,Mid-Value,Potential Loyalists
76543,1452,1,"6,65",2,1,1,4,Low-Value,Can't Lose
76552,621,2,"127,19999999999999",4,1,1,6,Mid-Value,Potential Loyalists
76553,242,1,"5,8",5,1,1,7,Mid-Value,Potential Loyalists
76554,43,4,"217,25",5,1,1,7,Mid-Value,Potential Loyalists
76557,1494,3,"81,5",1,1,1,3,Low-Value,Lost
76558,1237,2,"39,3",2,1,1,4,Low-Value,Can't Lose
76560,322,3,"137,3",5,1,1,7,Mid-Value,Potential Loyalists
76561,539,5,"228,45000000000002",4,1,1,6,Mid-Value,Potential Loyalists
76563,755,1,"26,9",3,1,1,5,Low-Value,At Risk Customers
76564,80,4,"179,2",5,1,1,7,Mid-Value,Potential Loyalists
76565,1084,1,"12,5",3,1,1,5,Low-Value,At Risk Customers
76567,737,3,"87,9",3,1,1,5,Low-Value,At Risk Customers
76568,150,10,"1133,3",5,2,2,9,High-Value,Champions
76569,22,7,"672,55",5,2,2,9,High-Value,Champions
76571,132,2,"14,7",5,1,1,7,Mid-Value,Potential Loyalists
76572,1612,1,"36,599999999999994",1,1,1,3,Low-Value,Lost
76574,405,4,"210,04999999999998",4,1,1,6,Mid-Value,Potential Loyalists
76578,749,5,"297,45",3,1,1,5,Low-Value,At Risk Customers
76579,1189,3,"191,65",2,1,1,4,Low-Value,Can't Lose
76582,175,3,"327,45",5,1,1,7,Mid-Value,Potential Loyalists
76583,553,2,"1025,25",4,1,2,7,Mid-Value,Potential Loyalists
76585,62,2,"89,75",5,1,1,7,Mid-Value,Potential Loyalists
76586,486,4,"379,29999999999995",4,1,1,6,Mid-Value,Potential Loyalists
76587,552,6,"507,1",4,1,1,6,Mid-Value,Potential Loyalists
76588,1568,1,"90,3",1,1,1,3,Low-Value,Lost
76592,339,1,"17,85",5,1,1,7,Mid-Value,Potential Loyalists
76593,542,1,"125,4",4,1,1,6,Mid-Value,Potential Loyalists
76594,29,4,"316,15",5,1,1,7,Mid-Value,Potential Loyalists
76596,152,2,"91,05",5,1,1,7,Mid-Value,Potential Loyalists
76599,115,7,"517,85",5,2,1,8,High-Value,Potential Loyalists
76602,790,2,"97,35",3,1,1,5,Low-Value,At Risk Customers
76603,209,2,"277,5",5,1,1,7,Mid-Value,Potential Loyalists
76605,170,3,"151,45",5,1,1,7,Mid-Value,Potential Loyalists
76607,1114,3,"397,25",2,1,1,4,Low-Value,Can't Lose
76609,271,4,"120,1",5,1,1,7,Mid-Value,Potential Loyalists
76612,1658,1,"117,2",1,1,1,3,Low-Value,Lost
76613,57,4,"86,9",5,1,1,7,Mid-Value,Potential Loyalists
76616,34,2,"101,6",5,1,1,7,Mid-Value,Potential Loyalists
76617,752,3,"342,59999999999997",3,1,1,5,Low-Value,At Risk Customers
76618,46,8,"661,3",5,2,1,8,High-Value,Potential Loyalists
76620,0,7,"314,65",5,2,1,8,High-Value,Potential Loyalists
76621,998,2,"25,25",3,1,1,5,Low-Value,At Risk Customers
76622,1131,1,"58,9",2,1,1,4,Low-Value,Can't Lose
76623,22,4,"134,60000000000002",5,1,1,7,Mid-Value,Potential Loyalists
76627,1106,4,"318,9",2,1,1,4,Low-Value,Can't Lose
76628,195,2,"258,4",5,1,1,7,Mid-Value,Potential Loyalists
76629,997,5,"163,15",3,1,1,5,Low-Value,At Risk Customers
76630,557,3,"51,3",4,1,1,6,Mid-Value,Potential Loyalists
76632,928,1,"63,9",3,1,1,5,Low-Value,At Risk Customers
76633,161,1,"66,8",5,1,1,7,Mid-Value,Potential Loyalists
76636,171,2,"112,4",5,1,1,7,Mid-Value,Potential Loyalists
76637,423,6,"193,9",4,1,1,6,Mid-Value,Potential Loyalists
76639,276,4,"159,70000000000002",5,1,1,7,Mid-Value,Potential Loyalists
76640,935,2,"292,5",3,1,1,5,Low-Value,At Risk Customers
76642,94,11,"1046,7",5,2,2,9,High-Value,Champions
76644,55,4,"378,15",5,1,1,7,Mid-Value,Potential Loyalists
76645,251,10,"1044,6",5,2,2,9,High-Value,Champions
76646,1601,1,"28,200000000000003",1,1,1,3,Low-Value,Lost
76648,1258,2,"154,5",2,1,1,4,Low-Value,Can't Lose
76650,954,2,"223,05",3,1,1,5,Low-Value,At Risk Customers
76651,948,1,"39,1",3,1,1,5,Low-Value,At Risk Customers
76652,52,7,"343,2",5,2,1,8,High-Value,Potential Loyalists
76654,1514,1,"8,3",1,1,1,3,Low-Value,Lost
76656,194,1,"101,2",5,1,1,7,Mid-Value,Potential Loyalists
76658,1515,1,"13,35",1,1,1,3,Low-Value,Lost
76661,550,1,"230,70000000000002",4,1,1,6,Mid-Value,Potential Loyalists
76662,1622,1,"96,3",1,1,1,3,Low-Value,Lost
76663,307,2,"44,05",5,1,1,7,Mid-Value,Potential Loyalists
76664,395,1,"22,0",4,1,1,6,Mid-Value,Potential Loyalists
76667,299,3,"84,8",5,1,1,7,Mid-Value,Potential Loyalists
76668,80,3,"121,25",5,1,1,7,Mid-Value,Potential Loyalists
76669,411,4,"113,1",4,1,1,6,Mid-Value,Potential Loyalists
76670,610,2,"121,35000000000001",4,1,1,6,Mid-Value,Potential Loyalists
76671,941,2,"74,2",3,1,1,5,Low-Value,At Risk Customers
76672,612,5,"588,95",4,1,1,6,Mid-Value,Potential Loyalists
76675,548,4,"240,6",4,1,1,6,Mid-Value,Potential Loyalists
76678,89,8,"408,65000000000003",5,2,1,8,High-Value,Potential Loyalists
76679,340,2,"32,0",5,1,1,7,Mid-Value,Potential Loyalists
76681,9,3,"135,95000000000002",5,1,1,7,Mid-Value,Potential Loyalists
76683,1737,1,"21,45",1,1,1,3,Low-Value,Lost
76684,813,1,"49,8",3,1,1,5,Low-Value,At Risk Customers
76688,277,1,"23,8",5,1,1,7,Mid-Value,Potential Loyalists
76689,202,4,"208,29999999999998",5,1,1,7,Mid-Value,Potential Loyalists
76691,38,3,"161,3",5,1,1,7,Mid-Value,Potential Loyalists
76694,1189,2,"149,10000000000002",2,1,1,4,Low-Value,Can't Lose
76696,316,3,"181,85",5,1,1,7,Mid-Value,Potential Loyalists
76697,1417,1,"116,0",2,1,1,4,Low-Value,Can't Lose
76699,1,3,"262,25",5,1,1,7,Mid-Value,Potential Loyalists
76700,136,5,"162,05",5,1,1,7,Mid-Value,Potential Loyalists
76701,168,2,"285,7",5,1,1,7,Mid-Value,Potential Loyalists
76702,1610,1,"102,89999999999999",1,1,1,3,Low-Value,Lost
76704,121,6,"397,20000000000005",5,1,1,7,Mid-Value,Potential Loyalists
76706,424,1,"13,2",4,1,1,6,Mid-Value,Potential Loyalists
76707,596,5,"308,15000000000003",4,1,1,6,Mid-Value,Potential Loyalists
76708,743,3,"357,0",3,1,1,5,Low-Value,At Risk Customers
76709,1,1,"58,6",5,1,1,7,Mid-Value,Potential Loyalists
76712,367,10,"506,0",4,2,1,7,Mid-Value,Potential Loyalists
76713,1537,1,"125,1",1,1,1,3,Low-Value,Lost
76717,1229,2,"112,7",2,1,1,4,Low-Value,Can't Lose
76719,77,3,"394,15",5,1,1,7,Mid-Value,Potential Loyalists
76723,348,2,"1202,3000000000002",5,1,2,8,High-Value,Potential Loyalists
76724,1291,2,"147,5",2,1,1,4,Low-Value,Can't Lose
76725,221,3,"141,05",5,1,1,7,Mid-Value,Potential Loyalists
76726,912,1,"44,1",3,1,1,5,Low-Value,At Risk Customers
76729,488,1,"87,1",4,1,1,6,Mid-Value,Potential Loyalists
76733,1671,1,"142,2",1,1,1,3,Low-Value,Lost
76735,724,1,"91,0",4,1,1,6,Mid-Value,Potential Loyalists
76736,238,3,"69,7",5,1,1,7,Mid-Value,Potential Loyalists
76737,1391,1,"117,2",2,1,1,4,Low-Value,Can't Lose
76738,247,4,"155,4",5,1,1,7,Mid-Value,Potential Loyalists
76740,721,2,"117,69999999999999",4,1,1,6,Mid-Value,Potential Loyalists
76741,375,3,"137,0",4,1,1,6,Mid-Value,Potential Loyalists
76742,176,5,"158,45000000000002",5,1,1,7,Mid-Value,Potential Loyalists
76743,116,8,"381,05",5,2,1,8,High-Value,Potential Loyalists
76744,577,5,"278,65",4,1,1,6,Mid-Value,Potential Loyalists
76745,195,1,"40,650000000000006",5,1,1,7,Mid-Value,Potential Loyalists
76747,1305,2,"39,4",2,1,1,4,Low-Value,Can't Lose
76748,85,3,"143,1",5,1,1,7,Mid-Value,Potential Loyalists
76752,1172,1,"28,0",2,1,1,4,Low-Value,Can't Lose
76753,1656,1,"92,9",1,1,1,3,Low-Value,Lost
76755,409,3,"91,15",4,1,1,6,Mid-Value,Potential Loyalists
76757,9,6,"491,0",5,1,1,7,Mid-Value,Potential Loyalists
76758,1527,3,"162,3",1,1,1,3,Low-Value,Lost
76759,1607,1,"30,25",1,1,1,3,Low-Value,Lost
76760,238,4,"536,0",5,1,1,7,Mid-Value,Potential Loyalists
76764,270,1,"12,4",5,1,1,7,Mid-Value,Potential Loyalists
76765,866,1,"19,1",3,1,1,5,Low-Value,At Risk Customers
76766,790,2,"38,45",3,1,1,5,Low-Value,At Risk Customers
76767,15,1,"324,0",5,1,1,7,Mid-Value,Potential Loyalists
76769,1151,1,"9,2",2,1,1,4,Low-Value,Can't Lose
76772,439,3,"194,1",4,1,1,6,Mid-Value,Potential Loyalists
76773,348,2,"76,25",5,1,1,7,Mid-Value,Potential Loyalists
76775,54,4,"168,8",5,1,1,7,Mid-Value,Potential Loyalists
76776,403,3,"250,75",4,1,1,6,Mid-Value,Potential Loyalists
76777,1335,2,"120,6",2,1,1,4,Low-Value,Can't Lose
76779,551,1,"43,2",4,1,1,6,Mid-Value,Potential Loyalists
76781,1194,1,"48,15",2,1,1,4,Low-Value,Can't Lose
76782,82,3,"174,05",5,1,1,7,Mid-Value,Potential Loyalists
76787,542,3,"131,05",4,1,1,6,Mid-Value,Potential Loyalists
76788,614,1,"17,35",4,1,1,6,Mid-Value,Potential Loyalists
76789,1700,1,"31,4",1,1,1,3,Low-Value,Lost
76790,141,5,"247,05",5,1,1,7,Mid-Value,Potential Loyalists
76791,412,2,"182,45000000000002",4,1,1,6,Mid-Value,Potential Loyalists
76792,66,5,"189,25",5,1,1,7,Mid-Value,Potential Loyalists
76793,1134,3,"212,7",2,1,1,4,Low-Value,Can't Lose
76794,448,2,"304,6",4,1,1,6,Mid-Value,Potential Loyalists
76795,586,1,"14,35",4,1,1,6,Mid-Value,Potential Loyalists
76797,9,1,"60,7",5,1,1,7,Mid-Value,Potential Loyalists
76800,796,5,"99,0",3,1,1,5,Low-Value,At Risk Customers
76801,60,2,"46,099999999999994",5,1,1,7,Mid-Value,Potential Loyalists
76802,13,5,"500,2",5,1,1,7,Mid-Value,Potential Loyalists
76805,452,5,"140,4",4,1,1,6,Mid-Value,Potential Loyalists
76806,900,5,"422,55",3,1,1,5,Low-Value,At Risk Customers
76807,1232,1,"82,8",2,1,1,4,Low-Value,Can't Lose
76808,1488,2,"96,1",1,1,1,3,Low-Value,Lost
76811,895,2,"92,44999999999999",3,1,1,5,Low-Value,At Risk Customers
76812,419,1,"46,05",4,1,1,6,Mid-Value,Potential Loyalists
76815,1822,1,"35,0",1,1,1,3,Low-Value,Lost
76816,1379,1,"31,7",2,1,1,4,Low-Value,Can't Lose
76817,64,1,"43,7",5,1,1,7,Mid-Value,Potential Loyalists
76818,1606,2,"103,00000000000001",1,1,1,3,Low-Value,Lost
76822,454,4,"316,2",4,1,1,6,Mid-Value,Potential Loyalists
76824,432,7,"273,85",4,2,1,7,Mid-Value,Potential Loyalists
76825,17,13,"889,75",5,3,2,10,High-Value,Champions
76826,1419,1,"98,85",2,1,1,4,Low-Value,Can't Lose
76827,1408,1,"68,0",2,1,1,4,Low-Value,Can't Lose
76828,27,5,"434,5",5,1,1,7,Mid-Value,Potential Loyalists
76831,1340,1,"300,0",2,1,1,4,Low-Value,Can't Lose
76832,804,6,"280,55",3,1,1,5,Low-Value,At Risk Customers
76833,189,2,"142,25",5,1,1,7,Mid-Value,Potential Loyalists
76834,115,5,"284,95",5,1,1,7,Mid-Value,Potential Loyalists
76836,886,3,"223,04999999999998",3,1,1,5,Low-Value,At Risk Customers
76838,585,3,"368,2",4,1,1,6,Mid-Value,Potential Loyalists
76839,1068,1,"34,0",3,1,1,5,Low-Value,At Risk Customers
76840,539,3,"73,94999999999999",4,1,1,6,Mid-Value,Potential Loyalists
76842,19,5,"182,10000000000002",5,1,1,7,Mid-Value,Potential Loyalists
76844,762,1,"50,4",3,1,1,5,Low-Value,At Risk Customers
76845,974,3,"40,95",3,1,1,5,Low-Value,At Risk Customers
76847,122,3,"222,7",5,1,1,7,Mid-Value,Potential Loyalists
76852,414,2,"260,25",4,1,1,6,Mid-Value,Potential Loyalists
76858,194,6,"154,85",5,1,1,7,Mid-Value,Potential Loyalists
76864,89,10,"661,9",5,2,1,8,High-Value,Potential Loyalists
76865,201,3,"510,59999999999997",5,1,1,7,Mid-Value,Potential Loyalists
76866,1203,3,"254,20000000000002",2,1,1,4,Low-Value,Can't Lose
76869,79,6,"430,55",5,1,1,7,Mid-Value,Potential Loyalists
76872,533,2,"162,75",4,1,1,6,Mid-Value,Potential Loyalists
76873,151,6,"331,15",5,1,1,7,Mid-Value,Potential Loyalists
76875,1446,3,"346,15000000000003",2,1,1,4,Low-Value,Can't Lose
76879,1461,2,"84,80000000000001",1,1,1,3,Low-Value,Lost
76881,519,4,"208,35",4,1,1,6,Mid-Value,Potential Loyalists
76882,1820,1,"34,85",1,1,1,3,Low-Value,Lost
76883,1327,3,"211,10000000000002",2,1,1,4,Low-Value,Can't Lose
76884,1091,2,"16,15",3,1,1,5,Low-Value,At Risk Customers
76885,68,3,"52,45",5,1,1,7,Mid-Value,Potential Loyalists
76888,782,1,"17,55",3,1,1,5,Low-Value,At Risk Customers
76890,235,5,"297,6",5,1,1,7,Mid-Value,Potential Loyalists
76892,243,1,"25,1",5,1,1,7,Mid-Value,Potential Loyalists
76893,770,3,"210,35",3,1,1,5,Low-Value,At Risk Customers
76895,560,2,"135,54999999999998",4,1,1,6,Mid-Value,Potential Loyalists
76896,775,2,"49,05",3,1,1,5,Low-Value,At Risk Customers
76897,547,3,"634,5",4,1,1,6,Mid-Value,Potential Loyalists
76898,14,1,"63,7",5,1,1,7,Mid-Value,Potential Loyalists
76901,22,2,"231,1",5,1,1,7,Mid-Value,Potential Loyalists
76902,1219,2,"89,69999999999999",2,1,1,4,Low-Value,Can't Lose
76903,1482,1,"19,4",1,1,1,3,Low-Value,Lost
76904,12,6,"386,35",5,1,1,7,Mid-Value,Potential Loyalists
76905,156,4,"253,9",5,1,1,7,Mid-Value,Potential Loyalists
76906,220,2,"91,6",5,1,1,7,Mid-Value,Potential Loyalists
76907,1466,1,"42,3",1,1,1,3,Low-Value,Lost
76908,14,4,"293,6",5,1,1,7,Mid-Value,Potential Loyalists
76911,385,1,"35,1",4,1,1,6,Mid-Value,Potential Loyalists
76912,971,1,"87,4",3,1,1,5,Low-Value,At Risk Customers
76913,104,2,"210,7",5,1,1,7,Mid-Value,Potential Loyalists
76914,954,3,"97,1",3,1,1,5,Low-Value,At Risk Customers
76915,394,8,"565,35",4,2,1,7,Mid-Value,Potential Loyalists
76922,92,5,"339,6",5,1,1,7,Mid-Value,Potential Loyalists
76923,900,1,"8,0",3,1,1,5,Low-Value,At Risk Customers
76925,227,3,"670,0",5,1,2,8,High-Value,Potential Loyalists
76930,264,1,"54,85",5,1,1,7,Mid-Value,Potential Loyalists
76931,19,3,"119,7",5,1,1,7,Mid-Value,Potential Loyalists
76934,7,3,"128,2",5,1,1,7,Mid-Value,Potential Loyalists
76936,1706,1,"48,4",1,1,1,3,Low-Value,Lost
76937,500,2,"256,2",4,1,1,6,Mid-Value,Potential Loyalists
76938,166,3,"202,55",5,1,1,7,Mid-Value,Potential Loyalists
76939,1762,1,"11,35",1,1,1,3,Low-Value,Lost
76940,13,1,"4,7",5,1,1,7,Mid-Value,Potential Loyalists
76941,158,5,"198,7",5,1,1,7,Mid-Value,Potential Loyalists
76942,1580,1,"82,25",1,1,1,3,Low-Value,Lost
76943,1525,1,"27,4",1,1,1,3,Low-Value,Lost
76944,62,2,"82,25",5,1,1,7,Mid-Value,Potential Loyalists
76947,381,3,"267,4",4,1,1,6,Mid-Value,Potential Loyalists
76949,425,10,"940,2",4,2,2,8,High-Value,Potential Loyalists
76951,475,4,"167,1",4,1,1,6,Mid-Value,Potential Loyalists
76953,736,2,"263,29999999999995",3,1,1,5,Low-Value,At Risk Customers
76955,368,6,"523,5",4,1,1,6,Mid-Value,Potential Loyalists
76956,757,3,"231,3",3,1,1,5,Low-Value,At Risk Customers
76957,1289,2,"66,95",2,1,1,4,Low-Value,Can't Lose
76959,858,4,"379,3",3,1,1,5,Low-Value,At Risk Customers
76961,441,3,"154,9",4,1,1,6,Mid-Value,Potential Loyalists
76963,1275,1,"103,3",2,1,1,4,Low-Value,Can't Lose
76964,96,3,"102,55000000000001",5,1,1,7,Mid-Value,Potential Loyalists
76965,2,6,"1048,75",5,1,2,8,High-Value,Potential Loyalists
76967,1241,1,"2,4",2,1,1,4,Low-Value,Can't Lose
76968,1066,2,"129,2",3,1,1,5,Low-Value,At Risk Customers
76969,1255,1,"29,8",2,1,1,4,Low-Value,Can't Lose
76970,165,2,"156,6",5,1,1,7,Mid-Value,Potential Loyalists
76971,1664,1,"22,6",1,1,1,3,Low-Value,Lost
76973,114,6,"419,05",5,1,1,7,Mid-Value,Potential Loyalists
76974,638,4,"133,25",4,1,1,6,Mid-Value,Potential Loyalists
76976,647,1,"113,65",4,1,1,6,Mid-Value,Potential Loyalists
76977,1297,2,"191,54999999999998",2,1,1,4,Low-Value,Can't Lose
76979,506,2,"135,0",4,1,1,6,Mid-Value,Potential Loyalists
76983,1151,3,"131,9",2,1,1,4,Low-Value,Can't Lose
76984,34,14,"628,05",5,3,1,9,High-Value,Champions
76987,1126,2,"356,9",2,1,1,4,Low-Value,Can't Lose
76988,370,2,"189,6",4,1,1,6,Mid-Value,Potential Loyalists
76990,98,1,"107,5",5,1,1,7,Mid-Value,Potential Loyalists
76991,466,2,"193,35",4,1,1,6,Mid-Value,Potential Loyalists
76992,283,4,"350,4",5,1,1,7,Mid-Value,Potential Loyalists
76993,25,3,"73,8",5,1,1,7,Mid-Value,Potential Loyalists
76995,851,5,"323,2",3,1,1,5,Low-Value,At Risk Customers
76997,367,1,"199,5",4,1,1,6,Mid-Value,Potential Loyalists
77001,1200,1,"17,4",2,1,1,4,Low-Value,Can't Lose
77002,360,3,"95,0",5,1,1,7,Mid-Value,Potential Loyalists
77004,44,3,"49,05",5,1,1,7,Mid-Value,Potential Loyalists
77006,794,4,"157,3",3,1,1,5,Low-Value,At Risk Customers
77007,23,5,"308,65000000000003",5,1,1,7,Mid-Value,Potential Loyalists
77008,176,5,"202,7",5,1,1,7,Mid-Value,Potential Loyalists
77010,415,6,"250,5",4,1,1,6,Mid-Value,Potential Loyalists
77012,225,4,"94,2",5,1,1,7,Mid-Value,Potential Loyalists
77013,1707,2,"94,15",1,1,1,3,Low-Value,Lost
77016,524,5,"220,95",4,1,1,6,Mid-Value,Potential Loyalists
77017,1172,2,"83,95",2,1,1,4,Low-Value,Can't Lose
77018,1116,3,"109,2",2,1,1,4,Low-Value,Can't Lose
77020,603,3,"1028,6",4,1,2,7,Mid-Value,Potential Loyalists
77021,1180,5,"444,0",2,1,1,4,Low-Value,Can't Lose
77022,130,8,"609,3",5,2,1,8,High-Value,Potential Loyalists
77023,88,3,"82,1",5,1,1,7,Mid-Value,Potential Loyalists
77024,95,5,"210,5",5,1,1,7,Mid-Value,Potential Loyalists
77026,247,3,"239,4",5,1,1,7,Mid-Value,Potential Loyalists
77029,334,7,"409,15",5,2,1,8,High-Value,Potential Loyalists
77030,1277,1,"252,8",2,1,1,4,Low-Value,Can't Lose
77034,711,1,"19,35",4,1,1,6,Mid-Value,Potential Loyalists
77035,1463,4,"212,2",1,1,1,3,Low-Value,Lost
77036,209,1,"10,7",5,1,1,7,Mid-Value,Potential Loyalists
77037,589,3,"69,1",4,1,1,6,Mid-Value,Potential Loyalists
77038,782,5,"371,65",3,1,1,5,Low-Value,At Risk Customers
77040,239,3,"137,2",5,1,1,7,Mid-Value,Potential Loyalists
77043,508,3,"113,3",4,1,1,6,Mid-Value,Potential Loyalists
77044,1339,1,"77,25",2,1,1,4,Low-Value,Can't Lose
77045,1719,1,"9,3",1,1,1,3,Low-Value,Lost
77047,1180,2,"64,35",2,1,1,4,Low-Value,Can't Lose
77048,1230,3,"127,0",2,1,1,4,Low-Value,Can't Lose
77049,1096,1,"21,45",2,1,1,4,Low-Value,Can't Lose
77050,240,3,"29,6",5,1,1,7,Mid-Value,Potential Loyalists
77052,934,6,"423,75",3,1,1,5,Low-Value,At Risk Customers
77056,21,4,"184,64999999999998",5,1,1,7,Mid-Value,Potential Loyalists
77058,1149,3,"195,65",2,1,1,4,Low-Value,Can't Lose
77059,800,2,"105,75",3,1,1,5,Low-Value,At Risk Customers
77062,121,4,"3262,3",5,1,5,11,High-Value,Champions
77063,902,2,"297,1",3,1,1,5,Low-Value,At Risk Customers
77064,977,2,"291,59999999999997",3,1,1,5,Low-Value,At Risk Customers
77065,34,4,"129,1",5,1,1,7,Mid-Value,Potential Loyalists
77069,360,3,"480,7",5,1,1,7,Mid-Value,Potential Loyalists
77070,1632,2,"34,55",1,1,1,3,Low-Value,Lost
77072,11,4,"376,0",5,1,1,7,Mid-Value,Potential Loyalists
77073,974,2,"121,3",3,1,1,5,Low-Value,At Risk Customers
77074,364,1,"35,8",5,1,1,7,Mid-Value,Potential Loyalists
77075,820,3,"165,7",3,1,1,5,Low-Value,At Risk Customers
77077,32,9,"684,25",5,2,2,9,High-Value,Champions
77079,204,2,"107,15",5,1,1,7,Mid-Value,Potential Loyalists
77080,1171,1,"4,85",2,1,1,4,Low-Value,Can't Lose
77082,1398,1,"55,1",2,1,1,4,Low-Value,Can't Lose
77083,873,1,"17,2",3,1,1,5,Low-Value,At Risk Customers
77084,763,2,"75,45",3,1,1,5,Low-Value,At Risk Customers
77085,7,6,"346,4",5,1,1,7,Mid-Value,Potential Loyalists
77087,815,2,"77,3",3,1,1,5,Low-Value,At Risk Customers
77089,66,5,"521,5500000000001",5,1,1,7,Mid-Value,Potential Loyalists
77090,746,4,"160,55",3,1,1,5,Low-Value,At Risk Customers
77095,591,1,"31,95",4,1,1,6,Mid-Value,Potential Loyalists
77096,766,6,"173,35",3,1,1,5,Low-Value,At Risk Customers
77097,931,6,"195,95",3,1,1,5,Low-Value,At Risk Customers
77098,1443,1,"107,7",2,1,1,4,Low-Value,Can't Lose
77101,45,2,"209,9",5,1,1,7,Mid-Value,Potential Loyalists
77102,1118,2,"49,800000000000004",2,1,1,4,Low-Value,Can't Lose
77103,799,3,"134,4",3,1,1,5,Low-Value,At Risk Customers
77105,879,2,"49,900000000000006",3,1,1,5,Low-Value,At Risk Customers
77106,597,1,"9,8",4,1,1,6,Mid-Value,Potential Loyalists
77107,981,1,"19,6",3,1,1,5,Low-Value,At Risk Customers
77109,31,2,"20,65",5,1,1,7,Mid-Value,Potential Loyalists
77110,815,1,"54,85",3,1,1,5,Low-Value,At Risk Customers
77111,853,1,"21,4",3,1,1,5,Low-Value,At Risk Customers
77115,1117,2,"50,6",2,1,1,4,Low-Value,Can't Lose
77120,72,7,"1222,2",5,2,2,9,High-Value,Champions
77122,37,10,"889,5",5,2,2,9,High-Value,Champions
77123,490,2,"26,15",4,1,1,6,Mid-Value,Potential Loyalists
77129,134,1,"76,7",5,1,1,7,Mid-Value,Potential Loyalists
77130,363,2,"20,8",5,1,1,7,Mid-Value,Potential Loyalists
77131,1464,3,"149,7",1,1,1,3,Low-Value,Lost
77132,933,2,"127,1",3,1,1,5,Low-Value,At Risk Customers
77134,203,1,"189,0",5,1,1,7,Mid-Value,Potential Loyalists
77135,1516,1,"8,65",1,1,1,3,Low-Value,Lost
77137,1256,1,"80,9",2,1,1,4,Low-Value,Can't Lose
77138,739,2,"66,45",3,1,1,5,Low-Value,At Risk Customers
77143,1654,1,"8,5",1,1,1,3,Low-Value,Lost
77145,5,12,"684,1500000000001",5,3,2,10,High-Value,Champions
77146,1502,4,"986,55",1,1,2,4,Low-Value,Can't Lose
77147,1204,4,"273,65",2,1,1,4,Low-Value,Can't Lose
77152,1188,6,"436,15",2,1,1,4,Low-Value,Can't Lose
77154,586,3,"132,65",4,1,1,6,Mid-Value,Potential Loyalists
77155,38,2,"89,85000000000001",5,1,1,7,Mid-Value,Potential Loyalists
77156,41,3,"230,64999999999998",5,1,1,7,Mid-Value,Potential Loyalists
77158,489,5,"188,15",4,1,1,6,Mid-Value,Potential Loyalists
77159,148,2,"150,35",5,1,1,7,Mid-Value,Potential Loyalists
77160,1181,1,"23,25",2,1,1,4,Low-Value,Can't Lose
77161,39,2,"37,7",5,1,1,7,Mid-Value,Potential Loyalists
77163,13,9,"556,2",5,2,1,8,High-Value,Potential Loyalists
77164,575,1,"54,9",4,1,1,6,Mid-Value,Potential Loyalists
77168,219,8,"252,9",5,2,1,8,High-Value,Potential Loyalists
77169,726,1,"5,75",4,1,1,6,Mid-Value,Potential Loyalists
77170,55,4,"212,6",5,1,1,7,Mid-Value,Potential Loyalists
77171,684,2,"283,34999999999997",4,1,1,6,Mid-Value,Potential Loyalists
77174,260,5,"519,75",5,1,1,7,Mid-Value,Potential Loyalists
77175,56,3,"129,65",5,1,1,7,Mid-Value,Potential Loyalists
77177,712,2,"342,2",4,1,1,6,Mid-Value,Potential Loyalists
77179,757,1,"166,2",3,1,1,5,Low-Value,At Risk Customers
77181,1394,2,"130,0",2,1,1,4,Low-Value,Can't Lose
77182,458,2,"260,54999999999995",4,1,1,6,Mid-Value,Potential Loyalists
77183,222,2,"291,95",5,1,1,7,Mid-Value,Potential Loyalists
77184,312,4,"167,7",5,1,1,7,Mid-Value,Potential Loyalists
77188,603,1,"18,6",4,1,1,6,Mid-Value,Potential Loyalists
77190,54,5,"104,85000000000001",5,1,1,7,Mid-Value,Potential Loyalists
77192,351,3,"91,10000000000001",5,1,1,7,Mid-Value,Potential Loyalists
77193,905,4,"455,25",3,1,1,5,Low-Value,At Risk Customers
77195,928,1,"203,10000000000002",3,1,1,5,Low-Value,At Risk Customers
77196,96,3,"278,75",5,1,1,7,Mid-Value,Potential Loyalists
77198,198,6,"200,35",5,1,1,7,Mid-Value,Potential Loyalists
77199,151,2,"277,45",5,1,1,7,Mid-Value,Potential Loyalists
77200,820,1,"25,5",3,1,1,5,Low-Value,At Risk Customers
77201,19,7,"293,3",5,2,1,8,High-Value,Potential Loyalists
77203,205,1,"181,4",5,1,1,7,Mid-Value,Potential Loyalists
77204,831,2,"137,0",3,1,1,5,Low-Value,At Risk Customers
77205,432,5,"203,45",4,1,1,6,Mid-Value,Potential Loyalists
77206,46,5,"400,75",5,1,1,7,Mid-Value,Potential Loyalists
77208,643,6,"372,4",4,1,1,6,Mid-Value,Potential Loyalists
77213,83,3,"370,1",5,1,1,7,Mid-Value,Potential Loyalists
77214,271,1,"43,5",5,1,1,7,Mid-Value,Potential Loyalists
77216,84,2,"19,7",5,1,1,7,Mid-Value,Potential Loyalists
77217,496,1,"24,6",4,1,1,6,Mid-Value,Potential Loyalists
77219,556,2,"283,1",4,1,1,6,Mid-Value,Potential Loyalists
77220,71,8,"622,9",5,2,1,8,High-Value,Potential Loyalists
77221,597,2,"203,85",4,1,1,6,Mid-Value,Potential Loyalists
77223,1389,1,"22,8",2,1,1,4,Low-Value,Can't Lose
77227,332,1,"49,15",5,1,1,7,Mid-Value,Potential Loyalists
77233,1183,4,"225,54999999999998",2,1,1,4,Low-Value,Can't Lose
77234,425,4,"231,39999999999998",4,1,1,6,Mid-Value,Potential Loyalists
77235,883,4,"197,5",3,1,1,5,Low-Value,At Risk Customers
77236,1242,1,"52,050000000000004",2,1,1,4,Low-Value,Can't Lose
77238,474,3,"289,7",4,1,1,6,Mid-Value,Potential Loyalists
77239,787,4,"104,85",3,1,1,5,Low-Value,At Risk Customers
77242,936,2,"64,4",3,1,1,5,Low-Value,At Risk Customers
77244,398,7,"529,95",4,2,1,7,Mid-Value,Potential Loyalists
77245,85,2,"31,9",5,1,1,7,Mid-Value,Potential Loyalists
77247,109,7,"186,3",5,2,1,8,High-Value,Potential Loyalists
77248,9,1,"497,84999999999997",5,1,1,7,Mid-Value,Potential Loyalists
77251,891,4,"528,2",3,1,1,5,Low-Value,At Risk Customers
77253,763,5,"346,25",3,1,1,5,Low-Value,At Risk Customers
77255,377,5,"529,0",4,1,1,6,Mid-Value,Potential Loyalists
77256,1674,1,"64,6",1,1,1,3,Low-Value,Lost
77261,493,3,"43,1",4,1,1,6,Mid-Value,Potential Loyalists
77262,1277,1,"34,5",2,1,1,4,Low-Value,Can't Lose
77263,1086,2,"81,0",3,1,1,5,Low-Value,At Risk Customers
77264,977,2,"38,349999999999994",3,1,1,5,Low-Value,At Risk Customers
77265,1245,1,"86,1",2,1,1,4,Low-Value,Can't Lose
77266,320,1,"19,7",5,1,1,7,Mid-Value,Potential Loyalists
77267,532,4,"192,55",4,1,1,6,Mid-Value,Potential Loyalists
77268,139,3,"575,0500000000001",5,1,1,7,Mid-Value,Potential Loyalists
77269,1625,1,"129,9",1,1,1,3,Low-Value,Lost
77272,1736,1,"6,5",1,1,1,3,Low-Value,Lost
77275,892,1,"35,8",3,1,1,5,Low-Value,At Risk Customers
77276,871,2,"121,5",3,1,1,5,Low-Value,At Risk Customers
77277,232,2,"80,4",5,1,1,7,Mid-Value,Potential Loyalists
77278,334,1,"52,7",5,1,1,7,Mid-Value,Potential Loyalists
77281,21,4,"266,0",5,1,1,7,Mid-Value,Potential Loyalists
77282,971,3,"294,25",3,1,1,5,Low-Value,At Risk Customers
77287,34,6,"347,0",5,1,1,7,Mid-Value,Potential Loyalists
77288,866,6,"391,29999999999995",3,1,1,5,Low-Value,At Risk Customers
77290,348,1,"36,65",5,1,1,7,Mid-Value,Potential Loyalists
77291,1353,1,"30,95",2,1,1,4,Low-Value,Can't Lose
77292,22,7,"330,85",5,2,1,8,High-Value,Potential Loyalists
77293,588,1,"161,8",4,1,1,6,Mid-Value,Potential Loyalists
77294,843,2,"31,200000000000003",3,1,1,5,Low-Value,At Risk Customers
77295,1114,1,"6,5",2,1,1,4,Low-Value,Can't Lose
77296,840,1,"17,1",3,1,1,5,Low-Value,At Risk Customers
77299,236,8,"287,20000000000005",5,2,1,8,High-Value,Potential Loyalists
77300,244,2,"471,8",5,1,1,7,Mid-Value,Potential Loyalists
77302,856,3,"263,4",3,1,1,5,Low-Value,At Risk Customers
77303,1288,3,"87,45",2,1,1,4,Low-Value,Can't Lose
77305,460,1,"15,4",4,1,1,6,Mid-Value,Potential Loyalists
77306,19,11,"652,3",5,2,1,8,High-Value,Potential Loyalists
77307,1281,1,"32,4",2,1,1,4,Low-Value,Can't Lose
77308,324,4,"143,3",5,1,1,7,Mid-Value,Potential Loyalists
77309,1085,1,"16,5",3,1,1,5,Low-Value,At Risk Customers
77310,629,1,"70,95",4,1,1,6,Mid-Value,Potential Loyalists
77311,50,4,"231,75",5,1,1,7,Mid-Value,Potential Loyalists
77313,296,3,"171,6",5,1,1,7,Mid-Value,Potential Loyalists
77314,319,2,"927,65",5,1,2,8,High-Value,Potential Loyalists
77316,894,5,"344,94999999999993",3,1,1,5,Low-Value,At Risk Customers
77318,1720,1,"66,1",1,1,1,3,Low-Value,Lost
77319,392,3,"104,99999999999999",4,1,1,6,Mid-Value,Potential Loyalists
77321,337,1,"87,1",5,1,1,7,Mid-Value,Potential Loyalists
77323,1524,2,"57,85",1,1,1,3,Low-Value,Lost
77325,27,2,"445,15",5,1,1,7,Mid-Value,Potential Loyalists
77327,1189,3,"171,6",2,1,1,4,Low-Value,Can't Lose
77328,281,4,"265,15000000000003",5,1,1,7,Mid-Value,Potential Loyalists
77329,1705,1,"32,9",1,1,1,3,Low-Value,Lost
77330,778,2,"66,8",3,1,1,5,Low-Value,At Risk Customers
77331,595,1,"56,849999999999994",4,1,1,6,Mid-Value,Potential Loyalists
77332,29,8,"574,6",5,2,1,8,High-Value,Potential Loyalists
77333,546,1,"24,7",4,1,1,6,Mid-Value,Potential Loyalists
77334,995,2,"73,0",3,1,1,5,Low-Value,At Risk Customers
77335,273,1,"72,55",5,1,1,7,Mid-Value,Potential Loyalists
77336,257,6,"549,5",5,1,1,7,Mid-Value,Potential Loyalists
77337,173,2,"106,2",5,1,1,7,Mid-Value,Potential Loyalists
77338,205,7,"180,35",5,2,1,8,High-Value,Potential Loyalists
77339,782,2,"75,2",3,1,1,5,Low-Value,At Risk Customers
77340,47,1,"14,8",5,1,1,7,Mid-Value,Potential Loyalists
77343,739,2,"123,5",3,1,1,5,Low-Value,At Risk Customers
77345,118,1,"30,65",5,1,1,7,Mid-Value,Potential Loyalists
77346,1003,3,"69,25",3,1,1,5,Low-Value,At Risk Customers
77347,39,5,"434,90000000000003",5,1,1,7,Mid-Value,Potential Loyalists
77348,773,3,"202,7",3,1,1,5,Low-Value,At Risk Customers
77351,249,1,"28,35",5,1,1,7,Mid-Value,Potential Loyalists
77352,399,4,"424,85",4,1,1,6,Mid-Value,Potential Loyalists
77353,542,2,"53,400000000000006",4,1,1,6,Mid-Value,Potential Loyalists
77354,1088,2,"130,4",3,1,1,5,Low-Value,At Risk Customers
77355,479,1,"23,2",4,1,1,6,Mid-Value,Potential Loyalists
77357,523,3,"181,8",4,1,1,6,Mid-Value,Potential Loyalists
77359,553,4,"279,3",4,1,1,6,Mid-Value,Potential Loyalists
77360,178,4,"383,55",5,1,1,7,Mid-Value,Potential Loyalists
77363,594,1,"49,95",4,1,1,6,Mid-Value,Potential Loyalists
77366,91,5,"154,35",5,1,1,7,Mid-Value,Potential Loyalists
77369,410,4,"132,85",4,1,1,6,Mid-Value,Potential Loyalists
77370,77,6,"521,5500000000001",5,1,1,7,Mid-Value,Potential Loyalists
77371,1649,1,"86,1",1,1,1,3,Low-Value,Lost
77372,17,7,"605,75",5,2,1,8,High-Value,Potential Loyalists
77373,414,6,"270,5",4,1,1,6,Mid-Value,Potential Loyalists
77374,568,4,"105,9",4,1,1,6,Mid-Value,Potential Loyalists
77375,579,2,"120,45",4,1,1,6,Mid-Value,Potential Loyalists
77376,73,5,"336,8",5,1,1,7,Mid-Value,Potential Loyalists
77378,105,2,"24,9",5,1,1,7,Mid-Value,Potential Loyalists
77379,41,3,"725,6500000000001",5,1,2,8,High-Value,Potential Loyalists
77383,3,11,"559,95",5,2,1,8,High-Value,Potential Loyalists
77385,31,9,"541,9499999999999",5,2,1,8,High-Value,Potential Loyalists
77386,155,1,"22,799999999999997",5,1,1,7,Mid-Value,Potential Loyalists
77388,463,1,"147,3",4,1,1,6,Mid-Value,Potential Loyalists
77389,556,3,"144,0",4,1,1,6,Mid-Value,Potential Loyalists
77390,393,2,"31,65",4,1,1,6,Mid-Value,Potential Loyalists
77391,362,1,"97,95",5,1,1,7,Mid-Value,Potential Loyalists
77394,124,3,"44,3",5,1,1,7,Mid-Value,Potential Loyalists
77395,223,2,"99,45",5,1,1,7,Mid-Value,Potential Loyalists
77399,173,2,"42,699999999999996",5,1,1,7,Mid-Value,Potential Loyalists
77400,20,7,"649,95",5,2,1,8,High-Value,Potential Loyalists
77401,248,1,"15,8",5,1,1,7,Mid-Value,Potential Loyalists
77402,42,5,"164,95",5,1,1,7,Mid-Value,Potential Loyalists
77403,104,3,"105,25",5,1,1,7,Mid-Value,Potential Loyalists
77404,437,2,"199,3",4,1,1,6,Mid-Value,Potential Loyalists
77406,1807,1,"11,3",1,1,1,3,Low-Value,Lost
77408,1294,2,"312,5",2,1,1,4,Low-Value,Can't Lose
77411,374,4,"148,55",4,1,1,6,Mid-Value,Potential Loyalists
77412,1067,3,"110,85000000000001",3,1,1,5,Low-Value,At Risk Customers
77415,472,1,"17,5",4,1,1,6,Mid-Value,Potential Loyalists
77416,43,4,"298,75",5,1,1,7,Mid-Value,Potential Loyalists
77418,98,2,"169,4",5,1,1,7,Mid-Value,Potential Loyalists
77419,1589,1,"5,7",1,1,1,3,Low-Value,Lost
77420,880,1,"38,4",3,1,1,5,Low-Value,At Risk Customers
77423,1087,1,"11,4",3,1,1,5,Low-Value,At Risk Customers
77424,1191,1,"26,65",2,1,1,4,Low-Value,Can't Lose
77425,388,3,"88,2",4,1,1,6,Mid-Value,Potential Loyalists
77427,989,5,"362,95",3,1,1,5,Low-Value,At Risk Customers
77428,207,2,"274,15",5,1,1,7,Mid-Value,Potential Loyalists
77429,874,1,"36,8",3,1,1,5,Low-Value,At Risk Customers
77431,750,5,"239,5",3,1,1,5,Low-Value,At Risk Customers
77432,191,3,"82,15",5,1,1,7,Mid-Value,Potential Loyalists
77434,334,4,"232,54999999999998",5,1,1,7,Mid-Value,Potential Loyalists
77435,790,1,"6,0",3,1,1,5,Low-Value,At Risk Customers
77436,610,1,"16,35",4,1,1,6,Mid-Value,Potential Loyalists
77437,1005,3,"128,75",3,1,1,5,Low-Value,At Risk Customers
77438,1763,1,"19,7",1,1,1,3,Low-Value,Lost
77442,211,6,"396,4",5,1,1,7,Mid-Value,Potential Loyalists
77444,621,2,"127,0",4,1,1,6,Mid-Value,Potential Loyalists
77447,1806,1,"69,1",1,1,1,3,Low-Value,Lost
77448,395,3,"79,7",4,1,1,6,Mid-Value,Potential Loyalists
77449,1023,1,"54,0",3,1,1,5,Low-Value,At Risk Customers
77452,1121,1,"3,35",2,1,1,4,Low-Value,Can't Lose
77453,1491,1,"5,9",1,1,1,3,Low-Value,Lost
77455,104,3,"121,9",5,1,1,7,Mid-Value,Potential Loyalists
77456,502,6,"295,8",4,1,1,6,Mid-Value,Potential Loyalists
77459,54,5,"356,15",5,1,1,7,Mid-Value,Potential Loyalists
77460,928,2,"55,75",3,1,1,5,Low-Value,At Risk Customers
77461,815,2,"312,75",3,1,1,5,Low-Value,At Risk Customers
77462,829,3,"62,55",3,1,1,5,Low-Value,At Risk Customers
77463,877,1,"11,7",3,1,1,5,Low-Value,At Risk Customers
77465,879,2,"198,65",3,1,1,5,Low-Value,At Risk Customers
77466,455,3,"817,15",4,1,2,7,Mid-Value,Potential Loyalists
77468,151,2,"205,5",5,1,1,7,Mid-Value,Potential Loyalists
77469,1251,1,"23,9",2,1,1,4,Low-Value,Can't Lose
77471,781,4,"305,35",3,1,1,5,Low-Value,At Risk Customers
77472,682,5,"310,05",4,1,1,6,Mid-Value,Potential Loyalists
77473,49,3,"26,5",5,1,1,7,Mid-Value,Potential Loyalists
77474,148,11,"623,55",5,2,1,8,High-Value,Potential Loyalists
77475,140,10,"392,65",5,2,1,8,High-Value,Potential Loyalists
77476,609,5,"453,5",4,1,1,6,Mid-Value,Potential Loyalists
77477,622,1,"16,799999999999997",4,1,1,6,Mid-Value,Potential Loyalists
77480,1092,8,"519,25",3,2,1,6,Mid-Value,Potential Loyalists
77481,126,2,"122,95",5,1,1,7,Mid-Value,Potential Loyalists
77482,23,3,"154,3",5,1,1,7,Mid-Value,Potential Loyalists
77483,234,1,"3,6",5,1,1,7,Mid-Value,Potential Loyalists
77484,56,6,"558,4499999999999",5,1,1,7,Mid-Value,Potential Loyalists
77485,919,5,"132,35",3,1,1,5,Low-Value,At Risk Customers
77486,1200,2,"72,75",2,1,1,4,Low-Value,Can't Lose
77487,227,2,"260,1",5,1,1,7,Mid-Value,Potential Loyalists
77491,143,3,"110,8",5,1,1,7,Mid-Value,Potential Loyalists
77493,126,3,"101,5",5,1,1,7,Mid-Value,Potential Loyalists
77494,472,2,"349,6",4,1,1,6,Mid-Value,Potential Loyalists
77495,531,1,"10,2",4,1,1,6,Mid-Value,Potential Loyalists
77496,4,4,"289,9",5,1,1,7,Mid-Value,Potential Loyalists
77498,1289,4,"122,15",2,1,1,4,Low-Value,Can't Lose
77499,745,3,"305,6",3,1,1,5,Low-Value,At Risk Customers
77500,376,4,"411,55",4,1,1,6,Mid-Value,Potential Loyalists
77501,651,2,"142,25",4,1,1,6,Mid-Value,Potential Loyalists
77503,1147,1,"53,8",2,1,1,4,Low-Value,Can't Lose
77506,516,3,"162,3",4,1,1,6,Mid-Value,Potential Loyalists
77508,862,3,"125,3",3,1,1,5,Low-Value,At Risk Customers
77511,1047,1,"50,2",3,1,1,5,Low-Value,At Risk Customers
77512,1081,2,"57,7",3,1,1,5,Low-Value,At Risk Customers
77515,1180,2,"19,5",2,1,1,4,Low-Value,Can't Lose
77519,768,1,"11,0",3,1,1,5,Low-Value,At Risk Customers
77520,33,6,"237,25",5,1,1,7,Mid-Value,Potential Loyalists
77521,214,4,"145,55",5,1,1,7,Mid-Value,Potential Loyalists
77522,10,6,"336,3",5,1,1,7,Mid-Value,Potential Loyalists
77523,7,3,"97,15",5,1,1,7,Mid-Value,Potential Loyalists
77524,432,2,"140,45000000000002",4,1,1,6,Mid-Value,Potential Loyalists
77525,1510,1,"72,55",1,1,1,3,Low-Value,Lost
77528,548,8,"332,25",4,2,1,7,Mid-Value,Potential Loyalists
77529,201,2,"409,7",5,1,1,7,Mid-Value,Potential Loyalists
77530,1159,2,"117,5",2,1,1,4,Low-Value,Can't Lose
77532,242,2,"249,0",5,1,1,7,Mid-Value,Potential Loyalists
77533,12,2,"130,95",5,1,1,7,Mid-Value,Potential Loyalists
77535,1812,1,"14,05",1,1,1,3,Low-Value,Lost
77536,1038,1,"18,35",3,1,1,5,Low-Value,At Risk Customers
77537,1011,1,"109,9",3,1,1,5,Low-Value,At Risk Customers
77538,39,6,"935,4",5,1,2,8,High-Value,Potential Loyalists
77539,49,8,"788,45",5,2,2,9,High-Value,Champions
77541,873,1,"14,3",3,1,1,5,Low-Value,At Risk Customers
77542,1574,1,"97,4",1,1,1,3,Low-Value,Lost
77543,29,2,"60,599999999999994",5,1,1,7,Mid-Value,Potential Loyalists
77544,585,3,"72,1",4,1,1,6,Mid-Value,Potential Loyalists
77545,1156,2,"84,3",2,1,1,4,Low-Value,Can't Lose
77546,1133,3,"345,35",2,1,1,4,Low-Value,Can't Lose
77547,309,6,"284,3",5,1,1,7,Mid-Value,Potential Loyalists
77550,185,3,"109,39999999999999",5,1,1,7,Mid-Value,Potential Loyalists
77552,1074,2,"118,94999999999999",3,1,1,5,Low-Value,At Risk Customers
77554,855,1,"16,1",3,1,1,5,Low-Value,At Risk Customers
77555,1070,2,"119,05",3,1,1,5,Low-Value,At Risk Customers
77556,721,6,"375,05",4,1,1,6,Mid-Value,Potential Loyalists
77558,662,2,"63,900000000000006",4,1,1,6,Mid-Value,Potential Loyalists
77559,177,3,"98,25",5,1,1,7,Mid-Value,Potential Loyalists
77560,1161,1,"21,6",2,1,1,4,Low-Value,Can't Lose
77561,338,5,"320,45",5,1,1,7,Mid-Value,Potential Loyalists
77563,204,6,"671,8499999999999",5,1,2,8,High-Value,Potential Loyalists
77565,64,5,"378,70000000000005",5,1,1,7,Mid-Value,Potential Loyalists
77567,375,4,"180,85",4,1,1,6,Mid-Value,Potential Loyalists
77569,75,4,"92,55",5,1,1,7,Mid-Value,Potential Loyalists
77570,256,3,"96,0",5,1,1,7,Mid-Value,Potential Loyalists
77571,553,8,"661,75",4,2,1,7,Mid-Value,Potential Loyalists
77573,377,2,"73,65",4,1,1,6,Mid-Value,Potential Loyalists
77575,856,2,"190,8",3,1,1,5,Low-Value,At Risk Customers
77576,554,4,"275,4",4,1,1,6,Mid-Value,Potential Loyalists
77577,350,3,"41,75",5,1,1,7,Mid-Value,Potential Loyalists
77579,686,2,"118,39999999999999",4,1,1,6,Mid-Value,Potential Loyalists
77580,173,1,"38,4",5,1,1,7,Mid-Value,Potential Loyalists
77582,629,2,"56,85",4,1,1,6,Mid-Value,Potential Loyalists
77584,712,3,"56,800000000000004",4,1,1,6,Mid-Value,Potential Loyalists
77585,606,1,"78,4",4,1,1,6,Mid-Value,Potential Loyalists
77586,197,7,"298,95",5,2,1,8,High-Value,Potential Loyalists
77587,432,2,"687,5999999999999",4,1,2,7,Mid-Value,Potential Loyalists
77589,396,6,"247,85",4,1,1,6,Mid-Value,Potential Loyalists
77591,887,2,"255,7",3,1,1,5,Low-Value,At Risk Customers
77592,1267,2,"277,5",2,1,1,4,Low-Value,Can't Lose
77593,763,2,"154,6",3,1,1,5,Low-Value,At Risk Customers
77594,19,3,"145,25",5,1,1,7,Mid-Value,Potential Loyalists
77598,70,1,"28,4",5,1,1,7,Mid-Value,Potential Loyalists
77599,193,1,"151,9",5,1,1,7,Mid-Value,Potential Loyalists
77600,123,2,"107,6",5,1,1,7,Mid-Value,Potential Loyalists
77602,515,1,"5,8",4,1,1,6,Mid-Value,Potential Loyalists
77603,900,1,"41,8",3,1,1,5,Low-Value,At Risk Customers
77604,1091,2,"110,25",3,1,1,5,Low-Value,At Risk Customers
77605,453,3,"110,7",4,1,1,6,Mid-Value,Potential Loyalists
77606,837,1,"62,3",3,1,1,5,Low-Value,At Risk Customers
77607,1122,1,"60,0",2,1,1,4,Low-Value,Can't Lose
77608,1070,3,"288,8",3,1,1,5,Low-Value,At Risk Customers
77609,755,6,"222,4",3,1,1,5,Low-Value,At Risk Customers
77610,1172,2,"173,75",2,1,1,4,Low-Value,Can't Lose
77611,66,16,"1181,2",5,3,2,10,High-Value,Champions
77612,86,6,"159,7",5,1,1,7,Mid-Value,Potential Loyalists
77616,397,2,"85,85",4,1,1,6,Mid-Value,Potential Loyalists
77617,40,1,"42,75",5,1,1,7,Mid-Value,Potential Loyalists
77620,370,5,"772,3",4,1,2,7,Mid-Value,Potential Loyalists
77621,128,1,"15,0",5,1,1,7,Mid-Value,Potential Loyalists
77622,221,4,"115,75",5,1,1,7,Mid-Value,Potential Loyalists
77623,22,2,"230,4",5,1,1,7,Mid-Value,Potential Loyalists
77624,194,6,"608,5",5,1,1,7,Mid-Value,Potential Loyalists
77628,719,1,"3,1",4,1,1,6,Mid-Value,Potential Loyalists
77629,1128,2,"40,95",2,1,1,4,Low-Value,Can't Lose
77633,1278,3,"63,05",2,1,1,4,Low-Value,Can't Lose
77634,93,5,"378,3",5,1,1,7,Mid-Value,Potential Loyalists
77636,565,4,"523,85",4,1,1,6,Mid-Value,Potential Loyalists
77637,893,1,"52,650000000000006",3,1,1,5,Low-Value,At Risk Customers
77638,901,1,"4,4",3,1,1,5,Low-Value,At Risk Customers
77640,109,6,"488,15000000000003",5,1,1,7,Mid-Value,Potential Loyalists
77641,615,5,"491,29999999999995",4,1,1,6,Mid-Value,Potential Loyalists
77642,1723,2,"85,6",1,1,1,3,Low-Value,Lost
77644,151,1,"44,9",5,1,1,7,Mid-Value,Potential Loyalists
77646,531,8,"782,9",4,2,2,8,High-Value,Potential Loyalists
77648,1186,1,"6,7",2,1,1,4,Low-Value,Can't Lose
77649,3,2,"125,3",5,1,1,7,Mid-Value,Potential Loyalists
77650,1509,1,"50,3",1,1,1,3,Low-Value,Lost
77651,577,2,"295,8",4,1,1,6,Mid-Value,Potential Loyalists
77652,72,3,"147,89999999999998",5,1,1,7,Mid-Value,Potential Loyalists
77653,193,5,"251,45",5,1,1,7,Mid-Value,Potential Loyalists
77655,981,1,"10,2",3,1,1,5,Low-Value,At Risk Customers
77657,1341,1,"11,0",2,1,1,4,Low-Value,Can't Lose
77658,682,1,"1,15",4,1,1,6,Mid-Value,Potential Loyalists
77659,11,4,"188,1",5,1,1,7,Mid-Value,Potential Loyalists
77660,1123,3,"128,89999999999998",2,1,1,4,Low-Value,Can't Lose
77665,1620,2,"99,2",1,1,1,3,Low-Value,Lost
77667,134,13,"753,5500000000001",5,3,2,10,High-Value,Champions
77668,757,5,"412,5",3,1,1,5,Low-Value,At Risk Customers
77670,493,3,"78,05",4,1,1,6,Mid-Value,Potential Loyalists
77672,257,4,"878,4999999999999",5,1,2,8,High-Value,Potential Loyalists
77674,128,6,"336,45",5,1,1,7,Mid-Value,Potential Loyalists
77676,25,3,"110,4",5,1,1,7,Mid-Value,Potential Loyalists
77677,48,6,"111,35",5,1,1,7,Mid-Value,Potential Loyalists
77679,987,2,"279,4",3,1,1,5,Low-Value,At Risk Customers
77680,1281,1,"122,0",2,1,1,4,Low-Value,Can't Lose
77682,801,5,"250,79999999999998",3,1,1,5,Low-Value,At Risk Customers
77685,467,1,"9,25",4,1,1,6,Mid-Value,Potential Loyalists
77689,812,2,"35,05",3,1,1,5,Low-Value,At Risk Customers
77690,19,10,"687,5999999999999",5,2,2,9,High-Value,Champions
77691,444,3,"138,45",4,1,1,6,Mid-Value,Potential Loyalists
77693,445,6,"552,25",4,1,1,6,Mid-Value,Potential Loyalists
77694,1100,5,"266,85",2,1,1,4,Low-Value,Can't Lose
77696,257,2,"393,34999999999997",5,1,1,7,Mid-Value,Potential Loyalists
77697,65,3,"91,94999999999999",5,1,1,7,Mid-Value,Potential Loyalists
77698,102,5,"182,2",5,1,1,7,Mid-Value,Potential Loyalists
77702,1197,1,"13,95",2,1,1,4,Low-Value,Can't Lose
77705,652,3,"246,4",4,1,1,6,Mid-Value,Potential Loyalists
77706,1313,1,"15,4",2,1,1,4,Low-Value,Can't Lose
77709,766,5,"156,85",3,1,1,5,Low-Value,At Risk Customers
77710,3,6,"619,6999999999999",5,1,1,7,Mid-Value,Potential Loyalists
77711,858,1,"26,3",3,1,1,5,Low-Value,At Risk Customers
77712,784,5,"170,05",3,1,1,5,Low-Value,At Risk Customers
77714,59,6,"256,95",5,1,1,7,Mid-Value,Potential Loyalists
77716,596,1,"227,70000000000002",4,1,1,6,Mid-Value,Potential Loyalists
77717,87,6,"375,0",5,1,1,7,Mid-Value,Potential Loyalists
77719,829,1,"199,0",3,1,1,5,Low-Value,At Risk Customers
77720,1400,1,"14,95",2,1,1,4,Low-Value,Can't Lose
77722,371,1,"23,9",4,1,1,6,Mid-Value,Potential Loyalists
77725,21,8,"429,95",5,2,1,8,High-Value,Potential Loyalists
77727,175,5,"527,7",5,1,1,7,Mid-Value,Potential Loyalists
77729,1042,1,"79,0",3,1,1,5,Low-Value,At Risk Customers
77730,1668,1,"47,4",1,1,1,3,Low-Value,Lost
77731,920,4,"117,4",3,1,1,5,Low-Value,At Risk Customers
77732,762,2,"101,05000000000001",3,1,1,5,Low-Value,At Risk Customers
77733,126,3,"216,25",5,1,1,7,Mid-Value,Potential Loyalists
77736,241,1,"29,6",5,1,1,7,Mid-Value,Potential Loyalists
77737,1686,1,"13,0",1,1,1,3,Low-Value,Lost
77738,402,2,"59,3",4,1,1,6,Mid-Value,Potential Loyalists
77740,417,1,"5,75",4,1,1,6,Mid-Value,Potential Loyalists
77741,129,5,"186,10000000000002",5,1,1,7,Mid-Value,Potential Loyalists
77742,12,4,"115,05",5,1,1,7,Mid-Value,Potential Loyalists
77745,63,6,"481,7",5,1,1,7,Mid-Value,Potential Loyalists
77746,140,3,"227,15",5,1,1,7,Mid-Value,Potential Loyalists
77748,90,4,"148,25",5,1,1,7,Mid-Value,Potential Loyalists
77751,917,2,"42,900000000000006",3,1,1,5,Low-Value,At Risk Customers
77753,24,7,"1091,2",5,2,2,9,High-Value,Champions
77754,811,6,"389,2",3,1,1,5,Low-Value,At Risk Customers
77756,672,2,"275,5",4,1,1,6,Mid-Value,Potential Loyalists
77757,113,8,"190,4",5,2,1,8,High-Value,Potential Loyalists
77759,171,4,"163,25",5,1,1,7,Mid-Value,Potential Loyalists
77762,948,2,"33,3",3,1,1,5,Low-Value,At Risk Customers
77763,747,4,"657,75",3,1,1,5,Low-Value,At Risk Customers
77765,1535,3,"163,9",1,1,1,3,Low-Value,Lost
77766,1404,4,"104,65",2,1,1,4,Low-Value,Can't Lose
77768,290,1,"9,2",5,1,1,7,Mid-Value,Potential Loyalists
77769,14,6,"280,25",5,1,1,7,Mid-Value,Potential Loyalists
77770,139,1,"146,10000000000002",5,1,1,7,Mid-Value,Potential Loyalists
77772,1534,1,"3,6",1,1,1,3,Low-Value,Lost
77773,31,5,"289,5",5,1,1,7,Mid-Value,Potential Loyalists
77774,28,3,"209,95",5,1,1,7,Mid-Value,Potential Loyalists
77775,709,2,"83,4",4,1,1,6,Mid-Value,Potential Loyalists
77777,88,4,"215,35",5,1,1,7,Mid-Value,Potential Loyalists
77779,97,5,"216,9",5,1,1,7,Mid-Value,Potential Loyalists
77780,809,2,"172,75",3,1,1,5,Low-Value,At Risk Customers
77782,516,3,"49,650000000000006",4,1,1,6,Mid-Value,Potential Loyalists
77784,151,2,"128,0",5,1,1,7,Mid-Value,Potential Loyalists
77785,395,1,"161,0",4,1,1,6,Mid-Value,Potential Loyalists
77786,774,2,"17,35",3,1,1,5,Low-Value,At Risk Customers
77787,245,4,"303,6",5,1,1,7,Mid-Value,Potential Loyalists
77789,164,1,"512,9",5,1,1,7,Mid-Value,Potential Loyalists
77790,973,3,"118,75",3,1,1,5,Low-Value,At Risk Customers
77791,100,7,"516,85",5,2,1,8,High-Value,Potential Loyalists
77793,651,1,"8,0",4,1,1,6,Mid-Value,Potential Loyalists
77796,573,7,"441,0",4,2,1,7,Mid-Value,Potential Loyalists
77797,23,8,"641,0",5,2,1,8,High-Value,Potential Loyalists
77800,60,3,"201,89999999999998",5,1,1,7,Mid-Value,Potential Loyalists
77801,1639,1,"47,45",1,1,1,3,Low-Value,Lost
77802,1123,2,"120,69999999999999",2,1,1,4,Low-Value,Can't Lose
77806,845,1,"7,25",3,1,1,5,Low-Value,At Risk Customers
77812,362,2,"16,15",5,1,1,7,Mid-Value,Potential Loyalists
77813,2,2,"99,1",5,1,1,7,Mid-Value,Potential Loyalists
77814,92,3,"69,0",5,1,1,7,Mid-Value,Potential Loyalists
77815,170,2,"193,3",5,1,1,7,Mid-Value,Potential Loyalists
77817,1216,2,"51,8",2,1,1,4,Low-Value,Can't Lose
77818,719,3,"84,45",4,1,1,6,Mid-Value,Potential Loyalists
77819,152,3,"77,55",5,1,1,7,Mid-Value,Potential Loyalists
77821,840,4,"62,800000000000004",3,1,1,5,Low-Value,At Risk Customers
77826,352,3,"208,3",5,1,1,7,Mid-Value,Potential Loyalists
77827,242,3,"129,8",5,1,1,7,Mid-Value,Potential Loyalists
77828,23,4,"96,7",5,1,1,7,Mid-Value,Potential Loyalists
77831,1120,1,"132,2",2,1,1,4,Low-Value,Can't Lose
77832,272,6,"222,5",5,1,1,7,Mid-Value,Potential Loyalists
77833,185,2,"46,3",5,1,1,7,Mid-Value,Potential Loyalists
77834,783,2,"126,35",3,1,1,5,Low-Value,At Risk Customers
77835,148,4,"428,54999999999995",5,1,1,7,Mid-Value,Potential Loyalists
77836,1152,1,"39,1",2,1,1,4,Low-Value,Can't Lose
77837,219,1,"11,0",5,1,1,7,Mid-Value,Potential Loyalists
77839,530,5,"553,3499999999999",4,1,1,6,Mid-Value,Potential Loyalists
77841,107,9,"377,85",5,2,1,8,High-Value,Potential Loyalists
77846,567,2,"219,3",4,1,1,6,Mid-Value,Potential Loyalists
77849,522,2,"163,10000000000002",4,1,1,6,Mid-Value,Potential Loyalists
77850,530,4,"204,35",4,1,1,6,Mid-Value,Potential Loyalists
77852,154,5,"117,7",5,1,1,7,Mid-Value,Potential Loyalists
77853,658,4,"503,75",4,1,1,6,Mid-Value,Potential Loyalists
77854,963,2,"315,6",3,1,1,5,Low-Value,At Risk Customers
77855,537,5,"149,65",4,1,1,6,Mid-Value,Potential Loyalists
77856,1432,1,"11,0",2,1,1,4,Low-Value,Can't Lose
77861,196,1,"18,2",5,1,1,7,Mid-Value,Potential Loyalists
77863,381,10,"465,3",4,2,1,7,Mid-Value,Potential Loyalists
77864,25,8,"340,15",5,2,1,8,High-Value,Potential Loyalists
77866,372,1,"80,5",4,1,1,6,Mid-Value,Potential Loyalists
77869,421,3,"72,1",4,1,1,6,Mid-Value,Potential Loyalists
77870,77,6,"490,35",5,1,1,7,Mid-Value,Potential Loyalists
77871,224,2,"50,800000000000004",5,1,1,7,Mid-Value,Potential Loyalists
77872,32,6,"327,79999999999995",5,1,1,7,Mid-Value,Potential Loyalists
77873,139,2,"42,7",5,1,1,7,Mid-Value,Potential Loyalists
77875,129,4,"346,1",5,1,1,7,Mid-Value,Potential Loyalists
77877,253,5,"225,85",5,1,1,7,Mid-Value,Potential Loyalists
77878,305,2,"197,05",5,1,1,7,Mid-Value,Potential Loyalists
77879,202,2,"93,4",5,1,1,7,Mid-Value,Potential Loyalists
77880,784,2,"118,9",3,1,1,5,Low-Value,At Risk Customers
77882,827,1,"9,05",3,1,1,5,Low-Value,At Risk Customers
77883,1267,1,"63,1",2,1,1,4,Low-Value,Can't Lose
77884,1339,3,"231,5",2,1,1,4,Low-Value,Can't Lose
77886,1543,3,"54,25",1,1,1,3,Low-Value,Lost
77887,286,1,"23,1",5,1,1,7,Mid-Value,Potential Loyalists
77888,159,8,"764,4",5,2,2,9,High-Value,Champions
77891,1575,1,"15,6",1,1,1,3,Low-Value,Lost
77892,113,3,"231,4",5,1,1,7,Mid-Value,Potential Loyalists
77893,1131,2,"20,95",2,1,1,4,Low-Value,Can't Lose
77895,833,2,"129,55",3,1,1,5,Low-Value,At Risk Customers
77896,57,4,"228,85",5,1,1,7,Mid-Value,Potential Loyalists
77897,1123,4,"470,44999999999993",2,1,1,4,Low-Value,Can't Lose
77898,508,1,"14,6",4,1,1,6,Mid-Value,Potential Loyalists
77899,561,1,"24,900000000000002",4,1,1,6,Mid-Value,Potential Loyalists
77901,320,1,"16,15",5,1,1,7,Mid-Value,Potential Loyalists
77903,500,7,"317,8",4,2,1,7,Mid-Value,Potential Loyalists
77904,222,1,"147,7",5,1,1,7,Mid-Value,Potential Loyalists
77905,77,4,"224,29999999999998",5,1,1,7,Mid-Value,Potential Loyalists
77906,634,1,"94,05",4,1,1,6,Mid-Value,Potential Loyalists
77907,22,6,"452,90000000000003",5,1,1,7,Mid-Value,Potential Loyalists
77908,66,3,"107,44999999999999",5,1,1,7,Mid-Value,Potential Loyalists
77909,442,6,"236,60000000000002",4,1,1,6,Mid-Value,Potential Loyalists
77911,1441,1,"5,3",2,1,1,4,Low-Value,Can't Lose
77912,1173,1,"19,25",2,1,1,4,Low-Value,Can't Lose
77913,897,1,"48,0",3,1,1,5,Low-Value,At Risk Customers
77914,1497,3,"141,45",1,1,1,3,Low-Value,Lost
77920,483,3,"173,7",4,1,1,6,Mid-Value,Potential Loyalists
77921,382,3,"564,15",4,1,1,6,Mid-Value,Potential Loyalists
77922,679,7,"281,2",4,2,1,7,Mid-Value,Potential Loyalists
77926,167,3,"129,9",5,1,1,7,Mid-Value,Potential Loyalists
77928,1194,1,"61,5",2,1,1,4,Low-Value,Can't Lose
77930,38,2,"115,45",5,1,1,7,Mid-Value,Potential Loyalists
77931,582,2,"165,0",4,1,1,6,Mid-Value,Potential Loyalists
77932,101,1,"20,75",5,1,1,7,Mid-Value,Potential Loyalists
77933,201,5,"61,75",5,1,1,7,Mid-Value,Potential Loyalists
77941,337,2,"130,6",5,1,1,7,Mid-Value,Potential Loyalists
77942,156,1,"32,1",5,1,1,7,Mid-Value,Potential Loyalists
77943,1285,4,"295,9",2,1,1,4,Low-Value,Can't Lose
77945,605,5,"419,25",4,1,1,6,Mid-Value,Potential Loyalists
77948,32,4,"384,3",5,1,1,7,Mid-Value,Potential Loyalists
77949,877,1,"13,350000000000001",3,1,1,5,Low-Value,At Risk Customers
77950,288,6,"238,25",5,1,1,7,Mid-Value,Potential Loyalists
77952,382,3,"261,9",4,1,1,6,Mid-Value,Potential Loyalists
77953,127,11,"365,45",5,2,1,8,High-Value,Potential Loyalists
77954,465,5,"150,0",4,1,1,6,Mid-Value,Potential Loyalists
77956,94,1,"18,2",5,1,1,7,Mid-Value,Potential Loyalists
77959,666,3,"329,15000000000003",4,1,1,6,Mid-Value,Potential Loyalists
77960,73,3,"127,5",5,1,1,7,Mid-Value,Potential Loyalists
77961,768,4,"333,4",3,1,1,5,Low-Value,At Risk Customers
77962,1077,3,"100,69999999999999",3,1,1,5,Low-Value,At Risk Customers
77964,997,2,"82,5",3,1,1,5,Low-Value,At Risk Customers
77966,644,1,"135,0",4,1,1,6,Mid-Value,Potential Loyalists
77968,350,3,"215,25",5,1,1,7,Mid-Value,Potential Loyalists
77969,188,1,"57,6",5,1,1,7,Mid-Value,Potential Loyalists
77973,73,1,"47,0",5,1,1,7,Mid-Value,Potential Loyalists
77974,1218,1,"47,7",2,1,1,4,Low-Value,Can't Lose
77976,122,1,"129,9",5,1,1,7,Mid-Value,Potential Loyalists
77977,404,1,"25,1",4,1,1,6,Mid-Value,Potential Loyalists
77978,386,5,"475,35",4,1,1,6,Mid-Value,Potential Loyalists
77980,1504,2,"28,0",1,1,1,3,Low-Value,Lost
77981,176,1,"37,5",5,1,1,7,Mid-Value,Potential Loyalists
77983,315,3,"196,95",5,1,1,7,Mid-Value,Potential Loyalists
77984,172,1,"338,1",5,1,1,7,Mid-Value,Potential Loyalists
77987,853,4,"221,45",3,1,1,5,Low-Value,At Risk Customers
77988,1302,1,"58,55",2,1,1,4,Low-Value,Can't Lose
77989,106,1,"204,9",5,1,1,7,Mid-Value,Potential Loyalists
77990,514,2,"168,0",4,1,1,6,Mid-Value,Potential Loyalists
77991,981,2,"89,75",3,1,1,5,Low-Value,At Risk Customers
77994,798,5,"152,6",3,1,1,5,Low-Value,At Risk Customers
77995,149,4,"306,9",5,1,1,7,Mid-Value,Potential Loyalists
77998,943,2,"69,0",3,1,1,5,Low-Value,At Risk Customers
77999,415,2,"124,3",4,1,1,6,Mid-Value,Potential Loyalists
78000,1429,1,"73,85",2,1,1,4,Low-Value,Can't Lose
78001,104,5,"240,05",5,1,1,7,Mid-Value,Potential Loyalists
78002,1044,1,"18,2",3,1,1,5,Low-Value,At Risk Customers
78003,379,5,"270,15",4,1,1,6,Mid-Value,Potential Loyalists
78004,415,3,"193,04999999999998",4,1,1,6,Mid-Value,Potential Loyalists
78005,29,2,"70,25",5,1,1,7,Mid-Value,Potential Loyalists
78006,1239,1,"32,9",2,1,1,4,Low-Value,Can't Lose
78010,27,1,"15,8",5,1,1,7,Mid-Value,Potential Loyalists
78011,24,6,"473,2",5,1,1,7,Mid-Value,Potential Loyalists
78012,70,1,"28,85",5,1,1,7,Mid-Value,Potential Loyalists
78014,981,1,"14,35",3,1,1,5,Low-Value,At Risk Customers
78015,110,16,"975,65",5,3,2,10,High-Value,Champions
78016,1597,1,"43,7",1,1,1,3,Low-Value,Lost
78017,1388,1,"79,85",2,1,1,4,Low-Value,Can't Lose
78018,1323,1,"9,4",2,1,1,4,Low-Value,Can't Lose
78020,716,2,"74,2",4,1,1,6,Mid-Value,Potential Loyalists
78021,384,7,"765,4",4,2,2,8,High-Value,Potential Loyalists
78022,1112,4,"56,150000000000006",2,1,1,4,Low-Value,Can't Lose
78023,559,1,"35,9",4,1,1,6,Mid-Value,Potential Loyalists
78025,1005,1,"22,6",3,1,1,5,Low-Value,At Risk Customers
78026,208,1,"341,4",5,1,1,7,Mid-Value,Potential Loyalists
78028,291,3,"267,59999999999997",5,1,1,7,Mid-Value,Potential Loyalists
78029,10,7,"424,54999999999995",5,2,1,8,High-Value,Potential Loyalists
78033,1667,1,"123,2",1,1,1,3,Low-Value,Lost
78035,1425,3,"50,150000000000006",2,1,1,4,Low-Value,Can't Lose
78037,505,3,"177,6",4,1,1,6,Mid-Value,Potential Loyalists
78039,600,3,"132,8",4,1,1,6,Mid-Value,Potential Loyalists
78042,1484,1,"118,05",1,1,1,3,Low-Value,Lost
78043,62,4,"111,75",5,1,1,7,Mid-Value,Potential Loyalists
78044,162,6,"273,65000000000003",5,1,1,7,Mid-Value,Potential Loyalists
78046,357,1,"39,25",5,1,1,7,Mid-Value,Potential Loyalists
78047,201,4,"185,85",5,1,1,7,Mid-Value,Potential Loyalists
78049,704,4,"194,5",4,1,1,6,Mid-Value,Potential Loyalists
78050,329,1,"20,0",5,1,1,7,Mid-Value,Potential Loyalists
78051,39,1,"14,0",5,1,1,7,Mid-Value,Potential Loyalists
78052,117,1,"4,65",5,1,1,7,Mid-Value,Potential Loyalists
78054,369,2,"97,7",4,1,1,6,Mid-Value,Potential Loyalists
78055,1174,1,"24,5",2,1,1,4,Low-Value,Can't Lose
78056,237,4,"293,1",5,1,1,7,Mid-Value,Potential Loyalists
78059,122,3,"95,4",5,1,1,7,Mid-Value,Potential Loyalists
78061,1477,1,"22,1",1,1,1,3,Low-Value,Lost
78062,1160,2,"108,55",2,1,1,4,Low-Value,Can't Lose
78063,1051,5,"462,04999999999995",3,1,1,5,Low-Value,At Risk Customers
78065,175,1,"101,8",5,1,1,7,Mid-Value,Potential Loyalists
78067,171,6,"183,95",5,1,1,7,Mid-Value,Potential Loyalists
78068,608,6,"340,3",4,1,1,6,Mid-Value,Potential Loyalists
78071,17,8,"337,3",5,2,1,8,High-Value,Potential Loyalists
78072,1498,1,"25,15",1,1,1,3,Low-Value,Lost
78073,1088,1,"45,6",3,1,1,5,Low-Value,At Risk Customers
78074,3,4,"175,6",5,1,1,7,Mid-Value,Potential Loyalists
78075,390,4,"89,35000000000001",4,1,1,6,Mid-Value,Potential Loyalists
78077,7,7,"431,55",5,2,1,8,High-Value,Potential Loyalists
78079,482,4,"120,95",4,1,1,6,Mid-Value,Potential Loyalists
78080,1446,1,"42,2",2,1,1,4,Low-Value,Can't Lose
78081,396,2,"117,35",4,1,1,6,Mid-Value,Potential Loyalists
78085,656,3,"177,7",4,1,1,6,Mid-Value,Potential Loyalists
78086,291,1,"2,75",5,1,1,7,Mid-Value,Potential Loyalists
78087,296,1,"13,85",5,1,1,7,Mid-Value,Potential Loyalists
78089,389,4,"345,75",4,1,1,6,Mid-Value,Potential Loyalists
78090,478,3,"349,85",4,1,1,6,Mid-Value,Potential Loyalists
78091,202,2,"18,6",5,1,1,7,Mid-Value,Potential Loyalists
78092,831,2,"53,150000000000006",3,1,1,5,Low-Value,At Risk Customers
78094,577,6,"316,7",4,1,1,6,Mid-Value,Potential Loyalists
78096,1613,1,"23,4",1,1,1,3,Low-Value,Lost
78100,126,4,"257,7",5,1,1,7,Mid-Value,Potential Loyalists
78101,577,5,"193,75",4,1,1,6,Mid-Value,Potential Loyalists
78103,984,1,"30,5",3,1,1,5,Low-Value,At Risk Customers
78104,308,3,"48,7",5,1,1,7,Mid-Value,Potential Loyalists
78105,4,2,"887,45",5,1,2,8,High-Value,Potential Loyalists
78106,866,3,"62,150000000000006",3,1,1,5,Low-Value,At Risk Customers
78107,1212,2,"69,75",2,1,1,4,Low-Value,Can't Lose
78109,1353,1,"18,3",2,1,1,4,Low-Value,Can't Lose
78112,1562,1,"14,15",1,1,1,3,Low-Value,Lost
78115,952,3,"198,65",3,1,1,5,Low-Value,At Risk Customers
78116,363,2,"82,1",5,1,1,7,Mid-Value,Potential Loyalists
78117,4,7,"368,3",5,2,1,8,High-Value,Potential Loyalists
78118,36,4,"124,5",5,1,1,7,Mid-Value,Potential Loyalists
78119,1525,1,"11,45",1,1,1,3,Low-Value,Lost
78120,612,3,"627,3",4,1,1,6,Mid-Value,Potential Loyalists
78122,31,1,"59,9",5,1,1,7,Mid-Value,Potential Loyalists
78124,84,2,"112,25",5,1,1,7,Mid-Value,Potential Loyalists
78125,650,2,"114,25",4,1,1,6,Mid-Value,Potential Loyalists
78128,20,3,"126,3",5,1,1,7,Mid-Value,Potential Loyalists
78130,582,2,"50,349999999999994",4,1,1,6,Mid-Value,Potential Loyalists
78131,676,4,"124,2",4,1,1,6,Mid-Value,Potential Loyalists
78132,854,5,"573,75",3,1,1,5,Low-Value,At Risk Customers
78133,1176,1,"13,65",2,1,1,4,Low-Value,Can't Lose
78134,984,1,"80,45",3,1,1,5,Low-Value,At Risk Customers
78135,1655,1,"40,5",1,1,1,3,Low-Value,Lost
78138,815,1,"13,3",3,1,1,5,Low-Value,At Risk Customers
78139,1669,1,"78,4",1,1,1,3,Low-Value,Lost
78140,892,2,"185,15",3,1,1,5,Low-Value,At Risk Customers
78141,1006,2,"66,45",3,1,1,5,Low-Value,At Risk Customers
78142,290,9,"591,8",5,2,1,8,High-Value,Potential Loyalists
78143,160,4,"158,35000000000002",5,1,1,7,Mid-Value,Potential Loyalists
78144,80,1,"7,25",5,1,1,7,Mid-Value,Potential Loyalists
78146,700,2,"120,75",4,1,1,6,Mid-Value,Potential Loyalists
78147,543,9,"353,9",4,2,1,7,Mid-Value,Potential Loyalists
78148,27,6,"126,5",5,1,1,7,Mid-Value,Potential Loyalists
78152,833,3,"631,65",3,1,1,5,Low-Value,At Risk Customers
78153,14,6,"569,3499999999999",5,1,1,7,Mid-Value,Potential Loyalists
78156,1390,1,"27,5",2,1,1,4,Low-Value,Can't Lose
78157,1128,3,"113,14999999999999",2,1,1,4,Low-Value,Can't Lose
78159,174,3,"454,40000000000003",5,1,1,7,Mid-Value,Potential Loyalists
78160,367,3,"223,1",4,1,1,6,Mid-Value,Potential Loyalists
78161,1643,1,"204,6",1,1,1,3,Low-Value,Lost
78162,992,2,"60,45",3,1,1,5,Low-Value,At Risk Customers
78163,483,2,"158,25",4,1,1,6,Mid-Value,Potential Loyalists
78164,101,2,"109,35",5,1,1,7,Mid-Value,Potential Loyalists
78165,1350,5,"328,95",2,1,1,4,Low-Value,Can't Lose
78166,83,5,"201,95",5,1,1,7,Mid-Value,Potential Loyalists
78167,508,1,"221,9",4,1,1,6,Mid-Value,Potential Loyalists
78169,997,1,"43,4",3,1,1,5,Low-Value,At Risk Customers
78170,593,6,"283,0",4,1,1,6,Mid-Value,Potential Loyalists
78171,273,6,"747,1499999999999",5,1,2,8,High-Value,Potential Loyalists
78172,1414,2,"46,3",2,1,1,4,Low-Value,Can't Lose
78173,1665,2,"130,3",1,1,1,3,Low-Value,Lost
78174,26,3,"390,7",5,1,1,7,Mid-Value,Potential Loyalists
78177,77,3,"38,3",5,1,1,7,Mid-Value,Potential Loyalists
78178,53,5,"176,8",5,1,1,7,Mid-Value,Potential Loyalists
78179,446,1,"50,3",4,1,1,6,Mid-Value,Potential Loyalists
78180,1220,2,"180,79999999999998",2,1,1,4,Low-Value,Can't Lose
78183,91,1,"59,25",5,1,1,7,Mid-Value,Potential Loyalists
78184,406,6,"339,45000000000005",4,1,1,6,Mid-Value,Potential Loyalists
78185,175,3,"183,79999999999998",5,1,1,7,Mid-Value,Potential Loyalists
78187,170,5,"297,09999999999997",5,1,1,7,Mid-Value,Potential Loyalists
78188,27,7,"569,9",5,2,1,8,High-Value,Potential Loyalists
78189,266,2,"167,60000000000002",5,1,1,7,Mid-Value,Potential Loyalists
78190,377,3,"157,2",4,1,1,6,Mid-Value,Potential Loyalists
78193,359,2,"197,6",5,1,1,7,Mid-Value,Potential Loyalists
78194,1171,2,"14,1",2,1,1,4,Low-Value,Can't Lose
78195,533,3,"141,4",4,1,1,6,Mid-Value,Potential Loyalists
78198,11,12,"1148,5",5,3,2,10,High-Value,Champions
78200,44,3,"69,7",5,1,1,7,Mid-Value,Potential Loyalists
78202,497,2,"164,3",4,1,1,6,Mid-Value,Potential Loyalists
78204,83,3,"73,55",5,1,1,7,Mid-Value,Potential Loyalists
78206,171,4,"158,4",5,1,1,7,Mid-Value,Potential Loyalists
78208,762,7,"341,1",3,2,1,6,Mid-Value,Potential Loyalists
78211,923,2,"36,0",3,1,1,5,Low-Value,At Risk Customers
78213,599,3,"148,4",4,1,1,6,Mid-Value,Potential Loyalists
78214,834,1,"113,45",3,1,1,5,Low-Value,At Risk Customers
78216,277,3,"190,55",5,1,1,7,Mid-Value,Potential Loyalists
78217,281,3,"215,3",5,1,1,7,Mid-Value,Potential Loyalists
78219,584,1,"125,85",4,1,1,6,Mid-Value,Potential Loyalists
78220,988,1,"67,35",3,1,1,5,Low-Value,At Risk Customers
78222,1490,1,"59,699999999999996",1,1,1,3,Low-Value,Lost
78225,802,4,"118,80000000000001",3,1,1,5,Low-Value,At Risk Customers
78233,808,2,"38,4",3,1,1,5,Low-Value,At Risk Customers
78234,183,2,"190,35",5,1,1,7,Mid-Value,Potential Loyalists
78236,58,4,"136,0",5,1,1,7,Mid-Value,Potential Loyalists
78237,844,3,"167,8",3,1,1,5,Low-Value,At Risk Customers
78238,597,1,"248,1",4,1,1,6,Mid-Value,Potential Loyalists
78241,671,1,"14,4",4,1,1,6,Mid-Value,Potential Loyalists
78244,193,1,"39,5",5,1,1,7,Mid-Value,Potential Loyalists
78247,587,1,"17,4",4,1,1,6,Mid-Value,Potential Loyalists
78248,474,3,"203,75",4,1,1,6,Mid-Value,Potential Loyalists
78250,791,3,"397,84999999999997",3,1,1,5,Low-Value,At Risk Customers
78251,785,3,"154,8",3,1,1,5,Low-Value,At Risk Customers
78252,607,1,"99,44999999999999",4,1,1,6,Mid-Value,Potential Loyalists
78253,543,3,"126,4",4,1,1,6,Mid-Value,Potential Loyalists
78254,433,4,"384,7",4,1,1,6,Mid-Value,Potential Loyalists
78256,1309,1,"57,4",2,1,1,4,Low-Value,Can't Lose
78259,378,2,"38,95",4,1,1,6,Mid-Value,Potential Loyalists
78260,257,1,"51,85",5,1,1,7,Mid-Value,Potential Loyalists
78261,7,3,"198,15",5,1,1,7,Mid-Value,Potential Loyalists
78262,22,2,"394,2",5,1,1,7,Mid-Value,Potential Loyalists
78263,509,7,"727,1999999999999",4,2,2,8,High-Value,Potential Loyalists
78264,66,6,"494,19999999999993",5,1,1,7,Mid-Value,Potential Loyalists
78265,455,2,"226,85000000000002",4,1,1,6,Mid-Value,Potential Loyalists
78267,213,5,"499,55",5,1,1,7,Mid-Value,Potential Loyalists
78268,509,4,"222,2",4,1,1,6,Mid-Value,Potential Loyalists
78269,29,4,"487,0",5,1,1,7,Mid-Value,Potential Loyalists
78271,822,5,"294,75",3,1,1,5,Low-Value,At Risk Customers
78273,98,3,"115,05",5,1,1,7,Mid-Value,Potential Loyalists
78274,194,3,"56,8",5,1,1,7,Mid-Value,Potential Loyalists
78275,77,1,"60,599999999999994",5,1,1,7,Mid-Value,Potential Loyalists
78276,26,14,"748,1999999999999",5,3,2,10,High-Value,Champions
78279,441,3,"31,55",4,1,1,6,Mid-Value,Potential Loyalists
78280,116,4,"244,2",5,1,1,7,Mid-Value,Potential Loyalists
78282,1187,3,"43,349999999999994",2,1,1,4,Low-Value,Can't Lose
78285,627,4,"70,35",4,1,1,6,Mid-Value,Potential Loyalists
78288,289,2,"115,4",5,1,1,7,Mid-Value,Potential Loyalists
78289,368,3,"63,3",4,1,1,6,Mid-Value,Potential Loyalists
78290,136,1,"30,2",5,1,1,7,Mid-Value,Potential Loyalists
78291,15,4,"243,45",5,1,1,7,Mid-Value,Potential Loyalists
78295,366,4,"304,1",4,1,1,6,Mid-Value,Potential Loyalists
78297,947,3,"132,5",3,1,1,5,Low-Value,At Risk Customers
78298,157,3,"257,15",5,1,1,7,Mid-Value,Potential Loyalists
78299,710,1,"479,2",4,1,1,6,Mid-Value,Potential Loyalists
78301,7,10,"421,25",5,2,1,8,High-Value,Potential Loyalists
78302,322,3,"50,449999999999996",5,1,1,7,Mid-Value,Potential Loyalists
78304,546,1,"99,44999999999999",4,1,1,6,Mid-Value,Potential Loyalists
78305,1099,3,"234,85",2,1,1,4,Low-Value,Can't Lose
78306,66,3,"173,65",5,1,1,7,Mid-Value,Potential Loyalists
78308,559,1,"24,1",4,1,1,6,Mid-Value,Potential Loyalists
78309,609,1,"31,8",4,1,1,6,Mid-Value,Potential Loyalists
78312,115,8,"373,3",5,2,1,8,High-Value,Potential Loyalists
78313,287,1,"28,9",5,1,1,7,Mid-Value,Potential Loyalists
78314,45,9,"380,5",5,2,1,8,High-Value,Potential Loyalists
78315,1503,4,"234,9",1,1,1,3,Low-Value,Lost
78318,396,5,"479,75",4,1,1,6,Mid-Value,Potential Loyalists
78320,119,3,"248,95000000000002",5,1,1,7,Mid-Value,Potential Loyalists
78321,130,7,"406,65000000000003",5,2,1,8,High-Value,Potential Loyalists
78323,292,2,"269,04999999999995",5,1,1,7,Mid-Value,Potential Loyalists
78324,1523,5,"386,09999999999997",1,1,1,3,Low-Value,Lost
78325,509,4,"454,05",4,1,1,6,Mid-Value,Potential Loyalists
78326,335,3,"139,15",5,1,1,7,Mid-Value,Potential Loyalists
78327,467,4,"151,45",4,1,1,6,Mid-Value,Potential Loyalists
78329,255,4,"79,0",5,1,1,7,Mid-Value,Potential Loyalists
78330,475,3,"134,15",4,1,1,6,Mid-Value,Potential Loyalists
78332,555,1,"38,8",4,1,1,6,Mid-Value,Potential Loyalists
78333,312,5,"124,9",5,1,1,7,Mid-Value,Potential Loyalists
78334,81,4,"322,9",5,1,1,7,Mid-Value,Potential Loyalists
78335,452,6,"209,45",4,1,1,6,Mid-Value,Potential Loyalists
78336,406,3,"39,5",4,1,1,6,Mid-Value,Potential Loyalists
78338,122,2,"81,8",5,1,1,7,Mid-Value,Potential Loyalists
78339,34,4,"147,15",5,1,1,7,Mid-Value,Potential Loyalists
78340,1262,2,"403,4",2,1,1,4,Low-Value,Can't Lose
78341,438,4,"141,95",4,1,1,6,Mid-Value,Potential Loyalists
78343,103,5,"182,25",5,1,1,7,Mid-Value,Potential Loyalists
78344,599,1,"17,1",4,1,1,6,Mid-Value,Potential Loyalists
78345,131,4,"564,55",5,1,1,7,Mid-Value,Potential Loyalists
78348,333,5,"212,4",5,1,1,7,Mid-Value,Potential Loyalists
78350,1039,1,"283,8",3,1,1,5,Low-Value,At Risk Customers
78351,1670,1,"132,45",1,1,1,3,Low-Value,Lost
78352,62,3,"88,39999999999999",5,1,1,7,Mid-Value,Potential Loyalists
78353,305,4,"566,95",5,1,1,7,Mid-Value,Potential Loyalists
78356,614,8,"561,35",4,2,1,7,Mid-Value,Potential Loyalists
78357,803,5,"168,05",3,1,1,5,Low-Value,At Risk Customers
78358,283,2,"71,9",5,1,1,7,Mid-Value,Potential Loyalists
78359,264,6,"864,65",5,1,2,8,High-Value,Potential Loyalists
78360,12,4,"229,89999999999998",5,1,1,7,Mid-Value,Potential Loyalists
78361,381,2,"22,0",4,1,1,6,Mid-Value,Potential Loyalists
78363,62,4,"175,1",5,1,1,7,Mid-Value,Potential Loyalists
78365,75,8,"248,04999999999998",5,2,1,8,High-Value,Potential Loyalists
78367,153,4,"327,3",5,1,1,7,Mid-Value,Potential Loyalists
78368,1609,2,"45,1",1,1,1,3,Low-Value,Lost
78371,89,4,"236,79999999999998",5,1,1,7,Mid-Value,Potential Loyalists
78374,1709,1,"7,5",1,1,1,3,Low-Value,Lost
78375,561,2,"144,6",4,1,1,6,Mid-Value,Potential Loyalists
78378,855,4,"332,1",3,1,1,5,Low-Value,At Risk Customers
78379,1047,2,"114,8",3,1,1,5,Low-Value,At Risk Customers
78380,42,4,"366,79999999999995",5,1,1,7,Mid-Value,Potential Loyalists
78381,272,3,"306,5",5,1,1,7,Mid-Value,Potential Loyalists
78382,178,4,"738,35",5,1,2,8,High-Value,Potential Loyalists
78384,1079,2,"55,9",3,1,1,5,Low-Value,At Risk Customers
78385,871,4,"179,8",3,1,1,5,Low-Value,At Risk Customers
78387,677,2,"190,45",4,1,1,6,Mid-Value,Potential Loyalists
78388,7,2,"222,89999999999998",5,1,1,7,Mid-Value,Potential Loyalists
78390,74,6,"521,15",5,1,1,7,Mid-Value,Potential Loyalists
78391,4,6,"545,2",5,1,1,7,Mid-Value,Potential Loyalists
78393,1353,2,"289,35",2,1,1,4,Low-Value,Can't Lose
78394,132,1,"20,5",5,1,1,7,Mid-Value,Potential Loyalists
78396,482,10,"448,95000000000005",4,2,1,7,Mid-Value,Potential Loyalists
78397,557,1,"10,0",4,1,1,6,Mid-Value,Potential Loyalists
78399,62,4,"151,4",5,1,1,7,Mid-Value,Potential Loyalists
78401,339,2,"33,05",5,1,1,7,Mid-Value,Potential Loyalists
78402,441,3,"66,85",4,1,1,6,Mid-Value,Potential Loyalists
78403,875,2,"42,5",3,1,1,5,Low-Value,At Risk Customers
78404,148,2,"92,4",5,1,1,7,Mid-Value,Potential Loyalists
78405,24,7,"772,9000000000001",5,2,2,9,High-Value,Champions
78409,162,5,"354,9",5,1,1,7,Mid-Value,Potential Loyalists
78411,182,6,"360,4",5,1,1,7,Mid-Value,Potential Loyalists
78412,60,8,"328,6",5,2,1,8,High-Value,Potential Loyalists
78415,405,6,"300,7",4,1,1,6,Mid-Value,Potential Loyalists
78419,1049,1,"28,7",3,1,1,5,Low-Value,At Risk Customers
78420,97,5,"577,75",5,1,1,7,Mid-Value,Potential Loyalists
78429,897,2,"141,20000000000002",3,1,1,5,Low-Value,At Risk Customers
78432,565,2,"78,30000000000001",4,1,1,6,Mid-Value,Potential Loyalists
78433,970,3,"91,30000000000001",3,1,1,5,Low-Value,At Risk Customers
78434,3,3,"85,15",5,1,1,7,Mid-Value,Potential Loyalists
78435,354,2,"199,3",5,1,1,7,Mid-Value,Potential Loyalists
78436,820,4,"110,4",3,1,1,5,Low-Value,At Risk Customers
78438,1365,1,"154,8",2,1,1,4,Low-Value,Can't Lose
78440,462,7,"234,95000000000002",4,2,1,7,Mid-Value,Potential Loyalists
78441,136,2,"48,3",5,1,1,7,Mid-Value,Potential Loyalists
78442,1631,1,"20,0",1,1,1,3,Low-Value,Lost
78444,41,4,"218,3",5,1,1,7,Mid-Value,Potential Loyalists
78445,103,8,"155,15",5,2,1,8,High-Value,Potential Loyalists
78446,510,7,"347,6",4,2,1,7,Mid-Value,Potential Loyalists
78447,970,1,"161,8",3,1,1,5,Low-Value,At Risk Customers
78448,105,1,"19,75",5,1,1,7,Mid-Value,Potential Loyalists
78449,393,12,"442,45",4,3,1,8,High-Value,Potential Loyalists
78450,314,4,"124,36",5,1,1,7,Mid-Value,Potential Loyalists
78451,1248,3,"344,6",2,1,1,4,Low-Value,Can't Lose
78453,130,1,"221,9",5,1,1,7,Mid-Value,Potential Loyalists
78455,438,5,"300,05",4,1,1,6,Mid-Value,Potential Loyalists
78457,1430,1,"18,65",2,1,1,4,Low-Value,Can't Lose
78459,568,4,"231,85",4,1,1,6,Mid-Value,Potential Loyalists
78460,1477,4,"212,8",1,1,1,3,Low-Value,Lost
78464,1171,1,"23,25",2,1,1,4,Low-Value,Can't Lose
78465,1116,4,"112,05",2,1,1,4,Low-Value,Can't Lose
78466,1493,2,"54,400000000000006",1,1,1,3,Low-Value,Lost
78467,120,3,"99,25",5,1,1,7,Mid-Value,Potential Loyalists
78468,638,8,"477,25",4,2,1,7,Mid-Value,Potential Loyalists
78469,57,3,"109,0",5,1,1,7,Mid-Value,Potential Loyalists
78470,748,2,"96,7",3,1,1,5,Low-Value,At Risk Customers
78474,717,3,"392,6",4,1,1,6,Mid-Value,Potential Loyalists
78475,268,5,"233,54999999999998",5,1,1,7,Mid-Value,Potential Loyalists
78476,830,1,"27,15",3,1,1,5,Low-Value,At Risk Customers
78477,897,6,"192,55",3,1,1,5,Low-Value,At Risk Customers
78480,581,4,"382,7",4,1,1,6,Mid-Value,Potential Loyalists
78482,29,9,"184,8",5,2,1,8,High-Value,Potential Loyalists
78484,1299,1,"36,3",2,1,1,4,Low-Value,Can't Lose
78485,321,2,"170,25",5,1,1,7,Mid-Value,Potential Loyalists
78488,496,4,"498,95",4,1,1,6,Mid-Value,Potential Loyalists
78489,26,7,"319,25",5,2,1,8,High-Value,Potential Loyalists
78491,380,4,"113,9",4,1,1,6,Mid-Value,Potential Loyalists
78492,69,5,"186,60000000000002",5,1,1,7,Mid-Value,Potential Loyalists
78494,373,2,"109,19999999999999",4,1,1,6,Mid-Value,Potential Loyalists
78495,420,4,"222,7",4,1,1,6,Mid-Value,Potential Loyalists
78497,144,6,"342,79999999999995",5,1,1,7,Mid-Value,Potential Loyalists
78498,1400,1,"87,15",2,1,1,4,Low-Value,Can't Lose
78499,139,7,"787,95",5,2,2,9,High-Value,Champions
78500,39,4,"303,85",5,1,1,7,Mid-Value,Potential Loyalists
78501,162,2,"280,0",5,1,1,7,Mid-Value,Potential Loyalists
78502,471,8,"348,05",4,2,1,7,Mid-Value,Potential Loyalists
78503,495,4,"445,29999999999995",4,1,1,6,Mid-Value,Potential Loyalists
78505,438,2,"85,15",4,1,1,6,Mid-Value,Potential Loyalists
78507,5,4,"250,39999999999998",5,1,1,7,Mid-Value,Potential Loyalists
78511,1305,1,"9,15",2,1,1,4,Low-Value,Can't Lose
78512,974,1,"96,14999999999999",3,1,1,5,Low-Value,At Risk Customers
78513,386,4,"258,45",4,1,1,6,Mid-Value,Potential Loyalists
78514,423,2,"49,3",4,1,1,6,Mid-Value,Potential Loyalists
78515,1190,1,"34,5",2,1,1,4,Low-Value,Can't Lose
78516,870,2,"83,85000000000001",3,1,1,5,Low-Value,At Risk Customers
78517,471,2,"163,55",4,1,1,6,Mid-Value,Potential Loyalists
78518,748,2,"246,10000000000002",3,1,1,5,Low-Value,At Risk Customers
78519,52,6,"251,1",5,1,1,7,Mid-Value,Potential Loyalists
78523,429,5,"231,65",4,1,1,6,Mid-Value,Potential Loyalists
78524,105,10,"774,65",5,2,2,9,High-Value,Champions
78525,498,5,"365,15",4,1,1,6,Mid-Value,Potential Loyalists
78528,1009,1,"18,9",3,1,1,5,Low-Value,At Risk Customers
78529,904,1,"38,9",3,1,1,5,Low-Value,At Risk Customers
78530,778,1,"13,5",3,1,1,5,Low-Value,At Risk Customers
78533,82,3,"48,2",5,1,1,7,Mid-Value,Potential Loyalists
78537,0,7,"271,54999999999995",5,2,1,8,High-Value,Potential Loyalists
78539,876,4,"150,79999999999998",3,1,1,5,Low-Value,At Risk Customers
78543,675,2,"87,1",4,1,1,6,Mid-Value,Potential Loyalists
78545,312,6,"396,0",5,1,1,7,Mid-Value,Potential Loyalists
78546,32,4,"133,2",5,1,1,7,Mid-Value,Potential Loyalists
78547,1687,1,"28,349999999999998",1,1,1,3,Low-Value,Lost
78554,54,4,"95,95",5,1,1,7,Mid-Value,Potential Loyalists
78555,388,4,"457,40000000000003",4,1,1,6,Mid-Value,Potential Loyalists
78556,142,3,"239,55",5,1,1,7,Mid-Value,Potential Loyalists
78557,736,4,"256,9",3,1,1,5,Low-Value,At Risk Customers
78559,543,4,"180,29999999999998",4,1,1,6,Mid-Value,Potential Loyalists
78562,18,1,"165,7",5,1,1,7,Mid-Value,Potential Loyalists
78563,773,1,"14,65",3,1,1,5,Low-Value,At Risk Customers
78564,889,1,"87,8",3,1,1,5,Low-Value,At Risk Customers
78565,454,3,"74,94999999999999",4,1,1,6,Mid-Value,Potential Loyalists
78568,486,1,"49,75",4,1,1,6,Mid-Value,Potential Loyalists
78569,1440,2,"802,35",2,1,2,5,Low-Value,At Risk Customers
78572,632,7,"306,3",4,2,1,7,Mid-Value,Potential Loyalists
78576,1767,1,"46,1",1,1,1,3,Low-Value,Lost
78578,190,2,"38,55",5,1,1,7,Mid-Value,Potential Loyalists
78579,120,5,"667,3",5,1,2,8,High-Value,Potential Loyalists
78581,594,4,"431,7",4,1,1,6,Mid-Value,Potential Loyalists
78590,1524,3,"333,95",1,1,1,3,Low-Value,Lost
78591,257,2,"125,55000000000001",5,1,1,7,Mid-Value,Potential Loyalists
78593,1656,1,"13,35",1,1,1,3,Low-Value,Lost
78596,289,1,"20,1",5,1,1,7,Mid-Value,Potential Loyalists
78597,20,9,"483,8",5,2,1,8,High-Value,Potential Loyalists
78599,12,3,"415,15000000000003",5,1,1,7,Mid-Value,Potential Loyalists
78601,1133,2,"186,3",2,1,1,4,Low-Value,Can't Lose
78605,853,2,"108,6",3,1,1,5,Low-Value,At Risk Customers
78607,1056,1,"11,55",3,1,1,5,Low-Value,At Risk Customers
78608,221,7,"336,55",5,2,1,8,High-Value,Potential Loyalists
78609,1690,1,"98,85000000000001",1,1,1,3,Low-Value,Lost
78610,389,7,"466,7",4,2,1,7,Mid-Value,Potential Loyalists
78611,874,2,"168,05",3,1,1,5,Low-Value,At Risk Customers
78612,150,3,"39,65",5,1,1,7,Mid-Value,Potential Loyalists
78613,299,2,"67,65",5,1,1,7,Mid-Value,Potential Loyalists
78614,421,11,"357,05",4,2,1,7,Mid-Value,Potential Loyalists
78615,478,3,"153,4",4,1,1,6,Mid-Value,Potential Loyalists
78616,954,1,"48,7",3,1,1,5,Low-Value,At Risk Customers
78618,377,6,"416,84999999999997",4,1,1,6,Mid-Value,Potential Loyalists
78619,111,5,"103,7",5,1,1,7,Mid-Value,Potential Loyalists
78626,16,1,"63,2",5,1,1,7,Mid-Value,Potential Loyalists
78628,67,5,"724,3499999999999",5,1,2,8,High-Value,Potential Loyalists
78630,56,3,"99,0",5,1,1,7,Mid-Value,Potential Loyalists
78633,68,8,"607,5",5,2,1,8,High-Value,Potential Loyalists
78634,1149,1,"16,5",2,1,1,4,Low-Value,Can't Lose
78636,797,5,"119,7",3,1,1,5,Low-Value,At Risk Customers
78637,120,6,"398,9",5,1,1,7,Mid-Value,Potential Loyalists
78639,43,6,"130,55",5,1,1,7,Mid-Value,Potential Loyalists
78640,493,3,"89,55",4,1,1,6,Mid-Value,Potential Loyalists
78641,846,2,"157,20000000000002",3,1,1,5,Low-Value,At Risk Customers
78642,11,3,"222,05",5,1,1,7,Mid-Value,Potential Loyalists
78644,208,5,"357,1",5,1,1,7,Mid-Value,Potential Loyalists
78646,400,3,"91,2",4,1,1,6,Mid-Value,Potential Loyalists
78647,1300,1,"101,0",2,1,1,4,Low-Value,Can't Lose
78651,958,3,"76,9",3,1,1,5,Low-Value,At Risk Customers
78652,39,5,"149,65",5,1,1,7,Mid-Value,Potential Loyalists
78654,1175,1,"20,75",2,1,1,4,Low-Value,Can't Lose
78655,417,4,"105,75",4,1,1,6,Mid-Value,Potential Loyalists
78656,676,4,"240,0",4,1,1,6,Mid-Value,Potential Loyalists
78657,947,2,"337,6",3,1,1,5,Low-Value,At Risk Customers
78658,809,3,"276,9",3,1,1,5,Low-Value,At Risk Customers
78661,752,3,"308,75",3,1,1,5,Low-Value,At Risk Customers
78662,35,2,"44,55",5,1,1,7,Mid-Value,Potential Loyalists
78665,283,5,"184,25",5,1,1,7,Mid-Value,Potential Loyalists
78667,563,2,"210,8",4,1,1,6,Mid-Value,Potential Loyalists
78668,126,4,"516,9000000000001",5,1,1,7,Mid-Value,Potential Loyalists
78669,393,1,"9,8",4,1,1,6,Mid-Value,Potential Loyalists
78671,809,3,"142,8",3,1,1,5,Low-Value,At Risk Customers
78674,766,1,"22,75",3,1,1,5,Low-Value,At Risk Customers
78675,54,4,"349,8",5,1,1,7,Mid-Value,Potential Loyalists
78677,60,4,"287,70000000000005",5,1,1,7,Mid-Value,Potential Loyalists
78679,390,4,"81,5",4,1,1,6,Mid-Value,Potential Loyalists
78681,987,1,"55,75",3,1,1,5,Low-Value,At Risk Customers
78684,176,3,"145,65",5,1,1,7,Mid-Value,Potential Loyalists
78686,208,2,"50,6",5,1,1,7,Mid-Value,Potential Loyalists
78688,66,9,"668,0",5,2,2,9,High-Value,Champions
78691,514,3,"196,35000000000002",4,1,1,6,Mid-Value,Potential Loyalists
78692,1355,1,"73,7",2,1,1,4,Low-Value,Can't Lose
78693,173,3,"64,75",5,1,1,7,Mid-Value,Potential Loyalists
78694,770,4,"218,55",3,1,1,5,Low-Value,At Risk Customers
78695,1771,2,"137,75",1,1,1,3,Low-Value,Lost
78696,185,3,"229,04999999999998",5,1,1,7,Mid-Value,Potential Loyalists
78697,5,3,"194,39999999999998",5,1,1,7,Mid-Value,Potential Loyalists
78700,1263,1,"77,8",2,1,1,4,Low-Value,Can't Lose
78701,770,2,"40,699999999999996",3,1,1,5,Low-Value,At Risk Customers
78703,158,3,"61,3",5,1,1,7,Mid-Value,Potential Loyalists
78705,192,5,"246,64999999999998",5,1,1,7,Mid-Value,Potential Loyalists
78706,380,4,"242,5",4,1,1,6,Mid-Value,Potential Loyalists
78709,423,2,"134,7",4,1,1,6,Mid-Value,Potential Loyalists
78710,307,5,"293,15",5,1,1,7,Mid-Value,Potential Loyalists
78711,288,2,"60,25",5,1,1,7,Mid-Value,Potential Loyalists
78713,202,4,"207,7",5,1,1,7,Mid-Value,Potential Loyalists
78714,7,3,"100,35",5,1,1,7,Mid-Value,Potential Loyalists
78715,4,6,"464,6",5,1,1,7,Mid-Value,Potential Loyalists
78716,726,6,"485,65",4,1,1,6,Mid-Value,Potential Loyalists
78723,4,4,"749,5",5,1,2,8,High-Value,Potential Loyalists
78726,620,2,"297,6",4,1,1,6,Mid-Value,Potential Loyalists
78731,211,3,"188,14999999999998",5,1,1,7,Mid-Value,Potential Loyalists
78732,1454,1,"194,2",2,1,1,4,Low-Value,Can't Lose
78733,173,6,"255,95",5,1,1,7,Mid-Value,Potential Loyalists
78734,141,2,"21,700000000000003",5,1,1,7,Mid-Value,Potential Loyalists
78735,74,5,"328,35",5,1,1,7,Mid-Value,Potential Loyalists
78736,76,6,"320,55",5,1,1,7,Mid-Value,Potential Loyalists
78737,505,3,"286,4",4,1,1,6,Mid-Value,Potential Loyalists
78738,143,6,"181,95",5,1,1,7,Mid-Value,Potential Loyalists
78741,1625,1,"398,0",1,1,1,3,Low-Value,Lost
78743,162,8,"745,05",5,2,2,9,High-Value,Champions
78744,20,1,"227,2",5,1,1,7,Mid-Value,Potential Loyalists
78745,102,8,"349,2",5,2,1,8,High-Value,Potential Loyalists
78748,192,6,"118,1",5,1,1,7,Mid-Value,Potential Loyalists
78750,58,8,"366,05",5,2,1,8,High-Value,Potential Loyalists
78751,865,1,"38,1",3,1,1,5,Low-Value,At Risk Customers
78752,122,4,"77,15",5,1,1,7,Mid-Value,Potential Loyalists
78754,1112,2,"41,800000000000004",2,1,1,4,Low-Value,Can't Lose
78755,294,4,"623,5",5,1,1,7,Mid-Value,Potential Loyalists
78757,1429,1,"54,95",2,1,1,4,Low-Value,Can't Lose
78758,1257,4,"374,1",2,1,1,4,Low-Value,Can't Lose
78759,753,2,"98,1",3,1,1,5,Low-Value,At Risk Customers
78761,1410,1,"35,2",2,1,1,4,Low-Value,Can't Lose
78762,165,1,"16,8",5,1,1,7,Mid-Value,Potential Loyalists
78765,365,11,"708,2",5,2,2,9,High-Value,Champions
78767,1293,1,"37,2",2,1,1,4,Low-Value,Can't Lose
78768,1675,1,"85,4",1,1,1,3,Low-Value,Lost
78769,565,1,"936,3",4,1,2,7,Mid-Value,Potential Loyalists
78770,817,1,"12,3",3,1,1,5,Low-Value,At Risk Customers
78772,26,5,"316,3",5,1,1,7,Mid-Value,Potential Loyalists
78774,812,3,"42,0",3,1,1,5,Low-Value,At Risk Customers
78776,261,2,"126,2",5,1,1,7,Mid-Value,Potential Loyalists
78777,1129,4,"161,5",2,1,1,4,Low-Value,Can't Lose
78779,383,1,"39,4",4,1,1,6,Mid-Value,Potential Loyalists
78780,1407,1,"29,15",2,1,1,4,Low-Value,Can't Lose
78781,7,2,"73,1",5,1,1,7,Mid-Value,Potential Loyalists
78782,358,1,"58,6",5,1,1,7,Mid-Value,Potential Loyalists
78786,493,1,"221,9",4,1,1,6,Mid-Value,Potential Loyalists
78789,1248,2,"530,85",2,1,1,4,Low-Value,Can't Lose
78792,1253,1,"81,3",2,1,1,4,Low-Value,Can't Lose
78794,1172,1,"73,85",2,1,1,4,Low-Value,Can't Lose
78796,932,3,"63,650000000000006",3,1,1,5,Low-Value,At Risk Customers
78798,530,2,"141,3",4,1,1,6,Mid-Value,Potential Loyalists
78799,58,3,"184,3",5,1,1,7,Mid-Value,Potential Loyalists
78800,513,4,"333,65",4,1,1,6,Mid-Value,Potential Loyalists
78801,166,5,"264,4",5,1,1,7,Mid-Value,Potential Loyalists
78802,518,1,"11,5",4,1,1,6,Mid-Value,Potential Loyalists
78803,168,2,"153,9",5,1,1,7,Mid-Value,Potential Loyalists
78804,372,8,"283,65",4,2,1,7,Mid-Value,Potential Loyalists
78805,492,1,"78,5",4,1,1,6,Mid-Value,Potential Loyalists
78806,185,4,"151,35",5,1,1,7,Mid-Value,Potential Loyalists
78807,3,7,"447,95",5,2,1,8,High-Value,Potential Loyalists
78813,39,7,"496,4",5,2,1,8,High-Value,Potential Loyalists
78815,1205,1,"158,0",2,1,1,4,Low-Value,Can't Lose
78816,1363,1,"2,95",2,1,1,4,Low-Value,Can't Lose
78817,59,2,"38,199999999999996",5,1,1,7,Mid-Value,Potential Loyalists
78821,288,5,"172,8",5,1,1,7,Mid-Value,Potential Loyalists
78822,25,4,"244,05",5,1,1,7,Mid-Value,Potential Loyalists
78823,424,3,"319,75",4,1,1,6,Mid-Value,Potential Loyalists
78825,439,6,"415,5",4,1,1,6,Mid-Value,Potential Loyalists
78826,285,5,"441,75",5,1,1,7,Mid-Value,Potential Loyalists
78829,647,2,"53,7",4,1,1,6,Mid-Value,Potential Loyalists
78831,881,1,"98,0",3,1,1,5,Low-Value,At Risk Customers
78832,1286,3,"116,65",2,1,1,4,Low-Value,Can't Lose
78833,473,4,"558,6",4,1,1,6,Mid-Value,Potential Loyalists
78834,98,4,"224,74999999999997",5,1,1,7,Mid-Value,Potential Loyalists
78835,1326,3,"131,65",2,1,1,4,Low-Value,Can't Lose
78837,21,1,"195,7",5,1,1,7,Mid-Value,Potential Loyalists
78838,1173,1,"18,65",2,1,1,4,Low-Value,Can't Lose
78839,1269,2,"184,8",2,1,1,4,Low-Value,Can't Lose
78841,116,5,"415,35",5,1,1,7,Mid-Value,Potential Loyalists
78842,395,4,"240,95",4,1,1,6,Mid-Value,Potential Loyalists
78845,725,1,"28,25",4,1,1,6,Mid-Value,Potential Loyalists
78846,1007,2,"76,65",3,1,1,5,Low-Value,At Risk Customers
78847,841,1,"23,75",3,1,1,5,Low-Value,At Risk Customers
78848,44,3,"27,75",5,1,1,7,Mid-Value,Potential Loyalists
78850,1138,2,"59,25",2,1,1,4,Low-Value,Can't Lose
78851,1104,2,"65,85",2,1,1,4,Low-Value,Can't Lose
78854,227,3,"352,6",5,1,1,7,Mid-Value,Potential Loyalists
78856,1682,1,"22,45",1,1,1,3,Low-Value,Lost
78857,125,2,"104,85",5,1,1,7,Mid-Value,Potential Loyalists
78858,97,2,"263,95000000000005",5,1,1,7,Mid-Value,Potential Loyalists
78859,746,2,"170,0",3,1,1,5,Low-Value,At Risk Customers
78860,755,1,"14,1",3,1,1,5,Low-Value,At Risk Customers
78861,47,4,"230,25",5,1,1,7,Mid-Value,Potential Loyalists
78864,9,16,"812,25",5,3,2,10,High-Value,Champions
78866,785,4,"526,25",3,1,1,5,Low-Value,At Risk Customers
78867,168,5,"923,6999999999999",5,1,2,8,High-Value,Potential Loyalists
78869,53,6,"356,55",5,1,1,7,Mid-Value,Potential Loyalists
78871,1113,1,"25,0",2,1,1,4,Low-Value,Can't Lose
78873,78,3,"155,0",5,1,1,7,Mid-Value,Potential Loyalists
78874,396,3,"112,0",4,1,1,6,Mid-Value,Potential Loyalists
78875,1214,1,"126,1",2,1,1,4,Low-Value,Can't Lose
78876,132,4,"623,05",5,1,1,7,Mid-Value,Potential Loyalists
78877,527,4,"315,79999999999995",4,1,1,6,Mid-Value,Potential Loyalists
78880,581,3,"1067,3999999999999",4,1,2,7,Mid-Value,Potential Loyalists
78882,725,13,"370,95",4,3,1,8,High-Value,Potential Loyalists
78884,1354,1,"40,7",2,1,1,4,Low-Value,Can't Lose
78887,132,5,"162,15",5,1,1,7,Mid-Value,Potential Loyalists
78889,191,3,"428,40000000000003",5,1,1,7,Mid-Value,Potential Loyalists
78890,292,4,"276,65",5,1,1,7,Mid-Value,Potential Loyalists
78891,1819,1,"8,4",1,1,1,3,Low-Value,Lost
78892,847,1,"104,8",3,1,1,5,Low-Value,At Risk Customers
78894,184,4,"522,75",5,1,1,7,Mid-Value,Potential Loyalists
78895,1161,1,"0,7",2,1,1,4,Low-Value,Can't Lose
78896,1404,1,"11,95",2,1,1,4,Low-Value,Can't Lose
78898,367,2,"310,95",4,1,1,6,Mid-Value,Potential Loyalists
78899,1789,1,"0,75",1,1,1,3,Low-Value,Lost
78902,342,5,"225,1",5,1,1,7,Mid-Value,Potential Loyalists
78911,1530,1,"115,6",1,1,1,3,Low-Value,Lost
78912,850,4,"162,45",3,1,1,5,Low-Value,At Risk Customers
78913,21,7,"234,15",5,2,1,8,High-Value,Potential Loyalists
78915,1462,2,"212,3",1,1,1,3,Low-Value,Lost
78916,419,2,"126,14999999999999",4,1,1,6,Mid-Value,Potential Loyalists
78917,1683,4,"189,05",1,1,1,3,Low-Value,Lost
78918,221,7,"303,34999999999997",5,2,1,8,High-Value,Potential Loyalists
78919,1004,2,"41,45",3,1,1,5,Low-Value,At Risk Customers
78921,1272,2,"195,3",2,1,1,4,Low-Value,Can't Lose
78922,24,5,"503,85",5,1,1,7,Mid-Value,Potential Loyalists
78923,15,6,"101,0",5,1,1,7,Mid-Value,Potential Loyalists
78924,1353,1,"35,4",2,1,1,4,Low-Value,Can't Lose
78925,1647,1,"24,4",1,1,1,3,Low-Value,Lost
78926,31,3,"94,35",5,1,1,7,Mid-Value,Potential Loyalists
78928,1452,1,"79,0",2,1,1,4,Low-Value,Can't Lose
78929,8,5,"258,45",5,1,1,7,Mid-Value,Potential Loyalists
78930,247,3,"478,8",5,1,1,7,Mid-Value,Potential Loyalists
78931,132,8,"462,35",5,2,1,8,High-Value,Potential Loyalists
78932,202,10,"564,85",5,2,1,8,High-Value,Potential Loyalists
78934,691,1,"149,0",4,1,1,6,Mid-Value,Potential Loyalists
78935,1289,3,"119,4",2,1,1,4,Low-Value,Can't Lose
78936,149,8,"717,3",5,2,2,9,High-Value,Champions
78937,29,7,"642,7",5,2,1,8,High-Value,Potential Loyalists
78939,80,6,"684,0",5,1,2,8,High-Value,Potential Loyalists
78942,1707,1,"15,4",1,1,1,3,Low-Value,Lost
78943,84,10,"499,15000000000003",5,2,1,8,High-Value,Potential Loyalists
78944,1151,2,"85,5",2,1,1,4,Low-Value,Can't Lose
78945,10,6,"522,65",5,1,1,7,Mid-Value,Potential Loyalists
78949,1475,2,"64,9",1,1,1,3,Low-Value,Lost
78951,809,2,"151,35000000000002",3,1,1,5,Low-Value,At Risk Customers
78954,356,2,"21,2",5,1,1,7,Mid-Value,Potential Loyalists
78955,868,3,"161,5",3,1,1,5,Low-Value,At Risk Customers
78956,612,2,"41,2",4,1,1,6,Mid-Value,Potential Loyalists
78957,18,1,"26,549999999999997",5,1,1,7,Mid-Value,Potential Loyalists
78958,31,4,"64,89999999999999",5,1,1,7,Mid-Value,Potential Loyalists
78960,73,2,"141,6",5,1,1,7,Mid-Value,Potential Loyalists
78961,68,2,"136,0",5,1,1,7,Mid-Value,Potential Loyalists
78962,309,3,"360,65000000000003",5,1,1,7,Mid-Value,Potential Loyalists
78963,375,6,"495,0",4,1,1,6,Mid-Value,Potential Loyalists
78965,220,4,"168,95",5,1,1,7,Mid-Value,Potential Loyalists
78968,826,4,"209,04999999999998",3,1,1,5,Low-Value,At Risk Customers
78972,178,2,"135,7",5,1,1,7,Mid-Value,Potential Loyalists
78975,159,3,"125,15",5,1,1,7,Mid-Value,Potential Loyalists
78977,497,7,"225,7",4,2,1,7,Mid-Value,Potential Loyalists
78978,398,1,"63,2",4,1,1,6,Mid-Value,Potential Loyalists
78979,501,8,"333,85",4,2,1,7,Mid-Value,Potential Loyalists
78980,181,3,"233,35000000000002",5,1,1,7,Mid-Value,Potential Loyalists
78982,774,7,"1044,5",3,2,2,7,Mid-Value,Potential Loyalists
78983,533,2,"207,45000000000002",4,1,1,6,Mid-Value,Potential Loyalists
78984,369,5,"123,8",4,1,1,6,Mid-Value,Potential Loyalists
78985,571,3,"278,6",4,1,1,6,Mid-Value,Potential Loyalists
78986,1511,1,"11,35",1,1,1,3,Low-Value,Lost
78988,490,2,"548,1",4,1,1,6,Mid-Value,Potential Loyalists
78990,137,5,"282,75",5,1,1,7,Mid-Value,Potential Loyalists
78991,1377,1,"12,2",2,1,1,4,Low-Value,Can't Lose
78992,877,1,"73,5",3,1,1,5,Low-Value,At Risk Customers
78994,1441,2,"18,45",2,1,1,4,Low-Value,Can't Lose
78997,204,1,"65,15",5,1,1,7,Mid-Value,Potential Loyalists
78998,106,12,"561,4",5,3,1,9,High-Value,Champions
78999,172,3,"392,24999999999994",5,1,1,7,Mid-Value,Potential Loyalists
79000,190,2,"145,4",5,1,1,7,Mid-Value,Potential Loyalists
79001,34,2,"116,45",5,1,1,7,Mid-Value,Potential Loyalists
79002,967,1,"128,39999999999998",3,1,1,5,Low-Value,At Risk Customers
79004,111,4,"277,05",5,1,1,7,Mid-Value,Potential Loyalists
79007,157,8,"1182,1",5,2,2,9,High-Value,Champions
79008,397,7,"521,9",4,2,1,7,Mid-Value,Potential Loyalists
79009,734,1,"54,6",3,1,1,5,Low-Value,At Risk Customers
79014,4,6,"673,5",5,1,2,8,High-Value,Potential Loyalists
79015,688,6,"347,4",4,1,1,6,Mid-Value,Potential Loyalists
79016,164,1,"277,0",5,1,1,7,Mid-Value,Potential Loyalists
79017,1250,3,"248,5",2,1,1,4,Low-Value,Can't Lose
79019,1598,1,"24,1",1,1,1,3,Low-Value,Lost
79021,130,10,"677,95",5,2,2,9,High-Value,Champions
79022,266,4,"506,09999999999997",5,1,1,7,Mid-Value,Potential Loyalists
79024,62,8,"244,9",5,2,1,8,High-Value,Potential Loyalists
79025,1474,1,"17,5",1,1,1,3,Low-Value,Lost
79026,31,8,"692,9",5,2,2,9,High-Value,Champions
79027,413,4,"225,05",4,1,1,6,Mid-Value,Potential Loyalists
79029,529,2,"140,60000000000002",4,1,1,6,Mid-Value,Potential Loyalists
79030,69,3,"48,25",5,1,1,7,Mid-Value,Potential Loyalists
79031,138,3,"202,29999999999998",5,1,1,7,Mid-Value,Potential Loyalists
79035,1793,1,"83,8",1,1,1,3,Low-Value,Lost
79036,305,7,"406,95",5,2,1,8,High-Value,Potential Loyalists
79037,860,1,"31,2",3,1,1,5,Low-Value,At Risk Customers
79038,1310,3,"81,6",2,1,1,4,Low-Value,Can't Lose
79039,19,11,"919,7",5,2,2,9,High-Value,Champions
79041,80,5,"269,6",5,1,1,7,Mid-Value,Potential Loyalists
79042,928,3,"86,5",3,1,1,5,Low-Value,At Risk Customers
79043,14,1,"143,8",5,1,1,7,Mid-Value,Potential Loyalists
79044,110,11,"320,25",5,2,1,8,High-Value,Potential Loyalists
79047,1120,1,"33,4",2,1,1,4,Low-Value,Can't Lose
79048,169,1,"109,4",5,1,1,7,Mid-Value,Potential Loyalists
79050,1,7,"510,5",5,2,1,8,High-Value,Potential Loyalists
79051,218,3,"127,89999999999999",5,1,1,7,Mid-Value,Potential Loyalists
79053,566,11,"418,95",4,2,1,7,Mid-Value,Potential Loyalists
79054,41,5,"167,95",5,1,1,7,Mid-Value,Potential Loyalists
79057,1124,3,"279,20000000000005",2,1,1,4,Low-Value,Can't Lose
79059,264,7,"403,1",5,2,1,8,High-Value,Potential Loyalists
79060,53,3,"86,35",5,1,1,7,Mid-Value,Potential Loyalists
79061,12,9,"862,2",5,2,2,9,High-Value,Champions
79064,200,1,"39,0",5,1,1,7,Mid-Value,Potential Loyalists
79066,613,3,"58,2",4,1,1,6,Mid-Value,Potential Loyalists
79067,16,2,"58,9",5,1,1,7,Mid-Value,Potential Loyalists
79068,446,4,"333,6",4,1,1,6,Mid-Value,Potential Loyalists
79070,1551,2,"173,8",1,1,1,3,Low-Value,Lost
79071,684,1,"118,1",4,1,1,6,Mid-Value,Potential Loyalists
79073,98,7,"450,15000000000003",5,2,1,8,High-Value,Potential Loyalists
79075,1477,2,"153,3",1,1,1,3,Low-Value,Lost
79077,701,1,"170,6",4,1,1,6,Mid-Value,Potential Loyalists
79078,1465,1,"58,6",1,1,1,3,Low-Value,Lost
79080,1180,3,"183,4",2,1,1,4,Low-Value,Can't Lose
79081,554,6,"252,5",4,1,1,6,Mid-Value,Potential Loyalists
79082,201,3,"50,6",5,1,1,7,Mid-Value,Potential Loyalists
79084,575,6,"230,85000000000002",4,1,1,6,Mid-Value,Potential Loyalists
79085,224,6,"426,15",5,1,1,7,Mid-Value,Potential Loyalists
79086,248,10,"372,20000000000005",5,2,1,8,High-Value,Potential Loyalists
79087,150,1,"10,8",5,1,1,7,Mid-Value,Potential Loyalists
79088,402,2,"138,75",4,1,1,6,Mid-Value,Potential Loyalists
79089,267,2,"97,25",5,1,1,7,Mid-Value,Potential Loyalists
79091,1517,2,"65,0",1,1,1,3,Low-Value,Lost
79093,747,8,"518,75",3,2,1,6,Mid-Value,Potential Loyalists
79094,1396,1,"10,45",2,1,1,4,Low-Value,Can't Lose
79095,760,1,"107,4",3,1,1,5,Low-Value,At Risk Customers
79096,648,1,"55,5",4,1,1,6,Mid-Value,Potential Loyalists
79097,745,4,"133,95000000000002",3,1,1,5,Low-Value,At Risk Customers
79099,340,2,"98,6",5,1,1,7,Mid-Value,Potential Loyalists
79100,347,1,"32,3",5,1,1,7,Mid-Value,Potential Loyalists
79101,256,5,"283,0",5,1,1,7,Mid-Value,Potential Loyalists
79102,108,3,"325,95",5,1,1,7,Mid-Value,Potential Loyalists
79107,266,3,"53,05",5,1,1,7,Mid-Value,Potential Loyalists
79111,36,4,"499,95000000000005",5,1,1,7,Mid-Value,Potential Loyalists
79112,1141,1,"23,85",2,1,1,4,Low-Value,Can't Lose
79115,265,3,"145,6",5,1,1,7,Mid-Value,Potential Loyalists
79117,280,3,"78,5",5,1,1,7,Mid-Value,Potential Loyalists
79120,281,10,"434,95",5,2,1,8,High-Value,Potential Loyalists
79121,1082,2,"100,45",3,1,1,5,Low-Value,At Risk Customers
79122,70,5,"473,09999999999997",5,1,1,7,Mid-Value,Potential Loyalists
79123,843,2,"110,4",3,1,1,5,Low-Value,At Risk Customers
79124,894,1,"80,9",3,1,1,5,Low-Value,At Risk Customers
79125,255,3,"143,7",5,1,1,7,Mid-Value,Potential Loyalists
79126,602,2,"263,4",4,1,1,6,Mid-Value,Potential Loyalists
79127,1480,1,"40,7",1,1,1,3,Low-Value,Lost
79128,999,3,"116,6",3,1,1,5,Low-Value,At Risk Customers
79130,1311,1,"10,7",2,1,1,4,Low-Value,Can't Lose
79131,431,1,"77,75",4,1,1,6,Mid-Value,Potential Loyalists
79134,188,6,"237,35",5,1,1,7,Mid-Value,Potential Loyalists
79135,1534,2,"156,05",1,1,1,3,Low-Value,Lost
79136,46,12,"751,3",5,3,2,10,High-Value,Champions
79137,1295,2,"128,75",2,1,1,4,Low-Value,Can't Lose
79138,425,3,"279,55",4,1,1,6,Mid-Value,Potential Loyalists
79141,336,2,"53,349999999999994",5,1,1,7,Mid-Value,Potential Loyalists
79145,1450,2,"51,35",2,1,1,4,Low-Value,Can't Lose
79148,784,2,"103,3",3,1,1,5,Low-Value,At Risk Customers
79149,941,2,"45,2",3,1,1,5,Low-Value,At Risk Customers
79150,433,2,"64,05",4,1,1,6,Mid-Value,Potential Loyalists
79152,503,1,"11,0",4,1,1,6,Mid-Value,Potential Loyalists
79154,426,5,"232,79999999999998",4,1,1,6,Mid-Value,Potential Loyalists
79160,946,1,"2,95",3,1,1,5,Low-Value,At Risk Customers
79161,514,3,"297,0",4,1,1,6,Mid-Value,Potential Loyalists
79163,209,8,"851,6",5,2,2,9,High-Value,Champions
79164,398,7,"328,2",4,2,1,7,Mid-Value,Potential Loyalists
79165,857,4,"456,84999999999997",3,1,1,5,Low-Value,At Risk Customers
79166,49,3,"211,25",5,1,1,7,Mid-Value,Potential Loyalists
79169,30,8,"672,1",5,2,2,9,High-Value,Champions
79170,38,1,"42,15",5,1,1,7,Mid-Value,Potential Loyalists
79173,869,1,"33,1",3,1,1,5,Low-Value,At Risk Customers
79176,521,4,"105,55",4,1,1,6,Mid-Value,Potential Loyalists
79177,993,1,"53,8",3,1,1,5,Low-Value,At Risk Customers
79178,1166,2,"69,30000000000001",2,1,1,4,Low-Value,Can't Lose
79179,122,9,"681,1999999999999",5,2,2,9,High-Value,Champions
79180,947,1,"77,7",3,1,1,5,Low-Value,At Risk Customers
79183,684,1,"4,7",4,1,1,6,Mid-Value,Potential Loyalists
79185,141,5,"901,1499999999999",5,1,2,8,High-Value,Potential Loyalists
79188,125,1,"936,3",5,1,2,8,High-Value,Potential Loyalists
79191,1656,1,"93,8",1,1,1,3,Low-Value,Lost
79192,225,3,"69,55",5,1,1,7,Mid-Value,Potential Loyalists
79194,577,2,"156,89999999999998",4,1,1,6,Mid-Value,Potential Loyalists
79195,266,3,"179,75",5,1,1,7,Mid-Value,Potential Loyalists
79198,414,1,"26,6",4,1,1,6,Mid-Value,Potential Loyalists
79199,28,7,"119,55",5,2,1,8,High-Value,Potential Loyalists
79201,418,5,"228,75",4,1,1,6,Mid-Value,Potential Loyalists
79202,4,1,"8,05",5,1,1,7,Mid-Value,Potential Loyalists
79203,1110,2,"166,05",2,1,1,4,Low-Value,Can't Lose
79205,60,1,"87,15",5,1,1,7,Mid-Value,Potential Loyalists
79206,1773,1,"11,95",1,1,1,3,Low-Value,Lost
79209,349,2,"131,8",5,1,1,7,Mid-Value,Potential Loyalists
79212,16,2,"47,6",5,1,1,7,Mid-Value,Potential Loyalists
79213,1519,2,"75,35",1,1,1,3,Low-Value,Lost
79214,86,2,"37,05",5,1,1,7,Mid-Value,Potential Loyalists
79215,926,5,"139,64999999999998",3,1,1,5,Low-Value,At Risk Customers
79216,381,1,"42,15",4,1,1,6,Mid-Value,Potential Loyalists
79218,554,1,"391,65000000000003",4,1,1,6,Mid-Value,Potential Loyalists
79220,1396,2,"105,5",2,1,1,4,Low-Value,Can't Lose
79221,10,2,"222,85",5,1,1,7,Mid-Value,Potential Loyalists
79222,119,3,"208,89999999999998",5,1,1,7,Mid-Value,Potential Loyalists
79223,431,2,"83,75",4,1,1,6,Mid-Value,Potential Loyalists
79225,185,3,"141,8",5,1,1,7,Mid-Value,Potential Loyalists
79226,807,1,"15,4",3,1,1,5,Low-Value,At Risk Customers
79227,433,4,"139,65",4,1,1,6,Mid-Value,Potential Loyalists
79228,224,5,"263,45",5,1,1,7,Mid-Value,Potential Loyalists
79229,1146,1,"63,900000000000006",2,1,1,4,Low-Value,Can't Lose
79236,198,3,"151,45",5,1,1,7,Mid-Value,Potential Loyalists
79238,746,1,"141,5",3,1,1,5,Low-Value,At Risk Customers
79240,1594,2,"11,4",1,1,1,3,Low-Value,Lost
79241,282,7,"227,4",5,2,1,8,High-Value,Potential Loyalists
79244,220,1,"36,4",5,1,1,7,Mid-Value,Potential Loyalists
79247,908,1,"85,9",3,1,1,5,Low-Value,At Risk Customers
79248,52,7,"596,1",5,2,1,8,High-Value,Potential Loyalists
79249,8,4,"129,75",5,1,1,7,Mid-Value,Potential Loyalists
79250,0,8,"561,6",5,2,1,8,High-Value,Potential Loyalists
79251,1759,1,"36,8",1,1,1,3,Low-Value,Lost
79253,105,8,"449,25",5,2,1,8,High-Value,Potential Loyalists
79255,733,2,"173,7",3,1,1,5,Low-Value,At Risk Customers
79257,15,1,"126,6",5,1,1,7,Mid-Value,Potential Loyalists
79260,730,3,"351,75",4,1,1,6,Mid-Value,Potential Loyalists
79263,161,2,"31,25",5,1,1,7,Mid-Value,Potential Loyalists
79264,339,3,"516,5",5,1,1,7,Mid-Value,Potential Loyalists
79265,1078,3,"192,95",3,1,1,5,Low-Value,At Risk Customers
79266,423,3,"166,14999999999998",4,1,1,6,Mid-Value,Potential Loyalists
79268,146,1,"84,3",5,1,1,7,Mid-Value,Potential Loyalists
79272,253,2,"24,3",5,1,1,7,Mid-Value,Potential Loyalists
79273,171,3,"170,20000000000002",5,1,1,7,Mid-Value,Potential Loyalists
79275,837,4,"248,85",3,1,1,5,Low-Value,At Risk Customers
79277,0,3,"181,2",5,1,1,7,Mid-Value,Potential Loyalists
79278,383,6,"293,05",4,1,1,6,Mid-Value,Potential Loyalists
79280,862,2,"73,75",3,1,1,5,Low-Value,At Risk Customers
79282,8,15,"1094,0",5,3,2,10,High-Value,Champions
79284,1452,1,"8,75",2,1,1,4,Low-Value,Can't Lose
79285,81,4,"126,45",5,1,1,7,Mid-Value,Potential Loyalists
79288,148,8,"647,8000000000001",5,2,1,8,High-Value,Potential Loyalists
79289,995,1,"7,9",3,1,1,5,Low-Value,At Risk Customers
79290,244,2,"58,99999999999999",5,1,1,7,Mid-Value,Potential Loyalists
79291,31,4,"77,0",5,1,1,7,Mid-Value,Potential Loyalists
79295,1471,3,"131,55",1,1,1,3,Low-Value,Lost
79296,157,1,"3,5",5,1,1,7,Mid-Value,Potential Loyalists
79297,354,7,"499,79999999999995",5,2,1,8,High-Value,Potential Loyalists
79300,118,1,"36,4",5,1,1,7,Mid-Value,Potential Loyalists
79301,36,13,"1189,8",5,3,2,10,High-Value,Champions
79302,1070,1,"62,9",3,1,1,5,Low-Value,At Risk Customers
79304,512,1,"49,7",4,1,1,6,Mid-Value,Potential Loyalists
79305,1115,2,"100,25",2,1,1,4,Low-Value,Can't Lose
79306,1174,3,"137,45",2,1,1,4,Low-Value,Can't Lose
79308,1084,2,"86,6",3,1,1,5,Low-Value,At Risk Customers
79310,231,7,"799,05",5,2,2,9,High-Value,Champions
79311,1485,3,"352,4",1,1,1,3,Low-Value,Lost
79312,924,2,"97,8",3,1,1,5,Low-Value,At Risk Customers
79313,948,2,"37,55",3,1,1,5,Low-Value,At Risk Customers
79314,153,4,"164,1",5,1,1,7,Mid-Value,Potential Loyalists
79315,1,1,"41,8",5,1,1,7,Mid-Value,Potential Loyalists
79316,126,3,"140,8",5,1,1,7,Mid-Value,Potential Loyalists
79318,872,2,"17,5",3,1,1,5,Low-Value,At Risk Customers
79320,1718,1,"61,0",1,1,1,3,Low-Value,Lost
79321,231,3,"43,0",5,1,1,7,Mid-Value,Potential Loyalists
79323,782,2,"28,85",3,1,1,5,Low-Value,At Risk Customers
79324,1487,1,"216,3",1,1,1,3,Low-Value,Lost
79326,844,3,"218,25",3,1,1,5,Low-Value,At Risk Customers
79327,64,8,"331,8",5,2,1,8,High-Value,Potential Loyalists
79328,848,6,"584,65",3,1,1,5,Low-Value,At Risk Customers
79330,1239,1,"6,3",2,1,1,4,Low-Value,Can't Lose
79331,462,2,"36,45",4,1,1,6,Mid-Value,Potential Loyalists
79332,1025,2,"19,049999999999997",3,1,1,5,Low-Value,At Risk Customers
79333,1473,2,"175,05",1,1,1,3,Low-Value,Lost
79334,412,1,"28,75",4,1,1,6,Mid-Value,Potential Loyalists
79335,1051,2,"76,2",3,1,1,5,Low-Value,At Risk Customers
79337,3,5,"400,45",5,1,1,7,Mid-Value,Potential Loyalists
79338,816,3,"138,85",3,1,1,5,Low-Value,At Risk Customers
79340,151,4,"575,5",5,1,1,7,Mid-Value,Potential Loyalists
79344,148,3,"277,9",5,1,1,7,Mid-Value,Potential Loyalists
79346,1022,1,"117,2",3,1,1,5,Low-Value,At Risk Customers
79350,79,3,"32,45",5,1,1,7,Mid-Value,Potential Loyalists
79351,1151,4,"115,7",2,1,1,4,Low-Value,Can't Lose
79352,128,11,"792,25",5,2,2,9,High-Value,Champions
79353,21,2,"213,65",5,1,1,7,Mid-Value,Potential Loyalists
79354,376,2,"44,5",4,1,1,6,Mid-Value,Potential Loyalists
79355,197,1,"20,6",5,1,1,7,Mid-Value,Potential Loyalists
79356,864,3,"200,54999999999998",3,1,1,5,Low-Value,At Risk Customers
79357,570,2,"82,15",4,1,1,6,Mid-Value,Potential Loyalists
79358,404,1,"43,55",4,1,1,6,Mid-Value,Potential Loyalists
79359,556,1,"5,05",4,1,1,6,Mid-Value,Potential Loyalists
79360,1219,1,"16,2",2,1,1,4,Low-Value,Can't Lose
79361,463,3,"144,9",4,1,1,6,Mid-Value,Potential Loyalists
79364,1139,1,"5,15",2,1,1,4,Low-Value,Can't Lose
79366,1443,1,"24,7",2,1,1,4,Low-Value,Can't Lose
79368,323,4,"152,10000000000002",5,1,1,7,Mid-Value,Potential Loyalists
79369,464,5,"189,85",4,1,1,6,Mid-Value,Potential Loyalists
79370,630,4,"248,04999999999998",4,1,1,6,Mid-Value,Potential Loyalists
79372,260,4,"105,65",5,1,1,7,Mid-Value,Potential Loyalists
79374,68,3,"198,95",5,1,1,7,Mid-Value,Potential Loyalists
79375,24,4,"651,15",5,1,1,7,Mid-Value,Potential Loyalists
79378,742,2,"56,55",3,1,1,5,Low-Value,At Risk Customers
79381,1757,1,"8,55",1,1,1,3,Low-Value,Lost
79382,67,10,"269,0",5,2,1,8,High-Value,Potential Loyalists
79385,299,3,"55,0",5,1,1,7,Mid-Value,Potential Loyalists
79388,499,4,"105,69999999999999",4,1,1,6,Mid-Value,Potential Loyalists
79390,806,1,"3,15",3,1,1,5,Low-Value,At Risk Customers
79392,2,7,"693,75",5,2,2,9,High-Value,Champions
79393,319,4,"88,9",5,1,1,7,Mid-Value,Potential Loyalists
79394,661,1,"56,45",4,1,1,6,Mid-Value,Potential Loyalists
79398,394,8,"384,15",4,2,1,7,Mid-Value,Potential Loyalists
79399,822,7,"320,55",3,2,1,6,Mid-Value,Potential Loyalists
79400,34,8,"608,2",5,2,1,8,High-Value,Potential Loyalists
79402,161,7,"233,70000000000002",5,2,1,8,High-Value,Potential Loyalists
79403,184,4,"112,2",5,1,1,7,Mid-Value,Potential Loyalists
79404,230,2,"57,95",5,1,1,7,Mid-Value,Potential Loyalists
79405,373,4,"211,45",4,1,1,6,Mid-Value,Potential Loyalists
79406,1268,1,"73,8",2,1,1,4,Low-Value,Can't Lose
79407,411,3,"103,85000000000001",4,1,1,6,Mid-Value,Potential Loyalists
79410,264,3,"58,849999999999994",5,1,1,7,Mid-Value,Potential Loyalists
79411,252,1,"21,85",5,1,1,7,Mid-Value,Potential Loyalists
79412,1088,2,"34,8",3,1,1,5,Low-Value,At Risk Customers
79413,671,1,"9,05",4,1,1,6,Mid-Value,Potential Loyalists
79415,13,3,"92,5",5,1,1,7,Mid-Value,Potential Loyalists
79416,741,1,"9,1",3,1,1,5,Low-Value,At Risk Customers
79417,1533,3,"47,5",1,1,1,3,Low-Value,Lost
79418,60,2,"100,2",5,1,1,7,Mid-Value,Potential Loyalists
79419,124,4,"428,95",5,1,1,7,Mid-Value,Potential Loyalists
79423,517,1,"56,9",4,1,1,6,Mid-Value,Potential Loyalists
79424,58,1,"16,4",5,1,1,7,Mid-Value,Potential Loyalists
79426,24,7,"614,7",5,2,1,8,High-Value,Potential Loyalists
79432,234,6,"358,4",5,1,1,7,Mid-Value,Potential Loyalists
79433,1279,1,"540,0",2,1,1,4,Low-Value,Can't Lose
79434,52,4,"176,85",5,1,1,7,Mid-Value,Potential Loyalists
79435,27,3,"72,0",5,1,1,7,Mid-Value,Potential Loyalists
79438,568,5,"297,9",4,1,1,6,Mid-Value,Potential Loyalists
79439,105,3,"97,54999999999998",5,1,1,7,Mid-Value,Potential Loyalists
79441,162,3,"191,0",5,1,1,7,Mid-Value,Potential Loyalists
79442,1498,1,"5,85",1,1,1,3,Low-Value,Lost
79444,1547,2,"33,699999999999996",1,1,1,3,Low-Value,Lost
79445,22,5,"224,05",5,1,1,7,Mid-Value,Potential Loyalists
79446,962,3,"223,65",3,1,1,5,Low-Value,At Risk Customers
79449,1039,6,"774,25",3,1,2,6,Mid-Value,Potential Loyalists
79453,1499,3,"159,45",1,1,1,3,Low-Value,Lost
79454,1596,4,"117,7",1,1,1,3,Low-Value,Lost
79456,454,2,"135,65",4,1,1,6,Mid-Value,Potential Loyalists
79457,140,5,"593,6",5,1,1,7,Mid-Value,Potential Loyalists
79458,250,3,"176,90000000000003",5,1,1,7,Mid-Value,Potential Loyalists
79459,290,2,"228,2",5,1,1,7,Mid-Value,Potential Loyalists
79460,22,2,"41,3",5,1,1,7,Mid-Value,Potential Loyalists
79461,864,1,"105,7",3,1,1,5,Low-Value,At Risk Customers
79462,1509,1,"12,35",1,1,1,3,Low-Value,Lost
79464,552,4,"699,95",4,1,2,7,Mid-Value,Potential Loyalists
79468,1256,1,"30,7",2,1,1,4,Low-Value,Can't Lose
79470,517,4,"121,75",4,1,1,6,Mid-Value,Potential Loyalists
79471,262,1,"24,0",5,1,1,7,Mid-Value,Potential Loyalists
79472,346,2,"66,2",5,1,1,7,Mid-Value,Potential Loyalists
79473,1415,1,"10,6",2,1,1,4,Low-Value,Can't Lose
79478,615,4,"134,95",4,1,1,6,Mid-Value,Potential Loyalists
79479,297,7,"467,15000000000003",5,2,1,8,High-Value,Potential Loyalists
79481,334,4,"255,0",5,1,1,7,Mid-Value,Potential Loyalists
79482,633,3,"918,3500000000001",4,1,2,7,Mid-Value,Potential Loyalists
79483,770,2,"1278,45",3,1,2,6,Mid-Value,Potential Loyalists
79485,80,3,"226,9",5,1,1,7,Mid-Value,Potential Loyalists
79486,130,1,"50,5",5,1,1,7,Mid-Value,Potential Loyalists
79488,15,3,"203,7",5,1,1,7,Mid-Value,Potential Loyalists
79489,487,3,"225,29999999999998",4,1,1,6,Mid-Value,Potential Loyalists
79491,874,1,"76,3",3,1,1,5,Low-Value,At Risk Customers
79494,1242,4,"308,0",2,1,1,4,Low-Value,Can't Lose
79499,171,1,"11,1",5,1,1,7,Mid-Value,Potential Loyalists
79501,882,2,"101,14999999999999",3,1,1,5,Low-Value,At Risk Customers
79502,563,2,"48,849999999999994",4,1,1,6,Mid-Value,Potential Loyalists
79504,595,1,"147,7",4,1,1,6,Mid-Value,Potential Loyalists
79505,30,6,"191,65",5,1,1,7,Mid-Value,Potential Loyalists
79507,1420,1,"3,4",2,1,1,4,Low-Value,Can't Lose
79508,307,2,"67,65",5,1,1,7,Mid-Value,Potential Loyalists
79510,610,1,"19,35",4,1,1,6,Mid-Value,Potential Loyalists
79511,264,1,"78,15",5,1,1,7,Mid-Value,Potential Loyalists
79514,1549,1,"7,6",1,1,1,3,Low-Value,Lost
79515,668,2,"45,35",4,1,1,6,Mid-Value,Potential Loyalists
79516,316,3,"56,75",5,1,1,7,Mid-Value,Potential Loyalists
79517,1083,2,"167,4",3,1,1,5,Low-Value,At Risk Customers
79519,42,7,"311,4",5,2,1,8,High-Value,Potential Loyalists
79521,731,1,"141,5",3,1,1,5,Low-Value,At Risk Customers
79522,600,5,"262,35",4,1,1,6,Mid-Value,Potential Loyalists
79524,1317,2,"118,6",2,1,1,4,Low-Value,Can't Lose
79525,1625,2,"75,8",1,1,1,3,Low-Value,Lost
79526,11,8,"637,9",5,2,1,8,High-Value,Potential Loyalists
79528,189,3,"252,6",5,1,1,7,Mid-Value,Potential Loyalists
79529,31,5,"145,8",5,1,1,7,Mid-Value,Potential Loyalists
79530,552,1,"6,1",4,1,1,6,Mid-Value,Potential Loyalists
79531,382,1,"12,2",4,1,1,6,Mid-Value,Potential Loyalists
79532,159,2,"14,25",5,1,1,7,Mid-Value,Potential Loyalists
79533,69,3,"328,6",5,1,1,7,Mid-Value,Potential Loyalists
79535,43,5,"134,6",5,1,1,7,Mid-Value,Potential Loyalists
79537,823,1,"14,15",3,1,1,5,Low-Value,At Risk Customers
79540,1696,1,"11,65",1,1,1,3,Low-Value,Lost
79544,532,4,"185,25",4,1,1,6,Mid-Value,Potential Loyalists
79546,1797,1,"12,55",1,1,1,3,Low-Value,Lost
79548,169,4,"173,45",5,1,1,7,Mid-Value,Potential Loyalists
79549,254,2,"98,25",5,1,1,7,Mid-Value,Potential Loyalists
79550,155,5,"387,4",5,1,1,7,Mid-Value,Potential Loyalists
79551,339,2,"52,849999999999994",5,1,1,7,Mid-Value,Potential Loyalists
79552,793,1,"36,8",3,1,1,5,Low-Value,At Risk Customers
79553,603,4,"231,05",4,1,1,6,Mid-Value,Potential Loyalists
79555,324,3,"183,9",5,1,1,7,Mid-Value,Potential Loyalists
79556,411,4,"222,75",4,1,1,6,Mid-Value,Potential Loyalists
79557,1,6,"143,1",5,1,1,7,Mid-Value,Potential Loyalists
79559,1499,1,"11,8",1,1,1,3,Low-Value,Lost
79560,8,4,"134,5",5,1,1,7,Mid-Value,Potential Loyalists
79561,464,1,"39,2",4,1,1,6,Mid-Value,Potential Loyalists
79562,1105,1,"13,4",2,1,1,4,Low-Value,Can't Lose
79564,755,3,"236,3",3,1,1,5,Low-Value,At Risk Customers
79567,1659,1,"157,0",1,1,1,3,Low-Value,Lost
79570,285,4,"202,55",5,1,1,7,Mid-Value,Potential Loyalists
79572,1043,6,"406,35",3,1,1,5,Low-Value,At Risk Customers
79573,417,2,"251,14999999999998",4,1,1,6,Mid-Value,Potential Loyalists
79575,376,2,"125,5",4,1,1,6,Mid-Value,Potential Loyalists
79577,162,4,"237,60000000000002",5,1,1,7,Mid-Value,Potential Loyalists
79580,224,5,"257,0",5,1,1,7,Mid-Value,Potential Loyalists
79581,1454,2,"13,4",2,1,1,4,Low-Value,Can't Lose
79584,239,10,"348,8",5,2,1,8,High-Value,Potential Loyalists
79585,233,7,"541,45",5,2,1,8,High-Value,Potential Loyalists
79586,13,5,"292,5",5,1,1,7,Mid-Value,Potential Loyalists
79588,104,2,"64,9",5,1,1,7,Mid-Value,Potential Loyalists
79589,1803,1,"109,9",1,1,1,3,Low-Value,Lost
79591,879,7,"364,55",3,2,1,6,Mid-Value,Potential Loyalists
79596,1522,3,"192,3",1,1,1,3,Low-Value,Lost
79599,1270,3,"980,3000000000001",2,1,2,5,Low-Value,At Risk Customers
79601,182,4,"150,35",5,1,1,7,Mid-Value,Potential Loyalists
79602,817,2,"158,55",3,1,1,5,Low-Value,At Risk Customers
79603,556,5,"297,05",4,1,1,6,Mid-Value,Potential Loyalists
79604,248,3,"106,95",5,1,1,7,Mid-Value,Potential Loyalists
79605,797,1,"13,9",3,1,1,5,Low-Value,At Risk Customers
79607,804,2,"700,8499999999999",3,1,2,6,Mid-Value,Potential Loyalists
79608,509,2,"44,849999999999994",4,1,1,6,Mid-Value,Potential Loyalists
79609,7,5,"261,65",5,1,1,7,Mid-Value,Potential Loyalists
79610,773,2,"211,75",3,1,1,5,Low-Value,At Risk Customers
79612,626,4,"105,0",4,1,1,6,Mid-Value,Potential Loyalists
79613,712,3,"81,95",4,1,1,6,Mid-Value,Potential Loyalists
79614,233,6,"353,85",5,1,1,7,Mid-Value,Potential Loyalists
79618,567,4,"336,0",4,1,1,6,Mid-Value,Potential Loyalists
79626,1135,2,"74,5",2,1,1,4,Low-Value,Can't Lose
79628,393,1,"52,8",4,1,1,6,Mid-Value,Potential Loyalists
79630,239,5,"608,35",5,1,1,7,Mid-Value,Potential Loyalists
79633,732,4,"204,95000000000002",3,1,1,5,Low-Value,At Risk Customers
79634,21,6,"282,5",5,1,1,7,Mid-Value,Potential Loyalists
79636,173,3,"437,0",5,1,1,7,Mid-Value,Potential Loyalists
79637,1366,1,"64,1",2,1,1,4,Low-Value,Can't Lose
79639,4,4,"244,9",5,1,1,7,Mid-Value,Potential Loyalists
79640,90,10,"458,1",5,2,1,8,High-Value,Potential Loyalists
79641,1428,2,"53,449999999999996",2,1,1,4,Low-Value,Can't Lose
79643,39,5,"191,1",5,1,1,7,Mid-Value,Potential Loyalists
79644,253,5,"220,20000000000002",5,1,1,7,Mid-Value,Potential Loyalists
79646,24,8,"399,65",5,2,1,8,High-Value,Potential Loyalists
79649,497,4,"162,95",4,1,1,6,Mid-Value,Potential Loyalists
79651,11,6,"698,3",5,1,2,8,High-Value,Potential Loyalists
79652,1169,1,"10,05",2,1,1,4,Low-Value,Can't Lose
79653,871,2,"61,2",3,1,1,5,Low-Value,At Risk Customers
79655,126,2,"84,6",5,1,1,7,Mid-Value,Potential Loyalists
79656,1296,1,"292,3",2,1,1,4,Low-Value,Can't Lose
79657,1372,2,"44,349999999999994",2,1,1,4,Low-Value,Can't Lose
79658,1358,2,"152,8",2,1,1,4,Low-Value,Can't Lose
79660,447,7,"245,65",4,2,1,7,Mid-Value,Potential Loyalists
79661,491,1,"57,8",4,1,1,6,Mid-Value,Potential Loyalists
79662,236,1,"2,95",5,1,1,7,Mid-Value,Potential Loyalists
79665,747,2,"106,10000000000001",3,1,1,5,Low-Value,At Risk Customers
79666,901,1,"20,9",3,1,1,5,Low-Value,At Risk Customers
79667,266,2,"47,8",5,1,1,7,Mid-Value,Potential Loyalists
79672,523,3,"274,9",4,1,1,6,Mid-Value,Potential Loyalists
79673,344,4,"111,75",5,1,1,7,Mid-Value,Potential Loyalists
79675,55,2,"80,15",5,1,1,7,Mid-Value,Potential Loyalists
79676,181,1,"37,0",5,1,1,7,Mid-Value,Potential Loyalists
79677,661,2,"40,3",4,1,1,6,Mid-Value,Potential Loyalists
79679,52,11,"369,35",5,2,1,8,High-Value,Potential Loyalists
79680,734,4,"446,5",3,1,1,5,Low-Value,At Risk Customers
79683,137,3,"73,3",5,1,1,7,Mid-Value,Potential Loyalists
79685,355,1,"47,95",5,1,1,7,Mid-Value,Potential Loyalists
79688,934,1,"25,1",3,1,1,5,Low-Value,At Risk Customers
79689,538,4,"150,05",4,1,1,6,Mid-Value,Potential Loyalists
79690,384,3,"426,79999999999995",4,1,1,6,Mid-Value,Potential Loyalists
79691,1803,1,"20,6",1,1,1,3,Low-Value,Lost
79693,855,6,"497,04999999999995",3,1,1,5,Low-Value,At Risk Customers
79694,194,2,"61,199999999999996",5,1,1,7,Mid-Value,Potential Loyalists
79695,454,3,"123,50000000000001",4,1,1,6,Mid-Value,Potential Loyalists
79696,230,14,"694,6",5,3,2,10,High-Value,Champions
79697,112,2,"87,69999999999999",5,1,1,7,Mid-Value,Potential Loyalists
79698,1284,3,"43,400000000000006",2,1,1,4,Low-Value,Can't Lose
79701,360,3,"155,85",5,1,1,7,Mid-Value,Potential Loyalists
79703,417,3,"167,2",4,1,1,6,Mid-Value,Potential Loyalists
79705,91,1,"86,1",5,1,1,7,Mid-Value,Potential Loyalists
79707,1376,1,"6,7",2,1,1,4,Low-Value,Can't Lose
79710,937,2,"104,5",3,1,1,5,Low-Value,At Risk Customers
79713,540,1,"53,550000000000004",4,1,1,6,Mid-Value,Potential Loyalists
79714,1719,1,"45,6",1,1,1,3,Low-Value,Lost
79716,526,1,"179,8",4,1,1,6,Mid-Value,Potential Loyalists
79719,1696,2,"205,65",1,1,1,3,Low-Value,Lost
79721,741,4,"221,7",3,1,1,5,Low-Value,At Risk Customers
79724,633,2,"141,70000000000002",4,1,1,6,Mid-Value,Potential Loyalists
79725,1350,1,"16,7",2,1,1,4,Low-Value,Can't Lose
79727,332,3,"402,09999999999997",5,1,1,7,Mid-Value,Potential Loyalists
79728,127,1,"9,6",5,1,1,7,Mid-Value,Potential Loyalists
79730,797,3,"98,9",3,1,1,5,Low-Value,At Risk Customers
79732,14,6,"101,55",5,1,1,7,Mid-Value,Potential Loyalists
79733,1120,3,"287,6",2,1,1,4,Low-Value,Can't Lose
79734,483,10,"775,85",4,2,2,8,High-Value,Potential Loyalists
79735,1212,3,"166,9",2,1,1,4,Low-Value,Can't Lose
79737,1590,1,"194,85000000000002",1,1,1,3,Low-Value,Lost
79738,18,1,"24,0",5,1,1,7,Mid-Value,Potential Loyalists
79739,289,1,"312,6",5,1,1,7,Mid-Value,Potential Loyalists
79741,1,2,"222,20000000000002",5,1,1,7,Mid-Value,Potential Loyalists
79742,966,1,"28,200000000000003",3,1,1,5,Low-Value,At Risk Customers
79743,207,3,"111,0",5,1,1,7,Mid-Value,Potential Loyalists
79744,350,2,"85,55",5,1,1,7,Mid-Value,Potential Loyalists
79746,208,2,"128,25",5,1,1,7,Mid-Value,Potential Loyalists
79747,639,5,"282,4",4,1,1,6,Mid-Value,Potential Loyalists
79748,332,6,"361,05",5,1,1,7,Mid-Value,Potential Loyalists
79749,1078,3,"125,6",3,1,1,5,Low-Value,At Risk Customers
79750,799,7,"425,1",3,2,1,6,Mid-Value,Potential Loyalists
79751,414,8,"464,5",4,2,1,7,Mid-Value,Potential Loyalists
79752,344,2,"122,45",5,1,1,7,Mid-Value,Potential Loyalists
79753,1412,2,"92,9",2,1,1,4,Low-Value,Can't Lose
79754,568,3,"106,55",4,1,1,6,Mid-Value,Potential Loyalists
79756,242,6,"196,1",5,1,1,7,Mid-Value,Potential Loyalists
79757,745,5,"600,9",3,1,1,5,Low-Value,At Risk Customers
79759,76,11,"909,75",5,2,2,9,High-Value,Champions
79761,140,4,"146,70000000000002",5,1,1,7,Mid-Value,Potential Loyalists
79762,624,3,"304,85",4,1,1,6,Mid-Value,Potential Loyalists
79766,758,1,"18,0",3,1,1,5,Low-Value,At Risk Customers
79767,720,1,"39,5",4,1,1,6,Mid-Value,Potential Loyalists
79768,1085,3,"309,35",3,1,1,5,Low-Value,At Risk Customers
79769,569,5,"295,5",4,1,1,6,Mid-Value,Potential Loyalists
79772,439,8,"429,3",4,2,1,7,Mid-Value,Potential Loyalists
79775,1663,1,"136,9",1,1,1,3,Low-Value,Lost
79776,1819,1,"17,5",1,1,1,3,Low-Value,Lost
79777,1038,1,"10,65",3,1,1,5,Low-Value,At Risk Customers
79778,1553,1,"64,55",1,1,1,3,Low-Value,Lost
79782,115,10,"458,79999999999995",5,2,1,8,High-Value,Potential Loyalists
79784,99,5,"217,10000000000002",5,1,1,7,Mid-Value,Potential Loyalists
79785,95,7,"342,2",5,2,1,8,High-Value,Potential Loyalists
79786,16,12,"494,95",5,3,1,9,High-Value,Champions
79789,45,4,"194,5",5,1,1,7,Mid-Value,Potential Loyalists
79792,818,3,"39,65",3,1,1,5,Low-Value,At Risk Customers
79794,860,1,"10,8",3,1,1,5,Low-Value,At Risk Customers
79799,1409,1,"9,0",2,1,1,4,Low-Value,Can't Lose
79801,375,2,"143,65",4,1,1,6,Mid-Value,Potential Loyalists
79810,626,1,"45,5",4,1,1,6,Mid-Value,Potential Loyalists
79815,36,5,"429,65000000000003",5,1,1,7,Mid-Value,Potential Loyalists
79817,229,3,"273,85",5,1,1,7,Mid-Value,Potential Loyalists
79819,267,2,"134,6",5,1,1,7,Mid-Value,Potential Loyalists
79820,1004,2,"117,80000000000001",3,1,1,5,Low-Value,At Risk Customers
79822,321,4,"108,10000000000001",5,1,1,7,Mid-Value,Potential Loyalists
79823,793,1,"20,0",3,1,1,5,Low-Value,At Risk Customers
79824,3,1,"26,75",5,1,1,7,Mid-Value,Potential Loyalists
79825,1528,2,"42,900000000000006",1,1,1,3,Low-Value,Lost
79826,340,6,"552,05",5,1,1,7,Mid-Value,Potential Loyalists
79830,28,4,"142,3",5,1,1,7,Mid-Value,Potential Loyalists
79832,254,3,"164,25",5,1,1,7,Mid-Value,Potential Loyalists
79833,952,3,"197,10000000000002",3,1,1,5,Low-Value,At Risk Customers
79835,220,7,"221,1",5,2,1,8,High-Value,Potential Loyalists
79836,83,2,"15,85",5,1,1,7,Mid-Value,Potential Loyalists
79838,612,2,"127,9",4,1,1,6,Mid-Value,Potential Loyalists
79839,1351,2,"56,349999999999994",2,1,1,4,Low-Value,Can't Lose
79841,60,1,"53,5",5,1,1,7,Mid-Value,Potential Loyalists
79842,652,2,"116,9",4,1,1,6,Mid-Value,Potential Loyalists
79843,1707,1,"5,7",1,1,1,3,Low-Value,Lost
79844,738,4,"229,3",3,1,1,5,Low-Value,At Risk Customers
79845,1097,2,"187,75",2,1,1,4,Low-Value,Can't Lose
79846,604,5,"314,3",4,1,1,6,Mid-Value,Potential Loyalists
79847,37,2,"51,8",5,1,1,7,Mid-Value,Potential Loyalists
79848,829,5,"413,34999999999997",3,1,1,5,Low-Value,At Risk Customers
79849,232,6,"238,1",5,1,1,7,Mid-Value,Potential Loyalists
79851,858,2,"55,8",3,1,1,5,Low-Value,At Risk Customers
79853,179,1,"26,3",5,1,1,7,Mid-Value,Potential Loyalists
79855,7,3,"163,0",5,1,1,7,Mid-Value,Potential Loyalists
79856,1458,2,"34,95",2,1,1,4,Low-Value,Can't Lose
79857,1345,4,"295,6",2,1,1,4,Low-Value,Can't Lose
79858,489,6,"278,0",4,1,1,6,Mid-Value,Potential Loyalists
79861,1636,1,"39,4",1,1,1,3,Low-Value,Lost
79863,352,2,"58,900000000000006",5,1,1,7,Mid-Value,Potential Loyalists
79865,641,1,"15,45",4,1,1,6,Mid-Value,Potential Loyalists
79866,766,6,"366,4",3,1,1,5,Low-Value,At Risk Customers
79867,188,3,"237,20000000000002",5,1,1,7,Mid-Value,Potential Loyalists
79868,79,1,"0,25",5,1,1,7,Mid-Value,Potential Loyalists
79870,830,2,"81,25",3,1,1,5,Low-Value,At Risk Customers
79871,102,3,"201,9",5,1,1,7,Mid-Value,Potential Loyalists
79873,399,4,"333,35",4,1,1,6,Mid-Value,Potential Loyalists
79875,33,10,"413,65000000000003",5,2,1,8,High-Value,Potential Loyalists
79876,160,1,"107,5",5,1,1,7,Mid-Value,Potential Loyalists
79877,442,2,"41,3",4,1,1,6,Mid-Value,Potential Loyalists
79881,843,2,"238,4",3,1,1,5,Low-Value,At Risk Customers
79883,1259,2,"29,4",2,1,1,4,Low-Value,Can't Lose
79884,374,3,"122,35",4,1,1,6,Mid-Value,Potential Loyalists
79885,976,1,"16,3",3,1,1,5,Low-Value,At Risk Customers
79887,597,2,"125,05",4,1,1,6,Mid-Value,Potential Loyalists
79888,701,1,"12,5",4,1,1,6,Mid-Value,Potential Loyalists
79889,553,9,"376,9",4,2,1,7,Mid-Value,Potential Loyalists
79891,1325,3,"79,1",2,1,1,4,Low-Value,Can't Lose
79892,1664,1,"64,5",1,1,1,3,Low-Value,Lost
79895,1268,1,"48,7",2,1,1,4,Low-Value,Can't Lose
79901,526,9,"539,95",4,2,1,7,Mid-Value,Potential Loyalists
79902,142,4,"317,0",5,1,1,7,Mid-Value,Potential Loyalists
79905,1295,3,"49,3",2,1,1,4,Low-Value,Can't Lose
79906,32,10,"1100,55",5,2,2,9,High-Value,Champions
79907,1158,1,"5,1",2,1,1,4,Low-Value,Can't Lose
79909,161,5,"1093,7",5,1,2,8,High-Value,Potential Loyalists
79912,151,3,"111,9",5,1,1,7,Mid-Value,Potential Loyalists
79913,72,9,"278,05",5,2,1,8,High-Value,Potential Loyalists
79914,608,1,"19,4",4,1,1,6,Mid-Value,Potential Loyalists
79917,958,2,"154,15",3,1,1,5,Low-Value,At Risk Customers
79919,184,1,"46,1",5,1,1,7,Mid-Value,Potential Loyalists
79922,434,7,"338,2",4,2,1,7,Mid-Value,Potential Loyalists
79926,382,4,"60,300000000000004",4,1,1,6,Mid-Value,Potential Loyalists
79929,367,7,"302,9",4,2,1,7,Mid-Value,Potential Loyalists
79930,1339,2,"24,450000000000003",2,1,1,4,Low-Value,Can't Lose
79931,449,3,"84,75",4,1,1,6,Mid-Value,Potential Loyalists
79934,407,5,"235,5",4,1,1,6,Mid-Value,Potential Loyalists
79935,553,1,"167,4",4,1,1,6,Mid-Value,Potential Loyalists
79936,225,2,"538,25",5,1,1,7,Mid-Value,Potential Loyalists
79937,1597,2,"175,0",1,1,1,3,Low-Value,Lost
79938,757,2,"222,04999999999998",3,1,1,5,Low-Value,At Risk Customers
79940,319,3,"244,9",5,1,1,7,Mid-Value,Potential Loyalists
79941,1604,1,"53,5",1,1,1,3,Low-Value,Lost
79944,3,3,"172,89999999999998",5,1,1,7,Mid-Value,Potential Loyalists
79945,1463,2,"194,15",1,1,1,3,Low-Value,Lost
79947,1390,1,"72,35",2,1,1,4,Low-Value,Can't Lose
79950,39,5,"270,55",5,1,1,7,Mid-Value,Potential Loyalists
79951,4,6,"944,55",5,1,2,8,High-Value,Potential Loyalists
79952,210,2,"225,6",5,1,1,7,Mid-Value,Potential Loyalists
79955,778,4,"288,0",3,1,1,5,Low-Value,At Risk Customers
79956,409,6,"244,6",4,1,1,6,Mid-Value,Potential Loyalists
79957,449,1,"14,25",4,1,1,6,Mid-Value,Potential Loyalists
79959,762,4,"324,05",3,1,1,5,Low-Value,At Risk Customers
79960,35,7,"276,6",5,2,1,8,High-Value,Potential Loyalists
79961,1429,1,"23,25",2,1,1,4,Low-Value,Can't Lose
79962,536,5,"172,55",4,1,1,6,Mid-Value,Potential Loyalists
79964,858,2,"82,5",3,1,1,5,Low-Value,At Risk Customers
79967,14,8,"255,9",5,2,1,8,High-Value,Potential Loyalists
79968,1459,1,"37,05",2,1,1,4,Low-Value,Can't Lose
79969,185,4,"770,6500000000001",5,1,2,8,High-Value,Potential Loyalists
79970,1208,2,"72,4",2,1,1,4,Low-Value,Can't Lose
79971,1433,2,"28,5",2,1,1,4,Low-Value,Can't Lose
79972,445,2,"125,94999999999999",4,1,1,6,Mid-Value,Potential Loyalists
79975,1666,1,"177,75",1,1,1,3,Low-Value,Lost
79977,272,5,"235,25",5,1,1,7,Mid-Value,Potential Loyalists
79978,73,7,"489,54999999999995",5,2,1,8,High-Value,Potential Loyalists
79980,770,3,"296,35",3,1,1,5,Low-Value,At Risk Customers
79985,181,8,"781,0",5,2,2,9,High-Value,Champions
79986,285,3,"176,65",5,1,1,7,Mid-Value,Potential Loyalists
79987,345,6,"115,55000000000001",5,1,1,7,Mid-Value,Potential Loyalists
79988,902,1,"145,2",3,1,1,5,Low-Value,At Risk Customers
79991,471,3,"348,19999999999993",4,1,1,6,Mid-Value,Potential Loyalists
79992,348,4,"388,50000000000006",5,1,1,7,Mid-Value,Potential Loyalists
79993,127,4,"295,7",5,1,1,7,Mid-Value,Potential Loyalists
79994,27,3,"75,55000000000001",5,1,1,7,Mid-Value,Potential Loyalists
79995,969,1,"33,6",3,1,1,5,Low-Value,At Risk Customers
79997,52,3,"260,2",5,1,1,7,Mid-Value,Potential Loyalists
79998,253,4,"195,85",5,1,1,7,Mid-Value,Potential Loyalists
79999,298,4,"390,1",5,1,1,7,Mid-Value,Potential Loyalists
80001,14,1,"60,5",5,1,1,7,Mid-Value,Potential Loyalists
80002,138,8,"624,45",5,2,1,8,High-Value,Potential Loyalists
80003,129,3,"277,09999999999997",5,1,1,7,Mid-Value,Potential Loyalists
80004,159,3,"103,15",5,1,1,7,Mid-Value,Potential Loyalists
80005,43,4,"94,05",5,1,1,7,Mid-Value,Potential Loyalists
80006,557,3,"204,85",4,1,1,6,Mid-Value,Potential Loyalists
80007,930,3,"200,35",3,1,1,5,Low-Value,At Risk Customers
80008,9,14,"520,45",5,3,1,9,High-Value,Champions
80010,434,1,"162,55",4,1,1,6,Mid-Value,Potential Loyalists
80012,984,1,"16,5",3,1,1,5,Low-Value,At Risk Customers
80013,227,1,"46,25",5,1,1,7,Mid-Value,Potential Loyalists
80014,66,6,"276,85",5,1,1,7,Mid-Value,Potential Loyalists
80016,599,1,"13,9",4,1,1,6,Mid-Value,Potential Loyalists
80018,250,2,"268,55",5,1,1,7,Mid-Value,Potential Loyalists
80019,1201,1,"2,95",2,1,1,4,Low-Value,Can't Lose
80020,811,2,"96,6",3,1,1,5,Low-Value,At Risk Customers
80022,1002,3,"324,0",3,1,1,5,Low-Value,At Risk Customers
80026,382,1,"134,85000000000002",4,1,1,6,Mid-Value,Potential Loyalists
80029,1158,2,"149,65",2,1,1,4,Low-Value,Can't Lose
80030,256,3,"165,35",5,1,1,7,Mid-Value,Potential Loyalists
80032,963,1,"57,35",3,1,1,5,Low-Value,At Risk Customers
80033,619,4,"287,6",4,1,1,6,Mid-Value,Potential Loyalists
80038,1348,1,"49,15",2,1,1,4,Low-Value,Can't Lose
80039,41,2,"132,15",5,1,1,7,Mid-Value,Potential Loyalists
80040,69,4,"138,64999999999998",5,1,1,7,Mid-Value,Potential Loyalists
80042,297,4,"405,35",5,1,1,7,Mid-Value,Potential Loyalists
80043,216,2,"49,75",5,1,1,7,Mid-Value,Potential Loyalists
80047,740,7,"335,04999999999995",3,2,1,6,Mid-Value,Potential Loyalists
80048,711,2,"45,449999999999996",4,1,1,6,Mid-Value,Potential Loyalists
80050,252,6,"519,1",5,1,1,7,Mid-Value,Potential Loyalists
80051,1076,1,"43,55",3,1,1,5,Low-Value,At Risk Customers
80055,538,5,"173,95",4,1,1,6,Mid-Value,Potential Loyalists
80057,726,2,"47,95",4,1,1,6,Mid-Value,Potential Loyalists
80058,1441,2,"90,05",2,1,1,4,Low-Value,Can't Lose
80059,145,9,"490,2",5,2,1,8,High-Value,Potential Loyalists
80060,8,6,"853,2",5,1,2,8,High-Value,Potential Loyalists
80062,69,3,"68,44999999999999",5,1,1,7,Mid-Value,Potential Loyalists
80070,32,5,"362,75",5,1,1,7,Mid-Value,Potential Loyalists
80071,666,2,"81,05",4,1,1,6,Mid-Value,Potential Loyalists
80073,436,3,"283,65",4,1,1,6,Mid-Value,Potential Loyalists
80074,9,3,"342,15",5,1,1,7,Mid-Value,Potential Loyalists
80076,269,9,"622,25",5,2,1,8,High-Value,Potential Loyalists
80077,1754,2,"1499,55",1,1,3,5,Low-Value,At Risk Customers
80079,201,3,"352,9",5,1,1,7,Mid-Value,Potential Loyalists
80080,664,1,"112,85",4,1,1,6,Mid-Value,Potential Loyalists
80081,1014,1,"21,2",3,1,1,5,Low-Value,At Risk Customers
80082,415,3,"123,60000000000001",4,1,1,6,Mid-Value,Potential Loyalists
80084,330,2,"60,9",5,1,1,7,Mid-Value,Potential Loyalists
80089,373,4,"89,4",4,1,1,6,Mid-Value,Potential Loyalists
80092,192,4,"190,35000000000002",5,1,1,7,Mid-Value,Potential Loyalists
80095,775,3,"109,80000000000001",3,1,1,5,Low-Value,At Risk Customers
80096,10,4,"84,0",5,1,1,7,Mid-Value,Potential Loyalists
80099,9,4,"219,6",5,1,1,7,Mid-Value,Potential Loyalists
80103,28,6,"791,25",5,1,2,8,High-Value,Potential Loyalists
80104,666,2,"77,35",4,1,1,6,Mid-Value,Potential Loyalists
80105,641,3,"141,45",4,1,1,6,Mid-Value,Potential Loyalists
80107,35,6,"643,55",5,1,1,7,Mid-Value,Potential Loyalists
80108,194,5,"161,15",5,1,1,7,Mid-Value,Potential Loyalists
80109,682,2,"134,2",4,1,1,6,Mid-Value,Potential Loyalists
80111,830,2,"171,4",3,1,1,5,Low-Value,At Risk Customers
80112,198,3,"83,35",5,1,1,7,Mid-Value,Potential Loyalists
80118,135,2,"59,199999999999996",5,1,1,7,Mid-Value,Potential Loyalists
80121,56,6,"300,4",5,1,1,7,Mid-Value,Potential Loyalists
80122,398,1,"59,65",4,1,1,6,Mid-Value,Potential Loyalists
80124,564,1,"42,9",4,1,1,6,Mid-Value,Potential Loyalists
80126,11,2,"90,7",5,1,1,7,Mid-Value,Potential Loyalists
80130,698,1,"13,55",4,1,1,6,Mid-Value,Potential Loyalists
80133,69,2,"153,39999999999998",5,1,1,7,Mid-Value,Potential Loyalists
80134,709,1,"48,15",4,1,1,6,Mid-Value,Potential Loyalists
80135,130,4,"154,7",5,1,1,7,Mid-Value,Potential Loyalists
80136,102,6,"511,9",5,1,1,7,Mid-Value,Potential Loyalists
80137,658,7,"378,35",4,2,1,7,Mid-Value,Potential Loyalists
80138,1267,3,"190,9",2,1,1,4,Low-Value,Can't Lose
80140,84,1,"21,4",5,1,1,7,Mid-Value,Potential Loyalists
80142,1096,1,"19,35",2,1,1,4,Low-Value,Can't Lose
80143,743,2,"67,05",3,1,1,5,Low-Value,At Risk Customers
80146,1376,2,"82,3",2,1,1,4,Low-Value,Can't Lose
80147,232,1,"275,1",5,1,1,7,Mid-Value,Potential Loyalists
80148,508,3,"140,6",4,1,1,6,Mid-Value,Potential Loyalists
80150,81,1,"20,5",5,1,1,7,Mid-Value,Potential Loyalists
80152,921,3,"167,75",3,1,1,5,Low-Value,At Risk Customers
80154,106,3,"81,0",5,1,1,7,Mid-Value,Potential Loyalists
80156,1397,1,"30,9",2,1,1,4,Low-Value,Can't Lose
80157,349,3,"152,2",5,1,1,7,Mid-Value,Potential Loyalists
80161,430,6,"155,1",4,1,1,6,Mid-Value,Potential Loyalists
80162,865,3,"152,85000000000002",3,1,1,5,Low-Value,At Risk Customers
80164,1556,1,"15,6",1,1,1,3,Low-Value,Lost
80165,56,3,"183,6",5,1,1,7,Mid-Value,Potential Loyalists
80167,732,2,"39,400000000000006",3,1,1,5,Low-Value,At Risk Customers
80168,254,6,"480,15",5,1,1,7,Mid-Value,Potential Loyalists
80172,136,9,"142,45",5,2,1,8,High-Value,Potential Loyalists
80173,381,8,"834,2",4,2,2,8,High-Value,Potential Loyalists
80174,1237,2,"73,35",2,1,1,4,Low-Value,Can't Lose
80175,104,5,"185,99999999999997",5,1,1,7,Mid-Value,Potential Loyalists
80177,801,3,"66,5",3,1,1,5,Low-Value,At Risk Customers
80178,211,5,"730,55",5,1,2,8,High-Value,Potential Loyalists
80179,41,2,"43,05",5,1,1,7,Mid-Value,Potential Loyalists
80180,1238,2,"124,5",2,1,1,4,Low-Value,Can't Lose
80181,1378,1,"19,25",2,1,1,4,Low-Value,Can't Lose
80182,488,1,"37,7",4,1,1,6,Mid-Value,Potential Loyalists
80186,21,1,"7,8",5,1,1,7,Mid-Value,Potential Loyalists
80187,379,1,"188,7",4,1,1,6,Mid-Value,Potential Loyalists
80188,386,2,"103,1",4,1,1,6,Mid-Value,Potential Loyalists
80189,1364,1,"469,6",2,1,1,4,Low-Value,Can't Lose
80192,955,1,"26,6",3,1,1,5,Low-Value,At Risk Customers
80193,403,3,"133,5",4,1,1,6,Mid-Value,Potential Loyalists
80195,29,7,"492,8",5,2,1,8,High-Value,Potential Loyalists
80196,1179,6,"264,75",2,1,1,4,Low-Value,Can't Lose
80197,1217,1,"36,7",2,1,1,4,Low-Value,Can't Lose
80202,97,4,"124,0",5,1,1,7,Mid-Value,Potential Loyalists
80203,217,1,"145,2",5,1,1,7,Mid-Value,Potential Loyalists
80204,139,1,"336,1",5,1,1,7,Mid-Value,Potential Loyalists
80206,92,6,"297,0",5,1,1,7,Mid-Value,Potential Loyalists
80208,431,2,"22,049999999999997",4,1,1,6,Mid-Value,Potential Loyalists
80209,743,3,"164,85",3,1,1,5,Low-Value,At Risk Customers
80211,476,2,"100,0",4,1,1,6,Mid-Value,Potential Loyalists
80212,731,3,"266,4",3,1,1,5,Low-Value,At Risk Customers
80213,1631,1,"54,2",1,1,1,3,Low-Value,Lost
80214,313,3,"230,5",5,1,1,7,Mid-Value,Potential Loyalists
80216,3,6,"127,75",5,1,1,7,Mid-Value,Potential Loyalists
80218,1165,2,"13,7",2,1,1,4,Low-Value,Can't Lose
80219,1598,1,"100,2",1,1,1,3,Low-Value,Lost
80224,5,4,"219,5",5,1,1,7,Mid-Value,Potential Loyalists
80225,195,5,"289,95",5,1,1,7,Mid-Value,Potential Loyalists
80227,50,9,"467,4",5,2,1,8,High-Value,Potential Loyalists
80229,1158,3,"200,89999999999998",2,1,1,4,Low-Value,Can't Lose
80233,586,1,"31,95",4,1,1,6,Mid-Value,Potential Loyalists
80234,158,2,"33,3",5,1,1,7,Mid-Value,Potential Loyalists
80235,231,4,"370,7",5,1,1,7,Mid-Value,Potential Loyalists
80236,865,1,"46,9",3,1,1,5,Low-Value,At Risk Customers
80237,515,3,"144,25",4,1,1,6,Mid-Value,Potential Loyalists
80240,335,7,"116,45",5,2,1,8,High-Value,Potential Loyalists
80242,84,12,"559,45",5,3,1,9,High-Value,Champions
80243,490,3,"189,89999999999998",4,1,1,6,Mid-Value,Potential Loyalists
80244,143,9,"428,5",5,2,1,8,High-Value,Potential Loyalists
80245,17,9,"475,95",5,2,1,8,High-Value,Potential Loyalists
80246,938,4,"146,64999999999998",3,1,1,5,Low-Value,At Risk Customers
80247,398,2,"102,7",4,1,1,6,Mid-Value,Potential Loyalists
80248,128,2,"97,6",5,1,1,7,Mid-Value,Potential Loyalists
80249,1651,1,"21,75",1,1,1,3,Low-Value,Lost
80253,867,4,"121,05",3,1,1,5,Low-Value,At Risk Customers
80255,520,4,"344,55",4,1,1,6,Mid-Value,Potential Loyalists
80257,987,1,"26,65",3,1,1,5,Low-Value,At Risk Customers
80258,796,4,"206,1",3,1,1,5,Low-Value,At Risk Customers
80260,878,2,"160,0",3,1,1,5,Low-Value,At Risk Customers
80261,1582,1,"35,8",1,1,1,3,Low-Value,Lost
80262,34,5,"548,8",5,1,1,7,Mid-Value,Potential Loyalists
80263,257,3,"106,55",5,1,1,7,Mid-Value,Potential Loyalists
80264,996,3,"151,85",3,1,1,5,Low-Value,At Risk Customers
80267,58,1,"14,4",5,1,1,7,Mid-Value,Potential Loyalists
80268,851,5,"258,2",3,1,1,5,Low-Value,At Risk Customers
80269,1298,1,"358,2",2,1,1,4,Low-Value,Can't Lose
80270,14,7,"463,35",5,2,1,8,High-Value,Potential Loyalists
80271,587,2,"64,10000000000001",4,1,1,6,Mid-Value,Potential Loyalists
80272,18,4,"300,2",5,1,1,7,Mid-Value,Potential Loyalists
80273,1586,1,"6,05",1,1,1,3,Low-Value,Lost
80275,277,13,"928,25",5,3,2,10,High-Value,Champions
80277,460,7,"484,0",4,2,1,7,Mid-Value,Potential Loyalists
80278,747,1,"91,5",3,1,1,5,Low-Value,At Risk Customers
80280,147,2,"165,04999999999998",5,1,1,7,Mid-Value,Potential Loyalists
80281,545,1,"12,1",4,1,1,6,Mid-Value,Potential Loyalists
80284,617,3,"203,25",4,1,1,6,Mid-Value,Potential Loyalists
80286,561,2,"296,1",4,1,1,6,Mid-Value,Potential Loyalists
80288,1407,1,"38,7",2,1,1,4,Low-Value,Can't Lose
80290,427,1,"256,45",4,1,1,6,Mid-Value,Potential Loyalists
80291,377,4,"650,5",4,1,1,6,Mid-Value,Potential Loyalists
80292,1791,1,"10,05",1,1,1,3,Low-Value,Lost
80295,401,6,"580,4",4,1,1,6,Mid-Value,Potential Loyalists
80297,673,1,"53,1",4,1,1,6,Mid-Value,Potential Loyalists
80300,71,7,"502,95",5,2,1,8,High-Value,Potential Loyalists
80301,1589,1,"26,8",1,1,1,3,Low-Value,Lost
80302,283,5,"289,2",5,1,1,7,Mid-Value,Potential Loyalists
80305,20,3,"223,39999999999998",5,1,1,7,Mid-Value,Potential Loyalists
80306,20,5,"164,65",5,1,1,7,Mid-Value,Potential Loyalists
80311,1463,1,"33,0",1,1,1,3,Low-Value,Lost
80312,175,1,"366,8",5,1,1,7,Mid-Value,Potential Loyalists
80313,76,3,"51,3",5,1,1,7,Mid-Value,Potential Loyalists
80317,1262,2,"378,4",2,1,1,4,Low-Value,Can't Lose
80318,758,6,"821,0",3,1,2,6,Mid-Value,Potential Loyalists
80320,1821,1,"90,7",1,1,1,3,Low-Value,Lost
80321,917,7,"1287,4",3,2,2,7,Mid-Value,Potential Loyalists
80322,1138,2,"161,15",2,1,1,4,Low-Value,Can't Lose
80323,64,3,"194,8",5,1,1,7,Mid-Value,Potential Loyalists
80326,25,2,"45,7",5,1,1,7,Mid-Value,Potential Loyalists
80330,491,8,"466,0",4,2,1,7,Mid-Value,Potential Loyalists
80332,166,3,"265,15",5,1,1,7,Mid-Value,Potential Loyalists
80333,63,6,"236,5",5,1,1,7,Mid-Value,Potential Loyalists
80336,753,1,"142,2",3,1,1,5,Low-Value,At Risk Customers
80338,1189,2,"78,5",2,1,1,4,Low-Value,Can't Lose
80342,165,6,"525,6",5,1,1,7,Mid-Value,Potential Loyalists
80343,346,2,"69,7",5,1,1,7,Mid-Value,Potential Loyalists
80346,1821,1,"32,4",1,1,1,3,Low-Value,Lost
80347,401,5,"209,65",4,1,1,6,Mid-Value,Potential Loyalists
80352,161,2,"316,0",5,1,1,7,Mid-Value,Potential Loyalists
80353,173,4,"278,85",5,1,1,7,Mid-Value,Potential Loyalists
80354,439,3,"188,9",4,1,1,6,Mid-Value,Potential Loyalists
80357,105,8,"282,0",5,2,1,8,High-Value,Potential Loyalists
80358,103,1,"122,0",5,1,1,7,Mid-Value,Potential Loyalists
80359,995,6,"423,85",3,1,1,5,Low-Value,At Risk Customers
80360,79,6,"446,1",5,1,1,7,Mid-Value,Potential Loyalists
80362,350,4,"364,7",5,1,1,7,Mid-Value,Potential Loyalists
80364,663,5,"177,2",4,1,1,6,Mid-Value,Potential Loyalists
80366,587,1,"44,3",4,1,1,6,Mid-Value,Potential Loyalists
80370,1321,2,"134,8",2,1,1,4,Low-Value,Can't Lose
80371,943,1,"19,6",3,1,1,5,Low-Value,At Risk Customers
80372,323,1,"103,4",5,1,1,7,Mid-Value,Potential Loyalists
80374,1620,1,"57,4",1,1,1,3,Low-Value,Lost
80376,247,2,"40,599999999999994",5,1,1,7,Mid-Value,Potential Loyalists
80378,1358,1,"30,75",2,1,1,4,Low-Value,Can't Lose
80381,1167,1,"287,1",2,1,1,4,Low-Value,Can't Lose
80386,1030,5,"303,1",3,1,1,5,Low-Value,At Risk Customers
80387,159,2,"106,5",5,1,1,7,Mid-Value,Potential Loyalists
80388,31,11,"641,6999999999999",5,2,1,8,High-Value,Potential Loyalists
80389,505,3,"88,5",4,1,1,6,Mid-Value,Potential Loyalists
80390,245,2,"130,95",5,1,1,7,Mid-Value,Potential Loyalists
80391,644,2,"25,900000000000002",4,1,1,6,Mid-Value,Potential Loyalists
80392,196,2,"86,4",5,1,1,7,Mid-Value,Potential Loyalists
80393,963,3,"101,2",3,1,1,5,Low-Value,At Risk Customers
80394,317,5,"244,3",5,1,1,7,Mid-Value,Potential Loyalists
80395,731,7,"291,05",3,2,1,6,Mid-Value,Potential Loyalists
80396,752,6,"228,0",3,1,1,5,Low-Value,At Risk Customers
80399,690,3,"1098,7",4,1,2,7,Mid-Value,Potential Loyalists
80400,154,2,"78,0",5,1,1,7,Mid-Value,Potential Loyalists
80401,1224,3,"169,3",2,1,1,4,Low-Value,Can't Lose
80402,894,1,"291,0",3,1,1,5,Low-Value,At Risk Customers
80404,723,1,"5,15",4,1,1,6,Mid-Value,Potential Loyalists
80405,600,3,"132,65",4,1,1,6,Mid-Value,Potential Loyalists
80406,1003,4,"92,44999999999999",3,1,1,5,Low-Value,At Risk Customers
80407,50,6,"215,9",5,1,1,7,Mid-Value,Potential Loyalists
80408,1446,2,"128,35",2,1,1,4,Low-Value,Can't Lose
80409,783,2,"255,25",3,1,1,5,Low-Value,At Risk Customers
80412,460,3,"261,9",4,1,1,6,Mid-Value,Potential Loyalists
80414,8,2,"47,4",5,1,1,7,Mid-Value,Potential Loyalists
80415,97,10,"646,1",5,2,1,8,High-Value,Potential Loyalists
80416,59,4,"212,4",5,1,1,7,Mid-Value,Potential Loyalists
80419,490,2,"35,849999999999994",4,1,1,6,Mid-Value,Potential Loyalists
80420,794,1,"49,5",3,1,1,5,Low-Value,At Risk Customers
80421,963,1,"453,5",3,1,1,5,Low-Value,At Risk Customers
80427,602,5,"217,65",4,1,1,6,Mid-Value,Potential Loyalists
80428,504,2,"144,25",4,1,1,6,Mid-Value,Potential Loyalists
80429,1818,1,"54,75",1,1,1,3,Low-Value,Lost
80430,267,1,"149,9",5,1,1,7,Mid-Value,Potential Loyalists
80431,19,5,"201,35",5,1,1,7,Mid-Value,Potential Loyalists
80432,134,7,"263,5",5,2,1,8,High-Value,Potential Loyalists
80433,860,1,"29,6",3,1,1,5,Low-Value,At Risk Customers
80434,170,6,"494,7",5,1,1,7,Mid-Value,Potential Loyalists
80436,300,3,"66,95",5,1,1,7,Mid-Value,Potential Loyalists
80437,509,3,"143,0",4,1,1,6,Mid-Value,Potential Loyalists
80438,138,2,"60,35",5,1,1,7,Mid-Value,Potential Loyalists
80439,49,1,"62,9",5,1,1,7,Mid-Value,Potential Loyalists
80441,2,12,"1530,6000000000001",5,3,3,11,High-Value,Champions
80442,1291,1,"239,25",2,1,1,4,Low-Value,Can't Lose
80443,273,2,"63,15",5,1,1,7,Mid-Value,Potential Loyalists
80444,164,5,"201,8",5,1,1,7,Mid-Value,Potential Loyalists
80445,34,8,"539,85",5,2,1,8,High-Value,Potential Loyalists
80446,20,7,"871,5",5,2,2,9,High-Value,Champions
80448,614,2,"137,35",4,1,1,6,Mid-Value,Potential Loyalists
80449,9,6,"192,35000000000002",5,1,1,7,Mid-Value,Potential Loyalists
80450,583,2,"19,25",4,1,1,6,Mid-Value,Potential Loyalists
80451,185,6,"246,45",5,1,1,7,Mid-Value,Potential Loyalists
80452,1282,3,"112,55",2,1,1,4,Low-Value,Can't Lose
80453,328,1,"20,75",5,1,1,7,Mid-Value,Potential Loyalists
80454,401,3,"173,95",4,1,1,6,Mid-Value,Potential Loyalists
80460,680,1,"38,6",4,1,1,6,Mid-Value,Potential Loyalists
80462,64,4,"773,25",5,1,2,8,High-Value,Potential Loyalists
80464,24,3,"206,75",5,1,1,7,Mid-Value,Potential Loyalists
80465,1142,1,"92,1",2,1,1,4,Low-Value,Can't Lose
80466,157,4,"247,35000000000002",5,1,1,7,Mid-Value,Potential Loyalists
80467,238,2,"26,400000000000002",5,1,1,7,Mid-Value,Potential Loyalists
80470,693,1,"83,8",4,1,1,6,Mid-Value,Potential Loyalists
80472,328,1,"263,4",5,1,1,7,Mid-Value,Potential Loyalists
80474,189,5,"197,4",5,1,1,7,Mid-Value,Potential Loyalists
80475,61,6,"264,15",5,1,1,7,Mid-Value,Potential Loyalists
80476,263,2,"156,40000000000003",5,1,1,7,Mid-Value,Potential Loyalists
80477,175,1,"5,9",5,1,1,7,Mid-Value,Potential Loyalists
80478,370,6,"267,45",4,1,1,6,Mid-Value,Potential Loyalists
80479,1480,1,"38,55",1,1,1,3,Low-Value,Lost
80480,494,1,"20,9",4,1,1,6,Mid-Value,Potential Loyalists
80483,436,2,"50,0",4,1,1,6,Mid-Value,Potential Loyalists
80484,1343,1,"31,2",2,1,1,4,Low-Value,Can't Lose
80486,410,3,"185,95",4,1,1,6,Mid-Value,Potential Loyalists
80487,22,6,"448,9",5,1,1,7,Mid-Value,Potential Loyalists
80488,178,5,"329,90000000000003",5,1,1,7,Mid-Value,Potential Loyalists
80489,98,5,"196,45",5,1,1,7,Mid-Value,Potential Loyalists
80490,1351,1,"1,5",2,1,1,4,Low-Value,Can't Lose
80491,114,1,"16,2",5,1,1,7,Mid-Value,Potential Loyalists
80494,501,7,"389,25",4,2,1,7,Mid-Value,Potential Loyalists
80496,1368,1,"47,1",2,1,1,4,Low-Value,Can't Lose
80499,564,3,"162,89999999999998",4,1,1,6,Mid-Value,Potential Loyalists
80500,1065,1,"7,9",3,1,1,5,Low-Value,At Risk Customers
80501,989,1,"4,45",3,1,1,5,Low-Value,At Risk Customers
80502,1622,2,"46,9",1,1,1,3,Low-Value,Lost
80504,591,2,"119,35",4,1,1,6,Mid-Value,Potential Loyalists
80505,5,6,"295,65",5,1,1,7,Mid-Value,Potential Loyalists
80507,218,9,"454,29999999999995",5,2,1,8,High-Value,Potential Loyalists
80508,631,3,"85,75",4,1,1,6,Mid-Value,Potential Loyalists
80509,409,1,"20,4",4,1,1,6,Mid-Value,Potential Loyalists
80511,244,7,"302,0",5,2,1,8,High-Value,Potential Loyalists
80512,57,5,"190,25",5,1,1,7,Mid-Value,Potential Loyalists
80513,787,4,"151,8",3,1,1,5,Low-Value,At Risk Customers
80514,1578,1,"69,6",1,1,1,3,Low-Value,Lost
80515,437,3,"191,45",4,1,1,6,Mid-Value,Potential Loyalists
80516,1040,2,"59,949999999999996",3,1,1,5,Low-Value,At Risk Customers
80517,146,7,"436,04999999999995",5,2,1,8,High-Value,Potential Loyalists
80518,867,1,"71,9",3,1,1,5,Low-Value,At Risk Customers
80519,1552,2,"251,4",1,1,1,3,Low-Value,Lost
80521,106,7,"326,6",5,2,1,8,High-Value,Potential Loyalists
80523,952,2,"33,45",3,1,1,5,Low-Value,At Risk Customers
80527,30,7,"359,05",5,2,1,8,High-Value,Potential Loyalists
80528,14,6,"215,65",5,1,1,7,Mid-Value,Potential Loyalists
80529,856,2,"40,9",3,1,1,5,Low-Value,At Risk Customers
80535,20,5,"259,90000000000003",5,1,1,7,Mid-Value,Potential Loyalists
80537,508,4,"591,5",4,1,1,6,Mid-Value,Potential Loyalists
80541,1544,2,"274,05",1,1,1,3,Low-Value,Lost
80542,302,1,"116,05",5,1,1,7,Mid-Value,Potential Loyalists
80545,1532,1,"89,0",1,1,1,3,Low-Value,Lost
80547,271,2,"207,55",5,1,1,7,Mid-Value,Potential Loyalists
80549,12,6,"104,95",5,1,1,7,Mid-Value,Potential Loyalists
80550,304,4,"110,05",5,1,1,7,Mid-Value,Potential Loyalists
80552,224,4,"189,54999999999998",5,1,1,7,Mid-Value,Potential Loyalists
80553,84,4,"124,5",5,1,1,7,Mid-Value,Potential Loyalists
80554,107,6,"162,5",5,1,1,7,Mid-Value,Potential Loyalists
80555,23,7,"1014,7",5,2,2,9,High-Value,Champions
80557,41,5,"161,0",5,1,1,7,Mid-Value,Potential Loyalists
80559,1239,1,"115,7",2,1,1,4,Low-Value,Can't Lose
80560,187,5,"205,45",5,1,1,7,Mid-Value,Potential Loyalists
80562,75,6,"260,8",5,1,1,7,Mid-Value,Potential Loyalists
80564,1247,1,"83,2",2,1,1,4,Low-Value,Can't Lose
80565,618,3,"83,85",4,1,1,6,Mid-Value,Potential Loyalists
80566,482,3,"238,79999999999998",4,1,1,6,Mid-Value,Potential Loyalists
80569,892,3,"115,9",3,1,1,5,Low-Value,At Risk Customers
80571,1159,3,"60,099999999999994",2,1,1,4,Low-Value,Can't Lose
80572,531,2,"72,7",4,1,1,6,Mid-Value,Potential Loyalists
80573,554,3,"123,14999999999999",4,1,1,6,Mid-Value,Potential Loyalists
80579,222,3,"632,7",5,1,1,7,Mid-Value,Potential Loyalists
80583,560,2,"29,799999999999997",4,1,1,6,Mid-Value,Potential Loyalists
80585,1240,1,"29,700000000000003",2,1,1,4,Low-Value,Can't Lose
80586,475,4,"233,20000000000002",4,1,1,6,Mid-Value,Potential Loyalists
80588,45,3,"58,2",5,1,1,7,Mid-Value,Potential Loyalists
80589,1628,2,"497,7",1,1,1,3,Low-Value,Lost
80592,30,4,"97,75",5,1,1,7,Mid-Value,Potential Loyalists
80593,1208,2,"65,25",2,1,1,4,Low-Value,Can't Lose
80597,973,5,"105,45",3,1,1,5,Low-Value,At Risk Customers
80599,83,7,"494,09999999999997",5,2,1,8,High-Value,Potential Loyalists
80600,19,5,"557,35",5,1,1,7,Mid-Value,Potential Loyalists
80603,11,3,"366,1",5,1,1,7,Mid-Value,Potential Loyalists
80604,1565,3,"54,800000000000004",1,1,1,3,Low-Value,Lost
80607,413,2,"27,549999999999997",4,1,1,6,Mid-Value,Potential Loyalists
80608,112,2,"43,599999999999994",5,1,1,7,Mid-Value,Potential Loyalists
80609,404,2,"183,7",4,1,1,6,Mid-Value,Potential Loyalists
80612,98,2,"58,7",5,1,1,7,Mid-Value,Potential Loyalists
80613,39,2,"109,65",5,1,1,7,Mid-Value,Potential Loyalists
80614,1462,10,"494,3",1,2,1,4,Low-Value,Can't Lose
80616,1505,1,"5,95",1,1,1,3,Low-Value,Lost
80617,1256,3,"108,1",2,1,1,4,Low-Value,Can't Lose
80618,192,5,"312,2",5,1,1,7,Mid-Value,Potential Loyalists
80621,93,7,"362,3",5,2,1,8,High-Value,Potential Loyalists
80625,123,5,"299,90000000000003",5,1,1,7,Mid-Value,Potential Loyalists
80626,112,1,"479,2",5,1,1,7,Mid-Value,Potential Loyalists
80628,5,5,"104,25",5,1,1,7,Mid-Value,Potential Loyalists
80631,545,3,"600,5500000000001",4,1,1,6,Mid-Value,Potential Loyalists
80632,980,3,"61,75",3,1,1,5,Low-Value,At Risk Customers
80633,1462,1,"6,5",1,1,1,3,Low-Value,Lost
80635,444,2,"56,849999999999994",4,1,1,6,Mid-Value,Potential Loyalists
80637,78,12,"383,0",5,3,1,9,High-Value,Champions
80638,1756,1,"45,75",1,1,1,3,Low-Value,Lost
80639,685,2,"148,5",4,1,1,6,Mid-Value,Potential Loyalists
80642,405,7,"295,55",4,2,1,7,Mid-Value,Potential Loyalists
80643,402,3,"248,85000000000002",4,1,1,6,Mid-Value,Potential Loyalists
80647,387,4,"243,8",4,1,1,6,Mid-Value,Potential Loyalists
80649,247,4,"260,2",5,1,1,7,Mid-Value,Potential Loyalists
80650,1323,2,"588,85",2,1,1,4,Low-Value,Can't Lose
80651,779,1,"20,0",3,1,1,5,Low-Value,At Risk Customers
80653,179,2,"188,25",5,1,1,7,Mid-Value,Potential Loyalists
80657,1468,1,"48,449999999999996",1,1,1,3,Low-Value,Lost
80658,923,4,"415,0",3,1,1,5,Low-Value,At Risk Customers
80659,3,6,"661,95",5,1,1,7,Mid-Value,Potential Loyalists
80661,418,1,"75,9",4,1,1,6,Mid-Value,Potential Loyalists
80662,1690,1,"22,6",1,1,1,3,Low-Value,Lost
80663,229,3,"133,4",5,1,1,7,Mid-Value,Potential Loyalists
80667,185,2,"136,95",5,1,1,7,Mid-Value,Potential Loyalists
80670,97,4,"579,85",5,1,1,7,Mid-Value,Potential Loyalists
80671,48,2,"68,1",5,1,1,7,Mid-Value,Potential Loyalists
80673,382,6,"315,6",4,1,1,6,Mid-Value,Potential Loyalists
80674,15,5,"184,7",5,1,1,7,Mid-Value,Potential Loyalists
80675,1051,1,"47,5",3,1,1,5,Low-Value,At Risk Customers
80677,572,1,"12,1",4,1,1,6,Mid-Value,Potential Loyalists
80678,192,5,"467,0",5,1,1,7,Mid-Value,Potential Loyalists
80681,83,7,"325,05",5,2,1,8,High-Value,Potential Loyalists
80685,2,3,"94,89999999999999",5,1,1,7,Mid-Value,Potential Loyalists
80686,530,4,"45,3",4,1,1,6,Mid-Value,Potential Loyalists
80687,369,8,"791,3000000000001",4,2,2,8,High-Value,Potential Loyalists
80691,695,2,"46,25",4,1,1,6,Mid-Value,Potential Loyalists
80695,1329,1,"12,95",2,1,1,4,Low-Value,Can't Lose
80698,168,5,"308,7",5,1,1,7,Mid-Value,Potential Loyalists
80699,21,5,"230,39999999999998",5,1,1,7,Mid-Value,Potential Loyalists
80700,37,14,"1275,65",5,3,2,10,High-Value,Champions
80701,132,6,"335,65",5,1,1,7,Mid-Value,Potential Loyalists
80702,492,3,"137,4",4,1,1,6,Mid-Value,Potential Loyalists
80703,1608,1,"45,6",1,1,1,3,Low-Value,Lost
80704,379,3,"107,7",4,1,1,6,Mid-Value,Potential Loyalists
80705,1326,1,"258,9",2,1,1,4,Low-Value,Can't Lose
80706,325,5,"306,1",5,1,1,7,Mid-Value,Potential Loyalists
80707,496,2,"135,6",4,1,1,6,Mid-Value,Potential Loyalists
80708,159,4,"88,1",5,1,1,7,Mid-Value,Potential Loyalists
80709,173,4,"437,8",5,1,1,7,Mid-Value,Potential Loyalists
80710,311,8,"379,3",5,2,1,8,High-Value,Potential Loyalists
80712,1802,1,"39,3",1,1,1,3,Low-Value,Lost
80714,668,1,"73,85",4,1,1,6,Mid-Value,Potential Loyalists
80715,519,6,"139,2",4,1,1,6,Mid-Value,Potential Loyalists
80717,755,1,"70,6",3,1,1,5,Low-Value,At Risk Customers
80718,227,3,"400,25000000000006",5,1,1,7,Mid-Value,Potential Loyalists
80719,64,8,"265,6",5,2,1,8,High-Value,Potential Loyalists
80720,322,2,"57,7",5,1,1,7,Mid-Value,Potential Loyalists
80721,78,4,"107,5",5,1,1,7,Mid-Value,Potential Loyalists
80724,1668,1,"48,2",1,1,1,3,Low-Value,Lost
80725,442,4,"205,20000000000002",4,1,1,6,Mid-Value,Potential Loyalists
80726,86,6,"637,45",5,1,1,7,Mid-Value,Potential Loyalists
80727,149,2,"40,4",5,1,1,7,Mid-Value,Potential Loyalists
80728,379,5,"288,75",4,1,1,6,Mid-Value,Potential Loyalists
80730,1256,2,"98,05000000000001",2,1,1,4,Low-Value,Can't Lose
80733,593,2,"730,5",4,1,2,7,Mid-Value,Potential Loyalists
80735,129,2,"32,3",5,1,1,7,Mid-Value,Potential Loyalists
80738,17,3,"93,3",5,1,1,7,Mid-Value,Potential Loyalists
80739,81,3,"198,7",5,1,1,7,Mid-Value,Potential Loyalists
80740,83,2,"30,950000000000003",5,1,1,7,Mid-Value,Potential Loyalists
80742,406,2,"129,95",4,1,1,6,Mid-Value,Potential Loyalists
80743,1548,1,"9,65",1,1,1,3,Low-Value,Lost
80747,165,1,"75,9",5,1,1,7,Mid-Value,Potential Loyalists
80749,1547,1,"316,2",1,1,1,3,Low-Value,Lost
80750,902,6,"283,65",3,1,1,5,Low-Value,At Risk Customers
80751,53,7,"368,2",5,2,1,8,High-Value,Potential Loyalists
80752,39,3,"29,25",5,1,1,7,Mid-Value,Potential Loyalists
80756,406,4,"81,25",4,1,1,6,Mid-Value,Potential Loyalists
80758,90,2,"28,700000000000003",5,1,1,7,Mid-Value,Potential Loyalists
80761,934,1,"50,1",3,1,1,5,Low-Value,At Risk Customers
80762,627,1,"18,3",4,1,1,6,Mid-Value,Potential Loyalists
80763,762,1,"38,6",3,1,1,5,Low-Value,At Risk Customers
80764,114,6,"539,8499999999999",5,1,1,7,Mid-Value,Potential Loyalists
80766,51,3,"72,75",5,1,1,7,Mid-Value,Potential Loyalists
80767,557,2,"138,9",4,1,1,6,Mid-Value,Potential Loyalists
80769,166,5,"116,25",5,1,1,7,Mid-Value,Potential Loyalists
80773,947,1,"82,85",3,1,1,5,Low-Value,At Risk Customers
80774,523,1,"83,3",4,1,1,6,Mid-Value,Potential Loyalists
80775,250,5,"273,35",5,1,1,7,Mid-Value,Potential Loyalists
80776,1127,5,"411,6",2,1,1,4,Low-Value,Can't Lose
80777,532,6,"123,39999999999999",4,1,1,6,Mid-Value,Potential Loyalists
80778,1411,1,"36,599999999999994",2,1,1,4,Low-Value,Can't Lose
80781,79,1,"41,2",5,1,1,7,Mid-Value,Potential Loyalists
80783,88,5,"198,75",5,1,1,7,Mid-Value,Potential Loyalists
80785,874,2,"92,2",3,1,1,5,Low-Value,At Risk Customers
80786,154,2,"165,7",5,1,1,7,Mid-Value,Potential Loyalists
80791,822,2,"67,3",3,1,1,5,Low-Value,At Risk Customers
80792,43,9,"375,6",5,2,1,8,High-Value,Potential Loyalists
80793,34,7,"1167,05",5,2,2,9,High-Value,Champions
80794,43,3,"70,3",5,1,1,7,Mid-Value,Potential Loyalists
80797,1073,2,"28,6",3,1,1,5,Low-Value,At Risk Customers
80798,1030,3,"132,0",3,1,1,5,Low-Value,At Risk Customers
80799,1128,4,"131,79999999999998",2,1,1,4,Low-Value,Can't Lose
80800,2,2,"174,3",5,1,1,7,Mid-Value,Potential Loyalists
80807,582,2,"55,00000000000001",4,1,1,6,Mid-Value,Potential Loyalists
80808,476,5,"138,25",4,1,1,6,Mid-Value,Potential Loyalists
80809,994,3,"141,9",3,1,1,5,Low-Value,At Risk Customers
80810,368,3,"122,6",4,1,1,6,Mid-Value,Potential Loyalists
80813,149,2,"127,6",5,1,1,7,Mid-Value,Potential Loyalists
80814,196,1,"27,450000000000003",5,1,1,7,Mid-Value,Potential Loyalists
80815,56,2,"9,85",5,1,1,7,Mid-Value,Potential Loyalists
80818,616,6,"225,65",4,1,1,6,Mid-Value,Potential Loyalists
80824,493,2,"286,0",4,1,1,6,Mid-Value,Potential Loyalists
80825,2,8,"525,0",5,2,1,8,High-Value,Potential Loyalists
80827,10,9,"1326,85",5,2,3,10,High-Value,Champions
80828,1278,4,"196,35",2,1,1,4,Low-Value,Can't Lose
80830,139,4,"147,55",5,1,1,7,Mid-Value,Potential Loyalists
80833,452,1,"34,35",4,1,1,6,Mid-Value,Potential Loyalists
80834,975,1,"25,95",3,1,1,5,Low-Value,At Risk Customers
80835,984,1,"10,15",3,1,1,5,Low-Value,At Risk Customers
80836,486,5,"106,4",4,1,1,6,Mid-Value,Potential Loyalists
80839,644,1,"23,35",4,1,1,6,Mid-Value,Potential Loyalists
80840,483,3,"97,75",4,1,1,6,Mid-Value,Potential Loyalists
80842,273,2,"34,7",5,1,1,7,Mid-Value,Potential Loyalists
80844,934,1,"58,650000000000006",3,1,1,5,Low-Value,At Risk Customers
80847,758,1,"86,6",3,1,1,5,Low-Value,At Risk Customers
80849,332,3,"128,4",5,1,1,7,Mid-Value,Potential Loyalists
80852,885,1,"43,349999999999994",3,1,1,5,Low-Value,At Risk Customers
80853,882,1,"75,15",3,1,1,5,Low-Value,At Risk Customers
80854,861,3,"1113,8",3,1,2,6,Mid-Value,Potential Loyalists
80855,1788,1,"20,0",1,1,1,3,Low-Value,Lost
80858,690,1,"225,7",4,1,1,6,Mid-Value,Potential Loyalists
80859,110,5,"252,95",5,1,1,7,Mid-Value,Potential Loyalists
80861,1207,3,"841,6",2,1,2,5,Low-Value,At Risk Customers
80864,134,2,"88,80000000000001",5,1,1,7,Mid-Value,Potential Loyalists
80865,350,8,"471,55",5,2,1,8,High-Value,Potential Loyalists
80866,591,2,"54,75",4,1,1,6,Mid-Value,Potential Loyalists
80869,199,1,"85,5",5,1,1,7,Mid-Value,Potential Loyalists
80872,14,11,"702,15",5,2,2,9,High-Value,Champions
80873,1156,1,"7,65",2,1,1,4,Low-Value,Can't Lose
80874,100,3,"32,85",5,1,1,7,Mid-Value,Potential Loyalists
80876,448,11,"452,7",4,2,1,7,Mid-Value,Potential Loyalists
80877,133,5,"172,7",5,1,1,7,Mid-Value,Potential Loyalists
80878,858,3,"88,7",3,1,1,5,Low-Value,At Risk Customers
80879,255,2,"26,049999999999997",5,1,1,7,Mid-Value,Potential Loyalists
80880,247,2,"139,8",5,1,1,7,Mid-Value,Potential Loyalists
80881,444,2,"95,05",4,1,1,6,Mid-Value,Potential Loyalists
80882,721,2,"99,2",4,1,1,6,Mid-Value,Potential Loyalists
80884,344,4,"452,5",5,1,1,7,Mid-Value,Potential Loyalists
80885,472,6,"661,25",4,1,1,6,Mid-Value,Potential Loyalists
80888,333,1,"60,2",5,1,1,7,Mid-Value,Potential Loyalists
80893,28,5,"296,3",5,1,1,7,Mid-Value,Potential Loyalists
80894,47,2,"17,0",5,1,1,7,Mid-Value,Potential Loyalists
80895,771,1,"28,3",3,1,1,5,Low-Value,At Risk Customers
80896,794,2,"23,25",3,1,1,5,Low-Value,At Risk Customers
80899,179,2,"79,6",5,1,1,7,Mid-Value,Potential Loyalists
80901,56,7,"290,4",5,2,1,8,High-Value,Potential Loyalists
80902,873,3,"499,0",3,1,1,5,Low-Value,At Risk Customers
80903,7,2,"97,65",5,1,1,7,Mid-Value,Potential Loyalists
80904,1268,4,"105,35",2,1,1,4,Low-Value,Can't Lose
80905,1188,1,"23,0",2,1,1,4,Low-Value,Can't Lose
80906,1164,1,"18,15",2,1,1,4,Low-Value,Can't Lose
80907,804,2,"146,65",3,1,1,5,Low-Value,At Risk Customers
80908,125,8,"284,45",5,2,1,8,High-Value,Potential Loyalists
80909,24,2,"100,9",5,1,1,7,Mid-Value,Potential Loyalists
80910,406,4,"100,25",4,1,1,6,Mid-Value,Potential Loyalists
80912,439,3,"140,3",4,1,1,6,Mid-Value,Potential Loyalists
80914,420,3,"435,54999999999995",4,1,1,6,Mid-Value,Potential Loyalists
80918,612,2,"75,74999999999999",4,1,1,6,Mid-Value,Potential Loyalists
80920,1699,2,"17,85",1,1,1,3,Low-Value,Lost
80926,266,1,"113,6",5,1,1,7,Mid-Value,Potential Loyalists
80928,98,3,"126,75",5,1,1,7,Mid-Value,Potential Loyalists
80929,197,1,"29,3",5,1,1,7,Mid-Value,Potential Loyalists
80930,977,1,"10,3",3,1,1,5,Low-Value,At Risk Customers
80931,677,2,"164,0",4,1,1,6,Mid-Value,Potential Loyalists
80933,71,10,"560,5999999999999",5,2,1,8,High-Value,Potential Loyalists
80935,173,1,"171,60000000000002",5,1,1,7,Mid-Value,Potential Loyalists
80936,112,2,"29,5",5,1,1,7,Mid-Value,Potential Loyalists
80937,1050,3,"100,60000000000001",3,1,1,5,Low-Value,At Risk Customers
80938,746,1,"49,55",3,1,1,5,Low-Value,At Risk Customers
80942,647,3,"113,95",4,1,1,6,Mid-Value,Potential Loyalists
80944,1148,3,"284,0",2,1,1,4,Low-Value,Can't Lose
80945,162,1,"17,1",5,1,1,7,Mid-Value,Potential Loyalists
80949,561,2,"38,699999999999996",4,1,1,6,Mid-Value,Potential Loyalists
80953,127,6,"318,35",5,1,1,7,Mid-Value,Potential Loyalists
80954,681,1,"19,7",4,1,1,6,Mid-Value,Potential Loyalists
80957,585,3,"143,5",4,1,1,6,Mid-Value,Potential Loyalists
80958,185,4,"159,85000000000002",5,1,1,7,Mid-Value,Potential Loyalists
80959,823,2,"26,849999999999998",3,1,1,5,Low-Value,At Risk Customers
80960,810,7,"310,65000000000003",3,2,1,6,Mid-Value,Potential Loyalists
80961,491,4,"139,5",4,1,1,6,Mid-Value,Potential Loyalists
80962,74,6,"289,5",5,1,1,7,Mid-Value,Potential Loyalists
80964,939,1,"73,6",3,1,1,5,Low-Value,At Risk Customers
80965,414,6,"434,6",4,1,1,6,Mid-Value,Potential Loyalists
80966,381,8,"248,05",4,2,1,7,Mid-Value,Potential Loyalists
80967,148,5,"332,95",5,1,1,7,Mid-Value,Potential Loyalists
80969,1097,1,"40,5",2,1,1,4,Low-Value,Can't Lose
80970,952,2,"46,2",3,1,1,5,Low-Value,At Risk Customers
80972,406,7,"161,65",4,2,1,7,Mid-Value,Potential Loyalists
80977,211,5,"152,15",5,1,1,7,Mid-Value,Potential Loyalists
80978,690,6,"471,45",4,1,1,6,Mid-Value,Potential Loyalists
80985,1071,2,"181,20000000000002",3,1,1,5,Low-Value,At Risk Customers
80986,852,3,"36,2",3,1,1,5,Low-Value,At Risk Customers
80987,1345,1,"37,0",2,1,1,4,Low-Value,Can't Lose
80988,1263,1,"42,3",2,1,1,4,Low-Value,Can't Lose
80989,501,2,"65,5",4,1,1,6,Mid-Value,Potential Loyalists
80990,125,6,"482,65",5,1,1,7,Mid-Value,Potential Loyalists
80991,300,5,"318,85",5,1,1,7,Mid-Value,Potential Loyalists
80995,214,5,"381,95000000000005",5,1,1,7,Mid-Value,Potential Loyalists
80997,46,1,"77,8",5,1,1,7,Mid-Value,Potential Loyalists
80998,745,8,"308,95",3,2,1,6,Mid-Value,Potential Loyalists
80999,138,7,"447,20000000000005",5,2,1,8,High-Value,Potential Loyalists
81000,186,3,"1093,3",5,1,2,8,High-Value,Potential Loyalists
81003,31,7,"753,5500000000001",5,2,2,9,High-Value,Champions
81004,507,1,"89,9",4,1,1,6,Mid-Value,Potential Loyalists
81005,958,3,"184,25",3,1,1,5,Low-Value,At Risk Customers
81007,734,1,"12,1",3,1,1,5,Low-Value,At Risk Customers
81010,568,3,"144,1",4,1,1,6,Mid-Value,Potential Loyalists
81012,1820,1,"12,9",1,1,1,3,Low-Value,Lost
81013,662,1,"33,4",4,1,1,6,Mid-Value,Potential Loyalists
81014,738,5,"288,1",3,1,1,5,Low-Value,At Risk Customers
81015,226,2,"128,55",5,1,1,7,Mid-Value,Potential Loyalists
81016,861,4,"256,35",3,1,1,5,Low-Value,At Risk Customers
81019,379,7,"400,35",4,2,1,7,Mid-Value,Potential Loyalists
81023,199,3,"54,949999999999996",5,1,1,7,Mid-Value,Potential Loyalists
81024,955,1,"10,3",3,1,1,5,Low-Value,At Risk Customers
81025,538,2,"127,2",4,1,1,6,Mid-Value,Potential Loyalists
81028,362,4,"68,6",5,1,1,7,Mid-Value,Potential Loyalists
81029,841,1,"33,9",3,1,1,5,Low-Value,At Risk Customers
81030,83,10,"512,45",5,2,1,8,High-Value,Potential Loyalists
81031,8,4,"386,45",5,1,1,7,Mid-Value,Potential Loyalists
81032,229,6,"198,7",5,1,1,7,Mid-Value,Potential Loyalists
81033,396,5,"397,65",4,1,1,6,Mid-Value,Potential Loyalists
81034,61,5,"202,95",5,1,1,7,Mid-Value,Potential Loyalists
81035,241,4,"237,75",5,1,1,7,Mid-Value,Potential Loyalists
81037,418,3,"186,85",4,1,1,6,Mid-Value,Potential Loyalists
81039,1286,2,"53,199999999999996",2,1,1,4,Low-Value,Can't Lose
81042,913,1,"20,5",3,1,1,5,Low-Value,At Risk Customers
81043,607,5,"241,0",4,1,1,6,Mid-Value,Potential Loyalists
81044,64,4,"278,55",5,1,1,7,Mid-Value,Potential Loyalists
81047,398,2,"56,849999999999994",4,1,1,6,Mid-Value,Potential Loyalists
81048,294,7,"323,95",5,2,1,8,High-Value,Potential Loyalists
81051,216,2,"187,65",5,1,1,7,Mid-Value,Potential Loyalists
81053,587,4,"74,14999999999999",4,1,1,6,Mid-Value,Potential Loyalists
81054,81,4,"267,3",5,1,1,7,Mid-Value,Potential Loyalists
81055,112,2,"261,1",5,1,1,7,Mid-Value,Potential Loyalists
81056,28,3,"96,6",5,1,1,7,Mid-Value,Potential Loyalists
81057,157,5,"324,7",5,1,1,7,Mid-Value,Potential Loyalists
81058,272,2,"269,35",5,1,1,7,Mid-Value,Potential Loyalists
81059,1264,1,"37,8",2,1,1,4,Low-Value,Can't Lose
81060,329,5,"221,45",5,1,1,7,Mid-Value,Potential Loyalists
81062,1060,1,"66,85",3,1,1,5,Low-Value,At Risk Customers
81064,1100,2,"98,4",2,1,1,4,Low-Value,Can't Lose
81067,1811,1,"115,7",1,1,1,3,Low-Value,Lost
81069,361,6,"552,35",5,1,1,7,Mid-Value,Potential Loyalists
81071,227,1,"160,05",5,1,1,7,Mid-Value,Potential Loyalists
81074,3,7,"338,95",5,2,1,8,High-Value,Potential Loyalists
81077,63,2,"208,65",5,1,1,7,Mid-Value,Potential Loyalists
81078,166,2,"92,65",5,1,1,7,Mid-Value,Potential Loyalists
81079,101,7,"275,35",5,2,1,8,High-Value,Potential Loyalists
81082,71,4,"186,9",5,1,1,7,Mid-Value,Potential Loyalists
81083,56,12,"759,55",5,3,2,10,High-Value,Champions
81086,91,7,"712,7",5,2,2,9,High-Value,Champions
81088,140,6,"486,20000000000005",5,1,1,7,Mid-Value,Potential Loyalists
81092,228,4,"175,64999999999998",5,1,1,7,Mid-Value,Potential Loyalists
81093,1137,2,"18,15",2,1,1,4,Low-Value,Can't Lose
81094,408,6,"113,44999999999999",4,1,1,6,Mid-Value,Potential Loyalists
81097,218,2,"18,0",5,1,1,7,Mid-Value,Potential Loyalists
81098,570,2,"221,85",4,1,1,6,Mid-Value,Potential Loyalists
81099,555,2,"123,8",4,1,1,6,Mid-Value,Potential Loyalists
81100,4,6,"157,2",5,1,1,7,Mid-Value,Potential Loyalists
81102,424,3,"173,54999999999998",4,1,1,6,Mid-Value,Potential Loyalists
81103,1,3,"244,3",5,1,1,7,Mid-Value,Potential Loyalists
81105,368,4,"401,25",4,1,1,6,Mid-Value,Potential Loyalists
81108,12,15,"939,8000000000001",5,3,2,10,High-Value,Champions
81109,784,3,"69,80000000000001",3,1,1,5,Low-Value,At Risk Customers
81112,973,2,"107,75",3,1,1,5,Low-Value,At Risk Customers
81113,131,6,"673,95",5,1,2,8,High-Value,Potential Loyalists
81114,255,4,"86,35",5,1,1,7,Mid-Value,Potential Loyalists
81117,1610,2,"140,7",1,1,1,3,Low-Value,Lost
81118,1243,3,"231,85",2,1,1,4,Low-Value,Can't Lose
81120,455,1,"19,35",4,1,1,6,Mid-Value,Potential Loyalists
81122,574,10,"638,8000000000001",4,2,1,7,Mid-Value,Potential Loyalists
81123,521,3,"150,5",4,1,1,6,Mid-Value,Potential Loyalists
81124,887,2,"116,8",3,1,1,5,Low-Value,At Risk Customers
81126,590,2,"125,75",4,1,1,6,Mid-Value,Potential Loyalists
81131,289,4,"209,65000000000003",5,1,1,7,Mid-Value,Potential Loyalists
81132,69,8,"284,7",5,2,1,8,High-Value,Potential Loyalists
81135,213,5,"230,45",5,1,1,7,Mid-Value,Potential Loyalists
81136,1235,1,"30,69",2,1,1,4,Low-Value,Can't Lose
81142,1635,1,"45,0",1,1,1,3,Low-Value,Lost
81143,1275,1,"172,8",2,1,1,4,Low-Value,Can't Lose
81144,458,9,"300,7",4,2,1,7,Mid-Value,Potential Loyalists
81145,733,3,"129,35",3,1,1,5,Low-Value,At Risk Customers
81146,1319,1,"8,4",2,1,1,4,Low-Value,Can't Lose
81147,184,7,"405,95",5,2,1,8,High-Value,Potential Loyalists
81149,45,5,"336,15",5,1,1,7,Mid-Value,Potential Loyalists
81150,11,4,"82,8",5,1,1,7,Mid-Value,Potential Loyalists
81153,1015,3,"93,0",3,1,1,5,Low-Value,At Risk Customers
81154,370,5,"251,75",4,1,1,6,Mid-Value,Potential Loyalists
81156,357,2,"52,400000000000006",5,1,1,7,Mid-Value,Potential Loyalists
81157,18,3,"107,35",5,1,1,7,Mid-Value,Potential Loyalists
81160,28,4,"132,2",5,1,1,7,Mid-Value,Potential Loyalists
81162,104,1,"21,2",5,1,1,7,Mid-Value,Potential Loyalists
81163,692,3,"225,8",4,1,1,6,Mid-Value,Potential Loyalists
81166,43,6,"286,45000000000005",5,1,1,7,Mid-Value,Potential Loyalists
81168,32,5,"570,6",5,1,1,7,Mid-Value,Potential Loyalists
81169,98,6,"236,7",5,1,1,7,Mid-Value,Potential Loyalists
81172,263,1,"76,9",5,1,1,7,Mid-Value,Potential Loyalists
81173,530,1,"252,8",4,1,1,6,Mid-Value,Potential Loyalists
81174,405,3,"278,8",4,1,1,6,Mid-Value,Potential Loyalists
81176,650,2,"106,85",4,1,1,6,Mid-Value,Potential Loyalists
81177,309,1,"15,55",5,1,1,7,Mid-Value,Potential Loyalists
81178,15,2,"40,05",5,1,1,7,Mid-Value,Potential Loyalists
81179,81,4,"164,2",5,1,1,7,Mid-Value,Potential Loyalists
81181,188,6,"905,1",5,1,2,8,High-Value,Potential Loyalists
81182,523,4,"203,1",4,1,1,6,Mid-Value,Potential Loyalists
81183,202,2,"36,55",5,1,1,7,Mid-Value,Potential Loyalists
81185,1193,4,"249,7",2,1,1,4,Low-Value,Can't Lose
81187,2,10,"463,05",5,2,1,8,High-Value,Potential Loyalists
81189,79,10,"959,9",5,2,2,9,High-Value,Champions
81192,81,7,"316,15",5,2,1,8,High-Value,Potential Loyalists
81193,298,3,"116,3",5,1,1,7,Mid-Value,Potential Loyalists
81194,1695,1,"34,5",1,1,1,3,Low-Value,Lost
81198,1388,1,"7,15",2,1,1,4,Low-Value,Can't Lose
81199,1323,1,"5,5",2,1,1,4,Low-Value,Can't Lose
81200,1741,1,"34,5",1,1,1,3,Low-Value,Lost
81202,26,6,"466,45",5,1,1,7,Mid-Value,Potential Loyalists
81204,194,6,"313,40000000000003",5,1,1,7,Mid-Value,Potential Loyalists
81205,75,5,"258,75",5,1,1,7,Mid-Value,Potential Loyalists
81207,346,5,"281,85",5,1,1,7,Mid-Value,Potential Loyalists
81210,72,5,"679,25",5,1,2,8,High-Value,Potential Loyalists
81211,1211,4,"172,15",2,1,1,4,Low-Value,Can't Lose
81212,3,5,"331,7",5,1,1,7,Mid-Value,Potential Loyalists
81213,1335,2,"135,55",2,1,1,4,Low-Value,Can't Lose
81214,1574,1,"14,0",1,1,1,3,Low-Value,Lost
81215,210,1,"6,1",5,1,1,7,Mid-Value,Potential Loyalists
81216,559,1,"94,1",4,1,1,6,Mid-Value,Potential Loyalists
81217,580,2,"37,15",4,1,1,6,Mid-Value,Potential Loyalists
81218,702,3,"129,75",4,1,1,6,Mid-Value,Potential Loyalists
81219,373,4,"427,35",4,1,1,6,Mid-Value,Potential Loyalists
81220,1575,3,"184,25",1,1,1,3,Low-Value,Lost
81222,161,3,"98,94999999999999",5,1,1,7,Mid-Value,Potential Loyalists
81225,198,4,"365,4",5,1,1,7,Mid-Value,Potential Loyalists
81227,1520,1,"10,65",1,1,1,3,Low-Value,Lost
81228,43,12,"842,5",5,3,2,10,High-Value,Champions
81229,1205,5,"175,8",2,1,1,4,Low-Value,Can't Lose
81230,116,2,"179,5",5,1,1,7,Mid-Value,Potential Loyalists
81232,330,2,"49,65",5,1,1,7,Mid-Value,Potential Loyalists
81234,929,1,"111,5",3,1,1,5,Low-Value,At Risk Customers
81235,529,4,"258,0",4,1,1,6,Mid-Value,Potential Loyalists
81239,143,2,"71,7",5,1,1,7,Mid-Value,Potential Loyalists
81240,518,3,"329,35",4,1,1,6,Mid-Value,Potential Loyalists
81242,311,4,"113,3",5,1,1,7,Mid-Value,Potential Loyalists
81243,118,8,"603,65",5,2,1,8,High-Value,Potential Loyalists
81244,1421,1,"14,35",2,1,1,4,Low-Value,Can't Lose
81245,1002,5,"146,1",3,1,1,5,Low-Value,At Risk Customers
81246,4,2,"113,55000000000001",5,1,1,7,Mid-Value,Potential Loyalists
81247,1656,1,"134,7",1,1,1,3,Low-Value,Lost
81248,759,4,"669,1500000000001",3,1,2,6,Mid-Value,Potential Loyalists
81251,391,4,"161,3",4,1,1,6,Mid-Value,Potential Loyalists
81252,237,6,"277,25",5,1,1,7,Mid-Value,Potential Loyalists
81253,267,3,"170,3",5,1,1,7,Mid-Value,Potential Loyalists
81254,1446,1,"166,8",2,1,1,4,Low-Value,Can't Lose
81255,28,7,"387,95",5,2,1,8,High-Value,Potential Loyalists
81256,28,1,"25,8",5,1,1,7,Mid-Value,Potential Loyalists
81257,45,3,"32,05",5,1,1,7,Mid-Value,Potential Loyalists
81258,974,1,"73,6",3,1,1,5,Low-Value,At Risk Customers
81262,913,2,"21,4",3,1,1,5,Low-Value,At Risk Customers
81263,202,3,"214,8",5,1,1,7,Mid-Value,Potential Loyalists
81264,60,5,"226,85000000000002",5,1,1,7,Mid-Value,Potential Loyalists
81266,174,4,"242,75",5,1,1,7,Mid-Value,Potential Loyalists
81267,3,5,"814,3499999999999",5,1,2,8,High-Value,Potential Loyalists
81268,1145,1,"79,0",2,1,1,4,Low-Value,Can't Lose
81271,190,6,"167,3",5,1,1,7,Mid-Value,Potential Loyalists
81272,394,2,"119,49999999999999",4,1,1,6,Mid-Value,Potential Loyalists
81273,263,1,"138,2",5,1,1,7,Mid-Value,Potential Loyalists
81274,593,2,"190,45",4,1,1,6,Mid-Value,Potential Loyalists
81275,16,2,"88,85000000000001",5,1,1,7,Mid-Value,Potential Loyalists
81276,418,7,"416,54999999999995",4,2,1,7,Mid-Value,Potential Loyalists
81278,199,6,"755,35",5,1,2,8,High-Value,Potential Loyalists
81279,160,11,"337,7",5,2,1,8,High-Value,Potential Loyalists
81280,911,3,"126,35",3,1,1,5,Low-Value,At Risk Customers
81283,30,4,"315,85",5,1,1,7,Mid-Value,Potential Loyalists
81285,532,2,"113,65",4,1,1,6,Mid-Value,Potential Loyalists
81286,171,2,"360,90000000000003",5,1,1,7,Mid-Value,Potential Loyalists
81288,826,1,"22,55",3,1,1,5,Low-Value,At Risk Customers
81289,1455,1,"7,95",2,1,1,4,Low-Value,Can't Lose
81293,770,3,"184,04999999999998",3,1,1,5,Low-Value,At Risk Customers
81294,746,3,"104,5",3,1,1,5,Low-Value,At Risk Customers
81295,119,6,"457,7",5,1,1,7,Mid-Value,Potential Loyalists
81296,257,1,"15,7",5,1,1,7,Mid-Value,Potential Loyalists
81298,31,2,"179,8",5,1,1,7,Mid-Value,Potential Loyalists
81299,1103,1,"71,9",2,1,1,4,Low-Value,Can't Lose
81301,89,4,"239,8",5,1,1,7,Mid-Value,Potential Loyalists
81302,891,3,"98,05",3,1,1,5,Low-Value,At Risk Customers
81307,10,7,"316,0",5,2,1,8,High-Value,Potential Loyalists
81313,933,2,"28,8",3,1,1,5,Low-Value,At Risk Customers
81314,673,1,"23,45",4,1,1,6,Mid-Value,Potential Loyalists
81315,399,7,"233,35000000000002",4,2,1,7,Mid-Value,Potential Loyalists
81316,230,4,"177,35",5,1,1,7,Mid-Value,Potential Loyalists
81318,130,1,"59,9",5,1,1,7,Mid-Value,Potential Loyalists
81319,321,4,"315,45000000000005",5,1,1,7,Mid-Value,Potential Loyalists
81320,396,2,"56,7",4,1,1,6,Mid-Value,Potential Loyalists
81324,713,5,"264,34999999999997",4,1,1,6,Mid-Value,Potential Loyalists
81325,1185,2,"57,900000000000006",2,1,1,4,Low-Value,Can't Lose
81327,1037,1,"7,2",3,1,1,5,Low-Value,At Risk Customers
81329,48,2,"70,85",5,1,1,7,Mid-Value,Potential Loyalists
81331,209,3,"161,85",5,1,1,7,Mid-Value,Potential Loyalists
81332,30,2,"79,6",5,1,1,7,Mid-Value,Potential Loyalists
81339,1111,1,"169,8",2,1,1,4,Low-Value,Can't Lose
81341,194,4,"325,35",5,1,1,7,Mid-Value,Potential Loyalists
81343,88,7,"392,25",5,2,1,8,High-Value,Potential Loyalists
81344,1004,3,"284,1",3,1,1,5,Low-Value,At Risk Customers
81346,732,1,"79,0",3,1,1,5,Low-Value,At Risk Customers
81347,473,7,"780,95",4,2,2,8,High-Value,Potential Loyalists
81348,380,18,"1474,5",4,4,3,11,High-Value,Champions
81349,93,3,"42,5",5,1,1,7,Mid-Value,Potential Loyalists
81351,977,2,"65,15",3,1,1,5,Low-Value,At Risk Customers
81353,298,4,"64,65",5,1,1,7,Mid-Value,Potential Loyalists
81354,342,7,"387,95",5,2,1,8,High-Value,Potential Loyalists
81355,285,3,"170,25",5,1,1,7,Mid-Value,Potential Loyalists
81356,273,2,"50,5",5,1,1,7,Mid-Value,Potential Loyalists
81357,579,2,"271,25",4,1,1,6,Mid-Value,Potential Loyalists
81358,89,8,"739,65",5,2,2,9,High-Value,Champions
81359,1019,2,"50,5",3,1,1,5,Low-Value,At Risk Customers
81363,508,2,"253,0",4,1,1,6,Mid-Value,Potential Loyalists
81364,80,8,"371,15",5,2,1,8,High-Value,Potential Loyalists
81366,32,5,"222,7",5,1,1,7,Mid-Value,Potential Loyalists
81370,810,2,"109,85",3,1,1,5,Low-Value,At Risk Customers
81371,231,2,"274,6",5,1,1,7,Mid-Value,Potential Loyalists
81372,1440,3,"80,0",2,1,1,4,Low-Value,Can't Lose
81375,1306,4,"189,5",2,1,1,4,Low-Value,Can't Lose
81376,490,1,"57,4",4,1,1,6,Mid-Value,Potential Loyalists
81377,113,2,"119,5",5,1,1,7,Mid-Value,Potential Loyalists
81378,816,3,"443,0",3,1,1,5,Low-Value,At Risk Customers
81380,225,1,"19,9",5,1,1,7,Mid-Value,Potential Loyalists
81381,1126,1,"182,4",2,1,1,4,Low-Value,Can't Lose
81383,879,1,"87,1",3,1,1,5,Low-Value,At Risk Customers
81385,406,2,"39,25",4,1,1,6,Mid-Value,Potential Loyalists
81386,17,6,"250,75",5,1,1,7,Mid-Value,Potential Loyalists
81391,545,8,"272,05",4,2,1,7,Mid-Value,Potential Loyalists
81392,418,8,"504,40000000000003",4,2,1,7,Mid-Value,Potential Loyalists
81393,787,1,"199,0",3,1,1,5,Low-Value,At Risk Customers
81394,436,3,"75,0",4,1,1,6,Mid-Value,Potential Loyalists
81395,77,4,"171,35000000000002",5,1,1,7,Mid-Value,Potential Loyalists
81396,1013,5,"108,2",3,1,1,5,Low-Value,At Risk Customers
81397,27,1,"18,4",5,1,1,7,Mid-Value,Potential Loyalists
81398,48,7,"644,95",5,2,1,8,High-Value,Potential Loyalists
81399,777,2,"432,85",3,1,1,5,Low-Value,At Risk Customers
81402,110,5,"194,55",5,1,1,7,Mid-Value,Potential Loyalists
81403,89,3,"93,15",5,1,1,7,Mid-Value,Potential Loyalists
81404,733,3,"342,59999999999997",3,1,1,5,Low-Value,At Risk Customers
81405,1360,1,"45,6",2,1,1,4,Low-Value,Can't Lose
81406,45,1,"29,9",5,1,1,7,Mid-Value,Potential Loyalists
81407,881,3,"212,45",3,1,1,5,Low-Value,At Risk Customers
81409,1774,1,"18,35",1,1,1,3,Low-Value,Lost
81412,790,6,"105,35000000000001",3,1,1,5,Low-Value,At Risk Customers
81415,221,7,"206,05",5,2,1,8,High-Value,Potential Loyalists
81416,691,1,"85,1",4,1,1,6,Mid-Value,Potential Loyalists
81417,1302,2,"63,75",2,1,1,4,Low-Value,Can't Lose
81418,75,4,"358,09999999999997",5,1,1,7,Mid-Value,Potential Loyalists
81419,896,2,"196,39999999999998",3,1,1,5,Low-Value,At Risk Customers
81420,1579,1,"8,1",1,1,1,3,Low-Value,Lost
81421,256,7,"556,75",5,2,1,8,High-Value,Potential Loyalists
81423,616,5,"230,70000000000002",4,1,1,6,Mid-Value,Potential Loyalists
81425,40,5,"503,75",5,1,1,7,Mid-Value,Potential Loyalists
81427,1009,5,"243,89999999999998",3,1,1,5,Low-Value,At Risk Customers
81428,589,3,"79,5",4,1,1,6,Mid-Value,Potential Loyalists
81434,751,1,"151,5",3,1,1,5,Low-Value,At Risk Customers
81436,40,1,"22,65",5,1,1,7,Mid-Value,Potential Loyalists
81437,677,6,"250,14999999999998",4,1,1,6,Mid-Value,Potential Loyalists
81439,1296,1,"68,6",2,1,1,4,Low-Value,Can't Lose
81440,996,3,"126,7",3,1,1,5,Low-Value,At Risk Customers
81441,29,4,"94,5",5,1,1,7,Mid-Value,Potential Loyalists
81444,265,1,"37,1",5,1,1,7,Mid-Value,Potential Loyalists
81445,435,2,"64,3",4,1,1,6,Mid-Value,Potential Loyalists
81446,1000,1,"36,8",3,1,1,5,Low-Value,At Risk Customers
81448,1473,1,"18,9",1,1,1,3,Low-Value,Lost
81449,441,7,"540,55",4,2,1,7,Mid-Value,Potential Loyalists
81451,952,3,"403,40000000000003",3,1,1,5,Low-Value,At Risk Customers
81453,1522,3,"127,7",1,1,1,3,Low-Value,Lost
81454,257,2,"135,45",5,1,1,7,Mid-Value,Potential Loyalists
81455,518,1,"38,3",4,1,1,6,Mid-Value,Potential Loyalists
81456,1526,2,"35,75",1,1,1,3,Low-Value,Lost
81457,1104,2,"292,0",2,1,1,4,Low-Value,Can't Lose
81460,426,3,"31,049999999999997",4,1,1,6,Mid-Value,Potential Loyalists
81461,67,7,"489,45",5,2,1,8,High-Value,Potential Loyalists
81463,285,5,"222,55",5,1,1,7,Mid-Value,Potential Loyalists
81464,1422,3,"1423,9500000000003",2,1,3,6,Mid-Value,Potential Loyalists
81465,148,8,"495,3",5,2,1,8,High-Value,Potential Loyalists
81469,382,7,"279,5",4,2,1,7,Mid-Value,Potential Loyalists
81470,59,5,"133,1",5,1,1,7,Mid-Value,Potential Loyalists
81471,361,6,"560,95",5,1,1,7,Mid-Value,Potential Loyalists
81474,10,1,"151,8",5,1,1,7,Mid-Value,Potential Loyalists
81478,435,7,"297,65000000000003",4,2,1,7,Mid-Value,Potential Loyalists
81479,35,4,"125,0",5,1,1,7,Mid-Value,Potential Loyalists
81480,267,5,"246,35",5,1,1,7,Mid-Value,Potential Loyalists
81481,432,8,"567,85",4,2,1,7,Mid-Value,Potential Loyalists
81482,1026,3,"536,25",3,1,1,5,Low-Value,At Risk Customers
81484,201,3,"54,4",5,1,1,7,Mid-Value,Potential Loyalists
81485,672,1,"44,4",4,1,1,6,Mid-Value,Potential Loyalists
81486,1404,1,"5,75",2,1,1,4,Low-Value,Can't Lose
81488,964,1,"23,6",3,1,1,5,Low-Value,At Risk Customers
81489,1277,2,"110,4",2,1,1,4,Low-Value,Can't Lose
81491,1278,3,"208,99999999999997",2,1,1,4,Low-Value,Can't Lose
81493,70,3,"293,35",5,1,1,7,Mid-Value,Potential Loyalists
81494,114,5,"218,04999999999998",5,1,1,7,Mid-Value,Potential Loyalists
81496,593,2,"193,7",4,1,1,6,Mid-Value,Potential Loyalists
81497,720,2,"95,05",4,1,1,6,Mid-Value,Potential Loyalists
81499,1595,1,"293,0",1,1,1,3,Low-Value,Lost
81500,347,1,"155,6",5,1,1,7,Mid-Value,Potential Loyalists
81505,834,3,"405,45000000000005",3,1,1,5,Low-Value,At Risk Customers
81506,190,3,"90,85",5,1,1,7,Mid-Value,Potential Loyalists
81507,1602,1,"60,5",1,1,1,3,Low-Value,Lost
81508,134,3,"555,0999999999999",5,1,1,7,Mid-Value,Potential Loyalists
81510,70,7,"175,25",5,2,1,8,High-Value,Potential Loyalists
81512,586,2,"609,1",4,1,1,6,Mid-Value,Potential Loyalists
81514,1146,3,"103,44999999999999",2,1,1,4,Low-Value,Can't Lose
81515,1157,2,"80,14999999999999",2,1,1,4,Low-Value,Can't Lose
81520,230,4,"142,55",5,1,1,7,Mid-Value,Potential Loyalists
81521,599,1,"16,75",4,1,1,6,Mid-Value,Potential Loyalists
81524,1245,3,"225,1",2,1,1,4,Low-Value,Can't Lose
81527,362,2,"51,85",5,1,1,7,Mid-Value,Potential Loyalists
81528,769,2,"253,39999999999998",3,1,1,5,Low-Value,At Risk Customers
81530,69,5,"640,4000000000001",5,1,1,7,Mid-Value,Potential Loyalists
81531,267,2,"43,599999999999994",5,1,1,7,Mid-Value,Potential Loyalists
81532,1657,1,"13,2",1,1,1,3,Low-Value,Lost
81534,121,8,"464,75",5,2,1,8,High-Value,Potential Loyalists
81536,1657,1,"23,0",1,1,1,3,Low-Value,Lost
81538,932,1,"7,95",3,1,1,5,Low-Value,At Risk Customers
81539,175,3,"159,95",5,1,1,7,Mid-Value,Potential Loyalists
81542,157,4,"211,4",5,1,1,7,Mid-Value,Potential Loyalists
81543,8,3,"571,8",5,1,1,7,Mid-Value,Potential Loyalists
81544,367,2,"122,1",4,1,1,6,Mid-Value,Potential Loyalists
81546,1163,2,"89,15",2,1,1,4,Low-Value,Can't Lose
81547,1759,1,"55,75",1,1,1,3,Low-Value,Lost
81548,1649,2,"36,3",1,1,1,3,Low-Value,Lost
81549,1365,1,"255,9",2,1,1,4,Low-Value,Can't Lose
81553,265,5,"304,59999999999997",5,1,1,7,Mid-Value,Potential Loyalists
81556,977,3,"70,2",3,1,1,5,Low-Value,At Risk Customers
81557,27,2,"45,95",5,1,1,7,Mid-Value,Potential Loyalists
81558,860,2,"73,05",3,1,1,5,Low-Value,At Risk Customers
81559,11,5,"227,95",5,1,1,7,Mid-Value,Potential Loyalists
81560,858,4,"333,5",3,1,1,5,Low-Value,At Risk Customers
81562,442,1,"19,45",4,1,1,6,Mid-Value,Potential Loyalists
81563,69,1,"29,9",5,1,1,7,Mid-Value,Potential Loyalists
81565,1635,1,"9,5",1,1,1,3,Low-Value,Lost
81570,110,13,"977,75",5,3,2,10,High-Value,Champions
81571,1150,2,"50,2",2,1,1,4,Low-Value,Can't Lose
81572,146,3,"212,95",5,1,1,7,Mid-Value,Potential Loyalists
81577,696,4,"116,75",4,1,1,6,Mid-Value,Potential Loyalists
81578,610,1,"146,2",4,1,1,6,Mid-Value,Potential Loyalists
81580,1190,4,"95,85",2,1,1,4,Low-Value,Can't Lose
81581,70,6,"374,35",5,1,1,7,Mid-Value,Potential Loyalists
81582,1142,1,"7,75",2,1,1,4,Low-Value,Can't Lose
81584,647,2,"200,25",4,1,1,6,Mid-Value,Potential Loyalists
81588,590,1,"26,45",4,1,1,6,Mid-Value,Potential Loyalists
81593,10,4,"126,25",5,1,1,7,Mid-Value,Potential Loyalists
81594,626,1,"30,25",4,1,1,6,Mid-Value,Potential Loyalists
81595,122,3,"160,25",5,1,1,7,Mid-Value,Potential Loyalists
81596,271,3,"382,35",5,1,1,7,Mid-Value,Potential Loyalists
81597,515,4,"210,95",4,1,1,6,Mid-Value,Potential Loyalists
81601,7,3,"191,25",5,1,1,7,Mid-Value,Potential Loyalists
81602,1107,1,"104,8",2,1,1,4,Low-Value,Can't Lose
81603,29,12,"607,9",5,3,1,9,High-Value,Champions
81604,463,3,"89,15",4,1,1,6,Mid-Value,Potential Loyalists
81605,1258,4,"61,75",2,1,1,4,Low-Value,Can't Lose
81606,858,7,"729,4",3,2,2,7,Mid-Value,Potential Loyalists
81614,510,1,"50,5",4,1,1,6,Mid-Value,Potential Loyalists
81616,782,6,"449,0",3,1,1,5,Low-Value,At Risk Customers
81617,232,5,"644,1500000000001",5,1,1,7,Mid-Value,Potential Loyalists
81624,204,3,"137,89999999999998",5,1,1,7,Mid-Value,Potential Loyalists
81625,101,5,"394,2",5,1,1,7,Mid-Value,Potential Loyalists
81626,77,3,"142,1",5,1,1,7,Mid-Value,Potential Loyalists
81627,1331,1,"38,3",2,1,1,4,Low-Value,Can't Lose
81628,18,2,"86,10000000000001",5,1,1,7,Mid-Value,Potential Loyalists
81630,777,3,"125,39999999999999",3,1,1,5,Low-Value,At Risk Customers
81631,438,4,"143,25",4,1,1,6,Mid-Value,Potential Loyalists
81633,1074,1,"7,4",3,1,1,5,Low-Value,At Risk Customers
81634,307,3,"106,6",5,1,1,7,Mid-Value,Potential Loyalists
81637,1062,1,"50,1",3,1,1,5,Low-Value,At Risk Customers
81638,692,5,"316,95",4,1,1,6,Mid-Value,Potential Loyalists
81640,77,3,"73,15",5,1,1,7,Mid-Value,Potential Loyalists
81641,379,3,"245,7",4,1,1,6,Mid-Value,Potential Loyalists
81642,570,1,"6,35",4,1,1,6,Mid-Value,Potential Loyalists
81643,246,7,"710,5999999999999",5,2,2,9,High-Value,Champions
81644,7,13,"1283,25",5,3,2,10,High-Value,Champions
81645,160,7,"355,1",5,2,1,8,High-Value,Potential Loyalists
81648,9,6,"300,85",5,1,1,7,Mid-Value,Potential Loyalists
81652,572,2,"44,199999999999996",4,1,1,6,Mid-Value,Potential Loyalists
81653,815,2,"33,900000000000006",3,1,1,5,Low-Value,At Risk Customers
81654,1143,1,"31,75",2,1,1,4,Low-Value,Can't Lose
81657,305,5,"55,5",5,1,1,7,Mid-Value,Potential Loyalists
81658,3,8,"731,3000000000001",5,2,2,9,High-Value,Champions
81659,154,5,"327,55",5,1,1,7,Mid-Value,Potential Loyalists
81660,1170,3,"110,80000000000001",2,1,1,4,Low-Value,Can't Lose
81662,572,1,"21,7",4,1,1,6,Mid-Value,Potential Loyalists
81663,4,2,"227,8",5,1,1,7,Mid-Value,Potential Loyalists
81664,1457,1,"161,8",2,1,1,4,Low-Value,Can't Lose
81665,366,1,"52,5",4,1,1,6,Mid-Value,Potential Loyalists
81666,886,4,"221,4",3,1,1,5,Low-Value,At Risk Customers
81668,80,3,"430,24999999999994",5,1,1,7,Mid-Value,Potential Loyalists
81669,413,3,"149,45",4,1,1,6,Mid-Value,Potential Loyalists
81670,129,3,"314,8",5,1,1,7,Mid-Value,Potential Loyalists
81671,340,4,"101,4",5,1,1,7,Mid-Value,Potential Loyalists
81672,1652,1,"102,8",1,1,1,3,Low-Value,Lost
81673,646,3,"137,39999999999998",4,1,1,6,Mid-Value,Potential Loyalists
81678,1098,1,"38,8",2,1,1,4,Low-Value,Can't Lose
81680,663,1,"58,6",4,1,1,6,Mid-Value,Potential Loyalists
81684,676,3,"39,6",4,1,1,6,Mid-Value,Potential Loyalists
81689,246,6,"174,6",5,1,1,7,Mid-Value,Potential Loyalists
81690,387,5,"143,45",4,1,1,6,Mid-Value,Potential Loyalists
81691,130,3,"60,05",5,1,1,7,Mid-Value,Potential Loyalists
81693,1061,4,"132,5",3,1,1,5,Low-Value,At Risk Customers
81694,791,5,"121,4",3,1,1,5,Low-Value,At Risk Customers
81697,30,2,"148,89999999999998",5,1,1,7,Mid-Value,Potential Loyalists
81700,754,1,"1552,6",3,1,3,7,Mid-Value,Potential Loyalists
81702,55,10,"619,45",5,2,1,8,High-Value,Potential Loyalists
81703,81,1,"13,15",5,1,1,7,Mid-Value,Potential Loyalists
81704,378,2,"327,84999999999997",4,1,1,6,Mid-Value,Potential Loyalists
81706,842,3,"197,45",3,1,1,5,Low-Value,At Risk Customers
81707,358,5,"308,9",5,1,1,7,Mid-Value,Potential Loyalists
81708,966,3,"79,5",3,1,1,5,Low-Value,At Risk Customers
81710,28,1,"135,0",5,1,1,7,Mid-Value,Potential Loyalists
81711,755,5,"570,6",3,1,1,5,Low-Value,At Risk Customers
81712,128,4,"230,45",5,1,1,7,Mid-Value,Potential Loyalists
81713,379,2,"48,9",4,1,1,6,Mid-Value,Potential Loyalists
81716,356,1,"5,4",5,1,1,7,Mid-Value,Potential Loyalists
81717,266,2,"130,7",5,1,1,7,Mid-Value,Potential Loyalists
81719,291,3,"121,60000000000001",5,1,1,7,Mid-Value,Potential Loyalists
81722,468,1,"13,5",4,1,1,6,Mid-Value,Potential Loyalists
81723,29,4,"319,7",5,1,1,7,Mid-Value,Potential Loyalists
81725,1679,1,"33,35",1,1,1,3,Low-Value,Lost
81727,1461,1,"39,05",1,1,1,3,Low-Value,Lost
81729,914,4,"241,05",3,1,1,5,Low-Value,At Risk Customers
81733,1432,2,"122,5",2,1,1,4,Low-Value,Can't Lose
81734,715,2,"202,2",4,1,1,6,Mid-Value,Potential Loyalists
81737,266,2,"131,95",5,1,1,7,Mid-Value,Potential Loyalists
81738,652,3,"249,35000000000002",4,1,1,6,Mid-Value,Potential Loyalists
81739,132,5,"709,5500000000001",5,1,2,8,High-Value,Potential Loyalists
81740,38,7,"331,35",5,2,1,8,High-Value,Potential Loyalists
81745,635,2,"80,25",4,1,1,6,Mid-Value,Potential Loyalists
81746,466,5,"150,0",4,1,1,6,Mid-Value,Potential Loyalists
81749,1134,1,"18,5",2,1,1,4,Low-Value,Can't Lose
81750,1058,1,"44,25",3,1,1,5,Low-Value,At Risk Customers
81751,948,7,"198,4",3,2,1,6,Mid-Value,Potential Loyalists
81752,106,5,"320,0",5,1,1,7,Mid-Value,Potential Loyalists
81755,659,6,"409,1",4,1,1,6,Mid-Value,Potential Loyalists
81756,1714,1,"15,4",1,1,1,3,Low-Value,Lost
81757,17,8,"645,0",5,2,1,8,High-Value,Potential Loyalists
81760,414,4,"149,3",4,1,1,6,Mid-Value,Potential Loyalists
81761,1586,4,"63,7",1,1,1,3,Low-Value,Lost
81763,273,7,"668,85",5,2,2,9,High-Value,Champions
81764,1159,5,"137,65",2,1,1,4,Low-Value,Can't Lose
81765,137,5,"70,75",5,1,1,7,Mid-Value,Potential Loyalists
81766,532,3,"233,4",4,1,1,6,Mid-Value,Potential Loyalists
81767,143,2,"273,04999999999995",5,1,1,7,Mid-Value,Potential Loyalists
81768,431,3,"321,3",4,1,1,6,Mid-Value,Potential Loyalists
81769,771,5,"458,05",3,1,1,5,Low-Value,At Risk Customers
81774,662,13,"724,0",4,3,2,9,High-Value,Champions
81776,1198,2,"109,1",2,1,1,4,Low-Value,Can't Lose
81778,396,1,"11,95",4,1,1,6,Mid-Value,Potential Loyalists
81780,8,9,"448,15",5,2,1,8,High-Value,Potential Loyalists
81787,340,3,"135,7",5,1,1,7,Mid-Value,Potential Loyalists
81788,437,3,"243,14999999999998",4,1,1,6,Mid-Value,Potential Loyalists
81790,494,4,"125,75",4,1,1,6,Mid-Value,Potential Loyalists
81792,405,3,"162,0",4,1,1,6,Mid-Value,Potential Loyalists
81794,1120,1,"99,5",2,1,1,4,Low-Value,Can't Lose
81797,249,4,"459,25",5,1,1,7,Mid-Value,Potential Loyalists
81798,213,4,"333,2",5,1,1,7,Mid-Value,Potential Loyalists
81799,564,6,"275,70000000000005",4,1,1,6,Mid-Value,Potential Loyalists
81801,111,8,"272,0",5,2,1,8,High-Value,Potential Loyalists
81802,1728,1,"55,0",1,1,1,3,Low-Value,Lost
81805,22,5,"239,55",5,1,1,7,Mid-Value,Potential Loyalists
81806,1435,1,"43,5",2,1,1,4,Low-Value,Can't Lose
81809,262,7,"609,4499999999999",5,2,1,8,High-Value,Potential Loyalists
81810,40,3,"168,89999999999998",5,1,1,7,Mid-Value,Potential Loyalists
81811,937,3,"54,75",3,1,1,5,Low-Value,At Risk Customers
81812,1622,1,"165,2",1,1,1,3,Low-Value,Lost
81813,134,2,"278,3",5,1,1,7,Mid-Value,Potential Loyalists
81814,389,2,"131,5",4,1,1,6,Mid-Value,Potential Loyalists
81816,108,6,"177,35",5,1,1,7,Mid-Value,Potential Loyalists
81818,507,3,"182,2",4,1,1,6,Mid-Value,Potential Loyalists
81819,81,5,"553,6",5,1,1,7,Mid-Value,Potential Loyalists
81822,569,1,"14,55",4,1,1,6,Mid-Value,Potential Loyalists
81824,1292,2,"284,6",2,1,1,4,Low-Value,Can't Lose
81825,1307,1,"40,8",2,1,1,4,Low-Value,Can't Lose
81826,1012,1,"30,5",3,1,1,5,Low-Value,At Risk Customers
81829,463,2,"153,25",4,1,1,6,Mid-Value,Potential Loyalists
81830,4,7,"1230,3",5,2,2,9,High-Value,Champions
81831,483,4,"261,95000000000005",4,1,1,6,Mid-Value,Potential Loyalists
81832,16,5,"380,9",5,1,1,7,Mid-Value,Potential Loyalists
81834,953,3,"105,85",3,1,1,5,Low-Value,At Risk Customers
81835,1539,1,"16,3",1,1,1,3,Low-Value,Lost
81836,49,4,"120,55",5,1,1,7,Mid-Value,Potential Loyalists
81838,1183,3,"108,8",2,1,1,4,Low-Value,Can't Lose
81840,1258,1,"15,4",2,1,1,4,Low-Value,Can't Lose
81842,218,5,"743,45",5,1,2,8,High-Value,Potential Loyalists
81843,591,1,"19,8",4,1,1,6,Mid-Value,Potential Loyalists
81845,1132,1,"28,1",2,1,1,4,Low-Value,Can't Lose
81846,1785,2,"5,5",1,1,1,3,Low-Value,Lost
81847,16,10,"723,8",5,2,2,9,High-Value,Champions
81848,1333,1,"45,75",2,1,1,4,Low-Value,Can't Lose
81851,17,3,"120,75",5,1,1,7,Mid-Value,Potential Loyalists
81853,437,5,"66,2",4,1,1,6,Mid-Value,Potential Loyalists
81855,21,5,"709,15",5,1,2,8,High-Value,Potential Loyalists
81859,368,7,"617,5500000000001",4,2,1,7,Mid-Value,Potential Loyalists
81860,23,11,"739,4",5,2,2,9,High-Value,Champions
81864,1335,2,"68,0",2,1,1,4,Low-Value,Can't Lose
81865,448,4,"203,7",4,1,1,6,Mid-Value,Potential Loyalists
81866,1369,1,"49,6",2,1,1,4,Low-Value,Can't Lose
81868,547,8,"284,8",4,2,1,7,Mid-Value,Potential Loyalists
81870,117,2,"57,3",5,1,1,7,Mid-Value,Potential Loyalists
81871,162,6,"212,6",5,1,1,7,Mid-Value,Potential Loyalists
81874,185,5,"247,1",5,1,1,7,Mid-Value,Potential Loyalists
81875,194,3,"122,64999999999999",5,1,1,7,Mid-Value,Potential Loyalists
81877,194,8,"422,0",5,2,1,8,High-Value,Potential Loyalists
81878,25,8,"689,95",5,2,2,9,High-Value,Champions
81879,66,5,"355,2",5,1,1,7,Mid-Value,Potential Loyalists
81880,18,1,"110,5",5,1,1,7,Mid-Value,Potential Loyalists
81885,500,1,"71,9",4,1,1,6,Mid-Value,Potential Loyalists
81886,951,1,"41,4",3,1,1,5,Low-Value,At Risk Customers
81889,1046,2,"76,25",3,1,1,5,Low-Value,At Risk Customers
81890,18,5,"147,75",5,1,1,7,Mid-Value,Potential Loyalists
81891,1113,1,"205,9",2,1,1,4,Low-Value,Can't Lose
81895,720,3,"41,2",4,1,1,6,Mid-Value,Potential Loyalists
81896,222,5,"595,25",5,1,1,7,Mid-Value,Potential Loyalists
81902,1666,1,"30,599999999999998",1,1,1,3,Low-Value,Lost
81903,182,1,"108,75",5,1,1,7,Mid-Value,Potential Loyalists
81904,85,6,"229,45",5,1,1,7,Mid-Value,Potential Loyalists
81906,118,7,"348,75",5,2,1,8,High-Value,Potential Loyalists
81908,1118,2,"255,35000000000002",2,1,1,4,Low-Value,Can't Lose
81910,1793,1,"57,85",1,1,1,3,Low-Value,Lost
81911,846,2,"75,89999999999999",3,1,1,5,Low-Value,At Risk Customers
81912,139,2,"201,8",5,1,1,7,Mid-Value,Potential Loyalists
81913,89,3,"64,5",5,1,1,7,Mid-Value,Potential Loyalists
81914,215,3,"116,3",5,1,1,7,Mid-Value,Potential Loyalists
81915,435,1,"53,3",4,1,1,6,Mid-Value,Potential Loyalists
81916,1147,2,"107,85000000000001",2,1,1,4,Low-Value,Can't Lose
81917,113,2,"643,8",5,1,1,7,Mid-Value,Potential Loyalists
81919,1304,4,"127,85",2,1,1,4,Low-Value,Can't Lose
81920,1201,1,"9,1",2,1,1,4,Low-Value,Can't Lose
81922,86,5,"485,2",5,1,1,7,Mid-Value,Potential Loyalists
81923,198,1,"100,5",5,1,1,7,Mid-Value,Potential Loyalists
81925,495,1,"8,7",4,1,1,6,Mid-Value,Potential Loyalists
81930,1337,1,"15,0",2,1,1,4,Low-Value,Can't Lose
81931,2,3,"185,7",5,1,1,7,Mid-Value,Potential Loyalists
81932,708,5,"470,7",4,1,1,6,Mid-Value,Potential Loyalists
81933,1347,1,"125,8",2,1,1,4,Low-Value,Can't Lose
81935,217,2,"127,39999999999999",5,1,1,7,Mid-Value,Potential Loyalists
81936,377,2,"514,7",4,1,1,6,Mid-Value,Potential Loyalists
81937,1176,1,"418,9",2,1,1,4,Low-Value,Can't Lose
81938,1047,2,"65,35",3,1,1,5,Low-Value,At Risk Customers
81941,249,6,"267,9",5,1,1,7,Mid-Value,Potential Loyalists
81943,267,3,"259,0",5,1,1,7,Mid-Value,Potential Loyalists
81944,622,1,"67,65",4,1,1,6,Mid-Value,Potential Loyalists
81945,29,7,"218,05",5,2,1,8,High-Value,Potential Loyalists
81946,239,2,"194,9",5,1,1,7,Mid-Value,Potential Loyalists
81950,214,5,"331,85",5,1,1,7,Mid-Value,Potential Loyalists
81953,1175,1,"23,45",2,1,1,4,Low-Value,Can't Lose
81955,554,5,"408,75",4,1,1,6,Mid-Value,Potential Loyalists
81956,721,1,"6,8",4,1,1,6,Mid-Value,Potential Loyalists
81958,535,5,"631,65",4,1,1,6,Mid-Value,Potential Loyalists
81959,929,3,"196,7",3,1,1,5,Low-Value,At Risk Customers
81960,1712,1,"50,5",1,1,1,3,Low-Value,Lost
81962,278,7,"387,6",5,2,1,8,High-Value,Potential Loyalists
81963,134,4,"158,15",5,1,1,7,Mid-Value,Potential Loyalists
81964,568,5,"464,45000000000005",4,1,1,6,Mid-Value,Potential Loyalists
81965,21,9,"232,95",5,2,1,8,High-Value,Potential Loyalists
81966,796,3,"37,05",3,1,1,5,Low-Value,At Risk Customers
81967,847,2,"94,8",3,1,1,5,Low-Value,At Risk Customers
81968,20,16,"1206,8",5,3,2,10,High-Value,Champions
81969,544,8,"337,4",4,2,1,7,Mid-Value,Potential Loyalists
81970,1317,1,"27,900000000000002",2,1,1,4,Low-Value,Can't Lose
81972,309,1,"57,45",5,1,1,7,Mid-Value,Potential Loyalists
81975,1125,2,"128,15",2,1,1,4,Low-Value,Can't Lose
81977,738,3,"80,45",3,1,1,5,Low-Value,At Risk Customers
81978,49,10,"347,5",5,2,1,8,High-Value,Potential Loyalists
81979,906,1,"24,8",3,1,1,5,Low-Value,At Risk Customers
81982,35,5,"228,45",5,1,1,7,Mid-Value,Potential Loyalists
81983,554,2,"158,55",4,1,1,6,Mid-Value,Potential Loyalists
81984,368,1,"13,3",4,1,1,6,Mid-Value,Potential Loyalists
81985,114,3,"116,85",5,1,1,7,Mid-Value,Potential Loyalists
81986,362,2,"130,7",5,1,1,7,Mid-Value,Potential Loyalists
81987,1085,1,"31,65",3,1,1,5,Low-Value,At Risk Customers
81989,433,8,"542,05",4,2,1,7,Mid-Value,Potential Loyalists
81990,920,1,"208,4",3,1,1,5,Low-Value,At Risk Customers
81991,185,7,"223,4",5,2,1,8,High-Value,Potential Loyalists
81992,749,1,"10,0",3,1,1,5,Low-Value,At Risk Customers
81993,1593,1,"219,8",1,1,1,3,Low-Value,Lost
81994,1177,4,"133,8",2,1,1,4,Low-Value,Can't Lose
81995,309,2,"103,9",5,1,1,7,Mid-Value,Potential Loyalists
81996,233,2,"176,35",5,1,1,7,Mid-Value,Potential Loyalists
81999,560,1,"13,5",4,1,1,6,Mid-Value,Potential Loyalists
82000,116,3,"147,0",5,1,1,7,Mid-Value,Potential Loyalists
82001,269,1,"6,55",5,1,1,7,Mid-Value,Potential Loyalists
82002,589,1,"58,5",4,1,1,6,Mid-Value,Potential Loyalists
82003,1567,2,"207,29999999999998",1,1,1,3,Low-Value,Lost
82007,63,5,"343,85",5,1,1,7,Mid-Value,Potential Loyalists
82008,652,4,"227,7",4,1,1,6,Mid-Value,Potential Loyalists
82009,44,6,"1067,4499999999998",5,1,2,8,High-Value,Potential Loyalists
82013,772,2,"172,9",3,1,1,5,Low-Value,At Risk Customers
82014,368,3,"275,2",4,1,1,6,Mid-Value,Potential Loyalists
82016,1259,5,"103,15",2,1,1,4,Low-Value,Can't Lose
82017,752,2,"66,85",3,1,1,5,Low-Value,At Risk Customers
82018,219,3,"457,15999999999997",5,1,1,7,Mid-Value,Potential Loyalists
82019,371,5,"253,5",4,1,1,6,Mid-Value,Potential Loyalists
82020,1123,2,"82,4",2,1,1,4,Low-Value,Can't Lose
82021,948,2,"245,14999999999998",3,1,1,5,Low-Value,At Risk Customers
82022,835,2,"114,19999999999999",3,1,1,5,Low-Value,At Risk Customers
82024,171,3,"273,75",5,1,1,7,Mid-Value,Potential Loyalists
82027,1743,1,"6,05",1,1,1,3,Low-Value,Lost
82028,543,5,"357,0",4,1,1,6,Mid-Value,Potential Loyalists
82029,259,1,"36,4",5,1,1,7,Mid-Value,Potential Loyalists
82030,927,4,"243,3",3,1,1,5,Low-Value,At Risk Customers
82031,616,2,"64,45",4,1,1,6,Mid-Value,Potential Loyalists
82034,246,5,"328,25",5,1,1,7,Mid-Value,Potential Loyalists
82035,724,2,"109,6",4,1,1,6,Mid-Value,Potential Loyalists
82037,137,2,"56,0",5,1,1,7,Mid-Value,Potential Loyalists
82038,321,6,"652,9",5,1,1,7,Mid-Value,Potential Loyalists
82040,46,3,"52,15",5,1,1,7,Mid-Value,Potential Loyalists
82041,40,2,"98,44999999999999",5,1,1,7,Mid-Value,Potential Loyalists
82042,27,6,"351,75",5,1,1,7,Mid-Value,Potential Loyalists
82045,139,10,"677,15",5,2,2,9,High-Value,Champions
82047,1374,1,"33,3",2,1,1,4,Low-Value,Can't Lose
82049,128,2,"58,75",5,1,1,7,Mid-Value,Potential Loyalists
82051,143,3,"116,39999999999999",5,1,1,7,Mid-Value,Potential Loyalists
82052,339,4,"437,5",5,1,1,7,Mid-Value,Potential Loyalists
82053,263,7,"426,5",5,2,1,8,High-Value,Potential Loyalists
82055,562,1,"46,3",4,1,1,6,Mid-Value,Potential Loyalists
82056,1337,2,"52,15",2,1,1,4,Low-Value,Can't Lose
82057,1596,1,"22,0",1,1,1,3,Low-Value,Lost
82060,22,7,"231,29999999999998",5,2,1,8,High-Value,Potential Loyalists
82062,1354,1,"16,55",2,1,1,4,Low-Value,Can't Lose
82063,1579,2,"113,85",1,1,1,3,Low-Value,Lost
82065,349,4,"389,3",5,1,1,7,Mid-Value,Potential Loyalists
82066,141,5,"317,25",5,1,1,7,Mid-Value,Potential Loyalists
82067,1796,1,"235,6",1,1,1,3,Low-Value,Lost
82069,399,9,"655,65",4,2,1,7,Mid-Value,Potential Loyalists
82070,544,7,"102,85",4,2,1,7,Mid-Value,Potential Loyalists
82071,884,2,"21,65",3,1,1,5,Low-Value,At Risk Customers
82073,845,3,"46,4",3,1,1,5,Low-Value,At Risk Customers
82076,875,10,"466,4",3,2,1,6,Mid-Value,Potential Loyalists
82081,1785,1,"101,6",1,1,1,3,Low-Value,Lost
82082,603,2,"122,05000000000001",4,1,1,6,Mid-Value,Potential Loyalists
82084,1138,4,"104,19999999999999",2,1,1,4,Low-Value,Can't Lose
82086,1670,1,"37,5",1,1,1,3,Low-Value,Lost
82087,579,3,"106,25",4,1,1,6,Mid-Value,Potential Loyalists
82089,46,10,"712,8",5,2,2,9,High-Value,Champions
82090,105,4,"107,05",5,1,1,7,Mid-Value,Potential Loyalists
82092,376,1,"17,1",4,1,1,6,Mid-Value,Potential Loyalists
82093,117,3,"358,34999999999997",5,1,1,7,Mid-Value,Potential Loyalists
82094,152,6,"170,79999999999998",5,1,1,7,Mid-Value,Potential Loyalists
82095,1439,1,"36,65",2,1,1,4,Low-Value,Can't Lose
82099,348,3,"214,6",5,1,1,7,Mid-Value,Potential Loyalists
82103,1140,2,"41,35",2,1,1,4,Low-Value,Can't Lose
82104,966,4,"91,95",3,1,1,5,Low-Value,At Risk Customers
82106,936,2,"324,0",3,1,1,5,Low-Value,At Risk Customers
82107,227,4,"97,3",5,1,1,7,Mid-Value,Potential Loyalists
82108,496,2,"176,8",4,1,1,6,Mid-Value,Potential Loyalists
82109,395,7,"1066,95",4,2,2,8,High-Value,Potential Loyalists
82113,1718,1,"45,15",1,1,1,3,Low-Value,Lost
82114,1466,1,"37,8",1,1,1,3,Low-Value,Lost
82115,383,1,"155,4",4,1,1,6,Mid-Value,Potential Loyalists
82117,815,2,"25,4",3,1,1,5,Low-Value,At Risk Customers
82121,3,4,"349,44999999999993",5,1,1,7,Mid-Value,Potential Loyalists
82124,558,1,"24,7",4,1,1,6,Mid-Value,Potential Loyalists
82125,7,2,"401,59999999999997",5,1,1,7,Mid-Value,Potential Loyalists
82127,1229,1,"101,8",2,1,1,4,Low-Value,Can't Lose
82128,1811,1,"17,05",1,1,1,3,Low-Value,Lost
82131,405,2,"54,45",4,1,1,6,Mid-Value,Potential Loyalists
82135,60,6,"158,3",5,1,1,7,Mid-Value,Potential Loyalists
82136,1129,3,"84,35",2,1,1,4,Low-Value,Can't Lose
82137,788,1,"53,6",3,1,1,5,Low-Value,At Risk Customers
82138,123,4,"114,25",5,1,1,7,Mid-Value,Potential Loyalists
82139,89,2,"739,9499999999999",5,1,2,8,High-Value,Potential Loyalists
82140,577,4,"77,45",4,1,1,6,Mid-Value,Potential Loyalists
82141,135,5,"541,9000000000001",5,1,1,7,Mid-Value,Potential Loyalists
82142,1,5,"330,05",5,1,1,7,Mid-Value,Potential Loyalists
82143,879,4,"434,75",3,1,1,5,Low-Value,At Risk Customers
82144,1564,1,"12,25",1,1,1,3,Low-Value,Lost
82149,1207,3,"114,35",2,1,1,4,Low-Value,Can't Lose
82150,152,2,"150,2",5,1,1,7,Mid-Value,Potential Loyalists
82151,323,5,"754,05",5,1,2,8,High-Value,Potential Loyalists
82152,322,4,"345,5",5,1,1,7,Mid-Value,Potential Loyalists
82154,229,1,"176,55",5,1,1,7,Mid-Value,Potential Loyalists
82155,296,1,"29,8",5,1,1,7,Mid-Value,Potential Loyalists
82156,85,5,"39,8",5,1,1,7,Mid-Value,Potential Loyalists
82157,18,8,"590,15",5,2,1,8,High-Value,Potential Loyalists
82160,137,1,"13,1",5,1,1,7,Mid-Value,Potential Loyalists
82161,315,2,"93,94999999999999",5,1,1,7,Mid-Value,Potential Loyalists
82162,17,9,"473,9",5,2,1,8,High-Value,Potential Loyalists
82165,523,2,"173,3",4,1,1,6,Mid-Value,Potential Loyalists
82166,815,2,"53,2",3,1,1,5,Low-Value,At Risk Customers
82168,126,2,"102,85",5,1,1,7,Mid-Value,Potential Loyalists
82169,32,5,"127,6",5,1,1,7,Mid-Value,Potential Loyalists
82170,1618,1,"33,0",1,1,1,3,Low-Value,Lost
82172,204,4,"332,90000000000003",5,1,1,7,Mid-Value,Potential Loyalists
82173,40,4,"126,39999999999999",5,1,1,7,Mid-Value,Potential Loyalists
82174,231,3,"182,3",5,1,1,7,Mid-Value,Potential Loyalists
82175,171,2,"72,25",5,1,1,7,Mid-Value,Potential Loyalists
82177,737,2,"438,4",3,1,1,5,Low-Value,At Risk Customers
82178,393,5,"130,95",4,1,1,6,Mid-Value,Potential Loyalists
82179,18,5,"366,35",5,1,1,7,Mid-Value,Potential Loyalists
82181,655,3,"47,75",4,1,1,6,Mid-Value,Potential Loyalists
82182,220,3,"488,75",5,1,1,7,Mid-Value,Potential Loyalists
82183,534,1,"71,25",4,1,1,6,Mid-Value,Potential Loyalists
82184,1227,1,"12,4",2,1,1,4,Low-Value,Can't Lose
82186,1383,1,"15,95",2,1,1,4,Low-Value,Can't Lose
82188,1650,2,"252,20000000000002",1,1,1,3,Low-Value,Lost
82189,711,2,"46,8",4,1,1,6,Mid-Value,Potential Loyalists
82190,62,2,"28,700000000000003",5,1,1,7,Mid-Value,Potential Loyalists
82191,48,3,"433,70000000000005",5,1,1,7,Mid-Value,Potential Loyalists
82193,787,3,"116,60000000000001",3,1,1,5,Low-Value,At Risk Customers
82196,1596,2,"133,6",1,1,1,3,Low-Value,Lost
82197,15,2,"51,8",5,1,1,7,Mid-Value,Potential Loyalists
82201,1507,2,"370,4",1,1,1,3,Low-Value,Lost
82202,111,4,"217,5",5,1,1,7,Mid-Value,Potential Loyalists
82203,753,9,"357,9",3,2,1,6,Mid-Value,Potential Loyalists
82204,1329,1,"35,45",2,1,1,4,Low-Value,Can't Lose
82208,64,4,"225,4",5,1,1,7,Mid-Value,Potential Loyalists
82210,62,6,"240,6",5,1,1,7,Mid-Value,Potential Loyalists
82211,175,2,"420,4",5,1,1,7,Mid-Value,Potential Loyalists
82213,408,3,"77,6",4,1,1,6,Mid-Value,Potential Loyalists
82214,1189,4,"63,5",2,1,1,4,Low-Value,Can't Lose
82215,1082,1,"113,45",3,1,1,5,Low-Value,At Risk Customers
82216,750,1,"33,8",3,1,1,5,Low-Value,At Risk Customers
82217,19,6,"251,70000000000002",5,1,1,7,Mid-Value,Potential Loyalists
82219,1277,1,"70,3",2,1,1,4,Low-Value,Can't Lose
82220,231,4,"146,7",5,1,1,7,Mid-Value,Potential Loyalists
82221,1105,1,"113,3",2,1,1,4,Low-Value,Can't Lose
82222,161,3,"206,25",5,1,1,7,Mid-Value,Potential Loyalists
82224,415,3,"120,6",4,1,1,6,Mid-Value,Potential Loyalists
82227,387,2,"307,4",4,1,1,6,Mid-Value,Potential Loyalists
82228,149,3,"83,05",5,1,1,7,Mid-Value,Potential Loyalists
82231,1386,1,"51,55",2,1,1,4,Low-Value,Can't Lose
82232,656,3,"80,2",4,1,1,6,Mid-Value,Potential Loyalists
82233,22,6,"273,7",5,1,1,7,Mid-Value,Potential Loyalists
82234,227,1,"20,4",5,1,1,7,Mid-Value,Potential Loyalists
82241,333,5,"395,5",5,1,1,7,Mid-Value,Potential Loyalists
82246,944,2,"116,3",3,1,1,5,Low-Value,At Risk Customers
82248,1705,1,"19,5",1,1,1,3,Low-Value,Lost
82249,1236,2,"201,29999999999998",2,1,1,4,Low-Value,Can't Lose
82250,768,7,"1002,9",3,2,2,7,Mid-Value,Potential Loyalists
82251,190,1,"114,9",5,1,1,7,Mid-Value,Potential Loyalists
82253,1712,1,"36,599999999999994",1,1,1,3,Low-Value,Lost
82256,344,6,"292,15",5,1,1,7,Mid-Value,Potential Loyalists
82257,252,2,"231,4",5,1,1,7,Mid-Value,Potential Loyalists
82258,435,4,"161,64999999999998",4,1,1,6,Mid-Value,Potential Loyalists
82260,269,3,"39,4",5,1,1,7,Mid-Value,Potential Loyalists
82261,866,2,"81,6",3,1,1,5,Low-Value,At Risk Customers
82262,38,5,"696,05",5,1,2,8,High-Value,Potential Loyalists
82263,1441,1,"19,35",2,1,1,4,Low-Value,Can't Lose
82264,42,4,"348,0",5,1,1,7,Mid-Value,Potential Loyalists
82265,879,5,"301,95000000000005",3,1,1,5,Low-Value,At Risk Customers
82267,337,3,"119,95",5,1,1,7,Mid-Value,Potential Loyalists
82268,1184,2,"235,7",2,1,1,4,Low-Value,Can't Lose
82269,550,1,"86,0",4,1,1,6,Mid-Value,Potential Loyalists
82270,717,1,"36,7",4,1,1,6,Mid-Value,Potential Loyalists
82271,107,4,"212,05",5,1,1,7,Mid-Value,Potential Loyalists
82274,222,3,"177,5",5,1,1,7,Mid-Value,Potential Loyalists
82276,387,3,"582,8",4,1,1,6,Mid-Value,Potential Loyalists
82279,22,2,"479,95",5,1,1,7,Mid-Value,Potential Loyalists
82280,487,5,"742,2",4,1,2,7,Mid-Value,Potential Loyalists
82281,1362,1,"13,75",2,1,1,4,Low-Value,Can't Lose
82282,189,5,"268,84999999999997",5,1,1,7,Mid-Value,Potential Loyalists
82283,553,2,"115,75",4,1,1,6,Mid-Value,Potential Loyalists
82284,1815,1,"23,4",1,1,1,3,Low-Value,Lost
82285,161,1,"29,0",5,1,1,7,Mid-Value,Potential Loyalists
82287,848,3,"346,29999999999995",3,1,1,5,Low-Value,At Risk Customers
82289,419,3,"51,95",4,1,1,6,Mid-Value,Potential Loyalists
82290,282,1,"5,35",5,1,1,7,Mid-Value,Potential Loyalists
82293,642,3,"59,45",4,1,1,6,Mid-Value,Potential Loyalists
82296,1119,2,"129,0",2,1,1,4,Low-Value,Can't Lose
82297,60,9,"511,05",5,2,1,8,High-Value,Potential Loyalists
82298,1123,5,"1015,3499999999999",2,1,2,5,Low-Value,At Risk Customers
82299,406,2,"99,65",4,1,1,6,Mid-Value,Potential Loyalists
82300,127,5,"326,9",5,1,1,7,Mid-Value,Potential Loyalists
82303,24,14,"747,5",5,3,2,10,High-Value,Champions
82304,390,3,"95,39999999999999",4,1,1,6,Mid-Value,Potential Loyalists
82305,0,4,"117,15",5,1,1,7,Mid-Value,Potential Loyalists
82306,1470,1,"102,8",1,1,1,3,Low-Value,Lost
82308,431,2,"192,89999999999998",4,1,1,6,Mid-Value,Potential Loyalists
82311,872,2,"50,6",3,1,1,5,Low-Value,At Risk Customers
82315,1222,1,"85,4",2,1,1,4,Low-Value,Can't Lose
82316,1384,4,"325,85",2,1,1,4,Low-Value,Can't Lose
82318,1181,1,"8,4",2,1,1,4,Low-Value,Can't Lose
82319,16,10,"563,5",5,2,1,8,High-Value,Potential Loyalists
82321,295,2,"151,15",5,1,1,7,Mid-Value,Potential Loyalists
82322,159,3,"266,79999999999995",5,1,1,7,Mid-Value,Potential Loyalists
82323,62,1,"11,8",5,1,1,7,Mid-Value,Potential Loyalists
82324,808,3,"285,0",3,1,1,5,Low-Value,At Risk Customers
82325,892,1,"100,2",3,1,1,5,Low-Value,At Risk Customers
82326,1648,1,"122,0",1,1,1,3,Low-Value,Lost
82327,23,4,"270,45",5,1,1,7,Mid-Value,Potential Loyalists
82330,191,2,"291,90000000000003",5,1,1,7,Mid-Value,Potential Loyalists
82331,915,1,"75,7",3,1,1,5,Low-Value,At Risk Customers
82335,869,5,"130,05",3,1,1,5,Low-Value,At Risk Customers
82336,339,4,"105,75",5,1,1,7,Mid-Value,Potential Loyalists
82337,30,4,"260,9",5,1,1,7,Mid-Value,Potential Loyalists
82339,48,6,"253,2",5,1,1,7,Mid-Value,Potential Loyalists
82340,52,3,"125,1",5,1,1,7,Mid-Value,Potential Loyalists
82342,398,7,"905,9499999999999",4,2,2,8,High-Value,Potential Loyalists
82345,1033,2,"52,85",3,1,1,5,Low-Value,At Risk Customers
82346,42,12,"1114,15",5,3,2,10,High-Value,Champions
82347,619,4,"90,6",4,1,1,6,Mid-Value,Potential Loyalists
82348,377,1,"41,0",4,1,1,6,Mid-Value,Potential Loyalists
82349,478,1,"18,9",4,1,1,6,Mid-Value,Potential Loyalists
82350,1508,1,"34,15",1,1,1,3,Low-Value,Lost
82352,1191,4,"85,5",2,1,1,4,Low-Value,Can't Lose
82353,29,1,"17,1",5,1,1,7,Mid-Value,Potential Loyalists
82354,733,1,"112,3",3,1,1,5,Low-Value,At Risk Customers
82355,1144,1,"17,35",2,1,1,4,Low-Value,Can't Lose
82357,411,4,"210,04999999999998",4,1,1,6,Mid-Value,Potential Loyalists
82358,65,3,"168,6",5,1,1,7,Mid-Value,Potential Loyalists
82365,1342,5,"283,95",2,1,1,4,Low-Value,Can't Lose
82367,197,2,"81,35000000000001",5,1,1,7,Mid-Value,Potential Loyalists
82368,104,3,"278,25",5,1,1,7,Mid-Value,Potential Loyalists
82372,550,1,"10,2",4,1,1,6,Mid-Value,Potential Loyalists
82373,297,4,"34,5",5,1,1,7,Mid-Value,Potential Loyalists
82377,1289,1,"124,6",2,1,1,4,Low-Value,Can't Lose
82378,30,4,"127,64999999999999",5,1,1,7,Mid-Value,Potential Loyalists
82380,1123,1,"102,8",2,1,1,4,Low-Value,Can't Lose
82381,145,8,"486,0",5,2,1,8,High-Value,Potential Loyalists
82383,291,1,"199,0",5,1,1,7,Mid-Value,Potential Loyalists
82385,433,7,"124,55",4,2,1,7,Mid-Value,Potential Loyalists
82386,0,1,"135,0",5,1,1,7,Mid-Value,Potential Loyalists
82387,957,2,"100,9",3,1,1,5,Low-Value,At Risk Customers
82388,48,4,"182,75",5,1,1,7,Mid-Value,Potential Loyalists
82392,423,5,"269,45",4,1,1,6,Mid-Value,Potential Loyalists
82393,824,8,"400,7",3,2,1,6,Mid-Value,Potential Loyalists
82394,1291,1,"189,75",2,1,1,4,Low-Value,Can't Lose
82395,1550,1,"21,8",1,1,1,3,Low-Value,Lost
82397,1590,1,"280,1",1,1,1,3,Low-Value,Lost
82398,103,1,"179,1",5,1,1,7,Mid-Value,Potential Loyalists
82401,296,2,"204,39999999999998",5,1,1,7,Mid-Value,Potential Loyalists
82404,5,4,"263,7",5,1,1,7,Mid-Value,Potential Loyalists
82405,1806,1,"59,95",1,1,1,3,Low-Value,Lost
82406,1097,4,"373,65",2,1,1,4,Low-Value,Can't Lose
82407,5,9,"303,4",5,2,1,8,High-Value,Potential Loyalists
82409,1167,1,"51,7",2,1,1,4,Low-Value,Can't Lose
82412,1783,1,"11,5",1,1,1,3,Low-Value,Lost
82414,142,2,"66,9",5,1,1,7,Mid-Value,Potential Loyalists
82415,801,4,"319,8",3,1,1,5,Low-Value,At Risk Customers
82416,878,1,"10,3",3,1,1,5,Low-Value,At Risk Customers
82417,974,4,"505,1",3,1,1,5,Low-Value,At Risk Customers
82420,879,1,"8,9",3,1,1,5,Low-Value,At Risk Customers
82421,383,2,"207,1",4,1,1,6,Mid-Value,Potential Loyalists
82423,1097,1,"171,0",2,1,1,4,Low-Value,Can't Lose
82425,797,4,"158,5",3,1,1,5,Low-Value,At Risk Customers
82426,126,2,"37,65",5,1,1,7,Mid-Value,Potential Loyalists
82427,133,3,"167,25",5,1,1,7,Mid-Value,Potential Loyalists
82433,69,4,"174,15",5,1,1,7,Mid-Value,Potential Loyalists
82436,821,1,"91,5",3,1,1,5,Low-Value,At Risk Customers
82438,489,4,"173,3",4,1,1,6,Mid-Value,Potential Loyalists
82439,1259,2,"192,45",2,1,1,4,Low-Value,Can't Lose
82443,53,3,"45,4",5,1,1,7,Mid-Value,Potential Loyalists
82445,428,6,"136,0",4,1,1,6,Mid-Value,Potential Loyalists
82446,396,6,"320,55",4,1,1,6,Mid-Value,Potential Loyalists
82453,250,1,"24,3",5,1,1,7,Mid-Value,Potential Loyalists
82454,62,7,"543,1500000000001",5,2,1,8,High-Value,Potential Loyalists
82455,548,2,"429,25000000000006",4,1,1,6,Mid-Value,Potential Loyalists
82456,1767,1,"148,6",1,1,1,3,Low-Value,Lost
82459,39,3,"110,94999999999999",5,1,1,7,Mid-Value,Potential Loyalists
82460,68,8,"611,68",5,2,1,8,High-Value,Potential Loyalists
82462,606,1,"84,9",4,1,1,6,Mid-Value,Potential Loyalists
82464,519,3,"107,65",4,1,1,6,Mid-Value,Potential Loyalists
82465,77,2,"48,45",5,1,1,7,Mid-Value,Potential Loyalists
82466,149,2,"173,35",5,1,1,7,Mid-Value,Potential Loyalists
82469,512,1,"13,1",4,1,1,6,Mid-Value,Potential Loyalists
82470,1505,2,"44,599999999999994",1,1,1,3,Low-Value,Lost
82472,135,2,"202,20000000000002",5,1,1,7,Mid-Value,Potential Loyalists
82473,1057,1,"12,5",3,1,1,5,Low-Value,At Risk Customers
82475,68,3,"66,75",5,1,1,7,Mid-Value,Potential Loyalists
82477,74,6,"182,6",5,1,1,7,Mid-Value,Potential Loyalists
82478,1411,3,"268,5",2,1,1,4,Low-Value,Can't Lose
82480,59,4,"106,85",5,1,1,7,Mid-Value,Potential Loyalists
82482,1157,2,"71,65",2,1,1,4,Low-Value,Can't Lose
82484,815,1,"64,95",3,1,1,5,Low-Value,At Risk Customers
82485,516,5,"565,25",4,1,1,6,Mid-Value,Potential Loyalists
82487,3,5,"117,6",5,1,1,7,Mid-Value,Potential Loyalists
82492,1358,1,"38,9",2,1,1,4,Low-Value,Can't Lose
82493,157,4,"155,54999999999998",5,1,1,7,Mid-Value,Potential Loyalists
82495,15,2,"147,9",5,1,1,7,Mid-Value,Potential Loyalists
82499,179,7,"291,75",5,2,1,8,High-Value,Potential Loyalists
82500,508,3,"170,65",4,1,1,6,Mid-Value,Potential Loyalists
82501,668,2,"31,0",4,1,1,6,Mid-Value,Potential Loyalists
82502,8,4,"117,55",5,1,1,7,Mid-Value,Potential Loyalists
82503,571,3,"145,60000000000002",4,1,1,6,Mid-Value,Potential Loyalists
82504,778,4,"486,30000000000007",3,1,1,5,Low-Value,At Risk Customers
82505,620,2,"153,3",4,1,1,6,Mid-Value,Potential Loyalists
82506,620,4,"27,199999999999996",4,1,1,6,Mid-Value,Potential Loyalists
82507,45,3,"84,3",5,1,1,7,Mid-Value,Potential Loyalists
82510,926,2,"101,5",3,1,1,5,Low-Value,At Risk Customers
82512,241,2,"58,35",5,1,1,7,Mid-Value,Potential Loyalists
82513,102,4,"217,6",5,1,1,7,Mid-Value,Potential Loyalists
82515,405,5,"857,3499999999999",4,1,2,7,Mid-Value,Potential Loyalists
82516,998,3,"478,5",3,1,1,5,Low-Value,At Risk Customers
82518,577,2,"238,89999999999998",4,1,1,6,Mid-Value,Potential Loyalists
82519,60,4,"128,5",5,1,1,7,Mid-Value,Potential Loyalists
82520,773,2,"140,1",3,1,1,5,Low-Value,At Risk Customers
82523,615,2,"139,20000000000002",4,1,1,6,Mid-Value,Potential Loyalists
82525,178,1,"128,8",5,1,1,7,Mid-Value,Potential Loyalists
82526,778,2,"24,2",3,1,1,5,Low-Value,At Risk Customers
82527,1292,3,"103,74999999999999",2,1,1,4,Low-Value,Can't Lose
82528,593,1,"49,6",4,1,1,6,Mid-Value,Potential Loyalists
82530,255,3,"136,75",5,1,1,7,Mid-Value,Potential Loyalists
82531,476,3,"151,35",4,1,1,6,Mid-Value,Potential Loyalists
82532,266,5,"179,89999999999998",5,1,1,7,Mid-Value,Potential Loyalists
82533,284,1,"36,7",5,1,1,7,Mid-Value,Potential Loyalists
82534,67,5,"367,75",5,1,1,7,Mid-Value,Potential Loyalists
82535,379,3,"96,19999999999999",4,1,1,6,Mid-Value,Potential Loyalists
82536,10,5,"250,05",5,1,1,7,Mid-Value,Potential Loyalists
82539,173,5,"446,0",5,1,1,7,Mid-Value,Potential Loyalists
82540,827,3,"95,3",3,1,1,5,Low-Value,At Risk Customers
82541,229,3,"219,45",5,1,1,7,Mid-Value,Potential Loyalists
82542,1050,2,"16,0",3,1,1,5,Low-Value,At Risk Customers
82543,243,3,"49,7",5,1,1,7,Mid-Value,Potential Loyalists
82546,1335,1,"30,25",2,1,1,4,Low-Value,Can't Lose
82547,1045,4,"73,95",3,1,1,5,Low-Value,At Risk Customers
82548,564,6,"799,3499999999999",4,1,2,7,Mid-Value,Potential Loyalists
82550,86,3,"142,15",5,1,1,7,Mid-Value,Potential Loyalists
82554,36,2,"61,6",5,1,1,7,Mid-Value,Potential Loyalists
82555,129,4,"92,95",5,1,1,7,Mid-Value,Potential Loyalists
82556,518,7,"589,0",4,2,1,7,Mid-Value,Potential Loyalists
82557,72,2,"105,0",5,1,1,7,Mid-Value,Potential Loyalists
82561,869,3,"212,8",3,1,1,5,Low-Value,At Risk Customers
82562,1246,1,"29,3",2,1,1,4,Low-Value,Can't Lose
82564,1341,1,"53,6",2,1,1,4,Low-Value,Can't Lose
82567,184,8,"447,95",5,2,1,8,High-Value,Potential Loyalists
82569,584,2,"65,65",4,1,1,6,Mid-Value,Potential Loyalists
82571,352,1,"3,2",5,1,1,7,Mid-Value,Potential Loyalists
82572,1469,2,"38,3",1,1,1,3,Low-Value,Lost
82573,52,8,"285,9",5,2,1,8,High-Value,Potential Loyalists
82574,858,5,"285,9",3,1,1,5,Low-Value,At Risk Customers
82576,157,4,"150,65",5,1,1,7,Mid-Value,Potential Loyalists
82577,299,4,"163,14999999999998",5,1,1,7,Mid-Value,Potential Loyalists
82578,1378,2,"58,650000000000006",2,1,1,4,Low-Value,Can't Lose
82579,421,3,"105,0",4,1,1,6,Mid-Value,Potential Loyalists
82580,134,3,"345,5",5,1,1,7,Mid-Value,Potential Loyalists
82581,1234,2,"229,5",2,1,1,4,Low-Value,Can't Lose
82582,53,6,"286,6",5,1,1,7,Mid-Value,Potential Loyalists
82583,522,4,"332,4",4,1,1,6,Mid-Value,Potential Loyalists
82584,11,4,"236,75",5,1,1,7,Mid-Value,Potential Loyalists
82585,1820,1,"12,8",1,1,1,3,Low-Value,Lost
82587,7,7,"629,1",5,2,1,8,High-Value,Potential Loyalists
82588,137,5,"631,05",5,1,1,7,Mid-Value,Potential Loyalists
82590,816,3,"378,85",3,1,1,5,Low-Value,At Risk Customers
82591,182,2,"53,05",5,1,1,7,Mid-Value,Potential Loyalists
82592,117,2,"94,65",5,1,1,7,Mid-Value,Potential Loyalists
82594,484,1,"113,8",4,1,1,6,Mid-Value,Potential Loyalists
82596,1184,2,"49,55",2,1,1,4,Low-Value,Can't Lose
82597,1145,1,"17,75",2,1,1,4,Low-Value,Can't Lose
82598,1508,4,"245,15",1,1,1,3,Low-Value,Lost
82601,165,3,"32,75",5,1,1,7,Mid-Value,Potential Loyalists
82602,94,7,"224,2",5,2,1,8,High-Value,Potential Loyalists
82603,434,4,"86,4",4,1,1,6,Mid-Value,Potential Loyalists
82604,1298,1,"30,1",2,1,1,4,Low-Value,Can't Lose
82605,503,8,"716,1",4,2,2,8,High-Value,Potential Loyalists
82607,33,1,"15,3",5,1,1,7,Mid-Value,Potential Loyalists
82608,206,3,"303,0",5,1,1,7,Mid-Value,Potential Loyalists
82610,783,4,"100,5",3,1,1,5,Low-Value,At Risk Customers
82611,777,3,"171,64999999999998",3,1,1,5,Low-Value,At Risk Customers
82612,61,7,"526,95",5,2,1,8,High-Value,Potential Loyalists
82613,215,2,"45,2",5,1,1,7,Mid-Value,Potential Loyalists
82615,1081,4,"253,5",3,1,1,5,Low-Value,At Risk Customers
82616,1273,2,"29,45",2,1,1,4,Low-Value,Can't Lose
82619,1317,3,"76,35",2,1,1,4,Low-Value,Can't Lose
82621,493,3,"262,6",4,1,1,6,Mid-Value,Potential Loyalists
82622,620,6,"342,2",4,1,1,6,Mid-Value,Potential Loyalists
82623,12,10,"453,15",5,2,1,8,High-Value,Potential Loyalists
82625,737,3,"366,6",3,1,1,5,Low-Value,At Risk Customers
82627,584,1,"251,4",4,1,1,6,Mid-Value,Potential Loyalists
82628,531,1,"3,0",4,1,1,6,Mid-Value,Potential Loyalists
82629,289,1,"35,95",5,1,1,7,Mid-Value,Potential Loyalists
82630,927,1,"23,35",3,1,1,5,Low-Value,At Risk Customers
82631,40,2,"63,45",5,1,1,7,Mid-Value,Potential Loyalists
82634,1592,1,"128,25",1,1,1,3,Low-Value,Lost
82635,40,3,"225,6",5,1,1,7,Mid-Value,Potential Loyalists
82636,512,2,"141,05",4,1,1,6,Mid-Value,Potential Loyalists
82640,143,2,"55,5",5,1,1,7,Mid-Value,Potential Loyalists
82641,462,3,"114,55",4,1,1,6,Mid-Value,Potential Loyalists
82642,781,3,"43,2",3,1,1,5,Low-Value,At Risk Customers
82643,500,2,"88,55000000000001",4,1,1,6,Mid-Value,Potential Loyalists
82644,666,2,"126,1",4,1,1,6,Mid-Value,Potential Loyalists
82645,545,2,"121,65",4,1,1,6,Mid-Value,Potential Loyalists
82647,1498,2,"12,1",1,1,1,3,Low-Value,Lost
82650,258,4,"74,8",5,1,1,7,Mid-Value,Potential Loyalists
82652,413,3,"276,90000000000003",4,1,1,6,Mid-Value,Potential Loyalists
82654,91,10,"941,1999999999999",5,2,2,9,High-Value,Champions
82656,1583,1,"77,1",1,1,1,3,Low-Value,Lost
82659,584,4,"159,04999999999998",4,1,1,6,Mid-Value,Potential Loyalists
82662,16,2,"69,7",5,1,1,7,Mid-Value,Potential Loyalists
82667,99,1,"6,45",5,1,1,7,Mid-Value,Potential Loyalists
82670,142,4,"266,3",5,1,1,7,Mid-Value,Potential Loyalists
82671,601,5,"521,7",4,1,1,6,Mid-Value,Potential Loyalists
82672,421,3,"108,85",4,1,1,6,Mid-Value,Potential Loyalists
82674,227,8,"981,55",5,2,2,9,High-Value,Champions
82675,455,2,"41,5",4,1,1,6,Mid-Value,Potential Loyalists
82678,30,4,"525,05",5,1,1,7,Mid-Value,Potential Loyalists
82679,237,3,"376,45",5,1,1,7,Mid-Value,Potential Loyalists
82680,431,4,"75,25",4,1,1,6,Mid-Value,Potential Loyalists
82681,266,1,"49,65",5,1,1,7,Mid-Value,Potential Loyalists
82682,1049,3,"57,0",3,1,1,5,Low-Value,At Risk Customers
82684,863,4,"148,60000000000002",3,1,1,5,Low-Value,At Risk Customers
82685,940,3,"325,59999999999997",3,1,1,5,Low-Value,At Risk Customers
82686,255,2,"45,75",5,1,1,7,Mid-Value,Potential Loyalists
82688,92,7,"528,5",5,2,1,8,High-Value,Potential Loyalists
82690,122,2,"374,9",5,1,1,7,Mid-Value,Potential Loyalists
82691,1167,1,"108,9",2,1,1,4,Low-Value,Can't Lose
82693,1072,2,"90,69999999999999",3,1,1,5,Low-Value,At Risk Customers
82698,457,9,"1120,5",4,2,2,8,High-Value,Potential Loyalists
82699,356,5,"124,85000000000001",5,1,1,7,Mid-Value,Potential Loyalists
82702,1130,1,"21,2",2,1,1,4,Low-Value,Can't Lose
82703,225,1,"6,35",5,1,1,7,Mid-Value,Potential Loyalists
82705,502,1,"52,4",4,1,1,6,Mid-Value,Potential Loyalists
82706,441,1,"101,2",4,1,1,6,Mid-Value,Potential Loyalists
82707,1629,1,"38,7",1,1,1,3,Low-Value,Lost
82709,561,1,"52,050000000000004",4,1,1,6,Mid-Value,Potential Loyalists
82710,2,3,"235,25",5,1,1,7,Mid-Value,Potential Loyalists
82711,910,3,"104,7",3,1,1,5,Low-Value,At Risk Customers
82715,529,4,"164,6",4,1,1,6,Mid-Value,Potential Loyalists
82718,1670,1,"172,35000000000002",1,1,1,3,Low-Value,Lost
82723,234,1,"4,85",5,1,1,7,Mid-Value,Potential Loyalists
82724,939,1,"49,199999999999996",3,1,1,5,Low-Value,At Risk Customers
82727,1257,2,"428,9",2,1,1,4,Low-Value,Can't Lose
82729,5,4,"168,4",5,1,1,7,Mid-Value,Potential Loyalists
82730,1176,1,"4,55",2,1,1,4,Low-Value,Can't Lose
82732,507,1,"38,5",4,1,1,6,Mid-Value,Potential Loyalists
82733,50,4,"301,1",5,1,1,7,Mid-Value,Potential Loyalists
82737,572,3,"126,2",4,1,1,6,Mid-Value,Potential Loyalists
82738,1425,1,"43,95",2,1,1,4,Low-Value,Can't Lose
82739,369,4,"151,55",4,1,1,6,Mid-Value,Potential Loyalists
82741,517,2,"46,3",4,1,1,6,Mid-Value,Potential Loyalists
82745,779,1,"64,5",3,1,1,5,Low-Value,At Risk Customers
82746,495,3,"220,8",4,1,1,6,Mid-Value,Potential Loyalists
82747,872,4,"21,65",3,1,1,5,Low-Value,At Risk Customers
82749,1416,1,"19,7",2,1,1,4,Low-Value,Can't Lose
82750,89,10,"392,70000000000005",5,2,1,8,High-Value,Potential Loyalists
82752,186,7,"317,5",5,2,1,8,High-Value,Potential Loyalists
82754,768,2,"222,95",3,1,1,5,Low-Value,At Risk Customers
82755,68,6,"174,35",5,1,1,7,Mid-Value,Potential Loyalists
82756,564,6,"279,65",4,1,1,6,Mid-Value,Potential Loyalists
82757,29,6,"459,65",5,1,1,7,Mid-Value,Potential Loyalists
82758,130,3,"216,25",5,1,1,7,Mid-Value,Potential Loyalists
82759,263,6,"462,45000000000005",5,1,1,7,Mid-Value,Potential Loyalists
82761,810,2,"52,65",3,1,1,5,Low-Value,At Risk Customers
82762,148,5,"109,85",5,1,1,7,Mid-Value,Potential Loyalists
82763,1286,2,"123,25000000000001",2,1,1,4,Low-Value,Can't Lose
82764,1489,2,"173,1",1,1,1,3,Low-Value,Lost
82767,218,3,"232,45",5,1,1,7,Mid-Value,Potential Loyalists
82768,1241,1,"162,0",2,1,1,4,Low-Value,Can't Lose
82772,276,2,"31,85",5,1,1,7,Mid-Value,Potential Loyalists
82774,519,5,"363,15",4,1,1,6,Mid-Value,Potential Loyalists
82775,315,2,"37,800000000000004",5,1,1,7,Mid-Value,Potential Loyalists
82777,1130,6,"232,5",2,1,1,4,Low-Value,Can't Lose
82779,552,6,"1501,15",4,1,3,8,High-Value,Potential Loyalists
82780,1143,2,"97,2",2,1,1,4,Low-Value,Can't Lose
82783,265,5,"253,3",5,1,1,7,Mid-Value,Potential Loyalists
82785,352,3,"177,7",5,1,1,7,Mid-Value,Potential Loyalists
82789,1654,1,"13,5",1,1,1,3,Low-Value,Lost
82790,122,2,"256,6",5,1,1,7,Mid-Value,Potential Loyalists
82791,16,13,"950,65",5,3,2,10,High-Value,Champions
82793,601,4,"220,85",4,1,1,6,Mid-Value,Potential Loyalists
82797,378,4,"175,75",4,1,1,6,Mid-Value,Potential Loyalists
82799,178,2,"89,35",5,1,1,7,Mid-Value,Potential Loyalists
82801,277,3,"301,0",5,1,1,7,Mid-Value,Potential Loyalists
82804,150,6,"500,40000000000003",5,1,1,7,Mid-Value,Potential Loyalists
82807,488,2,"76,8",4,1,1,6,Mid-Value,Potential Loyalists
82810,165,4,"176,35",5,1,1,7,Mid-Value,Potential Loyalists
82811,1236,5,"517,0999999999999",2,1,1,4,Low-Value,Can't Lose
82812,327,2,"74,9",5,1,1,7,Mid-Value,Potential Loyalists
82813,31,2,"127,89999999999999",5,1,1,7,Mid-Value,Potential Loyalists
82816,622,1,"37,8",4,1,1,6,Mid-Value,Potential Loyalists
82818,471,1,"33,6",4,1,1,6,Mid-Value,Potential Loyalists
82819,118,5,"294,8",5,1,1,7,Mid-Value,Potential Loyalists
82822,435,4,"120,45",4,1,1,6,Mid-Value,Potential Loyalists
82824,558,5,"699,0",4,1,2,7,Mid-Value,Potential Loyalists
82828,263,3,"265,70000000000005",5,1,1,7,Mid-Value,Potential Loyalists
82829,676,2,"153,0",4,1,1,6,Mid-Value,Potential Loyalists
82830,142,1,"121,0",5,1,1,7,Mid-Value,Potential Loyalists
82835,127,11,"693,4",5,2,2,9,High-Value,Champions
82836,1371,1,"84,3",2,1,1,4,Low-Value,Can't Lose
82837,317,2,"52,1",5,1,1,7,Mid-Value,Potential Loyalists
82838,1137,3,"125,80000000000001",2,1,1,4,Low-Value,Can't Lose
82841,171,3,"213,9",5,1,1,7,Mid-Value,Potential Loyalists
82842,260,1,"35,1",5,1,1,7,Mid-Value,Potential Loyalists
82845,570,1,"38,5",4,1,1,6,Mid-Value,Potential Loyalists
82846,310,3,"80,5",5,1,1,7,Mid-Value,Potential Loyalists
82848,328,4,"129,65",5,1,1,7,Mid-Value,Potential Loyalists
82849,236,4,"66,85",5,1,1,7,Mid-Value,Potential Loyalists
82850,5,6,"582,8",5,1,1,7,Mid-Value,Potential Loyalists
82851,166,8,"306,3",5,2,1,8,High-Value,Potential Loyalists
82854,880,3,"176,40000000000003",3,1,1,5,Low-Value,At Risk Customers
82855,647,4,"164,35",4,1,1,6,Mid-Value,Potential Loyalists
82856,748,1,"5,9",3,1,1,5,Low-Value,At Risk Customers
82859,1676,1,"104,6",1,1,1,3,Low-Value,Lost
82860,1208,5,"548,55",2,1,1,4,Low-Value,Can't Lose
82862,421,2,"56,099999999999994",4,1,1,6,Mid-Value,Potential Loyalists
82864,141,4,"140,85",5,1,1,7,Mid-Value,Potential Loyalists
82865,1251,5,"472,85",2,1,1,4,Low-Value,Can't Lose
82866,374,4,"131,65",4,1,1,6,Mid-Value,Potential Loyalists
82867,369,5,"247,2",4,1,1,6,Mid-Value,Potential Loyalists
82868,164,2,"82,05",5,1,1,7,Mid-Value,Potential Loyalists
82869,185,6,"834,8",5,1,2,8,High-Value,Potential Loyalists
82870,19,7,"241,15",5,2,1,8,High-Value,Potential Loyalists
82873,24,5,"160,85",5,1,1,7,Mid-Value,Potential Loyalists
82874,634,1,"99,1",4,1,1,6,Mid-Value,Potential Loyalists
82876,490,1,"71,6",4,1,1,6,Mid-Value,Potential Loyalists
82879,545,3,"433,2",4,1,1,6,Mid-Value,Potential Loyalists
82882,190,2,"106,1",5,1,1,7,Mid-Value,Potential Loyalists
82883,24,4,"237,3",5,1,1,7,Mid-Value,Potential Loyalists
82884,138,2,"371,25000000000006",5,1,1,7,Mid-Value,Potential Loyalists
82885,622,2,"203,95000000000002",4,1,1,6,Mid-Value,Potential Loyalists
82890,272,2,"58,75",5,1,1,7,Mid-Value,Potential Loyalists
82891,59,1,"16,8",5,1,1,7,Mid-Value,Potential Loyalists
82892,299,4,"103,7",5,1,1,7,Mid-Value,Potential Loyalists
82893,750,4,"296,29999999999995",3,1,1,5,Low-Value,At Risk Customers
82894,20,5,"555,7",5,1,1,7,Mid-Value,Potential Loyalists
82895,882,2,"55,0",3,1,1,5,Low-Value,At Risk Customers
82896,245,3,"384,25",5,1,1,7,Mid-Value,Potential Loyalists
82899,719,4,"251,15",4,1,1,6,Mid-Value,Potential Loyalists
82900,1474,2,"88,4",1,1,1,3,Low-Value,Lost
82901,1412,2,"326,1",2,1,1,4,Low-Value,Can't Lose
82904,69,2,"66,05",5,1,1,7,Mid-Value,Potential Loyalists
82906,746,2,"59,25",3,1,1,5,Low-Value,At Risk Customers
82910,526,2,"51,9",4,1,1,6,Mid-Value,Potential Loyalists
82911,129,2,"61,900000000000006",5,1,1,7,Mid-Value,Potential Loyalists
82912,102,4,"301,05",5,1,1,7,Mid-Value,Potential Loyalists
82913,18,1,"2,7",5,1,1,7,Mid-Value,Potential Loyalists
82914,697,2,"125,0",4,1,1,6,Mid-Value,Potential Loyalists
82915,37,2,"76,15",5,1,1,7,Mid-Value,Potential Loyalists
82917,106,3,"99,65",5,1,1,7,Mid-Value,Potential Loyalists
82919,483,1,"16,8",4,1,1,6,Mid-Value,Potential Loyalists
82921,814,3,"162,7",3,1,1,5,Low-Value,At Risk Customers
82922,473,5,"108,35000000000001",4,1,1,6,Mid-Value,Potential Loyalists
82923,13,2,"205,4",5,1,1,7,Mid-Value,Potential Loyalists
82924,131,2,"114,5",5,1,1,7,Mid-Value,Potential Loyalists
82925,673,5,"346,5",4,1,1,6,Mid-Value,Potential Loyalists
82926,156,6,"534,4",5,1,1,7,Mid-Value,Potential Loyalists
82928,1477,1,"78,8",1,1,1,3,Low-Value,Lost
82930,141,5,"1009,4",5,1,2,8,High-Value,Potential Loyalists
82932,672,1,"45,4",4,1,1,6,Mid-Value,Potential Loyalists
82933,923,2,"198,39999999999998",3,1,1,5,Low-Value,At Risk Customers
82934,95,3,"205,15",5,1,1,7,Mid-Value,Potential Loyalists
82938,1373,2,"163,3",2,1,1,4,Low-Value,Can't Lose
82939,127,9,"420,1",5,2,1,8,High-Value,Potential Loyalists
82940,138,4,"297,0",5,1,1,7,Mid-Value,Potential Loyalists
82945,86,1,"13,4",5,1,1,7,Mid-Value,Potential Loyalists
82949,694,8,"375,1",4,2,1,7,Mid-Value,Potential Loyalists
82954,184,5,"180,8",5,1,1,7,Mid-Value,Potential Loyalists
82955,311,5,"180,4",5,1,1,7,Mid-Value,Potential Loyalists
82959,461,2,"21,4",4,1,1,6,Mid-Value,Potential Loyalists
82961,254,5,"371,25",5,1,1,7,Mid-Value,Potential Loyalists
82963,1187,1,"54,95",2,1,1,4,Low-Value,Can't Lose
82964,149,1,"3,8",5,1,1,7,Mid-Value,Potential Loyalists
82965,528,1,"156,95",4,1,1,6,Mid-Value,Potential Loyalists
82966,3,2,"67,75",5,1,1,7,Mid-Value,Potential Loyalists
82969,1566,2,"57,0",1,1,1,3,Low-Value,Lost
82971,1084,2,"71,15",3,1,1,5,Low-Value,At Risk Customers
82972,264,7,"265,3",5,2,1,8,High-Value,Potential Loyalists
82975,158,1,"34,35",5,1,1,7,Mid-Value,Potential Loyalists
82977,75,2,"25,85",5,1,1,7,Mid-Value,Potential Loyalists
82978,18,3,"100,55",5,1,1,7,Mid-Value,Potential Loyalists
82979,41,4,"112,35",5,1,1,7,Mid-Value,Potential Loyalists
82980,414,2,"34,05",4,1,1,6,Mid-Value,Potential Loyalists
82981,39,3,"103,25",5,1,1,7,Mid-Value,Potential Loyalists
82982,4,5,"503,6",5,1,1,7,Mid-Value,Potential Loyalists
82984,244,4,"72,65",5,1,1,7,Mid-Value,Potential Loyalists
82986,581,6,"334,75",4,1,1,6,Mid-Value,Potential Loyalists
82988,154,2,"54,45",5,1,1,7,Mid-Value,Potential Loyalists
82990,734,2,"81,1",3,1,1,5,Low-Value,At Risk Customers
82991,30,4,"210,45",5,1,1,7,Mid-Value,Potential Loyalists
82995,49,2,"211,5",5,1,1,7,Mid-Value,Potential Loyalists
82996,342,1,"5,65",5,1,1,7,Mid-Value,Potential Loyalists
82998,63,5,"159,95000000000002",5,1,1,7,Mid-Value,Potential Loyalists
83003,779,11,"728,3",3,2,2,7,Mid-Value,Potential Loyalists
83008,1013,2,"40,7",3,1,1,5,Low-Value,At Risk Customers
83011,755,3,"235,9",3,1,1,5,Low-Value,At Risk Customers
83017,31,5,"103,1",5,1,1,7,Mid-Value,Potential Loyalists
83020,351,5,"525,5",5,1,1,7,Mid-Value,Potential Loyalists
83023,407,2,"33,25",4,1,1,6,Mid-Value,Potential Loyalists
83024,95,3,"82,8",5,1,1,7,Mid-Value,Potential Loyalists
83026,384,3,"88,6",4,1,1,6,Mid-Value,Potential Loyalists
83027,337,1,"19,95",5,1,1,7,Mid-Value,Potential Loyalists
83029,1224,1,"79,4",2,1,1,4,Low-Value,Can't Lose
83030,1281,1,"32,5",2,1,1,4,Low-Value,Can't Lose
83035,1650,4,"123,7",1,1,1,3,Low-Value,Lost
83037,1155,2,"201,25",2,1,1,4,Low-Value,Can't Lose
83038,1081,2,"68,9",3,1,1,5,Low-Value,At Risk Customers
83039,146,1,"3,2",5,1,1,7,Mid-Value,Potential Loyalists
83040,173,3,"113,85",5,1,1,7,Mid-Value,Potential Loyalists
83041,726,2,"47,349999999999994",4,1,1,6,Mid-Value,Potential Loyalists
83043,561,3,"477,70000000000005",4,1,1,6,Mid-Value,Potential Loyalists
83044,738,7,"318,85",3,2,1,6,Mid-Value,Potential Loyalists
83047,335,1,"7,25",5,1,1,7,Mid-Value,Potential Loyalists
83048,68,2,"19,45",5,1,1,7,Mid-Value,Potential Loyalists
83049,593,1,"17,15",4,1,1,6,Mid-Value,Potential Loyalists
83051,732,1,"91,7",3,1,1,5,Low-Value,At Risk Customers
83053,538,2,"174,7",4,1,1,6,Mid-Value,Potential Loyalists
83054,749,4,"250,2",3,1,1,5,Low-Value,At Risk Customers
83055,413,3,"73,4",4,1,1,6,Mid-Value,Potential Loyalists
83057,62,4,"204,10000000000002",5,1,1,7,Mid-Value,Potential Loyalists
83059,18,7,"222,5",5,2,1,8,High-Value,Potential Loyalists
83067,528,1,"5,5",4,1,1,6,Mid-Value,Potential Loyalists
83068,1500,1,"119,85000000000001",1,1,1,3,Low-Value,Lost
83069,660,6,"160,55",4,1,1,6,Mid-Value,Potential Loyalists
83071,327,1,"47,1",5,1,1,7,Mid-Value,Potential Loyalists
83072,15,4,"987,0999999999999",5,1,2,8,High-Value,Potential Loyalists
83073,450,1,"13,4",4,1,1,6,Mid-Value,Potential Loyalists
83074,1095,1,"40,9",3,1,1,5,Low-Value,At Risk Customers
83075,1029,1,"44,9",3,1,1,5,Low-Value,At Risk Customers
83076,3,1,"151,3",5,1,1,7,Mid-Value,Potential Loyalists
83082,953,1,"152,7",3,1,1,5,Low-Value,At Risk Customers
83083,24,5,"268,8",5,1,1,7,Mid-Value,Potential Loyalists
83084,535,3,"44,2",4,1,1,6,Mid-Value,Potential Loyalists
83085,151,6,"337,70000000000005",5,1,1,7,Mid-Value,Potential Loyalists
83086,765,5,"308,2",3,1,1,5,Low-Value,At Risk Customers
83089,17,7,"385,2",5,2,1,8,High-Value,Potential Loyalists
83092,431,5,"231,2",4,1,1,6,Mid-Value,Potential Loyalists
83094,591,1,"19,35",4,1,1,6,Mid-Value,Potential Loyalists
83097,401,2,"126,4",4,1,1,6,Mid-Value,Potential Loyalists
83098,598,1,"8,85",4,1,1,6,Mid-Value,Potential Loyalists
83099,1768,1,"41,0",1,1,1,3,Low-Value,Lost
83100,36,8,"1251,25",5,2,2,9,High-Value,Champions
83102,212,9,"462,75",5,2,1,8,High-Value,Potential Loyalists
83107,1072,2,"212,20000000000002",3,1,1,5,Low-Value,At Risk Customers
83109,116,6,"321,90000000000003",5,1,1,7,Mid-Value,Potential Loyalists
83111,240,7,"350,2",5,2,1,8,High-Value,Potential Loyalists
83116,260,6,"169,3",5,1,1,7,Mid-Value,Potential Loyalists
83117,916,1,"171,0",3,1,1,5,Low-Value,At Risk Customers
83118,8,5,"691,5",5,1,2,8,High-Value,Potential Loyalists
83119,157,3,"271,85",5,1,1,7,Mid-Value,Potential Loyalists
83121,542,1,"89,9",4,1,1,6,Mid-Value,Potential Loyalists
83122,1799,1,"45,75",1,1,1,3,Low-Value,Lost
83123,1051,2,"173,99999999999997",3,1,1,5,Low-Value,At Risk Customers
83125,783,2,"237,5",3,1,1,5,Low-Value,At Risk Customers
83126,939,3,"50,8",3,1,1,5,Low-Value,At Risk Customers
83128,262,2,"470,95000000000005",5,1,1,7,Mid-Value,Potential Loyalists
83131,440,5,"287,5",4,1,1,6,Mid-Value,Potential Loyalists
83132,743,3,"228,89999999999998",3,1,1,5,Low-Value,At Risk Customers
83134,206,4,"128,7",5,1,1,7,Mid-Value,Potential Loyalists
83136,543,3,"159,15",4,1,1,6,Mid-Value,Potential Loyalists
83138,423,6,"346,6",4,1,1,6,Mid-Value,Potential Loyalists
83139,753,1,"41,2",3,1,1,5,Low-Value,At Risk Customers
83140,1031,1,"30,0",3,1,1,5,Low-Value,At Risk Customers
83142,349,2,"59,9",5,1,1,7,Mid-Value,Potential Loyalists
83144,10,4,"387,95000000000005",5,1,1,7,Mid-Value,Potential Loyalists
83145,374,4,"212,75",4,1,1,6,Mid-Value,Potential Loyalists
83146,87,6,"154,7",5,1,1,7,Mid-Value,Potential Loyalists
83147,730,2,"656,9",4,1,1,6,Mid-Value,Potential Loyalists
83149,608,1,"38,25",4,1,1,6,Mid-Value,Potential Loyalists
83151,516,1,"20,7",4,1,1,6,Mid-Value,Potential Loyalists
83154,447,4,"148,1",4,1,1,6,Mid-Value,Potential Loyalists
83155,339,4,"831,7",5,1,2,8,High-Value,Potential Loyalists
83156,1327,2,"44,25",2,1,1,4,Low-Value,Can't Lose
83158,760,3,"104,55000000000001",3,1,1,5,Low-Value,At Risk Customers
83159,936,1,"18,1",3,1,1,5,Low-Value,At Risk Customers
83163,243,2,"129,75",5,1,1,7,Mid-Value,Potential Loyalists
83164,9,3,"437,55",5,1,1,7,Mid-Value,Potential Loyalists
83166,128,3,"205,5",5,1,1,7,Mid-Value,Potential Loyalists
83167,200,5,"218,19999999999996",5,1,1,7,Mid-Value,Potential Loyalists
83168,264,6,"143,75",5,1,1,7,Mid-Value,Potential Loyalists
83169,94,2,"144,7",5,1,1,7,Mid-Value,Potential Loyalists
83172,1749,1,"18,25",1,1,1,3,Low-Value,Lost
83173,17,5,"259,0",5,1,1,7,Mid-Value,Potential Loyalists
83174,174,7,"460,65",5,2,1,8,High-Value,Potential Loyalists
83176,523,2,"60,349999999999994",4,1,1,6,Mid-Value,Potential Loyalists
83177,79,4,"126,6",5,1,1,7,Mid-Value,Potential Loyalists
83179,10,9,"557,7",5,2,1,8,High-Value,Potential Loyalists
83182,1117,2,"96,0",2,1,1,4,Low-Value,Can't Lose
83183,1086,3,"77,0",3,1,1,5,Low-Value,At Risk Customers
83189,1245,3,"292,35",2,1,1,4,Low-Value,Can't Lose
83194,39,15,"771,35",5,3,2,10,High-Value,Champions
83195,495,3,"452,95",4,1,1,6,Mid-Value,Potential Loyalists
83202,500,5,"282,55",4,1,1,6,Mid-Value,Potential Loyalists
83203,1776,1,"51,1",1,1,1,3,Low-Value,Lost
83205,458,5,"165,45",4,1,1,6,Mid-Value,Potential Loyalists
83208,129,5,"344,65",5,1,1,7,Mid-Value,Potential Loyalists
83209,360,9,"638,3",5,2,1,8,High-Value,Potential Loyalists
83210,217,5,"196,90000000000003",5,1,1,7,Mid-Value,Potential Loyalists
83212,130,9,"512,55",5,2,1,8,High-Value,Potential Loyalists
83214,523,4,"222,60000000000002",4,1,1,6,Mid-Value,Potential Loyalists
83217,619,2,"212,25",4,1,1,6,Mid-Value,Potential Loyalists
83218,750,3,"342,99999999999994",3,1,1,5,Low-Value,At Risk Customers
83219,108,3,"127,9",5,1,1,7,Mid-Value,Potential Loyalists
83220,259,2,"186,5",5,1,1,7,Mid-Value,Potential Loyalists
83221,220,3,"30,299999999999997",5,1,1,7,Mid-Value,Potential Loyalists
83222,281,5,"213,8",5,1,1,7,Mid-Value,Potential Loyalists
83224,747,2,"71,55000000000001",3,1,1,5,Low-Value,At Risk Customers
83226,758,2,"163,15",3,1,1,5,Low-Value,At Risk Customers
83227,990,3,"127,7",3,1,1,5,Low-Value,At Risk Customers
83229,20,11,"461,95",5,2,1,8,High-Value,Potential Loyalists
83230,517,2,"119,39999999999999",4,1,1,6,Mid-Value,Potential Loyalists
83235,914,2,"108,3",3,1,1,5,Low-Value,At Risk Customers
83237,84,1,"29,6",5,1,1,7,Mid-Value,Potential Loyalists
83238,83,2,"17,7",5,1,1,7,Mid-Value,Potential Loyalists
83239,1540,1,"18,2",1,1,1,3,Low-Value,Lost
83240,385,14,"727,2",4,3,2,9,High-Value,Champions
83241,1343,1,"9,3",2,1,1,4,Low-Value,Can't Lose
83242,3,1,"18,4",5,1,1,7,Mid-Value,Potential Loyalists
83243,1220,1,"5,5",2,1,1,4,Low-Value,Can't Lose
83245,1658,2,"228,45",1,1,1,3,Low-Value,Lost
83246,1359,1,"146,6",2,1,1,4,Low-Value,Can't Lose
83248,146,11,"828,0",5,2,2,9,High-Value,Champions
83249,1420,1,"228,2",2,1,1,4,Low-Value,Can't Lose
83250,25,3,"179,2",5,1,1,7,Mid-Value,Potential Loyalists
83251,1757,2,"32,3",1,1,1,3,Low-Value,Lost
83253,344,5,"122,2",5,1,1,7,Mid-Value,Potential Loyalists
83254,1816,1,"42,15",1,1,1,3,Low-Value,Lost
83255,33,2,"93,3",5,1,1,7,Mid-Value,Potential Loyalists
83256,635,2,"56,6",4,1,1,6,Mid-Value,Potential Loyalists
83257,514,3,"360,35",4,1,1,6,Mid-Value,Potential Loyalists
83259,135,3,"223,9",5,1,1,7,Mid-Value,Potential Loyalists
83261,748,4,"152,15",3,1,1,5,Low-Value,At Risk Customers
83262,141,8,"1219,1",5,2,2,9,High-Value,Champions
83264,126,3,"107,6",5,1,1,7,Mid-Value,Potential Loyalists
83266,398,7,"306,45",4,2,1,7,Mid-Value,Potential Loyalists
83267,548,8,"554,3",4,2,1,7,Mid-Value,Potential Loyalists
83268,585,5,"222,15",4,1,1,6,Mid-Value,Potential Loyalists
83269,512,1,"47,099999999999994",4,1,1,6,Mid-Value,Potential Loyalists
83274,216,3,"165,7",5,1,1,7,Mid-Value,Potential Loyalists
83276,1250,2,"59,45",2,1,1,4,Low-Value,Can't Lose
83277,350,7,"241,6",5,2,1,8,High-Value,Potential Loyalists
83280,111,3,"158,25",5,1,1,7,Mid-Value,Potential Loyalists
83281,493,6,"306,2",4,1,1,6,Mid-Value,Potential Loyalists
83282,330,4,"71,1",5,1,1,7,Mid-Value,Potential Loyalists
83284,395,4,"184,0",4,1,1,6,Mid-Value,Potential Loyalists
83286,703,7,"244,39999999999998",4,2,1,7,Mid-Value,Potential Loyalists
83288,395,2,"83,0",4,1,1,6,Mid-Value,Potential Loyalists
83289,209,1,"9,5",5,1,1,7,Mid-Value,Potential Loyalists
83290,350,1,"14,9",5,1,1,7,Mid-Value,Potential Loyalists
83291,547,3,"75,3",4,1,1,6,Mid-Value,Potential Loyalists
83292,832,3,"240,54999999999995",3,1,1,5,Low-Value,At Risk Customers
83297,474,1,"196,15",4,1,1,6,Mid-Value,Potential Loyalists
83298,24,9,"938,25",5,2,2,9,High-Value,Champions
83299,172,3,"62,95",5,1,1,7,Mid-Value,Potential Loyalists
83300,13,2,"70,5",5,1,1,7,Mid-Value,Potential Loyalists
83302,757,8,"700,9000000000001",3,2,2,7,Mid-Value,Potential Loyalists
83307,1075,1,"58,0",3,1,1,5,Low-Value,At Risk Customers
83308,374,2,"164,75",4,1,1,6,Mid-Value,Potential Loyalists
83309,1535,1,"199,0",1,1,1,3,Low-Value,Lost
83311,177,3,"123,55",5,1,1,7,Mid-Value,Potential Loyalists
83312,28,5,"594,05",5,1,1,7,Mid-Value,Potential Loyalists
83314,880,4,"139,5",3,1,1,5,Low-Value,At Risk Customers
83317,91,2,"45,8",5,1,1,7,Mid-Value,Potential Loyalists
83319,769,3,"168,5",3,1,1,5,Low-Value,At Risk Customers
83320,1220,4,"276,65000000000003",2,1,1,4,Low-Value,Can't Lose
83321,494,1,"12,15",4,1,1,6,Mid-Value,Potential Loyalists
83322,35,1,"5,35",5,1,1,7,Mid-Value,Potential Loyalists
83324,0,10,"923,8000000000001",5,2,2,9,High-Value,Champions
83327,365,5,"527,4",5,1,1,7,Mid-Value,Potential Loyalists
83328,822,2,"327,0",3,1,1,5,Low-Value,At Risk Customers
83329,78,3,"88,2",5,1,1,7,Mid-Value,Potential Loyalists
83330,858,1,"29,849999999999998",3,1,1,5,Low-Value,At Risk Customers
83332,1347,1,"17,7",2,1,1,4,Low-Value,Can't Lose
83335,458,2,"141,34999999999997",4,1,1,6,Mid-Value,Potential Loyalists
83339,416,6,"435,5",4,1,1,6,Mid-Value,Potential Loyalists
83341,1243,2,"41,25",2,1,1,4,Low-Value,Can't Lose
83342,271,6,"241,85",5,1,1,7,Mid-Value,Potential Loyalists
83343,755,1,"99,75",3,1,1,5,Low-Value,At Risk Customers
83345,932,2,"320,1",3,1,1,5,Low-Value,At Risk Customers
83346,1430,1,"87,4",2,1,1,4,Low-Value,Can't Lose
83347,67,6,"289,0",5,1,1,7,Mid-Value,Potential Loyalists
83348,428,1,"71,8",4,1,1,6,Mid-Value,Potential Loyalists
83350,937,4,"327,0",3,1,1,5,Low-Value,At Risk Customers
83351,348,3,"242,35",5,1,1,7,Mid-Value,Potential Loyalists
83352,241,1,"26,65",5,1,1,7,Mid-Value,Potential Loyalists
83353,107,2,"29,700000000000003",5,1,1,7,Mid-Value,Potential Loyalists
83354,155,6,"923,25",5,1,2,8,High-Value,Potential Loyalists
83355,970,1,"1162,0",3,1,2,6,Mid-Value,Potential Loyalists
83358,481,3,"112,05",4,1,1,6,Mid-Value,Potential Loyalists
83359,129,8,"492,15",5,2,1,8,High-Value,Potential Loyalists
83361,593,4,"125,35",4,1,1,6,Mid-Value,Potential Loyalists
83363,1091,2,"38,550000000000004",3,1,1,5,Low-Value,At Risk Customers
83364,565,1,"251,6",4,1,1,6,Mid-Value,Potential Loyalists
83365,71,2,"29,9",5,1,1,7,Mid-Value,Potential Loyalists
83366,76,1,"168,05",5,1,1,7,Mid-Value,Potential Loyalists
83368,626,1,"253,2",4,1,1,6,Mid-Value,Potential Loyalists
83369,444,4,"688,8",4,1,2,7,Mid-Value,Potential Loyalists
83372,788,1,"84,85",3,1,1,5,Low-Value,At Risk Customers
83373,11,1,"37,7",5,1,1,7,Mid-Value,Potential Loyalists
83374,991,1,"41,4",3,1,1,5,Low-Value,At Risk Customers
83376,89,6,"143,75",5,1,1,7,Mid-Value,Potential Loyalists
83377,1147,1,"20,85",2,1,1,4,Low-Value,Can't Lose
83384,871,2,"84,5",3,1,1,5,Low-Value,At Risk Customers
83385,24,1,"7,0",5,1,1,7,Mid-Value,Potential Loyalists
83386,26,3,"133,55",5,1,1,7,Mid-Value,Potential Loyalists
83387,1695,1,"28,15",1,1,1,3,Low-Value,Lost
83390,1021,1,"20,1",3,1,1,5,Low-Value,At Risk Customers
83392,379,1,"165,2",4,1,1,6,Mid-Value,Potential Loyalists
83396,1043,1,"109,8",3,1,1,5,Low-Value,At Risk Customers
83398,504,1,"89,2",4,1,1,6,Mid-Value,Potential Loyalists
83399,54,4,"150,2",5,1,1,7,Mid-Value,Potential Loyalists
83400,424,8,"292,25",4,2,1,7,Mid-Value,Potential Loyalists
83401,1805,1,"207,9",1,1,1,3,Low-Value,Lost
83403,111,1,"149,9",5,1,1,7,Mid-Value,Potential Loyalists
83405,606,2,"59,1",4,1,1,6,Mid-Value,Potential Loyalists
83407,8,17,"849,95",5,4,2,11,High-Value,Champions
83408,31,9,"477,75",5,2,1,8,High-Value,Potential Loyalists
83409,1716,1,"26,0",1,1,1,3,Low-Value,Lost
83410,53,7,"563,75",5,2,1,8,High-Value,Potential Loyalists
83411,981,1,"61,4",3,1,1,5,Low-Value,At Risk Customers
83412,1188,3,"163,65",2,1,1,4,Low-Value,Can't Lose
83414,12,4,"270,85",5,1,1,7,Mid-Value,Potential Loyalists
83415,373,3,"142,60000000000002",4,1,1,6,Mid-Value,Potential Loyalists
83417,193,2,"126,19999999999999",5,1,1,7,Mid-Value,Potential Loyalists
83418,794,2,"27,8",3,1,1,5,Low-Value,At Risk Customers
83419,409,2,"101,5",4,1,1,6,Mid-Value,Potential Loyalists
83422,131,1,"32,6",5,1,1,7,Mid-Value,Potential Loyalists
83428,52,5,"120,8",5,1,1,7,Mid-Value,Potential Loyalists
83429,132,3,"58,900000000000006",5,1,1,7,Mid-Value,Potential Loyalists
83431,407,4,"178,15",4,1,1,6,Mid-Value,Potential Loyalists
83432,620,1,"34,05",4,1,1,6,Mid-Value,Potential Loyalists
83435,117,7,"557,0",5,2,1,8,High-Value,Potential Loyalists
83438,150,9,"709,45",5,2,2,9,High-Value,Champions
83440,1485,3,"137,10000000000002",1,1,1,3,Low-Value,Lost
83442,1677,2,"68,75",1,1,1,3,Low-Value,Lost
83444,969,2,"51,05",3,1,1,5,Low-Value,At Risk Customers
83448,768,2,"58,099999999999994",3,1,1,5,Low-Value,At Risk Customers
83449,418,2,"76,0",4,1,1,6,Mid-Value,Potential Loyalists
83450,621,1,"57,05",4,1,1,6,Mid-Value,Potential Loyalists
83454,680,2,"26,25",4,1,1,6,Mid-Value,Potential Loyalists
83456,201,1,"47,2",5,1,1,7,Mid-Value,Potential Loyalists
83458,348,6,"177,45",5,1,1,7,Mid-Value,Potential Loyalists
83459,211,1,"88,2",5,1,1,7,Mid-Value,Potential Loyalists
83460,1257,1,"36,1",2,1,1,4,Low-Value,Can't Lose
83465,200,4,"579,4",5,1,1,7,Mid-Value,Potential Loyalists
83467,733,3,"152,1",3,1,1,5,Low-Value,At Risk Customers
83468,230,2,"242,95000000000002",5,1,1,7,Mid-Value,Potential Loyalists
83469,644,4,"111,45",4,1,1,6,Mid-Value,Potential Loyalists
83473,166,2,"206,5",5,1,1,7,Mid-Value,Potential Loyalists
83476,96,6,"283,59999999999997",5,1,1,7,Mid-Value,Potential Loyalists
83481,738,1,"16,1",3,1,1,5,Low-Value,At Risk Customers
83482,807,1,"5,6",3,1,1,5,Low-Value,At Risk Customers
83486,414,9,"411,59999999999997",4,2,1,7,Mid-Value,Potential Loyalists
83487,908,3,"204,95",3,1,1,5,Low-Value,At Risk Customers
83488,1490,2,"345,25",1,1,1,3,Low-Value,Lost
83489,742,2,"130,54999999999998",3,1,1,5,Low-Value,At Risk Customers
83490,1092,1,"15,4",3,1,1,5,Low-Value,At Risk Customers
83491,405,1,"63,05",4,1,1,6,Mid-Value,Potential Loyalists
83492,52,5,"220,29999999999998",5,1,1,7,Mid-Value,Potential Loyalists
83493,1641,1,"147,3",1,1,1,3,Low-Value,Lost
83494,1159,2,"114,3",2,1,1,4,Low-Value,Can't Lose
83497,1036,2,"324,55",3,1,1,5,Low-Value,At Risk Customers
83498,862,3,"490,7",3,1,1,5,Low-Value,At Risk Customers
83499,224,10,"800,65",5,2,2,9,High-Value,Champions
83500,1553,3,"291,45000000000005",1,1,1,3,Low-Value,Lost
83501,16,8,"411,2",5,2,1,8,High-Value,Potential Loyalists
83502,986,1,"59,4",3,1,1,5,Low-Value,At Risk Customers
83503,407,1,"22,1",4,1,1,6,Mid-Value,Potential Loyalists
83505,134,4,"430,25",5,1,1,7,Mid-Value,Potential Loyalists
83507,45,5,"288,3",5,1,1,7,Mid-Value,Potential Loyalists
83512,938,3,"134,6",3,1,1,5,Low-Value,At Risk Customers
83513,1433,1,"82,0",2,1,1,4,Low-Value,Can't Lose
83514,1265,2,"74,65",2,1,1,4,Low-Value,Can't Lose
83515,89,4,"230,6",5,1,1,7,Mid-Value,Potential Loyalists
83516,132,7,"430,85",5,2,1,8,High-Value,Potential Loyalists
83517,51,6,"169,55",5,1,1,7,Mid-Value,Potential Loyalists
83518,386,4,"169,7",4,1,1,6,Mid-Value,Potential Loyalists
83520,1096,3,"188,10000000000002",2,1,1,4,Low-Value,Can't Lose
83521,1022,1,"30,2",3,1,1,5,Low-Value,At Risk Customers
83522,453,4,"136,55",4,1,1,6,Mid-Value,Potential Loyalists
83523,928,2,"260,3",3,1,1,5,Low-Value,At Risk Customers
83524,319,3,"145,14999999999998",5,1,1,7,Mid-Value,Potential Loyalists
83525,1660,2,"72,55",1,1,1,3,Low-Value,Lost
83529,434,1,"116,85",4,1,1,6,Mid-Value,Potential Loyalists
83530,780,4,"245,55",3,1,1,5,Low-Value,At Risk Customers
83531,225,2,"9,2",5,1,1,7,Mid-Value,Potential Loyalists
83533,1481,1,"169,8",1,1,1,3,Low-Value,Lost
83534,58,1,"116,2",5,1,1,7,Mid-Value,Potential Loyalists
83537,69,3,"98,3",5,1,1,7,Mid-Value,Potential Loyalists
83538,361,1,"151,8",5,1,1,7,Mid-Value,Potential Loyalists
83539,119,6,"311,7",5,1,1,7,Mid-Value,Potential Loyalists
83540,143,2,"911,9999999999999",5,1,2,8,High-Value,Potential Loyalists
83541,213,5,"295,2",5,1,1,7,Mid-Value,Potential Loyalists
83542,91,1,"25,1",5,1,1,7,Mid-Value,Potential Loyalists
83544,250,3,"174,4",5,1,1,7,Mid-Value,Potential Loyalists
83545,1067,1,"25,45",3,1,1,5,Low-Value,At Risk Customers
83548,30,1,"34,1",5,1,1,7,Mid-Value,Potential Loyalists
83549,374,3,"135,0",4,1,1,6,Mid-Value,Potential Loyalists
83551,414,5,"144,1",4,1,1,6,Mid-Value,Potential Loyalists
83552,782,2,"144,45000000000002",3,1,1,5,Low-Value,At Risk Customers
83555,1096,1,"107,2",2,1,1,4,Low-Value,Can't Lose
83557,872,3,"136,85",3,1,1,5,Low-Value,At Risk Customers
83558,470,6,"376,4",4,1,1,6,Mid-Value,Potential Loyalists
83559,158,5,"316,7",5,1,1,7,Mid-Value,Potential Loyalists
83560,348,2,"86,15",5,1,1,7,Mid-Value,Potential Loyalists
83563,53,2,"72,35",5,1,1,7,Mid-Value,Potential Loyalists
83564,9,9,"106,9",5,2,1,8,High-Value,Potential Loyalists
83566,189,7,"616,55",5,2,1,8,High-Value,Potential Loyalists
83567,1696,1,"28,55",1,1,1,3,Low-Value,Lost
83569,46,5,"339,8",5,1,1,7,Mid-Value,Potential Loyalists
83571,386,5,"1372,35",4,1,3,8,High-Value,Potential Loyalists
83574,803,2,"148,2",3,1,1,5,Low-Value,At Risk Customers
83575,785,2,"27,950000000000003",3,1,1,5,Low-Value,At Risk Customers
83578,901,3,"286,2",3,1,1,5,Low-Value,At Risk Customers
83579,721,3,"109,5",4,1,1,6,Mid-Value,Potential Loyalists
83580,1290,1,"43,45",2,1,1,4,Low-Value,Can't Lose
83583,2,2,"60,8",5,1,1,7,Mid-Value,Potential Loyalists
83584,1523,3,"368,09999999999997",1,1,1,3,Low-Value,Lost
83586,266,1,"167,85000000000002",5,1,1,7,Mid-Value,Potential Loyalists
83587,1104,1,"59,3",2,1,1,4,Low-Value,Can't Lose
83588,852,4,"199,35",3,1,1,5,Low-Value,At Risk Customers
83592,527,2,"154,9",4,1,1,6,Mid-Value,Potential Loyalists
83594,269,4,"166,89999999999998",5,1,1,7,Mid-Value,Potential Loyalists
83596,1145,1,"51,8",2,1,1,4,Low-Value,Can't Lose
83597,14,8,"303,75",5,2,1,8,High-Value,Potential Loyalists
83598,790,2,"352,0",3,1,1,5,Low-Value,At Risk Customers
83600,1300,1,"59,6",2,1,1,4,Low-Value,Can't Lose
83601,94,4,"182,35",5,1,1,7,Mid-Value,Potential Loyalists
83606,797,1,"72,55",3,1,1,5,Low-Value,At Risk Customers
83607,904,1,"218,8",3,1,1,5,Low-Value,At Risk Customers
83608,531,9,"360,15",4,2,1,7,Mid-Value,Potential Loyalists
83609,1534,2,"197,8",1,1,1,3,Low-Value,Lost
83611,54,4,"164,85",5,1,1,7,Mid-Value,Potential Loyalists
83615,109,5,"229,65",5,1,1,7,Mid-Value,Potential Loyalists
83616,94,5,"677,55",5,1,2,8,High-Value,Potential Loyalists
83618,775,4,"77,25",3,1,1,5,Low-Value,At Risk Customers
83619,332,1,"355,6",5,1,1,7,Mid-Value,Potential Loyalists
83624,827,4,"179,3",3,1,1,5,Low-Value,At Risk Customers
83625,532,2,"41,2",4,1,1,6,Mid-Value,Potential Loyalists
83627,784,2,"185,75",3,1,1,5,Low-Value,At Risk Customers
83629,81,4,"128,85",5,1,1,7,Mid-Value,Potential Loyalists
83630,56,3,"73,65",5,1,1,7,Mid-Value,Potential Loyalists
83631,70,6,"230,2",5,1,1,7,Mid-Value,Potential Loyalists
83633,81,11,"633,5",5,2,1,8,High-Value,Potential Loyalists
83635,747,6,"298,6",3,1,1,5,Low-Value,At Risk Customers
83637,41,6,"424,7",5,1,1,7,Mid-Value,Potential Loyalists
83639,1471,1,"40,8",1,1,1,3,Low-Value,Lost
83640,708,1,"36,85",4,1,1,6,Mid-Value,Potential Loyalists
83645,1033,1,"9,15",3,1,1,5,Low-Value,At Risk Customers
83646,207,2,"642,4000000000001",5,1,1,7,Mid-Value,Potential Loyalists
83650,624,8,"283,05",4,2,1,7,Mid-Value,Potential Loyalists
83655,11,6,"811,0",5,1,2,8,High-Value,Potential Loyalists
83657,134,1,"70,35",5,1,1,7,Mid-Value,Potential Loyalists
83660,365,5,"204,6",5,1,1,7,Mid-Value,Potential Loyalists
83664,1650,1,"32,2",1,1,1,3,Low-Value,Lost
83665,913,1,"137,2",3,1,1,5,Low-Value,At Risk Customers
83666,355,1,"19,9",5,1,1,7,Mid-Value,Potential Loyalists
83670,633,5,"153,75",4,1,1,6,Mid-Value,Potential Loyalists
83674,71,4,"105,5",5,1,1,7,Mid-Value,Potential Loyalists
83675,24,2,"115,89999999999999",5,1,1,7,Mid-Value,Potential Loyalists
83677,826,2,"193,0",3,1,1,5,Low-Value,At Risk Customers
83678,1697,1,"7,1",1,1,1,3,Low-Value,Lost
83679,388,1,"59,2",4,1,1,6,Mid-Value,Potential Loyalists
83681,54,5,"101,1",5,1,1,7,Mid-Value,Potential Loyalists
83683,88,6,"220,35",5,1,1,7,Mid-Value,Potential Loyalists
83684,1670,2,"77,2",1,1,1,3,Low-Value,Lost
83687,11,7,"414,75",5,2,1,8,High-Value,Potential Loyalists
83688,954,1,"66,35",3,1,1,5,Low-Value,At Risk Customers
83690,126,4,"312,1",5,1,1,7,Mid-Value,Potential Loyalists
83691,855,2,"31,15",3,1,1,5,Low-Value,At Risk Customers
83692,1040,2,"1528,3000000000002",3,1,3,7,Mid-Value,Potential Loyalists
83693,157,1,"19,2",5,1,1,7,Mid-Value,Potential Loyalists
83694,786,1,"38,65",3,1,1,5,Low-Value,At Risk Customers
83696,753,2,"64,9",3,1,1,5,Low-Value,At Risk Customers
83698,18,10,"1664,2",5,2,3,10,High-Value,Champions
83699,133,1,"40,8",5,1,1,7,Mid-Value,Potential Loyalists
83701,574,2,"37,7",4,1,1,6,Mid-Value,Potential Loyalists
83705,388,5,"369,35",4,1,1,6,Mid-Value,Potential Loyalists
83707,438,2,"44,2",4,1,1,6,Mid-Value,Potential Loyalists
83708,1091,1,"14,85",3,1,1,5,Low-Value,At Risk Customers
83709,1359,1,"14,8",2,1,1,4,Low-Value,Can't Lose
83710,368,2,"107,35000000000001",4,1,1,6,Mid-Value,Potential Loyalists
83713,630,5,"263,95",4,1,1,6,Mid-Value,Potential Loyalists
83715,1001,2,"170,0",3,1,1,5,Low-Value,At Risk Customers
83717,38,1,"44,1",5,1,1,7,Mid-Value,Potential Loyalists
83718,686,3,"603,1999999999999",4,1,1,6,Mid-Value,Potential Loyalists
83719,179,5,"342,1",5,1,1,7,Mid-Value,Potential Loyalists
83721,1086,1,"9,85",3,1,1,5,Low-Value,At Risk Customers
83722,596,3,"128,15",4,1,1,6,Mid-Value,Potential Loyalists
83723,1730,1,"4,45",1,1,1,3,Low-Value,Lost
83724,296,3,"105,6",5,1,1,7,Mid-Value,Potential Loyalists
83727,774,4,"257,6",3,1,1,5,Low-Value,At Risk Customers
83729,262,2,"313,6",5,1,1,7,Mid-Value,Potential Loyalists
83731,546,3,"309,50000000000006",4,1,1,6,Mid-Value,Potential Loyalists
83733,776,1,"11,95",3,1,1,5,Low-Value,At Risk Customers
83735,698,2,"67,05",4,1,1,6,Mid-Value,Potential Loyalists
83736,1213,1,"162,0",2,1,1,4,Low-Value,Can't Lose
83737,1343,1,"23,7",2,1,1,4,Low-Value,Can't Lose
83740,28,7,"347,25",5,2,1,8,High-Value,Potential Loyalists
83742,176,5,"173,85",5,1,1,7,Mid-Value,Potential Loyalists
83744,775,5,"365,20000000000005",3,1,1,5,Low-Value,At Risk Customers
83746,1671,3,"263,1",1,1,1,3,Low-Value,Lost
83747,1217,1,"19,45",2,1,1,4,Low-Value,Can't Lose
83749,142,5,"245,15",5,1,1,7,Mid-Value,Potential Loyalists
83750,415,4,"512,7",4,1,1,6,Mid-Value,Potential Loyalists
83751,813,1,"13,65",3,1,1,5,Low-Value,At Risk Customers
83752,263,3,"76,8",5,1,1,7,Mid-Value,Potential Loyalists
83754,112,3,"87,95",5,1,1,7,Mid-Value,Potential Loyalists
83755,144,2,"103,6",5,1,1,7,Mid-Value,Potential Loyalists
83756,986,1,"51,4",3,1,1,5,Low-Value,At Risk Customers
83757,180,4,"185,5",5,1,1,7,Mid-Value,Potential Loyalists
83758,531,1,"8,7",4,1,1,6,Mid-Value,Potential Loyalists
83761,513,2,"54,9",4,1,1,6,Mid-Value,Potential Loyalists
83765,227,3,"84,2",5,1,1,7,Mid-Value,Potential Loyalists
83769,784,3,"157,3",3,1,1,5,Low-Value,At Risk Customers
83770,173,4,"215,45000000000002",5,1,1,7,Mid-Value,Potential Loyalists
83771,519,10,"540,2",4,2,1,7,Mid-Value,Potential Loyalists
83772,1125,1,"23,2",2,1,1,4,Low-Value,Can't Lose
83774,777,3,"61,75",3,1,1,5,Low-Value,At Risk Customers
83776,398,3,"211,0",4,1,1,6,Mid-Value,Potential Loyalists
83777,42,7,"401,2",5,2,1,8,High-Value,Potential Loyalists
83778,375,2,"481,90000000000003",4,1,1,6,Mid-Value,Potential Loyalists
83779,40,9,"1496,85",5,2,3,10,High-Value,Champions
83780,241,2,"80,85",5,1,1,7,Mid-Value,Potential Loyalists
83782,705,3,"160,45",4,1,1,6,Mid-Value,Potential Loyalists
83783,260,3,"121,64999999999999",5,1,1,7,Mid-Value,Potential Loyalists
83785,1633,1,"65,7",1,1,1,3,Low-Value,Lost
83786,542,3,"187,6",4,1,1,6,Mid-Value,Potential Loyalists
83788,1117,4,"739,35",2,1,2,5,Low-Value,At Risk Customers
83789,25,6,"672,85",5,1,2,8,High-Value,Potential Loyalists
83790,543,4,"178,4",4,1,1,6,Mid-Value,Potential Loyalists
83791,1134,2,"42,55",2,1,1,4,Low-Value,Can't Lose
83794,1386,1,"58,6",2,1,1,4,Low-Value,Can't Lose
83797,294,3,"85,3",5,1,1,7,Mid-Value,Potential Loyalists
83798,1143,1,"86,65",2,1,1,4,Low-Value,Can't Lose
83799,322,4,"433,4",5,1,1,7,Mid-Value,Potential Loyalists
83800,346,3,"114,5",5,1,1,7,Mid-Value,Potential Loyalists
83804,1110,1,"45,6",2,1,1,4,Low-Value,Can't Lose
83805,1260,2,"710,4",2,1,2,5,Low-Value,At Risk Customers
83810,26,3,"185,75",5,1,1,7,Mid-Value,Potential Loyalists
83813,15,6,"227,5",5,1,1,7,Mid-Value,Potential Loyalists
83815,889,2,"152,2",3,1,1,5,Low-Value,At Risk Customers
83817,23,2,"32,5",5,1,1,7,Mid-Value,Potential Loyalists
83818,46,6,"359,05",5,1,1,7,Mid-Value,Potential Loyalists
83819,414,2,"180,64999999999998",4,1,1,6,Mid-Value,Potential Loyalists
83822,777,2,"149,55",3,1,1,5,Low-Value,At Risk Customers
83823,15,6,"487,29999999999995",5,1,1,7,Mid-Value,Potential Loyalists
83825,435,2,"18,8",4,1,1,6,Mid-Value,Potential Loyalists
83829,1110,2,"195,5",2,1,1,4,Low-Value,Can't Lose
83830,67,1,"76,3",5,1,1,7,Mid-Value,Potential Loyalists
83831,52,2,"96,85",5,1,1,7,Mid-Value,Potential Loyalists
83834,774,2,"28,299999999999997",3,1,1,5,Low-Value,At Risk Customers
83835,1189,1,"46,5",2,1,1,4,Low-Value,Can't Lose
83836,134,7,"583,1",5,2,1,8,High-Value,Potential Loyalists
83837,915,2,"28,049999999999997",3,1,1,5,Low-Value,At Risk Customers
83838,20,2,"152,4",5,1,1,7,Mid-Value,Potential Loyalists
83839,107,5,"81,5",5,1,1,7,Mid-Value,Potential Loyalists
83841,758,1,"18,3",3,1,1,5,Low-Value,At Risk Customers
83842,1,5,"170,65",5,1,1,7,Mid-Value,Potential Loyalists
83843,1,5,"359,1",5,1,1,7,Mid-Value,Potential Loyalists
83847,542,2,"48,75",4,1,1,6,Mid-Value,Potential Loyalists
83848,384,3,"132,79999999999998",4,1,1,6,Mid-Value,Potential Loyalists
83853,1134,3,"163,95",2,1,1,4,Low-Value,Can't Lose
83854,1790,1,"41,6",1,1,1,3,Low-Value,Lost
83855,1619,2,"399,5",1,1,1,3,Low-Value,Lost
83858,406,1,"39,25",4,1,1,6,Mid-Value,Potential Loyalists
83860,161,3,"92,55",5,1,1,7,Mid-Value,Potential Loyalists
83864,72,8,"637,15",5,2,1,8,High-Value,Potential Loyalists
83865,134,1,"144,0",5,1,1,7,Mid-Value,Potential Loyalists
83869,1268,3,"218,95000000000002",2,1,1,4,Low-Value,Can't Lose
83871,499,2,"59,95",4,1,1,6,Mid-Value,Potential Loyalists
83872,534,2,"136,9",4,1,1,6,Mid-Value,Potential Loyalists
83873,411,4,"380,24999999999994",4,1,1,6,Mid-Value,Potential Loyalists
83875,1324,1,"20,9",2,1,1,4,Low-Value,Can't Lose
83877,1365,1,"12,8",2,1,1,4,Low-Value,Can't Lose
83878,1260,3,"303,7",2,1,1,4,Low-Value,Can't Lose
83879,39,4,"288,09999999999997",5,1,1,7,Mid-Value,Potential Loyalists
83880,419,3,"224,7",4,1,1,6,Mid-Value,Potential Loyalists
83881,416,2,"81,05",4,1,1,6,Mid-Value,Potential Loyalists
83882,252,1,"52,8",5,1,1,7,Mid-Value,Potential Loyalists
83883,99,7,"374,4",5,2,1,8,High-Value,Potential Loyalists
83884,405,1,"106,0",4,1,1,6,Mid-Value,Potential Loyalists
83887,88,9,"413,75",5,2,1,8,High-Value,Potential Loyalists
83890,894,2,"105,2",3,1,1,5,Low-Value,At Risk Customers
83891,791,1,"20,5",3,1,1,5,Low-Value,At Risk Customers
83892,495,2,"154,3",4,1,1,6,Mid-Value,Potential Loyalists
83895,656,4,"332,0",4,1,1,6,Mid-Value,Potential Loyalists
83896,7,7,"288,8",5,2,1,8,High-Value,Potential Loyalists
83899,532,6,"334,5",4,1,1,6,Mid-Value,Potential Loyalists
83900,451,1,"34,1",4,1,1,6,Mid-Value,Potential Loyalists
83903,554,6,"350,55",4,1,1,6,Mid-Value,Potential Loyalists
83905,131,5,"307,6",5,1,1,7,Mid-Value,Potential Loyalists
83906,1483,2,"64,25",1,1,1,3,Low-Value,Lost
83908,1166,1,"1,5",2,1,1,4,Low-Value,Can't Lose
83909,468,3,"125,85000000000001",4,1,1,6,Mid-Value,Potential Loyalists
83912,188,2,"150,55",5,1,1,7,Mid-Value,Potential Loyalists
83913,179,3,"71,35",5,1,1,7,Mid-Value,Potential Loyalists
83914,279,4,"290,75",5,1,1,7,Mid-Value,Potential Loyalists
83916,1032,1,"6,1",3,1,1,5,Low-Value,At Risk Customers
83917,823,2,"79,5",3,1,1,5,Low-Value,At Risk Customers
83918,397,2,"81,7",4,1,1,6,Mid-Value,Potential Loyalists
83920,1070,1,"6,15",3,1,1,5,Low-Value,At Risk Customers
83924,893,4,"179,9",3,1,1,5,Low-Value,At Risk Customers
83925,1289,1,"136,2",2,1,1,4,Low-Value,Can't Lose
83927,162,3,"232,4",5,1,1,7,Mid-Value,Potential Loyalists
83928,83,4,"244,85000000000002",5,1,1,7,Mid-Value,Potential Loyalists
83929,1124,2,"103,75",2,1,1,4,Low-Value,Can't Lose
83930,391,3,"293,75",4,1,1,6,Mid-Value,Potential Loyalists
83935,1492,1,"40,65",1,1,1,3,Low-Value,Lost
83936,93,3,"143,7",5,1,1,7,Mid-Value,Potential Loyalists
83937,89,3,"55,25",5,1,1,7,Mid-Value,Potential Loyalists
83939,418,1,"188,10000000000002",4,1,1,6,Mid-Value,Potential Loyalists
83941,1133,1,"15,45",2,1,1,4,Low-Value,Can't Lose
83942,57,1,"42,15",5,1,1,7,Mid-Value,Potential Loyalists
83943,945,1,"9,65",3,1,1,5,Low-Value,At Risk Customers
83944,228,2,"49,550000000000004",5,1,1,7,Mid-Value,Potential Loyalists
83946,304,11,"765,95",5,2,2,9,High-Value,Champions
83947,393,4,"220,45000000000002",4,1,1,6,Mid-Value,Potential Loyalists
83949,660,4,"213,35",4,1,1,6,Mid-Value,Potential Loyalists
83950,745,8,"208,9",3,2,1,6,Mid-Value,Potential Loyalists
83953,215,8,"411,20000000000005",5,2,1,8,High-Value,Potential Loyalists
83954,1115,1,"46,8",2,1,1,4,Low-Value,Can't Lose
83955,466,2,"118,85",4,1,1,6,Mid-Value,Potential Loyalists
83961,426,7,"160,7",4,2,1,7,Mid-Value,Potential Loyalists
83962,1006,1,"108,0",3,1,1,5,Low-Value,At Risk Customers
83963,536,1,"21,6",4,1,1,6,Mid-Value,Potential Loyalists
83964,1498,4,"406,45",1,1,1,3,Low-Value,Lost
83966,255,4,"190,55",5,1,1,7,Mid-Value,Potential Loyalists
83967,961,1,"47,05",3,1,1,5,Low-Value,At Risk Customers
83968,89,4,"170,1",5,1,1,7,Mid-Value,Potential Loyalists
83970,1071,6,"181,05",3,1,1,5,Low-Value,At Risk Customers
83971,1290,1,"82,4",2,1,1,4,Low-Value,Can't Lose
83972,249,3,"77,25",5,1,1,7,Mid-Value,Potential Loyalists
83973,767,2,"71,45",3,1,1,5,Low-Value,At Risk Customers
83974,386,3,"321,3",4,1,1,6,Mid-Value,Potential Loyalists
83976,402,4,"345,9",4,1,1,6,Mid-Value,Potential Loyalists
83977,586,3,"82,3",4,1,1,6,Mid-Value,Potential Loyalists
83978,368,4,"211,20000000000002",4,1,1,6,Mid-Value,Potential Loyalists
83979,99,4,"222,75",5,1,1,7,Mid-Value,Potential Loyalists
83980,763,2,"788,6499999999999",3,1,2,6,Mid-Value,Potential Loyalists
83982,888,2,"213,45",3,1,1,5,Low-Value,At Risk Customers
83985,1775,1,"26,3",1,1,1,3,Low-Value,Lost
83987,266,10,"589,0",5,2,1,8,High-Value,Potential Loyalists
83988,908,2,"206,7",3,1,1,5,Low-Value,At Risk Customers
83989,1187,1,"28,75",2,1,1,4,Low-Value,Can't Lose
83993,1427,1,"68,6",2,1,1,4,Low-Value,Can't Lose
83994,509,1,"13,7",4,1,1,6,Mid-Value,Potential Loyalists
83996,152,2,"91,1",5,1,1,7,Mid-Value,Potential Loyalists
83997,1402,1,"281,5",2,1,1,4,Low-Value,Can't Lose
83998,913,2,"174,9",3,1,1,5,Low-Value,At Risk Customers
83999,1024,3,"60,05",3,1,1,5,Low-Value,At Risk Customers
84000,1732,1,"43,9",1,1,1,3,Low-Value,Lost
84001,73,4,"110,7",5,1,1,7,Mid-Value,Potential Loyalists
84002,710,1,"199,0",4,1,1,6,Mid-Value,Potential Loyalists
84005,901,2,"423,55",3,1,1,5,Low-Value,At Risk Customers
84006,43,8,"282,85",5,2,1,8,High-Value,Potential Loyalists
84010,777,2,"52,050000000000004",3,1,1,5,Low-Value,At Risk Customers
84011,1447,1,"62,5",2,1,1,4,Low-Value,Can't Lose
84012,416,4,"356,75",4,1,1,6,Mid-Value,Potential Loyalists
84018,157,5,"445,4",5,1,1,7,Mid-Value,Potential Loyalists
84021,182,6,"428,9",5,1,1,7,Mid-Value,Potential Loyalists
84022,728,4,"163,04999999999998",4,1,1,6,Mid-Value,Potential Loyalists
84023,4,6,"640,5",5,1,1,7,Mid-Value,Potential Loyalists
84024,1661,2,"75,8",1,1,1,3,Low-Value,Lost
84026,41,14,"706,9",5,3,2,10,High-Value,Champions
84027,825,1,"28,65",3,1,1,5,Low-Value,At Risk Customers
84028,30,1,"67,2",5,1,1,7,Mid-Value,Potential Loyalists
84029,832,8,"585,0500000000001",3,2,1,6,Mid-Value,Potential Loyalists
84035,671,2,"42,05",4,1,1,6,Mid-Value,Potential Loyalists
84036,1044,1,"39,900000000000006",3,1,1,5,Low-Value,At Risk Customers
84037,325,1,"10,45",5,1,1,7,Mid-Value,Potential Loyalists
84038,10,3,"331,65",5,1,1,7,Mid-Value,Potential Loyalists
84044,1513,1,"9,15",1,1,1,3,Low-Value,Lost
84047,206,21,"1285,2",5,4,2,11,High-Value,Champions
84049,318,1,"247,25",5,1,1,7,Mid-Value,Potential Loyalists
84051,59,2,"134,65",5,1,1,7,Mid-Value,Potential Loyalists
84052,27,5,"487,79999999999995",5,1,1,7,Mid-Value,Potential Loyalists
84054,846,1,"55,5",3,1,1,5,Low-Value,At Risk Customers
84055,17,3,"191,14999999999998",5,1,1,7,Mid-Value,Potential Loyalists
84056,1056,1,"141,9",3,1,1,5,Low-Value,At Risk Customers
84057,147,3,"296,95",5,1,1,7,Mid-Value,Potential Loyalists
84059,142,1,"36,1",5,1,1,7,Mid-Value,Potential Loyalists
84060,5,5,"296,15000000000003",5,1,1,7,Mid-Value,Potential Loyalists
84062,478,4,"173,85",4,1,1,6,Mid-Value,Potential Loyalists
84063,761,1,"150,0",3,1,1,5,Low-Value,At Risk Customers
84066,1145,4,"835,45",2,1,2,5,Low-Value,At Risk Customers
84067,375,8,"526,25",4,2,1,7,Mid-Value,Potential Loyalists
84068,1160,1,"42,15",2,1,1,4,Low-Value,Can't Lose
84071,686,1,"475,3",4,1,1,6,Mid-Value,Potential Loyalists
84077,1450,3,"49,7",2,1,1,4,Low-Value,Can't Lose
84078,860,1,"39,0",3,1,1,5,Low-Value,At Risk Customers
84079,202,5,"181,45",5,1,1,7,Mid-Value,Potential Loyalists
84080,1550,2,"56,150000000000006",1,1,1,3,Low-Value,Lost
84081,1224,3,"283,54999999999995",2,1,1,4,Low-Value,Can't Lose
84083,859,2,"109,05",3,1,1,5,Low-Value,At Risk Customers
84084,45,3,"126,4",5,1,1,7,Mid-Value,Potential Loyalists
84085,991,1,"15,6",3,1,1,5,Low-Value,At Risk Customers
84086,104,1,"40,8",5,1,1,7,Mid-Value,Potential Loyalists
84091,276,3,"102,64999999999999",5,1,1,7,Mid-Value,Potential Loyalists
84094,115,2,"260,7",5,1,1,7,Mid-Value,Potential Loyalists
84096,609,1,"4,9",4,1,1,6,Mid-Value,Potential Loyalists
84099,116,2,"43,1",5,1,1,7,Mid-Value,Potential Loyalists
84101,59,8,"381,1",5,2,1,8,High-Value,Potential Loyalists
84105,4,6,"314,29999999999995",5,1,1,7,Mid-Value,Potential Loyalists
84108,882,2,"43,15",3,1,1,5,Low-Value,At Risk Customers
84112,235,1,"39,45",5,1,1,7,Mid-Value,Potential Loyalists
84113,95,6,"220,14999999999998",5,1,1,7,Mid-Value,Potential Loyalists
84118,88,1,"42,15",5,1,1,7,Mid-Value,Potential Loyalists
84119,1148,1,"51,45",2,1,1,4,Low-Value,Can't Lose
84121,500,3,"183,55",4,1,1,6,Mid-Value,Potential Loyalists
84122,130,2,"189,95",5,1,1,7,Mid-Value,Potential Loyalists
84123,518,3,"67,5",4,1,1,6,Mid-Value,Potential Loyalists
84126,50,3,"745,85",5,1,2,8,High-Value,Potential Loyalists
84127,1318,2,"254,89999999999998",2,1,1,4,Low-Value,Can't Lose
84128,131,2,"530,3",5,1,1,7,Mid-Value,Potential Loyalists
84129,711,1,"135,1",4,1,1,6,Mid-Value,Potential Loyalists
84131,1208,1,"6,1",2,1,1,4,Low-Value,Can't Lose
84132,796,6,"281,6",3,1,1,5,Low-Value,At Risk Customers
84134,199,3,"201,79999999999998",5,1,1,7,Mid-Value,Potential Loyalists
84135,1061,1,"11,45",3,1,1,5,Low-Value,At Risk Customers
84140,695,1,"13,85",4,1,1,6,Mid-Value,Potential Loyalists
84141,158,8,"308,25",5,2,1,8,High-Value,Potential Loyalists
84142,464,2,"162,8",4,1,1,6,Mid-Value,Potential Loyalists
84143,221,1,"24,6",5,1,1,7,Mid-Value,Potential Loyalists
84144,780,3,"200,4",3,1,1,5,Low-Value,At Risk Customers
84145,487,1,"121,75",4,1,1,6,Mid-Value,Potential Loyalists
84146,5,7,"757,85",5,2,2,9,High-Value,Champions
84147,103,4,"310,3",5,1,1,7,Mid-Value,Potential Loyalists
84148,380,6,"301,25",4,1,1,6,Mid-Value,Potential Loyalists
84151,21,12,"293,3",5,3,1,9,High-Value,Champions
84152,237,8,"280,3",5,2,1,8,High-Value,Potential Loyalists
84153,1351,1,"28,4",2,1,1,4,Low-Value,Can't Lose
84154,0,8,"451,15",5,2,1,8,High-Value,Potential Loyalists
84156,792,1,"13,45",3,1,1,5,Low-Value,At Risk Customers
84158,13,3,"148,35",5,1,1,7,Mid-Value,Potential Loyalists
84160,684,6,"637,3",4,1,1,6,Mid-Value,Potential Loyalists
84163,573,1,"84,65",4,1,1,6,Mid-Value,Potential Loyalists
84164,1078,1,"68,4",3,1,1,5,Low-Value,At Risk Customers
84166,121,4,"259,6",5,1,1,7,Mid-Value,Potential Loyalists
84167,4,6,"483,84999999999997",5,1,1,7,Mid-Value,Potential Loyalists
84168,119,2,"42,4",5,1,1,7,Mid-Value,Potential Loyalists
84169,448,5,"268,6",4,1,1,6,Mid-Value,Potential Loyalists
84170,820,3,"168,45",3,1,1,5,Low-Value,At Risk Customers
84173,86,5,"432,0",5,1,1,7,Mid-Value,Potential Loyalists
84174,646,1,"47,25",4,1,1,6,Mid-Value,Potential Loyalists
84176,1000,2,"160,6",3,1,1,5,Low-Value,At Risk Customers
84177,487,6,"294,25",4,1,1,6,Mid-Value,Potential Loyalists
84179,1312,2,"201,15",2,1,1,4,Low-Value,Can't Lose
84180,38,3,"119,35",5,1,1,7,Mid-Value,Potential Loyalists
84181,404,2,"77,7",4,1,1,6,Mid-Value,Potential Loyalists
84184,778,3,"300,15",3,1,1,5,Low-Value,At Risk Customers
84186,1094,2,"62,150000000000006",3,1,1,5,Low-Value,At Risk Customers
84187,235,4,"274,70000000000005",5,1,1,7,Mid-Value,Potential Loyalists
84188,140,2,"109,85",5,1,1,7,Mid-Value,Potential Loyalists
84189,235,14,"1259,25",5,3,2,10,High-Value,Champions
84190,40,5,"515,05",5,1,1,7,Mid-Value,Potential Loyalists
84191,11,7,"328,7",5,2,1,8,High-Value,Potential Loyalists
84194,262,3,"53,650000000000006",5,1,1,7,Mid-Value,Potential Loyalists
84195,4,6,"560,0999999999999",5,1,1,7,Mid-Value,Potential Loyalists
84197,434,2,"78,2",4,1,1,6,Mid-Value,Potential Loyalists
84198,170,2,"493,5",5,1,1,7,Mid-Value,Potential Loyalists
84206,1250,3,"191,79999999999998",2,1,1,4,Low-Value,Can't Lose
84209,628,2,"57,099999999999994",4,1,1,6,Mid-Value,Potential Loyalists
84210,1149,1,"190,2",2,1,1,4,Low-Value,Can't Lose
84211,1736,1,"20,2",1,1,1,3,Low-Value,Lost
84212,965,2,"105,44999999999999",3,1,1,5,Low-Value,At Risk Customers
84213,970,1,"17,85",3,1,1,5,Low-Value,At Risk Customers
84215,1742,1,"76,45",1,1,1,3,Low-Value,Lost
84216,208,2,"338,1",5,1,1,7,Mid-Value,Potential Loyalists
84221,346,1,"20,15",5,1,1,7,Mid-Value,Potential Loyalists
84223,476,1,"13,3",4,1,1,6,Mid-Value,Potential Loyalists
84224,812,5,"133,8",3,1,1,5,Low-Value,At Risk Customers
84225,1292,2,"49,95",2,1,1,4,Low-Value,Can't Lose
84226,699,1,"62,7",4,1,1,6,Mid-Value,Potential Loyalists
84227,692,1,"49,05",4,1,1,6,Mid-Value,Potential Loyalists
84230,1191,4,"378,9",2,1,1,4,Low-Value,Can't Lose
84233,288,6,"196,35",5,1,1,7,Mid-Value,Potential Loyalists
84236,1543,1,"241,0",1,1,1,3,Low-Value,Lost
84237,783,3,"102,45",3,1,1,5,Low-Value,At Risk Customers
84238,24,4,"127,60000000000001",5,1,1,7,Mid-Value,Potential Loyalists
84239,1518,2,"27,55",1,1,1,3,Low-Value,Lost
84242,46,3,"184,4",5,1,1,7,Mid-Value,Potential Loyalists
84243,509,4,"257,45",4,1,1,6,Mid-Value,Potential Loyalists
84244,150,3,"131,75",5,1,1,7,Mid-Value,Potential Loyalists
84245,5,6,"260,2",5,1,1,7,Mid-Value,Potential Loyalists
84246,1502,1,"8,1",1,1,1,3,Low-Value,Lost
84248,1807,1,"62,9",1,1,1,3,Low-Value,Lost
84249,154,1,"3,5",5,1,1,7,Mid-Value,Potential Loyalists
84250,571,1,"191,5",4,1,1,6,Mid-Value,Potential Loyalists
84251,1281,1,"35,0",2,1,1,4,Low-Value,Can't Lose
84252,299,5,"735,9499999999999",5,1,2,8,High-Value,Potential Loyalists
84253,693,1,"135,0",4,1,1,6,Mid-Value,Potential Loyalists
84257,11,3,"75,55000000000001",5,1,1,7,Mid-Value,Potential Loyalists
84258,1521,7,"245,0",1,2,1,4,Low-Value,Can't Lose
84261,21,10,"471,6",5,2,1,8,High-Value,Potential Loyalists
84262,1679,2,"49,3",1,1,1,3,Low-Value,Lost
84263,293,6,"190,95",5,1,1,7,Mid-Value,Potential Loyalists
84266,501,3,"187,1",4,1,1,6,Mid-Value,Potential Loyalists
84267,848,1,"46,9",3,1,1,5,Low-Value,At Risk Customers
84268,1578,5,"558,85",1,1,1,3,Low-Value,Lost
84269,36,2,"61,599999999999994",5,1,1,7,Mid-Value,Potential Loyalists
84270,374,2,"31,6",4,1,1,6,Mid-Value,Potential Loyalists
84273,952,3,"25,1",3,1,1,5,Low-Value,At Risk Customers
84275,1041,2,"71,95",3,1,1,5,Low-Value,At Risk Customers
84276,23,2,"104,9",5,1,1,7,Mid-Value,Potential Loyalists
84277,786,2,"33,75",3,1,1,5,Low-Value,At Risk Customers
84278,91,6,"198,14999999999998",5,1,1,7,Mid-Value,Potential Loyalists
84279,448,2,"89,05",4,1,1,6,Mid-Value,Potential Loyalists
84282,1178,3,"116,15",2,1,1,4,Low-Value,Can't Lose
84284,77,3,"52,1",5,1,1,7,Mid-Value,Potential Loyalists
84289,45,8,"313,0",5,2,1,8,High-Value,Potential Loyalists
84290,430,5,"99,3",4,1,1,6,Mid-Value,Potential Loyalists
84291,1595,1,"43,9",1,1,1,3,Low-Value,Lost
84293,134,4,"604,9",5,1,1,7,Mid-Value,Potential Loyalists
84294,757,9,"403,45",3,2,1,6,Mid-Value,Potential Loyalists
84295,922,3,"218,1",3,1,1,5,Low-Value,At Risk Customers
84296,168,8,"886,25",5,2,2,9,High-Value,Champions
84297,617,11,"501,3",4,2,1,7,Mid-Value,Potential Loyalists
84299,1442,1,"14,05",2,1,1,4,Low-Value,Can't Lose
84301,465,2,"43,45",4,1,1,6,Mid-Value,Potential Loyalists
84303,86,2,"391,70000000000005",5,1,1,7,Mid-Value,Potential Loyalists
84304,227,2,"147,0",5,1,1,7,Mid-Value,Potential Loyalists
84307,1606,2,"83,65",1,1,1,3,Low-Value,Lost
84311,878,3,"138,95",3,1,1,5,Low-Value,At Risk Customers
84314,165,3,"153,4",5,1,1,7,Mid-Value,Potential Loyalists
84315,269,8,"539,7",5,2,1,8,High-Value,Potential Loyalists
84317,190,4,"123,8",5,1,1,7,Mid-Value,Potential Loyalists
84319,1209,2,"24,05",2,1,1,4,Low-Value,Can't Lose
84320,547,1,"38,7",4,1,1,6,Mid-Value,Potential Loyalists
84321,53,7,"493,3",5,2,1,8,High-Value,Potential Loyalists
84322,113,3,"389,1",5,1,1,7,Mid-Value,Potential Loyalists
84323,597,1,"85,5",4,1,1,6,Mid-Value,Potential Loyalists
84326,1644,1,"63,8",1,1,1,3,Low-Value,Lost
84329,262,6,"353,15",5,1,1,7,Mid-Value,Potential Loyalists
84332,460,7,"1175,95",4,2,2,8,High-Value,Potential Loyalists
84333,1544,4,"272,3",1,1,1,3,Low-Value,Lost
84334,240,4,"196,8",5,1,1,7,Mid-Value,Potential Loyalists
84336,34,7,"185,85",5,2,1,8,High-Value,Potential Loyalists
84339,620,1,"15,6",4,1,1,6,Mid-Value,Potential Loyalists
84341,781,2,"53,85",3,1,1,5,Low-Value,At Risk Customers
84342,414,1,"4,65",4,1,1,6,Mid-Value,Potential Loyalists
84343,43,6,"410,95",5,1,1,7,Mid-Value,Potential Loyalists
84344,106,8,"537,35",5,2,1,8,High-Value,Potential Loyalists
84347,870,1,"8,850000000000001",3,1,1,5,Low-Value,At Risk Customers
84348,959,1,"398,0",3,1,1,5,Low-Value,At Risk Customers
84349,228,3,"65,30000000000001",5,1,1,7,Mid-Value,Potential Loyalists
84350,449,4,"87,5",4,1,1,6,Mid-Value,Potential Loyalists
84353,304,6,"240,14999999999998",5,1,1,7,Mid-Value,Potential Loyalists
84354,784,5,"254,89999999999998",3,1,1,5,Low-Value,At Risk Customers
84356,266,2,"142,7",5,1,1,7,Mid-Value,Potential Loyalists
84359,469,1,"192,7",4,1,1,6,Mid-Value,Potential Loyalists
84361,127,3,"155,9",5,1,1,7,Mid-Value,Potential Loyalists
84363,146,3,"121,80000000000001",5,1,1,7,Mid-Value,Potential Loyalists
84364,550,1,"24,2",4,1,1,6,Mid-Value,Potential Loyalists
84366,374,8,"571,9",4,2,1,7,Mid-Value,Potential Loyalists
84368,1155,4,"495,3",2,1,1,4,Low-Value,Can't Lose
84369,755,7,"511,5",3,2,1,6,Mid-Value,Potential Loyalists
84370,28,4,"190,10000000000002",5,1,1,7,Mid-Value,Potential Loyalists
84373,18,3,"139,55",5,1,1,7,Mid-Value,Potential Loyalists
84374,697,5,"221,05",4,1,1,6,Mid-Value,Potential Loyalists
84375,162,3,"168,45",5,1,1,7,Mid-Value,Potential Loyalists
84376,121,2,"22,3",5,1,1,7,Mid-Value,Potential Loyalists
84377,1441,1,"18,35",2,1,1,4,Low-Value,Can't Lose
84378,990,2,"69,5",3,1,1,5,Low-Value,At Risk Customers
84382,348,3,"60,650000000000006",5,1,1,7,Mid-Value,Potential Loyalists
84384,125,3,"66,25",5,1,1,7,Mid-Value,Potential Loyalists
84385,82,1,"10,35",5,1,1,7,Mid-Value,Potential Loyalists
84386,190,8,"889,4",5,2,2,9,High-Value,Champions
84387,25,3,"160,45000000000002",5,1,1,7,Mid-Value,Potential Loyalists
84390,370,6,"257,05",4,1,1,6,Mid-Value,Potential Loyalists
84393,1487,2,"34,95",1,1,1,3,Low-Value,Lost
84394,1065,2,"304,25",3,1,1,5,Low-Value,At Risk Customers
84396,1705,1,"5,75",1,1,1,3,Low-Value,Lost
84399,200,3,"45,5",5,1,1,7,Mid-Value,Potential Loyalists
84400,1086,3,"197,95",3,1,1,5,Low-Value,At Risk Customers
84402,428,1,"8,25",4,1,1,6,Mid-Value,Potential Loyalists
84403,168,1,"55,800000000000004",5,1,1,7,Mid-Value,Potential Loyalists
84404,28,4,"137,5",5,1,1,7,Mid-Value,Potential Loyalists
84405,761,4,"305,5",3,1,1,5,Low-Value,At Risk Customers
84406,25,16,"1003,8",5,3,2,10,High-Value,Champions
84407,790,1,"4,050000000000001",3,1,1,5,Low-Value,At Risk Customers
84408,896,2,"93,2",3,1,1,5,Low-Value,At Risk Customers
84411,29,9,"1246,95",5,2,2,9,High-Value,Champions
84413,1819,1,"23,6",1,1,1,3,Low-Value,Lost
84415,306,4,"128,45",5,1,1,7,Mid-Value,Potential Loyalists
84416,617,2,"104,35",4,1,1,6,Mid-Value,Potential Loyalists
84422,312,7,"208,5",5,2,1,8,High-Value,Potential Loyalists
84423,1096,2,"150,75",2,1,1,4,Low-Value,Can't Lose
84425,531,1,"58,6",4,1,1,6,Mid-Value,Potential Loyalists
84426,43,1,"56,7",5,1,1,7,Mid-Value,Potential Loyalists
84427,1148,1,"5,45",2,1,1,4,Low-Value,Can't Lose
84428,331,5,"331,1",5,1,1,7,Mid-Value,Potential Loyalists
84429,162,1,"54,2",5,1,1,7,Mid-Value,Potential Loyalists
84430,499,1,"46,9",4,1,1,6,Mid-Value,Potential Loyalists
84438,1332,1,"4,35",2,1,1,4,Low-Value,Can't Lose
84439,50,5,"399,04999999999995",5,1,1,7,Mid-Value,Potential Loyalists
84440,692,4,"77,65",4,1,1,6,Mid-Value,Potential Loyalists
84442,210,5,"183,4",5,1,1,7,Mid-Value,Potential Loyalists
84443,93,5,"294,35",5,1,1,7,Mid-Value,Potential Loyalists
84444,89,9,"367,25",5,2,1,8,High-Value,Potential Loyalists
84445,895,1,"73,15",3,1,1,5,Low-Value,At Risk Customers
84447,1003,1,"45,4",3,1,1,5,Low-Value,At Risk Customers
84449,752,2,"380,4",3,1,1,5,Low-Value,At Risk Customers
84450,12,9,"376,95",5,2,1,8,High-Value,Potential Loyalists
84451,810,3,"74,6",3,1,1,5,Low-Value,At Risk Customers
84455,346,2,"498,90000000000003",5,1,1,7,Mid-Value,Potential Loyalists
84460,1104,2,"310,9",2,1,1,4,Low-Value,Can't Lose
84462,701,5,"325,35",4,1,1,6,Mid-Value,Potential Loyalists
84463,504,2,"323,5",4,1,1,6,Mid-Value,Potential Loyalists
84464,74,5,"62,6",5,1,1,7,Mid-Value,Potential Loyalists
84465,524,4,"149,3",4,1,1,6,Mid-Value,Potential Loyalists
84468,359,4,"104,45",5,1,1,7,Mid-Value,Potential Loyalists
84469,934,1,"101,0",3,1,1,5,Low-Value,At Risk Customers
84471,202,1,"33,150000000000006",5,1,1,7,Mid-Value,Potential Loyalists
84472,66,2,"32,2",5,1,1,7,Mid-Value,Potential Loyalists
84475,356,4,"133,9",5,1,1,7,Mid-Value,Potential Loyalists
84478,1446,1,"27,65",2,1,1,4,Low-Value,Can't Lose
84479,15,3,"86,95",5,1,1,7,Mid-Value,Potential Loyalists
84480,96,2,"201,05",5,1,1,7,Mid-Value,Potential Loyalists
84481,108,5,"287,1",5,1,1,7,Mid-Value,Potential Loyalists
84482,654,3,"125,0",4,1,1,6,Mid-Value,Potential Loyalists
84483,706,1,"48,45",4,1,1,6,Mid-Value,Potential Loyalists
84484,1731,2,"30,8",1,1,1,3,Low-Value,Lost
84487,253,3,"137,35",5,1,1,7,Mid-Value,Potential Loyalists
84489,1226,2,"73,95",2,1,1,4,Low-Value,Can't Lose
84490,622,8,"585,65",4,2,1,7,Mid-Value,Potential Loyalists
84491,958,1,"103,5",3,1,1,5,Low-Value,At Risk Customers
84492,381,2,"98,1",4,1,1,6,Mid-Value,Potential Loyalists
84493,906,5,"269,4",3,1,1,5,Low-Value,At Risk Customers
84494,421,5,"139,45",4,1,1,6,Mid-Value,Potential Loyalists
84496,441,3,"95,35",4,1,1,6,Mid-Value,Potential Loyalists
84500,1301,3,"428,34999999999997",2,1,1,4,Low-Value,Can't Lose
84501,13,2,"21,9",5,1,1,7,Mid-Value,Potential Loyalists
84502,1050,2,"185,60000000000002",3,1,1,5,Low-Value,At Risk Customers
84503,230,1,"78,0",5,1,1,7,Mid-Value,Potential Loyalists
84505,73,5,"222,5",5,1,1,7,Mid-Value,Potential Loyalists
84507,1110,1,"8,7",2,1,1,4,Low-Value,Can't Lose
84509,1002,5,"531,1",3,1,1,5,Low-Value,At Risk Customers
84510,402,1,"3,5",4,1,1,6,Mid-Value,Potential Loyalists
84514,462,2,"55,55",4,1,1,6,Mid-Value,Potential Loyalists
84516,37,4,"209,05",5,1,1,7,Mid-Value,Potential Loyalists
84519,197,8,"322,95",5,2,1,8,High-Value,Potential Loyalists
84520,41,1,"21,15",5,1,1,7,Mid-Value,Potential Loyalists
84521,195,4,"171,7",5,1,1,7,Mid-Value,Potential Loyalists
84523,1006,1,"67,8",3,1,1,5,Low-Value,At Risk Customers
84524,197,2,"126,4",5,1,1,7,Mid-Value,Potential Loyalists
84528,2,4,"344,3",5,1,1,7,Mid-Value,Potential Loyalists
84530,233,3,"182,35000000000002",5,1,1,7,Mid-Value,Potential Loyalists
84532,1105,2,"85,30000000000001",2,1,1,4,Low-Value,Can't Lose
84533,752,3,"251,49999999999997",3,1,1,5,Low-Value,At Risk Customers
84535,182,6,"246,0",5,1,1,7,Mid-Value,Potential Loyalists
84539,5,3,"116,05",5,1,1,7,Mid-Value,Potential Loyalists
84544,59,3,"66,75",5,1,1,7,Mid-Value,Potential Loyalists
84546,264,6,"273,05",5,1,1,7,Mid-Value,Potential Loyalists
84555,182,2,"247,5",5,1,1,7,Mid-Value,Potential Loyalists
84557,594,4,"219,39999999999998",4,1,1,6,Mid-Value,Potential Loyalists
84558,717,4,"239,3",4,1,1,6,Mid-Value,Potential Loyalists
84559,2,10,"406,9",5,2,1,8,High-Value,Potential Loyalists
84560,322,10,"486,34999999999997",5,2,1,8,High-Value,Potential Loyalists
84561,1612,1,"13,5",1,1,1,3,Low-Value,Lost
84562,12,3,"293,70000000000005",5,1,1,7,Mid-Value,Potential Loyalists
84564,516,4,"367,95000000000005",4,1,1,6,Mid-Value,Potential Loyalists
84565,92,6,"289,5",5,1,1,7,Mid-Value,Potential Loyalists
84567,1179,1,"22,15",2,1,1,4,Low-Value,Can't Lose
84570,1342,1,"164,4",2,1,1,4,Low-Value,Can't Lose
84571,1084,1,"12,5",3,1,1,5,Low-Value,At Risk Customers
84572,750,3,"234,6",3,1,1,5,Low-Value,At Risk Customers
84574,1131,1,"7,7",2,1,1,4,Low-Value,Can't Lose
84575,1052,2,"1039,4",3,1,2,6,Mid-Value,Potential Loyalists
84576,33,4,"729,0",5,1,2,8,High-Value,Potential Loyalists
84579,25,2,"381,15",5,1,1,7,Mid-Value,Potential Loyalists
84580,5,10,"614,75",5,2,1,8,High-Value,Potential Loyalists
84581,53,5,"382,15000000000003",5,1,1,7,Mid-Value,Potential Loyalists
84582,231,1,"46,9",5,1,1,7,Mid-Value,Potential Loyalists
84583,1222,2,"99,44999999999999",2,1,1,4,Low-Value,Can't Lose
84585,752,1,"165,7",3,1,1,5,Low-Value,At Risk Customers
84586,10,5,"52,65",5,1,1,7,Mid-Value,Potential Loyalists
84588,926,1,"16,0",3,1,1,5,Low-Value,At Risk Customers
84589,829,1,"8,65",3,1,1,5,Low-Value,At Risk Customers
84592,281,7,"908,6",5,2,2,9,High-Value,Champions
84594,277,3,"254,45",5,1,1,7,Mid-Value,Potential Loyalists
84595,1163,5,"393,75",2,1,1,4,Low-Value,Can't Lose
84596,336,2,"323,4",5,1,1,7,Mid-Value,Potential Loyalists
84599,92,6,"469,35",5,1,1,7,Mid-Value,Potential Loyalists
84600,571,4,"352,20000000000005",4,1,1,6,Mid-Value,Potential Loyalists
84602,398,4,"231,45",4,1,1,6,Mid-Value,Potential Loyalists
84604,78,4,"200,3",5,1,1,7,Mid-Value,Potential Loyalists
84605,82,1,"52,05",5,1,1,7,Mid-Value,Potential Loyalists
84606,28,6,"493,65000000000003",5,1,1,7,Mid-Value,Potential Loyalists
84607,390,2,"414,8",4,1,1,6,Mid-Value,Potential Loyalists
84608,1488,1,"140,10000000000002",1,1,1,3,Low-Value,Lost
84609,1460,2,"140,8",2,1,1,4,Low-Value,Can't Lose
84615,206,9,"332,95",5,2,1,8,High-Value,Potential Loyalists
84617,961,1,"11,6",3,1,1,5,Low-Value,At Risk Customers
84618,342,2,"32,599999999999994",5,1,1,7,Mid-Value,Potential Loyalists
84621,920,2,"193,8",3,1,1,5,Low-Value,At Risk Customers
84622,111,1,"7,55",5,1,1,7,Mid-Value,Potential Loyalists
84623,12,4,"353,35",5,1,1,7,Mid-Value,Potential Loyalists
84624,75,1,"5,75",5,1,1,7,Mid-Value,Potential Loyalists
84625,180,1,"32,25",5,1,1,7,Mid-Value,Potential Loyalists
84626,344,1,"8,1",5,1,1,7,Mid-Value,Potential Loyalists
84628,1337,1,"4,6",2,1,1,4,Low-Value,Can't Lose
84629,345,2,"126,14999999999999",5,1,1,7,Mid-Value,Potential Loyalists
84630,12,12,"1069,8",5,3,2,10,High-Value,Champions
84632,77,6,"292,2",5,1,1,7,Mid-Value,Potential Loyalists
84633,161,3,"266,95",5,1,1,7,Mid-Value,Potential Loyalists
84634,1660,2,"169,0",1,1,1,3,Low-Value,Lost
84638,59,6,"119,55000000000001",5,1,1,7,Mid-Value,Potential Loyalists
84640,586,3,"105,15",4,1,1,6,Mid-Value,Potential Loyalists
84642,1111,4,"109,5",2,1,1,4,Low-Value,Can't Lose
84644,699,4,"106,7",4,1,1,6,Mid-Value,Potential Loyalists
84646,378,5,"474,55",4,1,1,6,Mid-Value,Potential Loyalists
84650,130,4,"277,70000000000005",5,1,1,7,Mid-Value,Potential Loyalists
84652,379,4,"276,45",4,1,1,6,Mid-Value,Potential Loyalists
84653,297,1,"12,1",5,1,1,7,Mid-Value,Potential Loyalists
84655,389,2,"64,6",4,1,1,6,Mid-Value,Potential Loyalists
84656,437,2,"70,3",4,1,1,6,Mid-Value,Potential Loyalists
84658,0,6,"643,0",5,1,1,7,Mid-Value,Potential Loyalists
84662,140,3,"245,5",5,1,1,7,Mid-Value,Potential Loyalists
84663,17,8,"423,25",5,2,1,8,High-Value,Potential Loyalists
84664,289,4,"144,3",5,1,1,7,Mid-Value,Potential Loyalists
84666,801,2,"58,45",3,1,1,5,Low-Value,At Risk Customers
84667,396,2,"309,29999999999995",4,1,1,6,Mid-Value,Potential Loyalists
84669,340,4,"228,89999999999998",5,1,1,7,Mid-Value,Potential Loyalists
84670,933,2,"129,4",3,1,1,5,Low-Value,At Risk Customers
84671,45,4,"445,95000000000005",5,1,1,7,Mid-Value,Potential Loyalists
84672,35,3,"230,10000000000002",5,1,1,7,Mid-Value,Potential Loyalists
84673,695,1,"11,2",4,1,1,6,Mid-Value,Potential Loyalists
84676,363,2,"173,0",5,1,1,7,Mid-Value,Potential Loyalists
84679,22,1,"36,9",5,1,1,7,Mid-Value,Potential Loyalists
84685,750,5,"212,3",3,1,1,5,Low-Value,At Risk Customers
84686,1239,1,"112,3",2,1,1,4,Low-Value,Can't Lose
84687,260,1,"109,94999999999999",5,1,1,7,Mid-Value,Potential Loyalists
84688,195,1,"73,8",5,1,1,7,Mid-Value,Potential Loyalists
84691,1564,2,"230,5",1,1,1,3,Low-Value,Lost
84692,1352,1,"227,75",2,1,1,4,Low-Value,Can't Lose
84693,625,2,"399,15",4,1,1,6,Mid-Value,Potential Loyalists
84696,133,2,"407,09999999999997",5,1,1,7,Mid-Value,Potential Loyalists
84697,966,1,"207,29999999999998",3,1,1,5,Low-Value,At Risk Customers
84699,731,2,"199,45",3,1,1,5,Low-Value,At Risk Customers
84700,619,1,"191,3",4,1,1,6,Mid-Value,Potential Loyalists
84703,1469,3,"382,0",1,1,1,3,Low-Value,Lost
84704,157,5,"769,5999999999999",5,1,2,8,High-Value,Potential Loyalists
84705,53,12,"1286,4",5,3,2,10,High-Value,Champions
84707,302,7,"507,5",5,2,1,8,High-Value,Potential Loyalists
84708,782,4,"267,45",3,1,1,5,Low-Value,At Risk Customers
84709,759,9,"397,15",3,2,1,6,Mid-Value,Potential Loyalists
84710,455,1,"85,15",4,1,1,6,Mid-Value,Potential Loyalists
84711,326,2,"94,5",5,1,1,7,Mid-Value,Potential Loyalists
84712,146,7,"504,55",5,2,1,8,High-Value,Potential Loyalists
84714,25,4,"466,45000000000005",5,1,1,7,Mid-Value,Potential Loyalists
84716,612,2,"285,8",4,1,1,6,Mid-Value,Potential Loyalists
84717,1341,1,"0,8",2,1,1,4,Low-Value,Can't Lose
84719,622,1,"42,15",4,1,1,6,Mid-Value,Potential Loyalists
84723,353,4,"364,29999999999995",5,1,1,7,Mid-Value,Potential Loyalists
84724,126,6,"781,15",5,1,2,8,High-Value,Potential Loyalists
84725,140,2,"79,8",5,1,1,7,Mid-Value,Potential Loyalists
84728,47,2,"315,04999999999995",5,1,1,7,Mid-Value,Potential Loyalists
84729,1219,3,"170,8",2,1,1,4,Low-Value,Can't Lose
84731,263,7,"934,35",5,2,2,9,High-Value,Champions
84732,281,4,"120,69999999999999",5,1,1,7,Mid-Value,Potential Loyalists
84735,106,4,"389,4",5,1,1,7,Mid-Value,Potential Loyalists
84737,832,3,"70,7",3,1,1,5,Low-Value,At Risk Customers
84738,719,2,"91,9",4,1,1,6,Mid-Value,Potential Loyalists
84739,912,2,"78,25",3,1,1,5,Low-Value,At Risk Customers
84742,72,10,"456,7",5,2,1,8,High-Value,Potential Loyalists
84743,467,8,"183,3",4,2,1,7,Mid-Value,Potential Loyalists
84744,559,2,"114,0",4,1,1,6,Mid-Value,Potential Loyalists
84746,767,1,"10,5",3,1,1,5,Low-Value,At Risk Customers
84751,203,5,"217,05",5,1,1,7,Mid-Value,Potential Loyalists
84753,68,4,"222,95",5,1,1,7,Mid-Value,Potential Loyalists
84756,42,3,"326,05",5,1,1,7,Mid-Value,Potential Loyalists
84757,1626,1,"126,4",1,1,1,3,Low-Value,Lost
84760,1232,2,"122,9",2,1,1,4,Low-Value,Can't Lose
84762,1002,2,"177,85",3,1,1,5,Low-Value,At Risk Customers
84768,2,3,"193,9",5,1,1,7,Mid-Value,Potential Loyalists
84770,245,3,"152,9",5,1,1,7,Mid-Value,Potential Loyalists
84775,1552,2,"49,15",1,1,1,3,Low-Value,Lost
84776,36,2,"67,65",5,1,1,7,Mid-Value,Potential Loyalists
84779,22,2,"115,1",5,1,1,7,Mid-Value,Potential Loyalists
84780,160,7,"462,35",5,2,1,8,High-Value,Potential Loyalists
84782,218,2,"100,8",5,1,1,7,Mid-Value,Potential Loyalists
84784,542,2,"52,65",4,1,1,6,Mid-Value,Potential Loyalists
84785,289,1,"136,05",5,1,1,7,Mid-Value,Potential Loyalists
84786,738,4,"252,4",3,1,1,5,Low-Value,At Risk Customers
84790,381,8,"637,4",4,2,1,7,Mid-Value,Potential Loyalists
84791,807,3,"92,5",3,1,1,5,Low-Value,At Risk Customers
84792,1114,1,"169,5",2,1,1,4,Low-Value,Can't Lose
84793,11,5,"229,6",5,1,1,7,Mid-Value,Potential Loyalists
84794,1739,1,"24,8",1,1,1,3,Low-Value,Lost
84796,127,6,"357,15",5,1,1,7,Mid-Value,Potential Loyalists
84797,203,5,"236,89999999999998",5,1,1,7,Mid-Value,Potential Loyalists
84800,614,1,"157,05",4,1,1,6,Mid-Value,Potential Loyalists
84802,230,8,"942,25",5,2,2,9,High-Value,Champions
84805,96,2,"105,65",5,1,1,7,Mid-Value,Potential Loyalists
84807,600,3,"150,2",4,1,1,6,Mid-Value,Potential Loyalists
84809,64,6,"217,04999999999998",5,1,1,7,Mid-Value,Potential Loyalists
84810,33,2,"46,099999999999994",5,1,1,7,Mid-Value,Potential Loyalists
84811,56,7,"265,15",5,2,1,8,High-Value,Potential Loyalists
84813,557,6,"247,35",4,1,1,6,Mid-Value,Potential Loyalists
84814,1186,4,"148,4",2,1,1,4,Low-Value,Can't Lose
84815,186,3,"219,70000000000002",5,1,1,7,Mid-Value,Potential Loyalists
84816,300,1,"83,4",5,1,1,7,Mid-Value,Potential Loyalists
84817,72,3,"185,5",5,1,1,7,Mid-Value,Potential Loyalists
84818,357,1,"10,1",5,1,1,7,Mid-Value,Potential Loyalists
84819,156,4,"209,45",5,1,1,7,Mid-Value,Potential Loyalists
84820,1239,1,"168,89999999999998",2,1,1,4,Low-Value,Can't Lose
84821,171,10,"290,15",5,2,1,8,High-Value,Potential Loyalists
84823,21,1,"133,5",5,1,1,7,Mid-Value,Potential Loyalists
84824,162,3,"111,85",5,1,1,7,Mid-Value,Potential Loyalists
84825,404,1,"479,2",4,1,1,6,Mid-Value,Potential Loyalists
84826,99,1,"40,65",5,1,1,7,Mid-Value,Potential Loyalists
84829,931,1,"12,0",3,1,1,5,Low-Value,At Risk Customers
84832,837,2,"55,050000000000004",3,1,1,5,Low-Value,At Risk Customers
84833,677,3,"202,7",4,1,1,6,Mid-Value,Potential Loyalists
84834,182,2,"124,4",5,1,1,7,Mid-Value,Potential Loyalists
84835,211,7,"544,25",5,2,1,8,High-Value,Potential Loyalists
84836,1712,1,"30,4",1,1,1,3,Low-Value,Lost
84837,110,2,"121,0",5,1,1,7,Mid-Value,Potential Loyalists
84841,207,3,"108,80000000000001",5,1,1,7,Mid-Value,Potential Loyalists
84842,339,6,"407,4",5,1,1,7,Mid-Value,Potential Loyalists
84844,722,1,"14,55",4,1,1,6,Mid-Value,Potential Loyalists
84845,55,3,"456,0",5,1,1,7,Mid-Value,Potential Loyalists
84846,188,3,"436,55",5,1,1,7,Mid-Value,Potential Loyalists
84850,123,5,"929,3000000000001",5,1,2,8,High-Value,Potential Loyalists
84852,683,2,"152,3",4,1,1,6,Mid-Value,Potential Loyalists
84854,1005,1,"9,6",3,1,1,5,Low-Value,At Risk Customers
84855,26,5,"168,1",5,1,1,7,Mid-Value,Potential Loyalists
84856,333,2,"74,0",5,1,1,7,Mid-Value,Potential Loyalists
84858,490,4,"53,3",4,1,1,6,Mid-Value,Potential Loyalists
84860,419,2,"57,15",4,1,1,6,Mid-Value,Potential Loyalists
84861,1174,1,"127,75",2,1,1,4,Low-Value,Can't Lose
84864,1335,4,"119,8",2,1,1,4,Low-Value,Can't Lose
84865,473,2,"110,25",4,1,1,6,Mid-Value,Potential Loyalists
84867,775,2,"84,85",3,1,1,5,Low-Value,At Risk Customers
84872,718,1,"51,55",4,1,1,6,Mid-Value,Potential Loyalists
84873,1313,3,"130,04999999999998",2,1,1,4,Low-Value,Can't Lose
84877,152,1,"67,4",5,1,1,7,Mid-Value,Potential Loyalists
84879,368,6,"306,5",4,1,1,6,Mid-Value,Potential Loyalists
84880,49,5,"126,45",5,1,1,7,Mid-Value,Potential Loyalists
84881,877,4,"392,09999999999997",3,1,1,5,Low-Value,At Risk Customers
84883,690,4,"260,3",4,1,1,6,Mid-Value,Potential Loyalists
84884,1510,1,"50,65",1,1,1,3,Low-Value,Lost
84885,52,5,"156,36",5,1,1,7,Mid-Value,Potential Loyalists
84886,84,5,"270,9",5,1,1,7,Mid-Value,Potential Loyalists
84887,160,2,"146,29999999999998",5,1,1,7,Mid-Value,Potential Loyalists
84888,335,2,"174,5",5,1,1,7,Mid-Value,Potential Loyalists
84889,523,5,"428,3",4,1,1,6,Mid-Value,Potential Loyalists
84895,514,2,"213,5",4,1,1,6,Mid-Value,Potential Loyalists
84896,28,1,"103,6",5,1,1,7,Mid-Value,Potential Loyalists
84897,399,6,"308,3",4,1,1,6,Mid-Value,Potential Loyalists
84898,433,2,"296,5",4,1,1,6,Mid-Value,Potential Loyalists
84901,1247,2,"368,05",2,1,1,4,Low-Value,Can't Lose
84902,873,2,"206,04999999999998",3,1,1,5,Low-Value,At Risk Customers
84903,974,1,"72,15",3,1,1,5,Low-Value,At Risk Customers
84904,890,1,"54,3",3,1,1,5,Low-Value,At Risk Customers
84908,217,4,"111,8",5,1,1,7,Mid-Value,Potential Loyalists
84909,78,5,"410,09999999999997",5,1,1,7,Mid-Value,Potential Loyalists
84912,614,1,"80,9",4,1,1,6,Mid-Value,Potential Loyalists
84913,411,3,"207,25",4,1,1,6,Mid-Value,Potential Loyalists
84914,292,3,"92,7",5,1,1,7,Mid-Value,Potential Loyalists
84915,1773,1,"24,55",1,1,1,3,Low-Value,Lost
84918,1389,3,"111,89999999999999",2,1,1,4,Low-Value,Can't Lose
84919,1805,1,"26,55",1,1,1,3,Low-Value,Lost
84920,671,2,"85,14999999999999",4,1,1,6,Mid-Value,Potential Loyalists
84922,42,9,"512,35",5,2,1,8,High-Value,Potential Loyalists
84923,200,1,"12,2",5,1,1,7,Mid-Value,Potential Loyalists
84925,119,6,"244,2",5,1,1,7,Mid-Value,Potential Loyalists
84926,1146,4,"151,55",2,1,1,4,Low-Value,Can't Lose
84927,61,7,"340,45",5,2,1,8,High-Value,Potential Loyalists
84928,1306,2,"67,1",2,1,1,4,Low-Value,Can't Lose
84931,608,4,"191,0",4,1,1,6,Mid-Value,Potential Loyalists
84932,1406,4,"435,45",2,1,1,4,Low-Value,Can't Lose
84933,196,3,"93,3",5,1,1,7,Mid-Value,Potential Loyalists
84934,839,2,"82,35",3,1,1,5,Low-Value,At Risk Customers
84936,128,2,"341,75",5,1,1,7,Mid-Value,Potential Loyalists
84941,561,3,"125,60000000000002",4,1,1,6,Mid-Value,Potential Loyalists
84943,37,2,"26,75",5,1,1,7,Mid-Value,Potential Loyalists
84944,80,9,"432,65",5,2,1,8,High-Value,Potential Loyalists
84950,160,16,"1200,7",5,3,2,10,High-Value,Champions
84953,472,3,"89,45",4,1,1,6,Mid-Value,Potential Loyalists
84954,447,1,"45,5",4,1,1,6,Mid-Value,Potential Loyalists
84955,132,9,"223,75",5,2,1,8,High-Value,Potential Loyalists
84960,98,3,"94,0",5,1,1,7,Mid-Value,Potential Loyalists
84961,800,3,"74,1",3,1,1,5,Low-Value,At Risk Customers
84962,580,2,"81,35",4,1,1,6,Mid-Value,Potential Loyalists
84963,784,5,"381,85",3,1,1,5,Low-Value,At Risk Customers
84967,1110,2,"50,099999999999994",2,1,1,4,Low-Value,Can't Lose
84969,82,5,"199,2",5,1,1,7,Mid-Value,Potential Loyalists
84972,1327,1,"34,95",2,1,1,4,Low-Value,Can't Lose
84974,636,4,"188,35",4,1,1,6,Mid-Value,Potential Loyalists
84975,797,2,"114,5",3,1,1,5,Low-Value,At Risk Customers
84976,236,1,"120,44999999999999",5,1,1,7,Mid-Value,Potential Loyalists
84977,1159,2,"116,94999999999999",2,1,1,4,Low-Value,Can't Lose
84979,864,4,"255,7",3,1,1,5,Low-Value,At Risk Customers
84984,273,3,"98,69999999999999",5,1,1,7,Mid-Value,Potential Loyalists
84985,42,6,"264,05",5,1,1,7,Mid-Value,Potential Loyalists
84988,265,3,"170,39999999999998",5,1,1,7,Mid-Value,Potential Loyalists
84989,180,4,"115,0",5,1,1,7,Mid-Value,Potential Loyalists
84991,109,3,"263,95",5,1,1,7,Mid-Value,Potential Loyalists
84992,15,1,"145,2",5,1,1,7,Mid-Value,Potential Loyalists
84995,448,3,"144,45",4,1,1,6,Mid-Value,Potential Loyalists
84996,757,2,"62,1",3,1,1,5,Low-Value,At Risk Customers
84997,583,1,"108,0",4,1,1,6,Mid-Value,Potential Loyalists
84999,280,2,"182,25",5,1,1,7,Mid-Value,Potential Loyalists
85001,211,2,"81,25",5,1,1,7,Mid-Value,Potential Loyalists
85002,45,9,"371,9",5,2,1,8,High-Value,Potential Loyalists
85003,653,3,"121,0",4,1,1,6,Mid-Value,Potential Loyalists
85005,61,2,"298,09999999999997",5,1,1,7,Mid-Value,Potential Loyalists
85010,136,5,"704,8000000000001",5,1,2,8,High-Value,Potential Loyalists
85014,415,2,"52,65",4,1,1,6,Mid-Value,Potential Loyalists
85015,495,5,"253,2",4,1,1,6,Mid-Value,Potential Loyalists
85016,602,4,"128,55",4,1,1,6,Mid-Value,Potential Loyalists
85018,837,3,"185,95",3,1,1,5,Low-Value,At Risk Customers
85019,1658,3,"119,64999999999999",1,1,1,3,Low-Value,Lost
85020,334,1,"22,45",5,1,1,7,Mid-Value,Potential Loyalists
85021,1119,5,"151,4",2,1,1,4,Low-Value,Can't Lose
85022,70,3,"286,45",5,1,1,7,Mid-Value,Potential Loyalists
85023,59,7,"308,2",5,2,1,8,High-Value,Potential Loyalists
85024,20,6,"486,20000000000005",5,1,1,7,Mid-Value,Potential Loyalists
85025,420,5,"270,6",4,1,1,6,Mid-Value,Potential Loyalists
85026,27,7,"589,75",5,2,1,8,High-Value,Potential Loyalists
85028,1043,1,"48,45",3,1,1,5,Low-Value,At Risk Customers
85030,648,1,"78,15",4,1,1,6,Mid-Value,Potential Loyalists
85031,130,1,"112,64999999999999",5,1,1,7,Mid-Value,Potential Loyalists
85032,1535,1,"5,5",1,1,1,3,Low-Value,Lost
85033,122,1,"14,4",5,1,1,7,Mid-Value,Potential Loyalists
85034,463,1,"18,6",4,1,1,6,Mid-Value,Potential Loyalists
85035,74,4,"178,9",5,1,1,7,Mid-Value,Potential Loyalists
85036,0,2,"164,95",5,1,1,7,Mid-Value,Potential Loyalists
85038,137,1,"48,4",5,1,1,7,Mid-Value,Potential Loyalists
85039,467,4,"337,65000000000003",4,1,1,6,Mid-Value,Potential Loyalists
85041,346,4,"98,0",5,1,1,7,Mid-Value,Potential Loyalists
85045,474,3,"276,95",4,1,1,6,Mid-Value,Potential Loyalists
85046,1008,1,"83,8",3,1,1,5,Low-Value,At Risk Customers
85049,1140,1,"54,0",2,1,1,4,Low-Value,Can't Lose
85050,1618,1,"402,6",1,1,1,3,Low-Value,Lost
85051,951,4,"172,7",3,1,1,5,Low-Value,At Risk Customers
85055,1029,1,"31,2",3,1,1,5,Low-Value,At Risk Customers
85065,251,3,"168,95",5,1,1,7,Mid-Value,Potential Loyalists
85067,233,1,"156,89999999999998",5,1,1,7,Mid-Value,Potential Loyalists
85069,40,3,"155,6",5,1,1,7,Mid-Value,Potential Loyalists
85070,699,1,"225,7",4,1,1,6,Mid-Value,Potential Loyalists
85072,539,1,"117,25",4,1,1,6,Mid-Value,Potential Loyalists
85075,513,3,"240,8",4,1,1,6,Mid-Value,Potential Loyalists
85076,245,4,"215,45",5,1,1,7,Mid-Value,Potential Loyalists
85077,13,3,"100,75",5,1,1,7,Mid-Value,Potential Loyalists
85078,783,4,"110,15",3,1,1,5,Low-Value,At Risk Customers
85081,1105,2,"65,89999999999999",2,1,1,4,Low-Value,Can't Lose
85082,153,4,"283,95",5,1,1,7,Mid-Value,Potential Loyalists
85084,747,3,"183,2",3,1,1,5,Low-Value,At Risk Customers
85085,775,3,"421,7",3,1,1,5,Low-Value,At Risk Customers
85087,470,6,"489,9",4,1,1,6,Mid-Value,Potential Loyalists
85088,953,3,"247,85000000000002",3,1,1,5,Low-Value,At Risk Customers
85089,556,1,"94,0",4,1,1,6,Mid-Value,Potential Loyalists
85093,46,4,"445,79999999999995",5,1,1,7,Mid-Value,Potential Loyalists
85094,142,8,"334,55",5,2,1,8,High-Value,Potential Loyalists
85096,139,10,"375,8",5,2,1,8,High-Value,Potential Loyalists
85098,1550,2,"71,9",1,1,1,3,Low-Value,Lost
85100,1,13,"1004,9",5,3,2,10,High-Value,Champions
85103,8,3,"186,85",5,1,1,7,Mid-Value,Potential Loyalists
85104,120,4,"122,61000000000001",5,1,1,7,Mid-Value,Potential Loyalists
85105,1536,1,"46,65",1,1,1,3,Low-Value,Lost
85108,209,2,"155,65",5,1,1,7,Mid-Value,Potential Loyalists
85113,1485,2,"50,5",1,1,1,3,Low-Value,Lost
85114,699,1,"5,95",4,1,1,6,Mid-Value,Potential Loyalists
85116,130,3,"255,1",5,1,1,7,Mid-Value,Potential Loyalists
85117,37,9,"395,15",5,2,1,8,High-Value,Potential Loyalists
85122,501,3,"309,25",4,1,1,6,Mid-Value,Potential Loyalists
85123,296,2,"96,35",5,1,1,7,Mid-Value,Potential Loyalists
85124,7,3,"116,35",5,1,1,7,Mid-Value,Potential Loyalists
85125,780,1,"7,05",3,1,1,5,Low-Value,At Risk Customers
85126,368,4,"213,70000000000002",4,1,1,6,Mid-Value,Potential Loyalists
85128,1621,1,"17,5",1,1,1,3,Low-Value,Lost
85129,37,2,"75,89999999999999",5,1,1,7,Mid-Value,Potential Loyalists
85132,453,3,"82,35",4,1,1,6,Mid-Value,Potential Loyalists
85133,1585,1,"33,1",1,1,1,3,Low-Value,Lost
85134,1594,1,"75,6",1,1,1,3,Low-Value,Lost
85136,8,3,"263,7",5,1,1,7,Mid-Value,Potential Loyalists
85138,525,3,"36,45",4,1,1,6,Mid-Value,Potential Loyalists
85139,252,7,"217,65",5,2,1,8,High-Value,Potential Loyalists
85140,1347,3,"224,85000000000002",2,1,1,4,Low-Value,Can't Lose
85141,375,6,"477,95",4,1,1,6,Mid-Value,Potential Loyalists
85144,965,4,"171,1",3,1,1,5,Low-Value,At Risk Customers
85147,54,4,"120,55",5,1,1,7,Mid-Value,Potential Loyalists
85149,815,2,"80,3",3,1,1,5,Low-Value,At Risk Customers
85150,788,3,"205,8",3,1,1,5,Low-Value,At Risk Customers
85152,81,1,"13,0",5,1,1,7,Mid-Value,Potential Loyalists
85153,174,5,"571,55",5,1,1,7,Mid-Value,Potential Loyalists
85154,1396,3,"529,75",2,1,1,4,Low-Value,Can't Lose
85156,593,3,"266,15",4,1,1,6,Mid-Value,Potential Loyalists
85157,50,4,"178,3",5,1,1,7,Mid-Value,Potential Loyalists
85159,850,1,"55,5",3,1,1,5,Low-Value,At Risk Customers
85163,124,5,"920,9499999999999",5,1,2,8,High-Value,Potential Loyalists
85164,787,10,"672,55",3,2,2,7,Mid-Value,Potential Loyalists
85167,89,5,"145,49999999999997",5,1,1,7,Mid-Value,Potential Loyalists
85168,34,3,"104,75",5,1,1,7,Mid-Value,Potential Loyalists
85171,1373,1,"26,7",2,1,1,4,Low-Value,Can't Lose
85172,434,2,"95,35",4,1,1,6,Mid-Value,Potential Loyalists
85175,1137,4,"214,2",2,1,1,4,Low-Value,Can't Lose
85176,1510,2,"63,349999999999994",1,1,1,3,Low-Value,Lost
85178,204,3,"77,64999999999999",5,1,1,7,Mid-Value,Potential Loyalists
85180,608,4,"109,75",4,1,1,6,Mid-Value,Potential Loyalists
85183,426,7,"315,3",4,2,1,7,Mid-Value,Potential Loyalists
85185,629,5,"110,8",4,1,1,6,Mid-Value,Potential Loyalists
85186,211,2,"80,85",5,1,1,7,Mid-Value,Potential Loyalists
85187,19,6,"313,65",5,1,1,7,Mid-Value,Potential Loyalists
85188,12,5,"403,3",5,1,1,7,Mid-Value,Potential Loyalists
85190,297,2,"81,95",5,1,1,7,Mid-Value,Potential Loyalists
85194,1662,2,"95,2",1,1,1,3,Low-Value,Lost
85195,627,1,"19,5",4,1,1,6,Mid-Value,Potential Loyalists
85197,488,4,"362,70000000000005",4,1,1,6,Mid-Value,Potential Loyalists
85199,168,3,"157,45",5,1,1,7,Mid-Value,Potential Loyalists
85203,158,1,"55,349999999999994",5,1,1,7,Mid-Value,Potential Loyalists
85204,512,1,"8,55",4,1,1,6,Mid-Value,Potential Loyalists
85205,1099,4,"130,6",2,1,1,4,Low-Value,Can't Lose
85206,481,3,"77,4",4,1,1,6,Mid-Value,Potential Loyalists
85207,436,5,"139,2",4,1,1,6,Mid-Value,Potential Loyalists
85208,63,4,"229,35",5,1,1,7,Mid-Value,Potential Loyalists
85209,1256,2,"62,5",2,1,1,4,Low-Value,Can't Lose
85210,1494,1,"189,8",1,1,1,3,Low-Value,Lost
85211,408,3,"176,29999999999998",4,1,1,6,Mid-Value,Potential Loyalists
85213,726,2,"116,95",4,1,1,6,Mid-Value,Potential Loyalists
85214,29,5,"338,80000000000007",5,1,1,7,Mid-Value,Potential Loyalists
85215,409,7,"160,7",4,2,1,7,Mid-Value,Potential Loyalists
85219,1107,1,"66,0",2,1,1,4,Low-Value,Can't Lose
85221,260,1,"5,35",5,1,1,7,Mid-Value,Potential Loyalists
85223,186,3,"221,24999999999997",5,1,1,7,Mid-Value,Potential Loyalists
85224,10,8,"473,8",5,2,1,8,High-Value,Potential Loyalists
85226,24,6,"381,7",5,1,1,7,Mid-Value,Potential Loyalists
85227,204,5,"255,54999999999998",5,1,1,7,Mid-Value,Potential Loyalists
85229,19,4,"293,45000000000005",5,1,1,7,Mid-Value,Potential Loyalists
85230,412,4,"569,0",4,1,1,6,Mid-Value,Potential Loyalists
85232,19,6,"551,3499999999999",5,1,1,7,Mid-Value,Potential Loyalists
85233,80,5,"184,65",5,1,1,7,Mid-Value,Potential Loyalists
85236,276,10,"1012,9",5,2,2,9,High-Value,Champions
85242,783,2,"53,849999999999994",3,1,1,5,Low-Value,At Risk Customers
85247,215,2,"112,45",5,1,1,7,Mid-Value,Potential Loyalists
85248,1025,3,"89,35",3,1,1,5,Low-Value,At Risk Customers
85249,79,5,"232,3",5,1,1,7,Mid-Value,Potential Loyalists
85251,562,6,"253,6",4,1,1,6,Mid-Value,Potential Loyalists
85254,388,7,"713,8",4,2,2,8,High-Value,Potential Loyalists
85257,15,4,"230,15",5,1,1,7,Mid-Value,Potential Loyalists
85260,43,7,"624,6",5,2,1,8,High-Value,Potential Loyalists
85261,10,2,"433,0",5,1,1,7,Mid-Value,Potential Loyalists
85262,15,2,"286,5",5,1,1,7,Mid-Value,Potential Loyalists
85264,55,6,"852,3000000000001",5,1,2,8,High-Value,Potential Loyalists
85267,772,3,"132,5",3,1,1,5,Low-Value,At Risk Customers
85268,410,2,"139,6",4,1,1,6,Mid-Value,Potential Loyalists
85270,745,2,"530,6",3,1,1,5,Low-Value,At Risk Customers
85272,773,1,"12,4",3,1,1,5,Low-Value,At Risk Customers
85273,1296,2,"77,85",2,1,1,4,Low-Value,Can't Lose
85274,1175,6,"113,85",2,1,1,4,Low-Value,Can't Lose
85275,303,3,"121,5",5,1,1,7,Mid-Value,Potential Loyalists
85276,458,3,"147,15",4,1,1,6,Mid-Value,Potential Loyalists
85278,1415,1,"49,15",2,1,1,4,Low-Value,Can't Lose
85280,348,13,"617,2",5,3,1,9,High-Value,Champions
85282,955,2,"188,8",3,1,1,5,Low-Value,At Risk Customers
85283,348,4,"254,8",5,1,1,7,Mid-Value,Potential Loyalists
85284,1676,1,"51,6",1,1,1,3,Low-Value,Lost
85286,756,5,"423,30000000000007",3,1,1,5,Low-Value,At Risk Customers
85287,204,2,"47,45",5,1,1,7,Mid-Value,Potential Loyalists
85289,523,5,"446,8",4,1,1,6,Mid-Value,Potential Loyalists
85290,374,3,"211,1",4,1,1,6,Mid-Value,Potential Loyalists
85292,26,6,"263,9",5,1,1,7,Mid-Value,Potential Loyalists
85293,438,1,"51,7",4,1,1,6,Mid-Value,Potential Loyalists
85295,168,2,"124,1",5,1,1,7,Mid-Value,Potential Loyalists
85296,522,1,"58,9",4,1,1,6,Mid-Value,Potential Loyalists
85297,866,3,"151,75",3,1,1,5,Low-Value,At Risk Customers
85298,1719,1,"222,0",1,1,1,3,Low-Value,Lost
85301,70,11,"516,65",5,2,1,8,High-Value,Potential Loyalists
85303,1078,1,"10,95",3,1,1,5,Low-Value,At Risk Customers
85306,459,7,"511,84999999999997",4,2,1,7,Mid-Value,Potential Loyalists
85308,311,12,"1022,65",5,3,2,10,High-Value,Champions
85311,222,5,"247,55",5,1,1,7,Mid-Value,Potential Loyalists
85314,691,1,"10,3",4,1,1,6,Mid-Value,Potential Loyalists
85317,423,3,"62,95",4,1,1,6,Mid-Value,Potential Loyalists
85318,721,2,"167,25",4,1,1,6,Mid-Value,Potential Loyalists
85320,720,3,"158,55",4,1,1,6,Mid-Value,Potential Loyalists
85325,178,1,"15,6",5,1,1,7,Mid-Value,Potential Loyalists
85326,276,4,"186,2",5,1,1,7,Mid-Value,Potential Loyalists
85327,1209,1,"28,25",2,1,1,4,Low-Value,Can't Lose
85328,528,2,"147,5",4,1,1,6,Mid-Value,Potential Loyalists
85330,45,3,"130,70000000000002",5,1,1,7,Mid-Value,Potential Loyalists
85331,3,8,"583,7",5,2,1,8,High-Value,Potential Loyalists
85332,1686,1,"22,9",1,1,1,3,Low-Value,Lost
85333,968,2,"68,7",3,1,1,5,Low-Value,At Risk Customers
85338,623,4,"129,05",4,1,1,6,Mid-Value,Potential Loyalists
85339,1023,1,"9,9",3,1,1,5,Low-Value,At Risk Customers
85340,938,3,"181,75",3,1,1,5,Low-Value,At Risk Customers
85341,57,8,"391,2",5,2,1,8,High-Value,Potential Loyalists
85342,718,1,"80,85",4,1,1,6,Mid-Value,Potential Loyalists
85345,1,11,"555,05",5,2,1,8,High-Value,Potential Loyalists
85346,170,5,"307,65",5,1,1,7,Mid-Value,Potential Loyalists
85347,15,3,"142,85",5,1,1,7,Mid-Value,Potential Loyalists
85348,636,3,"90,75",4,1,1,6,Mid-Value,Potential Loyalists
85349,942,2,"32,35",3,1,1,5,Low-Value,At Risk Customers
85350,808,2,"24,35",3,1,1,5,Low-Value,At Risk Customers
85351,243,3,"275,55",5,1,1,7,Mid-Value,Potential Loyalists
85352,300,2,"24,4",5,1,1,7,Mid-Value,Potential Loyalists
85355,402,6,"247,85",4,1,1,6,Mid-Value,Potential Loyalists
85359,1022,1,"20,5",3,1,1,5,Low-Value,At Risk Customers
85361,151,4,"111,0",5,1,1,7,Mid-Value,Potential Loyalists
85362,84,4,"152,1",5,1,1,7,Mid-Value,Potential Loyalists
85364,701,2,"192,8",4,1,1,6,Mid-Value,Potential Loyalists
85365,178,2,"129,10000000000002",5,1,1,7,Mid-Value,Potential Loyalists
85367,189,2,"99,55",5,1,1,7,Mid-Value,Potential Loyalists
85368,521,1,"15,1",4,1,1,6,Mid-Value,Potential Loyalists
85372,518,5,"415,20000000000005",4,1,1,6,Mid-Value,Potential Loyalists
85374,458,4,"167,75",4,1,1,6,Mid-Value,Potential Loyalists
85375,917,4,"387,2",3,1,1,5,Low-Value,At Risk Customers
85376,1305,1,"43,4",2,1,1,4,Low-Value,Can't Lose
85377,174,3,"170,95",5,1,1,7,Mid-Value,Potential Loyalists
85378,6,5,"306,54999999999995",5,1,1,7,Mid-Value,Potential Loyalists
85381,413,3,"297,85",4,1,1,6,Mid-Value,Potential Loyalists
85386,1224,1,"99,3",2,1,1,4,Low-Value,Can't Lose
85388,372,7,"435,65",4,2,1,7,Mid-Value,Potential Loyalists
85389,368,5,"284,5",4,1,1,6,Mid-Value,Potential Loyalists
85392,763,2,"41,75",3,1,1,5,Low-Value,At Risk Customers
85395,7,3,"204,65000000000003",5,1,1,7,Mid-Value,Potential Loyalists
85396,1287,1,"17,1",2,1,1,4,Low-Value,Can't Lose
85398,61,3,"86,65",5,1,1,7,Mid-Value,Potential Loyalists
85399,146,4,"374,05",5,1,1,7,Mid-Value,Potential Loyalists
85401,5,6,"494,29999999999995",5,1,1,7,Mid-Value,Potential Loyalists
85403,170,2,"167,9",5,1,1,7,Mid-Value,Potential Loyalists
85404,402,5,"191,35",4,1,1,6,Mid-Value,Potential Loyalists
85407,36,8,"471,5",5,2,1,8,High-Value,Potential Loyalists
85408,346,2,"17,4",5,1,1,7,Mid-Value,Potential Loyalists
85410,599,2,"34,95",4,1,1,6,Mid-Value,Potential Loyalists
85411,1149,2,"56,75",2,1,1,4,Low-Value,Can't Lose
85413,1148,1,"9,95",2,1,1,4,Low-Value,Can't Lose
85414,1515,1,"9,1",1,1,1,3,Low-Value,Lost
85417,1075,2,"112,85000000000001",3,1,1,5,Low-Value,At Risk Customers
85421,173,1,"78,4",5,1,1,7,Mid-Value,Potential Loyalists
85423,344,3,"163,2",5,1,1,7,Mid-Value,Potential Loyalists
85424,88,1,"23,7",5,1,1,7,Mid-Value,Potential Loyalists
85425,193,3,"232,0",5,1,1,7,Mid-Value,Potential Loyalists
85428,509,2,"93,25",4,1,1,6,Mid-Value,Potential Loyalists
85429,194,2,"175,70000000000002",5,1,1,7,Mid-Value,Potential Loyalists
85431,295,3,"134,9",5,1,1,7,Mid-Value,Potential Loyalists
85434,142,5,"257,5",5,1,1,7,Mid-Value,Potential Loyalists
85435,1248,3,"213,0",2,1,1,4,Low-Value,Can't Lose
85437,1044,5,"241,55",3,1,1,5,Low-Value,At Risk Customers
85438,1196,3,"102,5",2,1,1,4,Low-Value,Can't Lose
85440,0,5,"687,8000000000001",5,1,2,8,High-Value,Potential Loyalists
85441,1427,1,"5,3",2,1,1,4,Low-Value,Can't Lose
85442,1331,1,"16,45",2,1,1,4,Low-Value,Can't Lose
85443,867,1,"12,3",3,1,1,5,Low-Value,At Risk Customers
85446,270,8,"270,55",5,2,1,8,High-Value,Potential Loyalists
85448,589,3,"97,35",4,1,1,6,Mid-Value,Potential Loyalists
85450,564,2,"35,6",4,1,1,6,Mid-Value,Potential Loyalists
85451,434,3,"201,45",4,1,1,6,Mid-Value,Potential Loyalists
85453,246,3,"63,8",5,1,1,7,Mid-Value,Potential Loyalists
85454,465,9,"691,55",4,2,2,8,High-Value,Potential Loyalists
85457,1018,2,"167,75",3,1,1,5,Low-Value,At Risk Customers
85458,810,3,"322,25",3,1,1,5,Low-Value,At Risk Customers
85459,84,5,"97,85",5,1,1,7,Mid-Value,Potential Loyalists
85460,724,2,"68,3",4,1,1,6,Mid-Value,Potential Loyalists
85466,431,4,"319,0",4,1,1,6,Mid-Value,Potential Loyalists
85467,102,3,"124,95",5,1,1,7,Mid-Value,Potential Loyalists
85468,276,3,"61,3",5,1,1,7,Mid-Value,Potential Loyalists
85470,628,1,"9,8",4,1,1,6,Mid-Value,Potential Loyalists
85472,1373,1,"74,5",2,1,1,4,Low-Value,Can't Lose
85474,453,5,"155,8",4,1,1,6,Mid-Value,Potential Loyalists
85475,1596,1,"54,0",1,1,1,3,Low-Value,Lost
85476,1365,2,"158,05",2,1,1,4,Low-Value,Can't Lose
85478,1490,2,"95,4",1,1,1,3,Low-Value,Lost
85479,17,1,"25,5",5,1,1,7,Mid-Value,Potential Loyalists
85481,494,4,"209,35000000000002",4,1,1,6,Mid-Value,Potential Loyalists
85483,368,7,"226,05",4,2,1,7,Mid-Value,Potential Loyalists
85484,270,4,"135,1",5,1,1,7,Mid-Value,Potential Loyalists
85487,11,3,"198,14999999999998",5,1,1,7,Mid-Value,Potential Loyalists
85488,1164,1,"20,75",2,1,1,4,Low-Value,Can't Lose
85489,813,1,"19,5",3,1,1,5,Low-Value,At Risk Customers
85492,706,1,"23,45",4,1,1,6,Mid-Value,Potential Loyalists
85493,587,6,"185,1",4,1,1,6,Mid-Value,Potential Loyalists
85496,488,2,"80,5",4,1,1,6,Mid-Value,Potential Loyalists
85497,878,3,"129,65",3,1,1,5,Low-Value,At Risk Customers
85499,1044,2,"45,55",3,1,1,5,Low-Value,At Risk Customers
85501,539,4,"443,45",4,1,1,6,Mid-Value,Potential Loyalists
85502,260,14,"871,1",5,3,2,10,High-Value,Champions
85503,79,7,"421,8",5,2,1,8,High-Value,Potential Loyalists
85505,136,7,"216,0",5,2,1,8,High-Value,Potential Loyalists
85506,64,5,"329,0",5,1,1,7,Mid-Value,Potential Loyalists
85507,200,8,"664,55",5,2,2,9,High-Value,Champions
85512,105,3,"238,9",5,1,1,7,Mid-Value,Potential Loyalists
85513,248,5,"97,45",5,1,1,7,Mid-Value,Potential Loyalists
85516,269,4,"426,7",5,1,1,7,Mid-Value,Potential Loyalists
85519,268,2,"192,1",5,1,1,7,Mid-Value,Potential Loyalists
85521,13,6,"232,8",5,1,1,7,Mid-Value,Potential Loyalists
85522,657,3,"64,45",4,1,1,6,Mid-Value,Potential Loyalists
85525,83,4,"195,85",5,1,1,7,Mid-Value,Potential Loyalists
85527,1109,2,"138,05",2,1,1,4,Low-Value,Can't Lose
85529,48,10,"325,79999999999995",5,2,1,8,High-Value,Potential Loyalists
85530,131,4,"479,95",5,1,1,7,Mid-Value,Potential Loyalists
85534,267,1,"31,2",5,1,1,7,Mid-Value,Potential Loyalists
85536,20,4,"74,6",5,1,1,7,Mid-Value,Potential Loyalists
85537,179,9,"567,4",5,2,1,8,High-Value,Potential Loyalists
85539,814,6,"469,65000000000003",3,1,1,5,Low-Value,At Risk Customers
85540,518,3,"249,79999999999998",4,1,1,6,Mid-Value,Potential Loyalists
85544,104,3,"288,84999999999997",5,1,1,7,Mid-Value,Potential Loyalists
85545,1209,2,"40,099999999999994",2,1,1,4,Low-Value,Can't Lose
85546,1697,1,"75,6",1,1,1,3,Low-Value,Lost
85549,1247,1,"43,8",2,1,1,4,Low-Value,Can't Lose
85550,157,3,"64,9",5,1,1,7,Mid-Value,Potential Loyalists
85551,1127,6,"278,9",2,1,1,4,Low-Value,Can't Lose
85553,137,3,"82,75",5,1,1,7,Mid-Value,Potential Loyalists
85554,752,2,"68,2",3,1,1,5,Low-Value,At Risk Customers
85556,262,5,"261,95",5,1,1,7,Mid-Value,Potential Loyalists
85557,23,6,"482,25",5,1,1,7,Mid-Value,Potential Loyalists
85558,9,7,"637,4",5,2,1,8,High-Value,Potential Loyalists
85559,19,4,"184,4",5,1,1,7,Mid-Value,Potential Loyalists
85561,1623,1,"73,6",1,1,1,3,Low-Value,Lost
85562,1377,1,"110,95",2,1,1,4,Low-Value,Can't Lose
85563,64,3,"136,0",5,1,1,7,Mid-Value,Potential Loyalists
85565,1023,1,"60,05",3,1,1,5,Low-Value,At Risk Customers
85567,28,4,"144,05",5,1,1,7,Mid-Value,Potential Loyalists
85568,258,14,"795,55",5,3,2,10,High-Value,Champions
85569,819,4,"78,1",3,1,1,5,Low-Value,At Risk Customers
85570,17,6,"484,95",5,1,1,7,Mid-Value,Potential Loyalists
85571,168,3,"130,55",5,1,1,7,Mid-Value,Potential Loyalists
85574,229,1,"15,6",5,1,1,7,Mid-Value,Potential Loyalists
85577,1462,1,"10,8",1,1,1,3,Low-Value,Lost
85578,1778,1,"11,1",1,1,1,3,Low-Value,Lost
85579,1130,1,"17,7",2,1,1,4,Low-Value,Can't Lose
85582,1658,2,"66,69999999999999",1,1,1,3,Low-Value,Lost
85583,407,2,"103,05",4,1,1,6,Mid-Value,Potential Loyalists
85584,559,6,"736,95",4,1,2,7,Mid-Value,Potential Loyalists
85585,4,2,"205,10000000000002",5,1,1,7,Mid-Value,Potential Loyalists
85588,911,1,"23,4",3,1,1,5,Low-Value,At Risk Customers
85589,1084,2,"20,1",3,1,1,5,Low-Value,At Risk Customers
85591,1658,1,"82,0",1,1,1,3,Low-Value,Lost
85593,467,5,"504,34999999999997",4,1,1,6,Mid-Value,Potential Loyalists
85594,82,5,"108,7",5,1,1,7,Mid-Value,Potential Loyalists
85595,404,2,"89,30000000000001",4,1,1,6,Mid-Value,Potential Loyalists
85596,5,4,"124,4",5,1,1,7,Mid-Value,Potential Loyalists
85597,345,1,"26,6",5,1,1,7,Mid-Value,Potential Loyalists
85599,434,3,"67,1",4,1,1,6,Mid-Value,Potential Loyalists
85601,11,8,"518,75",5,2,1,8,High-Value,Potential Loyalists
85602,25,2,"136,1",5,1,1,7,Mid-Value,Potential Loyalists
85608,24,2,"57,8",5,1,1,7,Mid-Value,Potential Loyalists
85609,2,4,"321,15",5,1,1,7,Mid-Value,Potential Loyalists
85610,1307,1,"14,75",2,1,1,4,Low-Value,Can't Lose
85611,1007,1,"11,55",3,1,1,5,Low-Value,At Risk Customers
85613,636,5,"328,04999999999995",4,1,1,6,Mid-Value,Potential Loyalists
85614,1062,3,"173,5",3,1,1,5,Low-Value,At Risk Customers
85617,30,5,"321,9",5,1,1,7,Mid-Value,Potential Loyalists
85619,458,2,"17,6",4,1,1,6,Mid-Value,Potential Loyalists
85620,1024,3,"110,65",3,1,1,5,Low-Value,At Risk Customers
85624,1519,2,"32,1",1,1,1,3,Low-Value,Lost
85626,995,1,"23,45",3,1,1,5,Low-Value,At Risk Customers
85628,699,6,"499,95000000000005",4,1,1,6,Mid-Value,Potential Loyalists
85629,927,4,"185,55",3,1,1,5,Low-Value,At Risk Customers
85630,1166,3,"62,949999999999996",2,1,1,4,Low-Value,Can't Lose
85633,1137,2,"187,95",2,1,1,4,Low-Value,Can't Lose
85634,466,4,"304,45000000000005",4,1,1,6,Mid-Value,Potential Loyalists
85635,1519,1,"56,7",1,1,1,3,Low-Value,Lost
85636,210,11,"975,5",5,2,2,9,High-Value,Champions
85637,690,3,"162,15",4,1,1,6,Mid-Value,Potential Loyalists
85638,51,2,"223,45",5,1,1,7,Mid-Value,Potential Loyalists
85640,150,4,"357,3",5,1,1,7,Mid-Value,Potential Loyalists
85641,645,2,"40,5",4,1,1,6,Mid-Value,Potential Loyalists
85642,708,1,"22,45",4,1,1,6,Mid-Value,Potential Loyalists
85644,70,3,"46,949999999999996",5,1,1,7,Mid-Value,Potential Loyalists
85652,1270,2,"119,85",2,1,1,4,Low-Value,Can't Lose
85653,217,8,"673,9",5,2,2,9,High-Value,Champions
85654,545,3,"157,9",4,1,1,6,Mid-Value,Potential Loyalists
85655,313,3,"112,7",5,1,1,7,Mid-Value,Potential Loyalists
85656,146,1,"256,6",5,1,1,7,Mid-Value,Potential Loyalists
85657,104,5,"547,3",5,1,1,7,Mid-Value,Potential Loyalists
85662,1090,1,"34,7",3,1,1,5,Low-Value,At Risk Customers
85663,512,2,"92,30000000000001",4,1,1,6,Mid-Value,Potential Loyalists
85664,27,3,"369,29999999999995",5,1,1,7,Mid-Value,Potential Loyalists
85665,50,9,"553,15",5,2,1,8,High-Value,Potential Loyalists
85667,1583,2,"144,55",1,1,1,3,Low-Value,Lost
85668,113,6,"286,2",5,1,1,7,Mid-Value,Potential Loyalists
85671,19,3,"162,3",5,1,1,7,Mid-Value,Potential Loyalists
85676,792,1,"20,0",3,1,1,5,Low-Value,At Risk Customers
85678,991,3,"89,10000000000001",3,1,1,5,Low-Value,At Risk Customers
85679,139,3,"415,8",5,1,1,7,Mid-Value,Potential Loyalists
85680,7,4,"458,05",5,1,1,7,Mid-Value,Potential Loyalists
85681,449,1,"10,6",4,1,1,6,Mid-Value,Potential Loyalists
85682,654,2,"90,65",4,1,1,6,Mid-Value,Potential Loyalists
85687,1363,1,"58,9",2,1,1,4,Low-Value,Can't Lose
85690,382,4,"97,85",4,1,1,6,Mid-Value,Potential Loyalists
85692,35,7,"262,1",5,2,1,8,High-Value,Potential Loyalists
85693,402,2,"50,65",4,1,1,6,Mid-Value,Potential Loyalists
85695,47,2,"33,400000000000006",5,1,1,7,Mid-Value,Potential Loyalists
85697,273,1,"5,9",5,1,1,7,Mid-Value,Potential Loyalists
85701,125,5,"338,9",5,1,1,7,Mid-Value,Potential Loyalists
85702,12,2,"99,75",5,1,1,7,Mid-Value,Potential Loyalists
85704,385,6,"385,65",4,1,1,6,Mid-Value,Potential Loyalists
85706,476,1,"28,9",4,1,1,6,Mid-Value,Potential Loyalists
85707,166,1,"86,8",5,1,1,7,Mid-Value,Potential Loyalists
85710,292,3,"106,85",5,1,1,7,Mid-Value,Potential Loyalists
85711,80,4,"161,75",5,1,1,7,Mid-Value,Potential Loyalists
85712,1114,1,"31,1",2,1,1,4,Low-Value,Can't Lose
85713,1226,1,"525,5999999999999",2,1,1,4,Low-Value,Can't Lose
85715,8,9,"498,45000000000005",5,2,1,8,High-Value,Potential Loyalists
85716,931,1,"21,4",3,1,1,5,Low-Value,At Risk Customers
85719,403,2,"26,35",4,1,1,6,Mid-Value,Potential Loyalists
85723,204,2,"244,39999999999998",5,1,1,7,Mid-Value,Potential Loyalists
85725,83,6,"293,8",5,1,1,7,Mid-Value,Potential Loyalists
85726,49,7,"246,8",5,2,1,8,High-Value,Potential Loyalists
85727,692,1,"44,6",4,1,1,6,Mid-Value,Potential Loyalists
85728,382,1,"21,5",4,1,1,6,Mid-Value,Potential Loyalists
85730,1603,1,"31,5",1,1,1,3,Low-Value,Lost
85731,449,1,"23,9",4,1,1,6,Mid-Value,Potential Loyalists
85734,511,1,"9,5",4,1,1,6,Mid-Value,Potential Loyalists
85735,1469,7,"242,2",1,2,1,4,Low-Value,Can't Lose
85738,925,1,"226,5",3,1,1,5,Low-Value,At Risk Customers
85739,21,3,"282,0",5,1,1,7,Mid-Value,Potential Loyalists
85740,326,3,"259,2",5,1,1,7,Mid-Value,Potential Loyalists
85741,1244,1,"55,1",2,1,1,4,Low-Value,Can't Lose
85742,28,4,"86,3",5,1,1,7,Mid-Value,Potential Loyalists
85743,1046,1,"7,5",3,1,1,5,Low-Value,At Risk Customers
85745,927,3,"443,55",3,1,1,5,Low-Value,At Risk Customers
85746,47,3,"67,05",5,1,1,7,Mid-Value,Potential Loyalists
85748,531,5,"425,15000000000003",4,1,1,6,Mid-Value,Potential Loyalists
85750,87,4,"263,65",5,1,1,7,Mid-Value,Potential Loyalists
85755,1250,3,"105,6",2,1,1,4,Low-Value,Can't Lose
85756,1092,5,"154,95",3,1,1,5,Low-Value,At Risk Customers
85757,932,2,"284,54999999999995",3,1,1,5,Low-Value,At Risk Customers
85760,890,1,"327,2",3,1,1,5,Low-Value,At Risk Customers
85761,367,2,"30,6",4,1,1,6,Mid-Value,Potential Loyalists
85763,876,2,"149,85000000000002",3,1,1,5,Low-Value,At Risk Customers
85764,203,3,"591,1999999999999",5,1,1,7,Mid-Value,Potential Loyalists
85767,271,4,"132,35",5,1,1,7,Mid-Value,Potential Loyalists
85768,127,1,"24,3",5,1,1,7,Mid-Value,Potential Loyalists
85769,1116,1,"298,1",2,1,1,4,Low-Value,Can't Lose
85771,731,2,"181,75",3,1,1,5,Low-Value,At Risk Customers
85773,9,1,"278,9",5,1,1,7,Mid-Value,Potential Loyalists
85774,1083,3,"142,2",3,1,1,5,Low-Value,At Risk Customers
85775,741,4,"307,55",3,1,1,5,Low-Value,At Risk Customers
85776,5,10,"761,9",5,2,2,9,High-Value,Champions
85777,95,4,"83,95",5,1,1,7,Mid-Value,Potential Loyalists
85778,204,7,"532,1",5,2,1,8,High-Value,Potential Loyalists
85781,1105,3,"148,89999999999998",2,1,1,4,Low-Value,Can't Lose
85782,445,1,"19,05",4,1,1,6,Mid-Value,Potential Loyalists
85783,1136,5,"502,1",2,1,1,4,Low-Value,Can't Lose
85785,57,3,"405,35",5,1,1,7,Mid-Value,Potential Loyalists
85786,1255,2,"163,5",2,1,1,4,Low-Value,Can't Lose
85787,193,1,"49,4",5,1,1,7,Mid-Value,Potential Loyalists
85789,440,1,"19,5",4,1,1,6,Mid-Value,Potential Loyalists
85791,1586,2,"69,4",1,1,1,3,Low-Value,Lost
85792,216,3,"62,9",5,1,1,7,Mid-Value,Potential Loyalists
85793,14,4,"76,05",5,1,1,7,Mid-Value,Potential Loyalists
85794,894,2,"66,5",3,1,1,5,Low-Value,At Risk Customers
85795,158,2,"40,650000000000006",5,1,1,7,Mid-Value,Potential Loyalists
85796,126,4,"228,8",5,1,1,7,Mid-Value,Potential Loyalists
85797,720,2,"426,7",4,1,1,6,Mid-Value,Potential Loyalists
85798,449,3,"117,35",4,1,1,6,Mid-Value,Potential Loyalists
85799,499,3,"176,35",4,1,1,6,Mid-Value,Potential Loyalists
85800,304,1,"46,05",5,1,1,7,Mid-Value,Potential Loyalists
85801,763,3,"62,15",3,1,1,5,Low-Value,At Risk Customers
85805,898,1,"17,85",3,1,1,5,Low-Value,At Risk Customers
85808,175,8,"1015,75",5,2,2,9,High-Value,Champions
85810,348,5,"172,9",5,1,1,7,Mid-Value,Potential Loyalists
85811,492,1,"36,150000000000006",4,1,1,6,Mid-Value,Potential Loyalists
85812,647,7,"169,45",4,2,1,7,Mid-Value,Potential Loyalists
85813,246,4,"96,55",5,1,1,7,Mid-Value,Potential Loyalists
85814,358,3,"139,65",5,1,1,7,Mid-Value,Potential Loyalists
85815,165,4,"655,8499999999999",5,1,1,7,Mid-Value,Potential Loyalists
85816,502,1,"46,8",4,1,1,6,Mid-Value,Potential Loyalists
85817,20,4,"123,45",5,1,1,7,Mid-Value,Potential Loyalists
85819,226,5,"299,09999999999997",5,1,1,7,Mid-Value,Potential Loyalists
85821,522,7,"813,0",4,2,2,8,High-Value,Potential Loyalists
85822,772,3,"90,85",3,1,1,5,Low-Value,At Risk Customers
85823,546,4,"326,8",4,1,1,6,Mid-Value,Potential Loyalists
85824,147,3,"154,05",5,1,1,7,Mid-Value,Potential Loyalists
85826,127,3,"123,25",5,1,1,7,Mid-Value,Potential Loyalists
85827,528,2,"68,0",4,1,1,6,Mid-Value,Potential Loyalists
85828,11,3,"190,75",5,1,1,7,Mid-Value,Potential Loyalists
85830,570,3,"76,5",4,1,1,6,Mid-Value,Potential Loyalists
85832,604,1,"12,95",4,1,1,6,Mid-Value,Potential Loyalists
85834,1090,3,"52,150000000000006",3,1,1,5,Low-Value,At Risk Customers
85836,1340,1,"28,0",2,1,1,4,Low-Value,Can't Lose
85838,186,2,"227,75",5,1,1,7,Mid-Value,Potential Loyalists
85839,40,5,"168,64999999999998",5,1,1,7,Mid-Value,Potential Loyalists
85840,836,5,"382,4",3,1,1,5,Low-Value,At Risk Customers
85841,594,2,"95,4",4,1,1,6,Mid-Value,Potential Loyalists
85842,901,3,"121,19999999999999",3,1,1,5,Low-Value,At Risk Customers
85844,343,1,"57,0",5,1,1,7,Mid-Value,Potential Loyalists
85846,1607,1,"63,8",1,1,1,3,Low-Value,Lost
85847,1106,2,"130,75",2,1,1,4,Low-Value,Can't Lose
85848,1415,1,"21,25",2,1,1,4,Low-Value,Can't Lose
85852,43,7,"244,9",5,2,1,8,High-Value,Potential Loyalists
85853,1250,2,"78,05",2,1,1,4,Low-Value,Can't Lose
85856,495,5,"569,85",4,1,1,6,Mid-Value,Potential Loyalists
85857,62,2,"56,099999999999994",5,1,1,7,Mid-Value,Potential Loyalists
85858,631,5,"257,9",4,1,1,6,Mid-Value,Potential Loyalists
85860,949,2,"61,15",3,1,1,5,Low-Value,At Risk Customers
85861,213,4,"655,85",5,1,1,7,Mid-Value,Potential Loyalists
85862,23,4,"329,54999999999995",5,1,1,7,Mid-Value,Potential Loyalists
85864,593,9,"755,8000000000001",4,2,2,8,High-Value,Potential Loyalists
85865,40,3,"221,7",5,1,1,7,Mid-Value,Potential Loyalists
85867,725,8,"209,95",4,2,1,7,Mid-Value,Potential Loyalists
85868,740,3,"42,8",3,1,1,5,Low-Value,At Risk Customers
85869,20,3,"212,7",5,1,1,7,Mid-Value,Potential Loyalists
85870,581,2,"106,05",4,1,1,6,Mid-Value,Potential Loyalists
85872,1155,3,"94,9",2,1,1,4,Low-Value,Can't Lose
85873,932,4,"202,55",3,1,1,5,Low-Value,At Risk Customers
85874,311,4,"249,5",5,1,1,7,Mid-Value,Potential Loyalists
85875,411,1,"55,55",4,1,1,6,Mid-Value,Potential Loyalists
85878,1004,3,"147,95",3,1,1,5,Low-Value,At Risk Customers
85883,1682,1,"188,7",1,1,1,3,Low-Value,Lost
85885,38,4,"246,65",5,1,1,7,Mid-Value,Potential Loyalists
85886,14,1,"49,0",5,1,1,7,Mid-Value,Potential Loyalists
85888,25,3,"361,5",5,1,1,7,Mid-Value,Potential Loyalists
85893,192,5,"706,9",5,1,2,8,High-Value,Potential Loyalists
85894,1517,1,"4,6",1,1,1,3,Low-Value,Lost
85895,61,5,"577,85",5,1,1,7,Mid-Value,Potential Loyalists
85896,755,1,"96,3",3,1,1,5,Low-Value,At Risk Customers
85897,395,2,"22,9",4,1,1,6,Mid-Value,Potential Loyalists
85899,73,3,"156,05",5,1,1,7,Mid-Value,Potential Loyalists
85901,895,1,"105,7",3,1,1,5,Low-Value,At Risk Customers
85902,402,4,"129,04999999999998",4,1,1,6,Mid-Value,Potential Loyalists
85904,1046,2,"142,65",3,1,1,5,Low-Value,At Risk Customers
85905,556,18,"831,5",4,4,2,10,High-Value,Champions
85906,1054,1,"491,6",3,1,1,5,Low-Value,At Risk Customers
85908,21,6,"395,7",5,1,1,7,Mid-Value,Potential Loyalists
85911,833,1,"5,15",3,1,1,5,Low-Value,At Risk Customers
85913,75,3,"267,95",5,1,1,7,Mid-Value,Potential Loyalists
85918,810,4,"668,35",3,1,2,6,Mid-Value,Potential Loyalists
85919,112,2,"45,5",5,1,1,7,Mid-Value,Potential Loyalists
85922,540,2,"132,05",4,1,1,6,Mid-Value,Potential Loyalists
85923,13,5,"523,55",5,1,1,7,Mid-Value,Potential Loyalists
85925,797,4,"238,1",3,1,1,5,Low-Value,At Risk Customers
85927,1312,3,"270,9",2,1,1,4,Low-Value,Can't Lose
85928,31,1,"6,35",5,1,1,7,Mid-Value,Potential Loyalists
85929,161,5,"248,45",5,1,1,7,Mid-Value,Potential Loyalists
85930,595,5,"327,5",4,1,1,6,Mid-Value,Potential Loyalists
85931,148,4,"276,25",5,1,1,7,Mid-Value,Potential Loyalists
85932,602,2,"397,2",4,1,1,6,Mid-Value,Potential Loyalists
85933,123,5,"227,45",5,1,1,7,Mid-Value,Potential Loyalists
85934,187,4,"190,65",5,1,1,7,Mid-Value,Potential Loyalists
85935,257,4,"371,65000000000003",5,1,1,7,Mid-Value,Potential Loyalists
85937,989,1,"28,65",3,1,1,5,Low-Value,At Risk Customers
85939,831,1,"165,9",3,1,1,5,Low-Value,At Risk Customers
85941,1498,1,"83,6",1,1,1,3,Low-Value,Lost
85943,376,2,"163,6",4,1,1,6,Mid-Value,Potential Loyalists
85945,423,3,"266,95000000000005",4,1,1,6,Mid-Value,Potential Loyalists
85946,195,2,"131,95",5,1,1,7,Mid-Value,Potential Loyalists
85948,418,5,"116,4",4,1,1,6,Mid-Value,Potential Loyalists
85949,104,3,"119,8",5,1,1,7,Mid-Value,Potential Loyalists
85951,382,3,"159,75",4,1,1,6,Mid-Value,Potential Loyalists
85952,1328,1,"9,7",2,1,1,4,Low-Value,Can't Lose
85953,1803,1,"54,0",1,1,1,3,Low-Value,Lost
85954,1531,1,"11,25",1,1,1,3,Low-Value,Lost
85956,176,3,"144,25",5,1,1,7,Mid-Value,Potential Loyalists
85958,34,14,"498,95",5,3,1,9,High-Value,Champions
85959,16,4,"107,55",5,1,1,7,Mid-Value,Potential Loyalists
85960,255,2,"111,39999999999999",5,1,1,7,Mid-Value,Potential Loyalists
85961,139,1,"34,9",5,1,1,7,Mid-Value,Potential Loyalists
85963,1224,1,"25,0",2,1,1,4,Low-Value,Can't Lose
85964,143,3,"125,5",5,1,1,7,Mid-Value,Potential Loyalists
85965,850,3,"269,5",3,1,1,5,Low-Value,At Risk Customers
85966,1156,1,"22,45",2,1,1,4,Low-Value,Can't Lose
85968,783,5,"252,75",3,1,1,5,Low-Value,At Risk Customers
85969,304,4,"263,05",5,1,1,7,Mid-Value,Potential Loyalists
85970,1324,2,"13,5",2,1,1,4,Low-Value,Can't Lose
85971,1188,3,"64,85",2,1,1,4,Low-Value,Can't Lose
85973,1232,1,"50,5",2,1,1,4,Low-Value,Can't Lose
85974,147,4,"192,9",5,1,1,7,Mid-Value,Potential Loyalists
85975,22,5,"322,5",5,1,1,7,Mid-Value,Potential Loyalists
85976,1663,1,"25,3",1,1,1,3,Low-Value,Lost
85978,241,8,"458,7",5,2,1,8,High-Value,Potential Loyalists
85979,372,6,"527,2",4,1,1,6,Mid-Value,Potential Loyalists
85980,1229,1,"40,75",2,1,1,4,Low-Value,Can't Lose
85981,407,4,"480,2",4,1,1,6,Mid-Value,Potential Loyalists
85983,370,7,"396,9",4,2,1,7,Mid-Value,Potential Loyalists
85984,109,3,"456,0",5,1,1,7,Mid-Value,Potential Loyalists
85985,1660,1,"69,0",1,1,1,3,Low-Value,Lost
85986,174,4,"152,6",5,1,1,7,Mid-Value,Potential Loyalists
85987,892,4,"473,79999999999995",3,1,1,5,Low-Value,At Risk Customers
85988,40,7,"295,25",5,2,1,8,High-Value,Potential Loyalists
85990,1774,1,"23,6",1,1,1,3,Low-Value,Lost
85991,399,5,"355,59999999999997",4,1,1,6,Mid-Value,Potential Loyalists
85992,283,4,"736,65",5,1,2,8,High-Value,Potential Loyalists
85993,12,5,"89,4",5,1,1,7,Mid-Value,Potential Loyalists
85999,1258,1,"663,8",2,1,2,5,Low-Value,At Risk Customers
86000,737,2,"59,6",3,1,1,5,Low-Value,At Risk Customers
86001,297,5,"371,8",5,1,1,7,Mid-Value,Potential Loyalists
86002,171,5,"446,79999999999995",5,1,1,7,Mid-Value,Potential Loyalists
86003,157,9,"648,8499999999999",5,2,1,8,High-Value,Potential Loyalists
86004,1397,1,"15,0",2,1,1,4,Low-Value,Can't Lose
86006,1,2,"428,04999999999995",5,1,1,7,Mid-Value,Potential Loyalists
86007,21,7,"379,85",5,2,1,8,High-Value,Potential Loyalists
86009,389,4,"158,45",4,1,1,6,Mid-Value,Potential Loyalists
86013,50,9,"845,95",5,2,2,9,High-Value,Champions
86014,796,2,"38,8",3,1,1,5,Low-Value,At Risk Customers
86016,796,2,"390,3",3,1,1,5,Low-Value,At Risk Customers
86017,172,5,"260,6",5,1,1,7,Mid-Value,Potential Loyalists
86020,45,7,"400,25",5,2,1,8,High-Value,Potential Loyalists
86022,438,5,"318,5",4,1,1,6,Mid-Value,Potential Loyalists
86023,1229,1,"89,2",2,1,1,4,Low-Value,Can't Lose
86026,1374,1,"3,6",2,1,1,4,Low-Value,Can't Lose
86027,685,1,"93,75",4,1,1,6,Mid-Value,Potential Loyalists
86029,252,2,"86,3",5,1,1,7,Mid-Value,Potential Loyalists
86030,8,3,"77,7",5,1,1,7,Mid-Value,Potential Loyalists
86032,117,12,"937,75",5,3,2,10,High-Value,Champions
86033,536,6,"435,95",4,1,1,6,Mid-Value,Potential Loyalists
86034,40,6,"120,35",5,1,1,7,Mid-Value,Potential Loyalists
86036,21,8,"542,95",5,2,1,8,High-Value,Potential Loyalists
86037,132,1,"18,4",5,1,1,7,Mid-Value,Potential Loyalists
86038,176,1,"65,8",5,1,1,7,Mid-Value,Potential Loyalists
86039,330,3,"102,85000000000001",5,1,1,7,Mid-Value,Potential Loyalists
86040,9,8,"693,1999999999999",5,2,2,9,High-Value,Champions
86041,534,2,"272,75",4,1,1,6,Mid-Value,Potential Loyalists
86043,739,1,"21,2",3,1,1,5,Low-Value,At Risk Customers
86045,225,3,"67,64999999999999",5,1,1,7,Mid-Value,Potential Loyalists
86046,370,5,"168,3",4,1,1,6,Mid-Value,Potential Loyalists
86048,1231,1,"33,0",2,1,1,4,Low-Value,Can't Lose
86049,578,1,"6,35",4,1,1,6,Mid-Value,Potential Loyalists
86050,1111,1,"46,4",2,1,1,4,Low-Value,Can't Lose
86052,1345,1,"10,65",2,1,1,4,Low-Value,Can't Lose
86053,72,5,"767,1999999999999",5,1,2,8,High-Value,Potential Loyalists
86057,746,1,"122,2",3,1,1,5,Low-Value,At Risk Customers
86061,245,2,"314,5",5,1,1,7,Mid-Value,Potential Loyalists
86063,570,1,"1236,25",4,1,2,7,Mid-Value,Potential Loyalists
86064,1051,2,"34,849999999999994",3,1,1,5,Low-Value,At Risk Customers
86067,169,5,"690,25",5,1,2,8,High-Value,Potential Loyalists
86068,33,2,"39,599999999999994",5,1,1,7,Mid-Value,Potential Loyalists
86069,25,11,"581,4",5,2,1,8,High-Value,Potential Loyalists
86070,87,1,"22,8",5,1,1,7,Mid-Value,Potential Loyalists
86071,318,1,"38,35",5,1,1,7,Mid-Value,Potential Loyalists
86072,714,1,"58,4",4,1,1,6,Mid-Value,Potential Loyalists
86075,245,2,"153,7",5,1,1,7,Mid-Value,Potential Loyalists
86077,1268,4,"71,45",2,1,1,4,Low-Value,Can't Lose
86078,409,2,"80,8",4,1,1,6,Mid-Value,Potential Loyalists
86079,1050,1,"11,45",3,1,1,5,Low-Value,At Risk Customers
86080,89,10,"428,7",5,2,1,8,High-Value,Potential Loyalists
86081,182,3,"220,7",5,1,1,7,Mid-Value,Potential Loyalists
86082,1242,2,"228,9",2,1,1,4,Low-Value,Can't Lose
86083,727,4,"158,35",4,1,1,6,Mid-Value,Potential Loyalists
86085,20,14,"845,95",5,3,2,10,High-Value,Champions
86089,372,5,"412,2",4,1,1,6,Mid-Value,Potential Loyalists
86090,410,5,"259,75",4,1,1,6,Mid-Value,Potential Loyalists
86091,1057,1,"50,75",3,1,1,5,Low-Value,At Risk Customers
86094,796,3,"130,0",3,1,1,5,Low-Value,At Risk Customers
86095,819,1,"23,3",3,1,1,5,Low-Value,At Risk Customers
86096,967,1,"45,3",3,1,1,5,Low-Value,At Risk Customers
86098,862,2,"74,2",3,1,1,5,Low-Value,At Risk Customers
86101,206,3,"246,5",5,1,1,7,Mid-Value,Potential Loyalists
86104,552,9,"728,3",4,2,2,8,High-Value,Potential Loyalists
86105,451,2,"30,15",4,1,1,6,Mid-Value,Potential Loyalists
86106,152,3,"436,25",5,1,1,7,Mid-Value,Potential Loyalists
86107,158,4,"111,45",5,1,1,7,Mid-Value,Potential Loyalists
86111,257,1,"6,65",5,1,1,7,Mid-Value,Potential Loyalists
86112,1199,1,"29,6",2,1,1,4,Low-Value,Can't Lose
86114,588,2,"132,55",4,1,1,6,Mid-Value,Potential Loyalists
86116,64,9,"391,65",5,2,1,8,High-Value,Potential Loyalists
86117,368,5,"365,54999999999995",4,1,1,6,Mid-Value,Potential Loyalists
86118,57,4,"172,55",5,1,1,7,Mid-Value,Potential Loyalists
86123,396,1,"16,85",4,1,1,6,Mid-Value,Potential Loyalists
86124,189,5,"350,45",5,1,1,7,Mid-Value,Potential Loyalists
86125,886,2,"309,7",3,1,1,5,Low-Value,At Risk Customers
86126,315,1,"15,6",5,1,1,7,Mid-Value,Potential Loyalists
86127,100,8,"416,15000000000003",5,2,1,8,High-Value,Potential Loyalists
86129,306,2,"101,3",5,1,1,7,Mid-Value,Potential Loyalists
86132,221,5,"142,5",5,1,1,7,Mid-Value,Potential Loyalists
86135,580,1,"12,8",4,1,1,6,Mid-Value,Potential Loyalists
86136,1789,1,"14,65",1,1,1,3,Low-Value,Lost
86137,695,4,"188,85",4,1,1,6,Mid-Value,Potential Loyalists
86141,129,7,"818,0",5,2,2,9,High-Value,Champions
86142,422,4,"118,54999999999998",4,1,1,6,Mid-Value,Potential Loyalists
86144,99,6,"203,4",5,1,1,7,Mid-Value,Potential Loyalists
86145,1662,1,"61,25",1,1,1,3,Low-Value,Lost
86151,530,2,"214,25",4,1,1,6,Mid-Value,Potential Loyalists
86153,85,7,"465,00000000000006",5,2,1,8,High-Value,Potential Loyalists
86154,145,4,"388,4",5,1,1,7,Mid-Value,Potential Loyalists
86155,12,6,"486,45",5,1,1,7,Mid-Value,Potential Loyalists
86158,342,1,"42,45",5,1,1,7,Mid-Value,Potential Loyalists
86159,1407,2,"20,75",2,1,1,4,Low-Value,Can't Lose
86161,341,1,"48,7",5,1,1,7,Mid-Value,Potential Loyalists
86162,139,6,"609,05",5,1,1,7,Mid-Value,Potential Loyalists
86163,382,4,"813,55",4,1,2,7,Mid-Value,Potential Loyalists
86164,654,3,"33,85",4,1,1,6,Mid-Value,Potential Loyalists
86165,587,1,"37,05",4,1,1,6,Mid-Value,Potential Loyalists
86166,755,7,"803,1999999999999",3,2,2,7,Mid-Value,Potential Loyalists
86167,144,8,"584,0",5,2,1,8,High-Value,Potential Loyalists
86170,1115,2,"81,25",2,1,1,4,Low-Value,Can't Lose
86171,475,4,"664,9",4,1,2,7,Mid-Value,Potential Loyalists
86172,363,5,"989,95",5,1,2,8,High-Value,Potential Loyalists
86174,995,1,"16,7",3,1,1,5,Low-Value,At Risk Customers
86175,887,2,"37,8",3,1,1,5,Low-Value,At Risk Customers
86176,238,4,"120,3",5,1,1,7,Mid-Value,Potential Loyalists
86177,685,4,"287,0",4,1,1,6,Mid-Value,Potential Loyalists
86178,53,1,"22,8",5,1,1,7,Mid-Value,Potential Loyalists
86179,1239,1,"18,5",2,1,1,4,Low-Value,Can't Lose
86180,62,1,"1,0",5,1,1,7,Mid-Value,Potential Loyalists
86183,492,1,"11,7",4,1,1,6,Mid-Value,Potential Loyalists
86184,52,1,"9,95",5,1,1,7,Mid-Value,Potential Loyalists
86186,374,2,"112,45",4,1,1,6,Mid-Value,Potential Loyalists
86187,353,1,"42,7",5,1,1,7,Mid-Value,Potential Loyalists
86191,606,1,"392,5",4,1,1,6,Mid-Value,Potential Loyalists
86192,496,4,"318,15",4,1,1,6,Mid-Value,Potential Loyalists
86194,494,3,"323,7",4,1,1,6,Mid-Value,Potential Loyalists
86195,602,2,"681,7499999999999",4,1,2,7,Mid-Value,Potential Loyalists
86196,248,4,"177,45",5,1,1,7,Mid-Value,Potential Loyalists
86197,538,4,"231,4",4,1,1,6,Mid-Value,Potential Loyalists
86198,93,2,"140,2",5,1,1,7,Mid-Value,Potential Loyalists
86199,1588,1,"62,400000000000006",1,1,1,3,Low-Value,Lost
86200,1499,1,"161,2",1,1,1,3,Low-Value,Lost
86202,1505,3,"182,95000000000002",1,1,1,3,Low-Value,Lost
86206,684,5,"400,95",4,1,1,6,Mid-Value,Potential Loyalists
86208,643,2,"37,75",4,1,1,6,Mid-Value,Potential Loyalists
86209,401,2,"70,1",4,1,1,6,Mid-Value,Potential Loyalists
86210,382,6,"432,45",4,1,1,6,Mid-Value,Potential Loyalists
86212,1463,2,"92,6",1,1,1,3,Low-Value,Lost
86216,554,3,"158,5",4,1,1,6,Mid-Value,Potential Loyalists
86217,283,1,"9,9",5,1,1,7,Mid-Value,Potential Loyalists
86218,128,2,"53,65",5,1,1,7,Mid-Value,Potential Loyalists
86219,629,2,"674,3",4,1,2,7,Mid-Value,Potential Loyalists
86220,801,2,"46,300000000000004",3,1,1,5,Low-Value,At Risk Customers
86221,638,2,"25,3",4,1,1,6,Mid-Value,Potential Loyalists
86222,1381,1,"11,8",2,1,1,4,Low-Value,Can't Lose
86224,832,1,"41,6",3,1,1,5,Low-Value,At Risk Customers
86226,1243,4,"805,75",2,1,2,5,Low-Value,At Risk Customers
86228,1046,4,"258,20000000000005",3,1,1,5,Low-Value,At Risk Customers
86230,41,6,"499,65000000000003",5,1,1,7,Mid-Value,Potential Loyalists
86231,1145,3,"79,3",2,1,1,4,Low-Value,Can't Lose
86232,294,3,"224,39999999999998",5,1,1,7,Mid-Value,Potential Loyalists
86234,500,2,"91,25",4,1,1,6,Mid-Value,Potential Loyalists
86235,282,1,"63,7",5,1,1,7,Mid-Value,Potential Loyalists
86236,1285,1,"13,5",2,1,1,4,Low-Value,Can't Lose
86237,138,5,"121,3",5,1,1,7,Mid-Value,Potential Loyalists
86238,711,1,"61,15",4,1,1,6,Mid-Value,Potential Loyalists
86242,1242,1,"42,3",2,1,1,4,Low-Value,Can't Lose
86244,1123,1,"60,5",2,1,1,4,Low-Value,Can't Lose
86245,10,11,"255,85",5,2,1,8,High-Value,Potential Loyalists
86246,649,1,"5,3",4,1,1,6,Mid-Value,Potential Loyalists
86247,385,13,"521,4",4,3,1,8,High-Value,Potential Loyalists
86249,1632,1,"85,5",1,1,1,3,Low-Value,Lost
86252,430,1,"48,3",4,1,1,6,Mid-Value,Potential Loyalists
86256,1560,1,"27,7",1,1,1,3,Low-Value,Lost
86257,420,2,"35,55",4,1,1,6,Mid-Value,Potential Loyalists
86258,23,1,"117,75",5,1,1,7,Mid-Value,Potential Loyalists
86259,27,4,"257,35",5,1,1,7,Mid-Value,Potential Loyalists
86261,951,3,"287,6",3,1,1,5,Low-Value,At Risk Customers
86262,237,6,"109,15",5,1,1,7,Mid-Value,Potential Loyalists
86263,202,11,"470,2",5,2,1,8,High-Value,Potential Loyalists
86267,617,8,"591,0",4,2,1,7,Mid-Value,Potential Loyalists
86268,673,3,"223,35",4,1,1,6,Mid-Value,Potential Loyalists
86269,855,3,"146,45",3,1,1,5,Low-Value,At Risk Customers
86270,1137,2,"43,6",2,1,1,4,Low-Value,Can't Lose
86271,1221,1,"60,300000000000004",2,1,1,4,Low-Value,Can't Lose
86272,154,1,"39,8",5,1,1,7,Mid-Value,Potential Loyalists
86273,74,2,"81,05",5,1,1,7,Mid-Value,Potential Loyalists
86274,679,2,"264,55",4,1,1,6,Mid-Value,Potential Loyalists
86275,427,3,"172,35000000000002",4,1,1,6,Mid-Value,Potential Loyalists
86276,40,6,"221,35",5,1,1,7,Mid-Value,Potential Loyalists
86277,1615,1,"276,25",1,1,1,3,Low-Value,Lost
86278,570,2,"121,3",4,1,1,6,Mid-Value,Potential Loyalists
86279,1088,1,"387,5",3,1,1,5,Low-Value,At Risk Customers
86280,1425,1,"169,45",2,1,1,4,Low-Value,Can't Lose
86281,13,8,"1334,9",5,2,3,10,High-Value,Champions
86288,1529,2,"147,2",1,1,1,3,Low-Value,Lost
86289,374,4,"207,45000000000002",4,1,1,6,Mid-Value,Potential Loyalists
86294,1483,1,"16,3",1,1,1,3,Low-Value,Lost
86300,746,15,"592,2",3,3,1,7,Mid-Value,Potential Loyalists
86302,1046,1,"25,6",3,1,1,5,Low-Value,At Risk Customers
86303,1671,3,"102,25",1,1,1,3,Low-Value,Lost
86304,48,6,"436,25",5,1,1,7,Mid-Value,Potential Loyalists
86305,738,3,"421,25",3,1,1,5,Low-Value,At Risk Customers
86307,5,1,"93,2",5,1,1,7,Mid-Value,Potential Loyalists
86310,842,1,"85,5",3,1,1,5,Low-Value,At Risk Customers
86311,1329,1,"52,5",2,1,1,4,Low-Value,Can't Lose
86313,265,4,"117,75",5,1,1,7,Mid-Value,Potential Loyalists
86314,1470,2,"167,5",1,1,1,3,Low-Value,Lost
86315,5,5,"275,55",5,1,1,7,Mid-Value,Potential Loyalists
86318,801,5,"204,85",3,1,1,5,Low-Value,At Risk Customers
86320,1339,2,"240,5",2,1,1,4,Low-Value,Can't Lose
86321,49,1,"122,8",5,1,1,7,Mid-Value,Potential Loyalists
86322,602,3,"470,34999999999997",4,1,1,6,Mid-Value,Potential Loyalists
86323,257,6,"519,45",5,1,1,7,Mid-Value,Potential Loyalists
86325,1535,1,"67,35",1,1,1,3,Low-Value,Lost
86327,880,3,"131,85",3,1,1,5,Low-Value,At Risk Customers
86328,176,4,"403,55",5,1,1,7,Mid-Value,Potential Loyalists
86331,74,2,"64,15",5,1,1,7,Mid-Value,Potential Loyalists
86332,1683,1,"16,55",1,1,1,3,Low-Value,Lost
86333,633,2,"313,6",4,1,1,6,Mid-Value,Potential Loyalists
86334,1273,1,"13,350000000000001",2,1,1,4,Low-Value,Can't Lose
86336,507,4,"77,75",4,1,1,6,Mid-Value,Potential Loyalists
86337,549,1,"346,6",4,1,1,6,Mid-Value,Potential Loyalists
86338,382,1,"27,8",4,1,1,6,Mid-Value,Potential Loyalists
86341,23,9,"457,05",5,2,1,8,High-Value,Potential Loyalists
86346,483,4,"117,2",4,1,1,6,Mid-Value,Potential Loyalists
86347,397,2,"128,95",4,1,1,6,Mid-Value,Potential Loyalists
86348,659,3,"67,4",4,1,1,6,Mid-Value,Potential Loyalists
86349,586,1,"52,3",4,1,1,6,Mid-Value,Potential Loyalists
86353,832,2,"24,099999999999998",3,1,1,5,Low-Value,At Risk Customers
86354,612,1,"13,15",4,1,1,6,Mid-Value,Potential Loyalists
86355,1547,1,"109,4",1,1,1,3,Low-Value,Lost
86357,920,5,"183,2",3,1,1,5,Low-Value,At Risk Customers
86359,501,1,"39,4",4,1,1,6,Mid-Value,Potential Loyalists
86360,699,1,"6,1",4,1,1,6,Mid-Value,Potential Loyalists
86361,1466,3,"112,25",1,1,1,3,Low-Value,Lost
86362,236,2,"167,1",5,1,1,7,Mid-Value,Potential Loyalists
86363,130,1,"21,4",5,1,1,7,Mid-Value,Potential Loyalists
86364,17,6,"352,29999999999995",5,1,1,7,Mid-Value,Potential Loyalists
86366,21,12,"765,8",5,3,2,10,High-Value,Champions
86367,3,5,"442,35",5,1,1,7,Mid-Value,Potential Loyalists
86369,170,9,"219,20000000000002",5,2,1,8,High-Value,Potential Loyalists
86370,113,2,"119,7",5,1,1,7,Mid-Value,Potential Loyalists
86373,200,1,"28,1",5,1,1,7,Mid-Value,Potential Loyalists
86375,183,3,"132,65",5,1,1,7,Mid-Value,Potential Loyalists
86376,74,2,"42,199999999999996",5,1,1,7,Mid-Value,Potential Loyalists
86379,85,3,"60,800000000000004",5,1,1,7,Mid-Value,Potential Loyalists
86381,1347,2,"145,0",2,1,1,4,Low-Value,Can't Lose
86386,981,1,"6,85",3,1,1,5,Low-Value,At Risk Customers
86389,1303,1,"81,5",2,1,1,4,Low-Value,Can't Lose
86391,321,3,"73,05",5,1,1,7,Mid-Value,Potential Loyalists
86392,247,1,"117,75",5,1,1,7,Mid-Value,Potential Loyalists
86394,350,2,"68,35000000000001",5,1,1,7,Mid-Value,Potential Loyalists
86398,0,2,"135,12",5,1,1,7,Mid-Value,Potential Loyalists
86399,395,4,"57,5",4,1,1,6,Mid-Value,Potential Loyalists
86400,172,5,"743,75",5,1,2,8,High-Value,Potential Loyalists
86402,417,3,"1080,65",4,1,2,7,Mid-Value,Potential Loyalists
86403,1214,1,"47,65",2,1,1,4,Low-Value,Can't Lose
86407,49,4,"96,25",5,1,1,7,Mid-Value,Potential Loyalists
86408,1127,1,"6,3",2,1,1,4,Low-Value,Can't Lose
86411,1553,1,"53,7",1,1,1,3,Low-Value,Lost
86412,630,4,"601,45",4,1,1,6,Mid-Value,Potential Loyalists
86413,507,3,"284,8",4,1,1,6,Mid-Value,Potential Loyalists
86414,251,5,"199,55",5,1,1,7,Mid-Value,Potential Loyalists
86415,231,3,"267,65",5,1,1,7,Mid-Value,Potential Loyalists
86417,40,4,"190,1",5,1,1,7,Mid-Value,Potential Loyalists
86418,719,3,"115,6",4,1,1,6,Mid-Value,Potential Loyalists
86421,1134,4,"285,75",2,1,1,4,Low-Value,Can't Lose
86424,995,4,"173,7",3,1,1,5,Low-Value,At Risk Customers
86426,12,3,"223,95",5,1,1,7,Mid-Value,Potential Loyalists
86427,14,10,"620,15",5,2,1,8,High-Value,Potential Loyalists
86428,358,1,"44,25",5,1,1,7,Mid-Value,Potential Loyalists
86431,230,5,"233,79999999999998",5,1,1,7,Mid-Value,Potential Loyalists
86432,94,7,"475,05",5,2,1,8,High-Value,Potential Loyalists
86436,45,1,"17,0",5,1,1,7,Mid-Value,Potential Loyalists
86437,1185,2,"185,85",2,1,1,4,Low-Value,Can't Lose
86438,1764,1,"23,4",1,1,1,3,Low-Value,Lost
86439,308,9,"546,3",5,2,1,8,High-Value,Potential Loyalists
86442,10,7,"148,55",5,2,1,8,High-Value,Potential Loyalists
86449,619,1,"42,15",4,1,1,6,Mid-Value,Potential Loyalists
86453,326,2,"67,65",5,1,1,7,Mid-Value,Potential Loyalists
86455,823,2,"152,3",3,1,1,5,Low-Value,At Risk Customers
86456,342,3,"82,15",5,1,1,7,Mid-Value,Potential Loyalists
86460,1112,1,"99,3",2,1,1,4,Low-Value,Can't Lose
86461,49,1,"17,1",5,1,1,7,Mid-Value,Potential Loyalists
86463,102,2,"175,25",5,1,1,7,Mid-Value,Potential Loyalists
86467,1757,1,"6,3",1,1,1,3,Low-Value,Lost
86468,44,4,"99,8",5,1,1,7,Mid-Value,Potential Loyalists
86470,37,3,"179,64999999999998",5,1,1,7,Mid-Value,Potential Loyalists
86472,270,2,"48,6",5,1,1,7,Mid-Value,Potential Loyalists
86473,267,2,"79,95",5,1,1,7,Mid-Value,Potential Loyalists
86474,435,1,"27,35",4,1,1,6,Mid-Value,Potential Loyalists
86475,526,3,"280,0",4,1,1,6,Mid-Value,Potential Loyalists
86476,821,1,"26,15",3,1,1,5,Low-Value,At Risk Customers
86477,157,1,"15,0",5,1,1,7,Mid-Value,Potential Loyalists
86479,348,3,"284,2",5,1,1,7,Mid-Value,Potential Loyalists
86482,1759,1,"19,3",1,1,1,3,Low-Value,Lost
86483,964,1,"269,70000000000005",3,1,1,5,Low-Value,At Risk Customers
86484,277,3,"30,6",5,1,1,7,Mid-Value,Potential Loyalists
86487,451,3,"401,0",4,1,1,6,Mid-Value,Potential Loyalists
86489,240,1,"50,25",5,1,1,7,Mid-Value,Potential Loyalists
86492,78,3,"288,25",5,1,1,7,Mid-Value,Potential Loyalists
86493,53,4,"236,64999999999998",5,1,1,7,Mid-Value,Potential Loyalists
86500,516,6,"273,35",4,1,1,6,Mid-Value,Potential Loyalists
86501,662,1,"35,9",4,1,1,6,Mid-Value,Potential Loyalists
86502,146,2,"81,5",5,1,1,7,Mid-Value,Potential Loyalists
86503,1123,5,"313,55",2,1,1,4,Low-Value,Can't Lose
86507,892,1,"22,4",3,1,1,5,Low-Value,At Risk Customers
86508,21,13,"465,4",5,3,1,9,High-Value,Champions
86509,861,8,"231,15",3,2,1,6,Mid-Value,Potential Loyalists
86510,52,3,"128,05",5,1,1,7,Mid-Value,Potential Loyalists
86511,1321,2,"42,15",2,1,1,4,Low-Value,Can't Lose
86512,1240,1,"10,7",2,1,1,4,Low-Value,Can't Lose
86513,746,1,"16,8",3,1,1,5,Low-Value,At Risk Customers
86515,182,6,"223,54999999999998",5,1,1,7,Mid-Value,Potential Loyalists
86518,1672,1,"40,4",1,1,1,3,Low-Value,Lost
86519,32,3,"77,35",5,1,1,7,Mid-Value,Potential Loyalists
86520,1267,5,"715,95",2,1,2,5,Low-Value,At Risk Customers
86523,401,5,"144,25",4,1,1,6,Mid-Value,Potential Loyalists
86524,492,5,"342,7",4,1,1,6,Mid-Value,Potential Loyalists
86525,765,2,"28,5",3,1,1,5,Low-Value,At Risk Customers
86526,1616,2,"128,35",1,1,1,3,Low-Value,Lost
86527,1470,2,"19,65",1,1,1,3,Low-Value,Lost
86528,757,1,"195,6",3,1,1,5,Low-Value,At Risk Customers
86529,31,12,"884,85",5,3,2,10,High-Value,Champions
86531,1585,1,"2,85",1,1,1,3,Low-Value,Lost
86534,642,3,"277,3",4,1,1,6,Mid-Value,Potential Loyalists
86535,22,4,"406,55",5,1,1,7,Mid-Value,Potential Loyalists
86536,449,3,"123,85",4,1,1,6,Mid-Value,Potential Loyalists
86538,170,4,"168,5",5,1,1,7,Mid-Value,Potential Loyalists
86539,844,2,"110,8",3,1,1,5,Low-Value,At Risk Customers
86540,124,4,"309,35",5,1,1,7,Mid-Value,Potential Loyalists
86541,1182,1,"24,65",2,1,1,4,Low-Value,Can't Lose
86542,456,6,"461,1",4,1,1,6,Mid-Value,Potential Loyalists
86544,715,4,"174,9",4,1,1,6,Mid-Value,Potential Loyalists
86546,83,2,"103,5",5,1,1,7,Mid-Value,Potential Loyalists
86548,165,2,"82,44999999999999",5,1,1,7,Mid-Value,Potential Loyalists
86549,551,1,"0,4",4,1,1,6,Mid-Value,Potential Loyalists
86551,1707,1,"6,1",1,1,1,3,Low-Value,Lost
86552,103,2,"167,05",5,1,1,7,Mid-Value,Potential Loyalists
86553,229,6,"761,35",5,1,2,8,High-Value,Potential Loyalists
86556,549,3,"31,95",4,1,1,6,Mid-Value,Potential Loyalists
86557,1113,6,"130,25",2,1,1,4,Low-Value,Can't Lose
86558,755,3,"290,05",3,1,1,5,Low-Value,At Risk Customers
86559,66,2,"26,25",5,1,1,7,Mid-Value,Potential Loyalists
86563,8,4,"192,85",5,1,1,7,Mid-Value,Potential Loyalists
86565,1015,5,"227,5",3,1,1,5,Low-Value,At Risk Customers
86566,411,5,"751,8",4,1,2,7,Mid-Value,Potential Loyalists
86567,73,4,"148,55",5,1,1,7,Mid-Value,Potential Loyalists
86568,27,2,"104,5",5,1,1,7,Mid-Value,Potential Loyalists
86569,403,6,"284,85",4,1,1,6,Mid-Value,Potential Loyalists
86571,506,3,"226,60000000000002",4,1,1,6,Mid-Value,Potential Loyalists
86576,549,1,"58,949999999999996",4,1,1,6,Mid-Value,Potential Loyalists
86578,631,6,"345,95000000000005",4,1,1,6,Mid-Value,Potential Loyalists
86579,169,5,"549,55",5,1,1,7,Mid-Value,Potential Loyalists
86580,1124,4,"353,7",2,1,1,4,Low-Value,Can't Lose
86581,503,13,"803,7",4,3,2,9,High-Value,Champions
86582,10,3,"77,65",5,1,1,7,Mid-Value,Potential Loyalists
86583,443,4,"102,14999999999999",4,1,1,6,Mid-Value,Potential Loyalists
86585,184,2,"239,35000000000002",5,1,1,7,Mid-Value,Potential Loyalists
86588,56,3,"99,10000000000001",5,1,1,7,Mid-Value,Potential Loyalists
86589,1321,1,"32,099999999999994",2,1,1,4,Low-Value,Can't Lose
86592,1682,1,"18,25",1,1,1,3,Low-Value,Lost
86595,61,3,"248,85",5,1,1,7,Mid-Value,Potential Loyalists
86596,912,6,"214,8",3,1,1,5,Low-Value,At Risk Customers
86599,1081,1,"25,3",3,1,1,5,Low-Value,At Risk Customers
86600,915,5,"275,25",3,1,1,5,Low-Value,At Risk Customers
86603,1270,1,"14,5",2,1,1,4,Low-Value,Can't Lose
86606,956,2,"45,5",3,1,1,5,Low-Value,At Risk Customers
86608,840,5,"220,3",3,1,1,5,Low-Value,At Risk Customers
86609,538,1,"64,65",4,1,1,6,Mid-Value,Potential Loyalists
86610,778,6,"279,65",3,1,1,5,Low-Value,At Risk Customers
86612,162,3,"115,5",5,1,1,7,Mid-Value,Potential Loyalists
86614,88,3,"137,95",5,1,1,7,Mid-Value,Potential Loyalists
86615,807,1,"22,8",3,1,1,5,Low-Value,At Risk Customers
86616,1118,4,"141,25",2,1,1,4,Low-Value,Can't Lose
86617,341,5,"181,35",5,1,1,7,Mid-Value,Potential Loyalists
86621,78,3,"149,05",5,1,1,7,Mid-Value,Potential Loyalists
86622,538,2,"92,94999999999999",4,1,1,6,Mid-Value,Potential Loyalists
86623,18,4,"122,1",5,1,1,7,Mid-Value,Potential Loyalists
86624,1648,1,"367,15000000000003",1,1,1,3,Low-Value,Lost
86628,760,2,"116,7",3,1,1,5,Low-Value,At Risk Customers
86634,1805,1,"28,75",1,1,1,3,Low-Value,Lost
86635,234,5,"159,5",5,1,1,7,Mid-Value,Potential Loyalists
86637,901,5,"102,44999999999999",3,1,1,5,Low-Value,At Risk Customers
86639,1162,7,"554,5",2,2,1,5,Low-Value,At Risk Customers
86641,930,4,"470,42999999999995",3,1,1,5,Low-Value,At Risk Customers
86642,788,2,"244,6",3,1,1,5,Low-Value,At Risk Customers
86644,52,3,"183,5",5,1,1,7,Mid-Value,Potential Loyalists
86645,88,4,"128,4",5,1,1,7,Mid-Value,Potential Loyalists
86647,623,6,"328,15",4,1,1,6,Mid-Value,Potential Loyalists
86648,242,9,"556,05",5,2,1,8,High-Value,Potential Loyalists
86653,405,3,"127,35",4,1,1,6,Mid-Value,Potential Loyalists
86654,1609,1,"48,449999999999996",1,1,1,3,Low-Value,Lost
86656,476,4,"122,25",4,1,1,6,Mid-Value,Potential Loyalists
86657,81,2,"134,95",5,1,1,7,Mid-Value,Potential Loyalists
86660,638,3,"85,95",4,1,1,6,Mid-Value,Potential Loyalists
86661,681,1,"168,45",4,1,1,6,Mid-Value,Potential Loyalists
86663,224,1,"7,8",5,1,1,7,Mid-Value,Potential Loyalists
86666,545,1,"119,6",4,1,1,6,Mid-Value,Potential Loyalists
86668,1049,1,"48,45",3,1,1,5,Low-Value,At Risk Customers
86671,1771,1,"21,8",1,1,1,3,Low-Value,Lost
86672,811,6,"251,8",3,1,1,5,Low-Value,At Risk Customers
86673,3,2,"248,8",5,1,1,7,Mid-Value,Potential Loyalists
86675,729,1,"122,8",4,1,1,6,Mid-Value,Potential Loyalists
86678,1420,1,"25,65",2,1,1,4,Low-Value,Can't Lose
86680,312,5,"221,5",5,1,1,7,Mid-Value,Potential Loyalists
86682,139,4,"296,85",5,1,1,7,Mid-Value,Potential Loyalists
86685,388,1,"155,7",4,1,1,6,Mid-Value,Potential Loyalists
86688,33,6,"200,8",5,1,1,7,Mid-Value,Potential Loyalists
86691,23,6,"442,25",5,1,1,7,Mid-Value,Potential Loyalists
86693,733,2,"47,05",3,1,1,5,Low-Value,At Risk Customers
86695,560,2,"243,05",4,1,1,6,Mid-Value,Potential Loyalists
86696,94,6,"181,6",5,1,1,7,Mid-Value,Potential Loyalists
86697,881,3,"169,2",3,1,1,5,Low-Value,At Risk Customers
86698,109,9,"607,5",5,2,1,8,High-Value,Potential Loyalists
86699,283,8,"329,65",5,2,1,8,High-Value,Potential Loyalists
86700,741,2,"152,65",3,1,1,5,Low-Value,At Risk Customers
86701,865,2,"108,45000000000002",3,1,1,5,Low-Value,At Risk Customers
86702,259,5,"299,55",5,1,1,7,Mid-Value,Potential Loyalists
86703,880,4,"317,5",3,1,1,5,Low-Value,At Risk Customers
86707,436,2,"139,8",4,1,1,6,Mid-Value,Potential Loyalists
86708,139,1,"24,0",5,1,1,7,Mid-Value,Potential Loyalists
86710,1131,3,"163,5",2,1,1,4,Low-Value,Can't Lose
86711,162,4,"246,3",5,1,1,7,Mid-Value,Potential Loyalists
86713,465,1,"20,7",4,1,1,6,Mid-Value,Potential Loyalists
86714,1584,3,"304,5",1,1,1,3,Low-Value,Lost
86715,236,5,"193,25",5,1,1,7,Mid-Value,Potential Loyalists
86716,1344,1,"51,85",2,1,1,4,Low-Value,Can't Lose
86717,441,2,"263,6",4,1,1,6,Mid-Value,Potential Loyalists
86719,964,4,"248,04999999999995",3,1,1,5,Low-Value,At Risk Customers
86722,443,1,"85,15",4,1,1,6,Mid-Value,Potential Loyalists
86724,563,5,"324,84999999999997",4,1,1,6,Mid-Value,Potential Loyalists
86726,1308,1,"63,1",2,1,1,4,Low-Value,Can't Lose
86727,181,5,"221,35000000000002",5,1,1,7,Mid-Value,Potential Loyalists
86728,175,1,"227,8",5,1,1,7,Mid-Value,Potential Loyalists
86730,1351,1,"17,8",2,1,1,4,Low-Value,Can't Lose
86732,965,1,"39,2",3,1,1,5,Low-Value,At Risk Customers
86733,55,1,"20,65",5,1,1,7,Mid-Value,Potential Loyalists
86735,4,4,"494,85",5,1,1,7,Mid-Value,Potential Loyalists
86737,1134,1,"10,0",2,1,1,4,Low-Value,Can't Lose
86739,866,2,"100,89999999999999",3,1,1,5,Low-Value,At Risk Customers
86741,1149,5,"528,5",2,1,1,4,Low-Value,Can't Lose
86742,945,1,"33,2",3,1,1,5,Low-Value,At Risk Customers
86745,1231,2,"147,5",2,1,1,4,Low-Value,Can't Lose
86746,622,2,"90,7",4,1,1,6,Mid-Value,Potential Loyalists
86747,1511,2,"39,2",1,1,1,3,Low-Value,Lost
86750,166,3,"379,54999999999995",5,1,1,7,Mid-Value,Potential Loyalists
86752,419,4,"383,85",4,1,1,6,Mid-Value,Potential Loyalists
86753,247,3,"262,7",5,1,1,7,Mid-Value,Potential Loyalists
86756,1717,1,"23,7",1,1,1,3,Low-Value,Lost
86758,193,2,"203,85",5,1,1,7,Mid-Value,Potential Loyalists
86759,17,3,"411,05",5,1,1,7,Mid-Value,Potential Loyalists
86760,704,1,"31,95",4,1,1,6,Mid-Value,Potential Loyalists
86761,130,7,"164,6",5,2,1,8,High-Value,Potential Loyalists
86765,797,4,"277,65",3,1,1,5,Low-Value,At Risk Customers
86766,1702,1,"34,5",1,1,1,3,Low-Value,Lost
86767,16,4,"259,0",5,1,1,7,Mid-Value,Potential Loyalists
86768,766,5,"277,75",3,1,1,5,Low-Value,At Risk Customers
86769,945,3,"162,05",3,1,1,5,Low-Value,At Risk Customers
86770,794,6,"171,25",3,1,1,5,Low-Value,At Risk Customers
86771,1134,2,"273,25",2,1,1,4,Low-Value,Can't Lose
86772,121,3,"63,65",5,1,1,7,Mid-Value,Potential Loyalists
86773,754,2,"228,29999999999998",3,1,1,5,Low-Value,At Risk Customers
86774,56,4,"135,9",5,1,1,7,Mid-Value,Potential Loyalists
86775,447,5,"311,09999999999997",4,1,1,6,Mid-Value,Potential Loyalists
86776,379,6,"230,25",4,1,1,6,Mid-Value,Potential Loyalists
86778,381,3,"111,8",4,1,1,6,Mid-Value,Potential Loyalists
86779,1056,1,"58,0",3,1,1,5,Low-Value,At Risk Customers
86780,445,3,"192,54999999999998",4,1,1,6,Mid-Value,Potential Loyalists
86781,255,5,"244,8",5,1,1,7,Mid-Value,Potential Loyalists
86782,1063,1,"41,4",3,1,1,5,Low-Value,At Risk Customers
86783,1055,2,"87,75",3,1,1,5,Low-Value,At Risk Customers
86784,374,3,"73,0",4,1,1,6,Mid-Value,Potential Loyalists
86785,1194,2,"155,55",2,1,1,4,Low-Value,Can't Lose
86788,707,1,"8,7",4,1,1,6,Mid-Value,Potential Loyalists
86789,130,4,"136,95",5,1,1,7,Mid-Value,Potential Loyalists
86791,5,3,"114,94999999999999",5,1,1,7,Mid-Value,Potential Loyalists
86792,952,1,"35,7",3,1,1,5,Low-Value,At Risk Customers
86793,532,1,"129,8",4,1,1,6,Mid-Value,Potential Loyalists
86794,546,2,"91,3",4,1,1,6,Mid-Value,Potential Loyalists
86795,720,1,"10,3",4,1,1,6,Mid-Value,Potential Loyalists
86796,505,2,"72,4",4,1,1,6,Mid-Value,Potential Loyalists
86797,592,3,"448,19999999999993",4,1,1,6,Mid-Value,Potential Loyalists
86802,1291,3,"129,35",2,1,1,4,Low-Value,Can't Lose
86805,290,2,"27,799999999999997",5,1,1,7,Mid-Value,Potential Loyalists
86806,565,6,"229,35",4,1,1,6,Mid-Value,Potential Loyalists
86808,59,6,"251,6",5,1,1,7,Mid-Value,Potential Loyalists
86811,412,10,"377,65",4,2,1,7,Mid-Value,Potential Loyalists
86812,1067,5,"653,3",3,1,1,5,Low-Value,At Risk Customers
86813,732,1,"7,5",3,1,1,5,Low-Value,At Risk Customers
86816,756,1,"177,6",3,1,1,5,Low-Value,At Risk Customers
86817,89,5,"268,65",5,1,1,7,Mid-Value,Potential Loyalists
86819,1146,1,"62,9",2,1,1,4,Low-Value,Can't Lose
86821,24,4,"106,35",5,1,1,7,Mid-Value,Potential Loyalists
86824,604,2,"182,45",4,1,1,6,Mid-Value,Potential Loyalists
86827,156,4,"358,2",5,1,1,7,Mid-Value,Potential Loyalists
86829,1685,1,"80,0",1,1,1,3,Low-Value,Lost
86831,428,1,"90,7",4,1,1,6,Mid-Value,Potential Loyalists
86832,756,4,"183,15",3,1,1,5,Low-Value,At Risk Customers
86833,921,1,"32,2",3,1,1,5,Low-Value,At Risk Customers
86834,13,6,"622,15",5,1,1,7,Mid-Value,Potential Loyalists
86836,752,3,"638,35",3,1,1,5,Low-Value,At Risk Customers
86837,875,1,"213,9",3,1,1,5,Low-Value,At Risk Customers
86839,25,5,"216,95",5,1,1,7,Mid-Value,Potential Loyalists
86840,22,5,"147,75",5,1,1,7,Mid-Value,Potential Loyalists
86842,517,10,"547,1",4,2,1,7,Mid-Value,Potential Loyalists
86843,780,2,"39,05",3,1,1,5,Low-Value,At Risk Customers
86844,612,2,"49,5",4,1,1,6,Mid-Value,Potential Loyalists
86847,910,3,"64,0",3,1,1,5,Low-Value,At Risk Customers
86848,742,5,"121,2",3,1,1,5,Low-Value,At Risk Customers
86849,476,4,"192,1",4,1,1,6,Mid-Value,Potential Loyalists
86850,85,7,"544,8499999999999",5,2,1,8,High-Value,Potential Loyalists
86851,43,4,"495,5",5,1,1,7,Mid-Value,Potential Loyalists
86852,1305,3,"268,45",2,1,1,4,Low-Value,Can't Lose
86854,1616,1,"45,2",1,1,1,3,Low-Value,Lost
86855,72,4,"162,75",5,1,1,7,Mid-Value,Potential Loyalists
86856,130,1,"21,4",5,1,1,7,Mid-Value,Potential Loyalists
86860,78,3,"381,75",5,1,1,7,Mid-Value,Potential Loyalists
86861,1115,4,"163,05",2,1,1,4,Low-Value,Can't Lose
86862,1508,2,"98,4",1,1,1,3,Low-Value,Lost
86863,183,6,"411,55",5,1,1,7,Mid-Value,Potential Loyalists
86868,130,3,"56,25",5,1,1,7,Mid-Value,Potential Loyalists
86869,155,5,"611,6",5,1,1,7,Mid-Value,Potential Loyalists
86870,156,8,"495,25",5,2,1,8,High-Value,Potential Loyalists
86871,542,3,"121,15",4,1,1,6,Mid-Value,Potential Loyalists
86872,439,9,"431,45000000000005",4,2,1,7,Mid-Value,Potential Loyalists
86874,509,3,"172,20000000000002",4,1,1,6,Mid-Value,Potential Loyalists
86877,298,1,"46,05",5,1,1,7,Mid-Value,Potential Loyalists
86878,5,2,"131,65",5,1,1,7,Mid-Value,Potential Loyalists
86880,8,8,"448,05",5,2,1,8,High-Value,Potential Loyalists
86881,7,10,"546,3",5,2,1,8,High-Value,Potential Loyalists
86882,386,1,"40,55",4,1,1,6,Mid-Value,Potential Loyalists
86884,502,1,"48,1",4,1,1,6,Mid-Value,Potential Loyalists
86885,796,2,"444,95",3,1,1,5,Low-Value,At Risk Customers
86886,851,2,"97,0",3,1,1,5,Low-Value,At Risk Customers
86889,206,1,"204,5",5,1,1,7,Mid-Value,Potential Loyalists
86893,1324,1,"73,94999999999999",2,1,1,4,Low-Value,Can't Lose
86894,3,7,"160,75",5,2,1,8,High-Value,Potential Loyalists
86900,158,4,"170,2",5,1,1,7,Mid-Value,Potential Loyalists
86902,202,4,"186,65",5,1,1,7,Mid-Value,Potential Loyalists
86904,620,5,"109,7",4,1,1,6,Mid-Value,Potential Loyalists
86907,234,2,"16,65",5,1,1,7,Mid-Value,Potential Loyalists
86909,314,4,"155,10000000000002",5,1,1,7,Mid-Value,Potential Loyalists
86915,119,13,"995,0",5,3,2,10,High-Value,Champions
86916,1407,1,"68,6",2,1,1,4,Low-Value,Can't Lose
86919,1453,3,"254,95000000000002",2,1,1,4,Low-Value,Can't Lose
86921,422,4,"194,3",4,1,1,6,Mid-Value,Potential Loyalists
86922,427,1,"5,9",4,1,1,6,Mid-Value,Potential Loyalists
86923,28,7,"377,9",5,2,1,8,High-Value,Potential Loyalists
86924,1066,3,"183,55",3,1,1,5,Low-Value,At Risk Customers
86925,938,2,"95,7",3,1,1,5,Low-Value,At Risk Customers
86929,1139,2,"78,55",2,1,1,4,Low-Value,Can't Lose
86930,166,3,"646,5999999999999",5,1,1,7,Mid-Value,Potential Loyalists
86931,534,1,"118,4",4,1,1,6,Mid-Value,Potential Loyalists
86932,330,2,"13,35",5,1,1,7,Mid-Value,Potential Loyalists
86933,819,1,"38,6",3,1,1,5,Low-Value,At Risk Customers
86934,813,4,"249,10000000000002",3,1,1,5,Low-Value,At Risk Customers
86936,143,4,"288,6",5,1,1,7,Mid-Value,Potential Loyalists
86937,153,2,"177,15",5,1,1,7,Mid-Value,Potential Loyalists
86939,28,7,"548,9",5,2,1,8,High-Value,Potential Loyalists
86940,936,1,"228,2",3,1,1,5,Low-Value,At Risk Customers
86942,29,12,"851,55",5,3,2,10,High-Value,Champions
86944,946,3,"320,7",3,1,1,5,Low-Value,At Risk Customers
86948,268,4,"149,25",5,1,1,7,Mid-Value,Potential Loyalists
86950,1285,3,"258,34999999999997",2,1,1,4,Low-Value,Can't Lose
86951,43,5,"265,84999999999997",5,1,1,7,Mid-Value,Potential Loyalists
86953,67,3,"464,45",5,1,1,7,Mid-Value,Potential Loyalists
86954,231,2,"36,5",5,1,1,7,Mid-Value,Potential Loyalists
86955,118,5,"1105,1999999999998",5,1,2,8,High-Value,Potential Loyalists
86956,605,2,"497,85",4,1,1,6,Mid-Value,Potential Loyalists
86957,367,2,"119,44999999999999",4,1,1,6,Mid-Value,Potential Loyalists
86958,204,4,"163,9",5,1,1,7,Mid-Value,Potential Loyalists
86959,159,2,"48,5",5,1,1,7,Mid-Value,Potential Loyalists
86960,742,5,"695,2",3,1,2,6,Mid-Value,Potential Loyalists
86961,611,3,"88,55000000000001",4,1,1,6,Mid-Value,Potential Loyalists
86969,1180,2,"18,35",2,1,1,4,Low-Value,Can't Lose
86970,10,2,"227,9",5,1,1,7,Mid-Value,Potential Loyalists
86971,212,3,"65,65",5,1,1,7,Mid-Value,Potential Loyalists
86973,1173,5,"222,65",2,1,1,4,Low-Value,Can't Lose
86976,1120,1,"91,2",2,1,1,4,Low-Value,Can't Lose
86978,231,2,"192,3",5,1,1,7,Mid-Value,Potential Loyalists
86979,1680,1,"11,4",1,1,1,3,Low-Value,Lost
86980,784,1,"40,7",3,1,1,5,Low-Value,At Risk Customers
86981,20,5,"371,3",5,1,1,7,Mid-Value,Potential Loyalists
86985,70,5,"997,4999999999999",5,1,2,8,High-Value,Potential Loyalists
86986,1099,2,"488,0",2,1,1,4,Low-Value,Can't Lose
86987,248,2,"123,35",5,1,1,7,Mid-Value,Potential Loyalists
86989,421,5,"467,8",4,1,1,6,Mid-Value,Potential Loyalists
86990,372,5,"566,85",4,1,1,6,Mid-Value,Potential Loyalists
86991,1182,1,"56,45",2,1,1,4,Low-Value,Can't Lose
86992,858,1,"140,0",3,1,1,5,Low-Value,At Risk Customers
86993,20,8,"236,7",5,2,1,8,High-Value,Potential Loyalists
86994,1165,1,"11,7",2,1,1,4,Low-Value,Can't Lose
86996,357,3,"153,55",5,1,1,7,Mid-Value,Potential Loyalists
86998,283,1,"77,85",5,1,1,7,Mid-Value,Potential Loyalists
87000,522,1,"18,75",4,1,1,6,Mid-Value,Potential Loyalists
87002,16,4,"129,75",5,1,1,7,Mid-Value,Potential Loyalists
87003,22,3,"155,0",5,1,1,7,Mid-Value,Potential Loyalists
87004,1239,1,"14,55",2,1,1,4,Low-Value,Can't Lose
87005,330,3,"200,9",5,1,1,7,Mid-Value,Potential Loyalists
87006,111,4,"396,6",5,1,1,7,Mid-Value,Potential Loyalists
87008,162,2,"51,1",5,1,1,7,Mid-Value,Potential Loyalists
87010,201,4,"513,25",5,1,1,7,Mid-Value,Potential Loyalists
87011,354,2,"159,8",5,1,1,7,Mid-Value,Potential Loyalists
87012,32,10,"463,3",5,2,1,8,High-Value,Potential Loyalists
87017,638,4,"165,25",4,1,1,6,Mid-Value,Potential Loyalists
87020,29,11,"1400,05",5,2,3,10,High-Value,Champions
87021,933,4,"81,55",3,1,1,5,Low-Value,At Risk Customers
87023,653,4,"219,60000000000002",4,1,1,6,Mid-Value,Potential Loyalists
87025,925,1,"143,10000000000002",3,1,1,5,Low-Value,At Risk Customers
87027,459,2,"8,05",4,1,1,6,Mid-Value,Potential Loyalists
87029,882,2,"209,75",3,1,1,5,Low-Value,At Risk Customers
87031,29,5,"257,35",5,1,1,7,Mid-Value,Potential Loyalists
87032,584,4,"503,50000000000006",4,1,1,6,Mid-Value,Potential Loyalists
87033,39,2,"50,5",5,1,1,7,Mid-Value,Potential Loyalists
87034,18,6,"844,9",5,1,2,8,High-Value,Potential Loyalists
87035,420,4,"198,6",4,1,1,6,Mid-Value,Potential Loyalists
87036,397,5,"327,85",4,1,1,6,Mid-Value,Potential Loyalists
87037,263,4,"109,5",5,1,1,7,Mid-Value,Potential Loyalists
87040,20,5,"1024,65",5,1,2,8,High-Value,Potential Loyalists
87041,258,7,"785,0",5,2,2,9,High-Value,Champions
87042,671,6,"536,55",4,1,1,6,Mid-Value,Potential Loyalists
87045,505,2,"240,15",4,1,1,6,Mid-Value,Potential Loyalists
87048,17,5,"589,45",5,1,1,7,Mid-Value,Potential Loyalists
87049,47,11,"555,25",5,2,1,8,High-Value,Potential Loyalists
87051,68,2,"136,9",5,1,1,7,Mid-Value,Potential Loyalists
87053,126,3,"81,75",5,1,1,7,Mid-Value,Potential Loyalists
87055,53,1,"11,95",5,1,1,7,Mid-Value,Potential Loyalists
87056,241,2,"74,3",5,1,1,7,Mid-Value,Potential Loyalists
87057,472,2,"60,2",4,1,1,6,Mid-Value,Potential Loyalists
87060,1636,1,"107,4",1,1,1,3,Low-Value,Lost
87062,823,1,"11,3",3,1,1,5,Low-Value,At Risk Customers
87063,633,3,"60,65",4,1,1,6,Mid-Value,Potential Loyalists
87065,259,6,"235,65",5,1,1,7,Mid-Value,Potential Loyalists
87068,378,3,"610,85",4,1,1,6,Mid-Value,Potential Loyalists
87069,153,2,"459,29999999999995",5,1,1,7,Mid-Value,Potential Loyalists
87071,478,1,"32,5",4,1,1,6,Mid-Value,Potential Loyalists
87072,596,6,"240,8",4,1,1,6,Mid-Value,Potential Loyalists
87073,1352,1,"56,9",2,1,1,4,Low-Value,Can't Lose
87075,1419,1,"65,05",2,1,1,4,Low-Value,Can't Lose
87078,215,2,"41,9",5,1,1,7,Mid-Value,Potential Loyalists
87081,1697,1,"64,3",1,1,1,3,Low-Value,Lost
87082,1770,1,"13,35",1,1,1,3,Low-Value,Lost
87083,1266,3,"323,9",2,1,1,4,Low-Value,Can't Lose
87084,29,18,"1119,9",5,4,2,11,High-Value,Champions
87086,398,3,"148,75",4,1,1,6,Mid-Value,Potential Loyalists
87087,110,2,"88,89999999999999",5,1,1,7,Mid-Value,Potential Loyalists
87089,156,9,"835,5500000000001",5,2,2,9,High-Value,Champions
87091,924,1,"91,2",3,1,1,5,Low-Value,At Risk Customers
87095,962,4,"191,2",3,1,1,5,Low-Value,At Risk Customers
87096,764,1,"23,35",3,1,1,5,Low-Value,At Risk Customers
87097,1373,1,"29,0",2,1,1,4,Low-Value,Can't Lose
87099,1530,1,"171,25",1,1,1,3,Low-Value,Lost
87100,543,4,"173,8",4,1,1,6,Mid-Value,Potential Loyalists
87101,155,2,"28,65",5,1,1,7,Mid-Value,Potential Loyalists
87106,446,3,"110,4",4,1,1,6,Mid-Value,Potential Loyalists
87108,1100,2,"161,3",2,1,1,4,Low-Value,Can't Lose
87109,323,3,"166,89999999999998",5,1,1,7,Mid-Value,Potential Loyalists
87110,1821,1,"23,4",1,1,1,3,Low-Value,Lost
87111,1049,1,"24,2",3,1,1,5,Low-Value,At Risk Customers
87112,176,5,"541,2",5,1,1,7,Mid-Value,Potential Loyalists
87113,983,7,"407,9",3,2,1,6,Mid-Value,Potential Loyalists
87114,102,3,"222,3",5,1,1,7,Mid-Value,Potential Loyalists
87115,144,3,"43,45",5,1,1,7,Mid-Value,Potential Loyalists
87117,66,2,"35,25",5,1,1,7,Mid-Value,Potential Loyalists
87119,568,1,"86,1",4,1,1,6,Mid-Value,Potential Loyalists
87120,544,1,"38,5",4,1,1,6,Mid-Value,Potential Loyalists
87121,863,2,"148,65",3,1,1,5,Low-Value,At Risk Customers
87123,209,9,"543,4",5,2,1,8,High-Value,Potential Loyalists
87124,410,4,"117,55",4,1,1,6,Mid-Value,Potential Loyalists
87127,749,3,"166,65",3,1,1,5,Low-Value,At Risk Customers
87128,760,7,"358,5",3,2,1,6,Mid-Value,Potential Loyalists
87130,276,5,"315,45",5,1,1,7,Mid-Value,Potential Loyalists
87131,1329,1,"6,7",2,1,1,4,Low-Value,Can't Lose
87135,111,4,"196,55",5,1,1,7,Mid-Value,Potential Loyalists
87136,1279,1,"86,8",2,1,1,4,Low-Value,Can't Lose
87137,1146,2,"15,399999999999999",2,1,1,4,Low-Value,Can't Lose
87139,882,1,"78,15",3,1,1,5,Low-Value,At Risk Customers
87141,1355,2,"217,0",2,1,1,4,Low-Value,Can't Lose
87145,789,2,"71,45",3,1,1,5,Low-Value,At Risk Customers
87146,395,2,"582,4",4,1,1,6,Mid-Value,Potential Loyalists
87147,405,6,"270,6",4,1,1,6,Mid-Value,Potential Loyalists
87148,1142,3,"379,80000000000007",2,1,1,4,Low-Value,Can't Lose
87150,395,2,"280,69999999999993",4,1,1,6,Mid-Value,Potential Loyalists
87152,771,3,"120,10000000000001",3,1,1,5,Low-Value,At Risk Customers
87157,201,2,"90,9",5,1,1,7,Mid-Value,Potential Loyalists
87159,66,1,"16,75",5,1,1,7,Mid-Value,Potential Loyalists
87161,117,3,"87,95",5,1,1,7,Mid-Value,Potential Loyalists
87164,1210,1,"10,23",2,1,1,4,Low-Value,Can't Lose
87165,1766,1,"9,35",1,1,1,3,Low-Value,Lost
87166,1114,1,"52,650000000000006",2,1,1,4,Low-Value,Can't Lose
87167,1065,1,"30,25",3,1,1,5,Low-Value,At Risk Customers
87168,1400,1,"9,0",2,1,1,4,Low-Value,Can't Lose
87169,1106,3,"100,5",2,1,1,4,Low-Value,Can't Lose
87172,153,5,"152,7",5,1,1,7,Mid-Value,Potential Loyalists
87173,304,4,"77,95",5,1,1,7,Mid-Value,Potential Loyalists
87175,179,4,"162,2",5,1,1,7,Mid-Value,Potential Loyalists
87176,60,2,"520,65",5,1,1,7,Mid-Value,Potential Loyalists
87177,660,4,"188,25",4,1,1,6,Mid-Value,Potential Loyalists
87178,85,3,"78,05",5,1,1,7,Mid-Value,Potential Loyalists
87180,18,5,"592,9",5,1,1,7,Mid-Value,Potential Loyalists
87181,669,2,"98,10000000000001",4,1,1,6,Mid-Value,Potential Loyalists
87184,17,4,"386,04999999999995",5,1,1,7,Mid-Value,Potential Loyalists
87185,139,11,"1647,4499999999998",5,2,3,10,High-Value,Champions
87186,91,3,"245,15",5,1,1,7,Mid-Value,Potential Loyalists
87187,1723,1,"11,4",1,1,1,3,Low-Value,Lost
87189,840,4,"120,85",3,1,1,5,Low-Value,At Risk Customers
87190,634,2,"34,550000000000004",4,1,1,6,Mid-Value,Potential Loyalists
87191,359,1,"10,15",5,1,1,7,Mid-Value,Potential Loyalists
87192,45,3,"62,7",5,1,1,7,Mid-Value,Potential Loyalists
87193,1285,1,"64,5",2,1,1,4,Low-Value,Can't Lose
87196,589,3,"411,6",4,1,1,6,Mid-Value,Potential Loyalists
87198,1236,1,"53,7",2,1,1,4,Low-Value,Can't Lose
87199,1118,1,"100,80000000000001",2,1,1,4,Low-Value,Can't Lose
87202,2,15,"1356,1499999999999",5,3,3,11,High-Value,Champions
87203,211,1,"20,6",5,1,1,7,Mid-Value,Potential Loyalists
87205,194,3,"212,2",5,1,1,7,Mid-Value,Potential Loyalists
87208,517,4,"205,7",4,1,1,6,Mid-Value,Potential Loyalists
87210,58,4,"241,95",5,1,1,7,Mid-Value,Potential Loyalists
87211,69,4,"464,15",5,1,1,7,Mid-Value,Potential Loyalists
87214,249,4,"185,25",5,1,1,7,Mid-Value,Potential Loyalists
87215,17,12,"782,4",5,3,2,10,High-Value,Champions
87217,125,10,"754,15",5,2,2,9,High-Value,Champions
87220,717,1,"46,25",4,1,1,6,Mid-Value,Potential Loyalists
87222,498,2,"463,5",4,1,1,6,Mid-Value,Potential Loyalists
87223,1218,1,"6,5",2,1,1,4,Low-Value,Can't Lose
87224,25,8,"722,8",5,2,2,9,High-Value,Champions
87225,1305,1,"36,3",2,1,1,4,Low-Value,Can't Lose
87226,483,6,"1536,05",4,1,3,8,High-Value,Potential Loyalists
87228,386,6,"703,15",4,1,2,7,Mid-Value,Potential Loyalists
87232,155,4,"143,55",5,1,1,7,Mid-Value,Potential Loyalists
87233,1111,1,"161,2",2,1,1,4,Low-Value,Can't Lose
87235,339,2,"91,45",5,1,1,7,Mid-Value,Potential Loyalists
87238,150,2,"141,9",5,1,1,7,Mid-Value,Potential Loyalists
87240,1228,3,"195,45",2,1,1,4,Low-Value,Can't Lose
87241,1137,4,"76,8",2,1,1,4,Low-Value,Can't Lose
87242,1015,4,"287,25",3,1,1,5,Low-Value,At Risk Customers
87244,443,6,"410,45",4,1,1,6,Mid-Value,Potential Loyalists
87245,792,6,"258,65000000000003",3,1,1,5,Low-Value,At Risk Customers
87246,18,7,"404,65",5,2,1,8,High-Value,Potential Loyalists
87248,244,1,"36,75",5,1,1,7,Mid-Value,Potential Loyalists
87250,1099,3,"144,85",2,1,1,4,Low-Value,Can't Lose
87251,1121,7,"218,9",2,2,1,5,Low-Value,At Risk Customers
87253,35,8,"743,75",5,2,2,9,High-Value,Champions
87257,28,10,"673,7",5,2,2,9,High-Value,Champions
87262,213,1,"81,0",5,1,1,7,Mid-Value,Potential Loyalists
87264,32,4,"215,6",5,1,1,7,Mid-Value,Potential Loyalists
87265,1680,1,"7,95",1,1,1,3,Low-Value,Lost
87267,1279,2,"97,8",2,1,1,4,Low-Value,Can't Lose
87268,55,2,"309,90000000000003",5,1,1,7,Mid-Value,Potential Loyalists
87269,1134,2,"144,75",2,1,1,4,Low-Value,Can't Lose
87270,1308,1,"16,65",2,1,1,4,Low-Value,Can't Lose
87274,490,6,"606,5500000000001",4,1,1,6,Mid-Value,Potential Loyalists
87278,1042,2,"28,950000000000003",3,1,1,5,Low-Value,At Risk Customers
87279,68,2,"41,65",5,1,1,7,Mid-Value,Potential Loyalists
87281,53,4,"101,3",5,1,1,7,Mid-Value,Potential Loyalists
87284,347,4,"181,9",5,1,1,7,Mid-Value,Potential Loyalists
87288,817,4,"96,5",3,1,1,5,Low-Value,At Risk Customers
87291,1320,3,"128,9",2,1,1,4,Low-Value,Can't Lose
87292,191,7,"374,4",5,2,1,8,High-Value,Potential Loyalists
87293,267,5,"235,95",5,1,1,7,Mid-Value,Potential Loyalists
87294,961,1,"74,55000000000001",3,1,1,5,Low-Value,At Risk Customers
87295,1821,1,"43,55",1,1,1,3,Low-Value,Lost
87301,264,4,"174,9",5,1,1,7,Mid-Value,Potential Loyalists
87302,1361,1,"82,85",2,1,1,4,Low-Value,Can't Lose
87303,1815,1,"62,1",1,1,1,3,Low-Value,Lost
87306,26,12,"795,4",5,3,2,10,High-Value,Champions
87307,607,3,"146,2",4,1,1,6,Mid-Value,Potential Loyalists
87309,507,4,"102,35000000000001",4,1,1,6,Mid-Value,Potential Loyalists
87310,1138,2,"57,6",2,1,1,4,Low-Value,Can't Lose
87313,402,3,"53,45",4,1,1,6,Mid-Value,Potential Loyalists
87315,1686,1,"33,6",1,1,1,3,Low-Value,Lost
87316,79,3,"446,7",5,1,1,7,Mid-Value,Potential Loyalists
87319,1020,5,"158,6",3,1,1,5,Low-Value,At Risk Customers
87322,1643,4,"195,85",1,1,1,3,Low-Value,Lost
87323,1445,1,"134,7",2,1,1,4,Low-Value,Can't Lose
87326,938,1,"494,5",3,1,1,5,Low-Value,At Risk Customers
87331,51,2,"35,45",5,1,1,7,Mid-Value,Potential Loyalists
87332,463,2,"109,3",4,1,1,6,Mid-Value,Potential Loyalists
87333,76,2,"47,9",5,1,1,7,Mid-Value,Potential Loyalists
87337,474,1,"24,1",4,1,1,6,Mid-Value,Potential Loyalists
87340,272,4,"126,5",5,1,1,7,Mid-Value,Potential Loyalists
87343,1255,4,"73,45",2,1,1,4,Low-Value,Can't Lose
87345,1680,1,"10,95",1,1,1,3,Low-Value,Lost
87348,516,3,"78,05",4,1,1,6,Mid-Value,Potential Loyalists
87349,146,2,"73,65",5,1,1,7,Mid-Value,Potential Loyalists
87351,22,4,"134,25",5,1,1,7,Mid-Value,Potential Loyalists
87352,422,4,"114,05000000000001",4,1,1,6,Mid-Value,Potential Loyalists
87353,1231,1,"51,300000000000004",2,1,1,4,Low-Value,Can't Lose
87355,1288,1,"48,1",2,1,1,4,Low-Value,Can't Lose
87356,212,2,"578,7",5,1,1,7,Mid-Value,Potential Loyalists
87363,96,6,"950,0",5,1,2,8,High-Value,Potential Loyalists
87364,889,3,"100,15",3,1,1,5,Low-Value,At Risk Customers
87368,30,2,"60,55",5,1,1,7,Mid-Value,Potential Loyalists
87369,133,4,"470,0",5,1,1,7,Mid-Value,Potential Loyalists
87371,752,4,"355,15",3,1,1,5,Low-Value,At Risk Customers
87373,919,3,"321,09999999999997",3,1,1,5,Low-Value,At Risk Customers
87374,24,3,"102,64999999999999",5,1,1,7,Mid-Value,Potential Loyalists
87375,906,2,"172,6",3,1,1,5,Low-Value,At Risk Customers
87376,15,9,"392,95",5,2,1,8,High-Value,Potential Loyalists
87377,1236,3,"37,1",2,1,1,4,Low-Value,Can't Lose
87378,259,2,"24,9",5,1,1,7,Mid-Value,Potential Loyalists
87380,1008,3,"84,10000000000001",3,1,1,5,Low-Value,At Risk Customers
87383,46,5,"244,75",5,1,1,7,Mid-Value,Potential Loyalists
87384,400,11,"567,8",4,2,1,7,Mid-Value,Potential Loyalists
87386,394,9,"924,05",4,2,2,8,High-Value,Potential Loyalists
87387,471,7,"309,85",4,2,1,7,Mid-Value,Potential Loyalists
87389,89,3,"263,3",5,1,1,7,Mid-Value,Potential Loyalists
87392,578,3,"228,5",4,1,1,6,Mid-Value,Potential Loyalists
87393,363,3,"84,15",5,1,1,7,Mid-Value,Potential Loyalists
87400,315,3,"183,0",5,1,1,7,Mid-Value,Potential Loyalists
87401,1737,2,"227,1",1,1,1,3,Low-Value,Lost
87402,344,1,"4,9",5,1,1,7,Mid-Value,Potential Loyalists
87404,291,4,"177,75",5,1,1,7,Mid-Value,Potential Loyalists
87405,206,4,"389,90000000000003",5,1,1,7,Mid-Value,Potential Loyalists
87406,1804,1,"4,8",1,1,1,3,Low-Value,Lost
87408,166,3,"59,45",5,1,1,7,Mid-Value,Potential Loyalists
87409,428,1,"22,85",4,1,1,6,Mid-Value,Potential Loyalists
87411,1720,1,"27,1",1,1,1,3,Low-Value,Lost
87413,1314,1,"12,1",2,1,1,4,Low-Value,Can't Lose
87414,5,3,"436,2",5,1,1,7,Mid-Value,Potential Loyalists
87416,1334,1,"0,25",2,1,1,4,Low-Value,Can't Lose
87418,385,4,"439,75000000000006",4,1,1,6,Mid-Value,Potential Loyalists
87420,1125,1,"122,3",2,1,1,4,Low-Value,Can't Lose
87421,1014,4,"128,35",3,1,1,5,Low-Value,At Risk Customers
87423,72,3,"192,2",5,1,1,7,Mid-Value,Potential Loyalists
87426,630,3,"161,7",4,1,1,6,Mid-Value,Potential Loyalists
87427,466,3,"143,45000000000002",4,1,1,6,Mid-Value,Potential Loyalists
87428,843,4,"443,05",3,1,1,5,Low-Value,At Risk Customers
87430,107,3,"197,85000000000002",5,1,1,7,Mid-Value,Potential Loyalists
87432,168,2,"50,5",5,1,1,7,Mid-Value,Potential Loyalists
87433,339,2,"148,7",5,1,1,7,Mid-Value,Potential Loyalists
87436,460,2,"33,55",4,1,1,6,Mid-Value,Potential Loyalists
87438,337,1,"29,95",5,1,1,7,Mid-Value,Potential Loyalists
87440,59,2,"125,54999999999998",5,1,1,7,Mid-Value,Potential Loyalists
87441,1642,2,"35,2",1,1,1,3,Low-Value,Lost
87442,751,1,"78,5",3,1,1,5,Low-Value,At Risk Customers
87443,15,11,"670,25",5,2,2,9,High-Value,Champions
87444,817,4,"773,6",3,1,2,6,Mid-Value,Potential Loyalists
87446,368,7,"655,3",4,2,1,7,Mid-Value,Potential Loyalists
87448,868,3,"66,7",3,1,1,5,Low-Value,At Risk Customers
87449,887,4,"206,95",3,1,1,5,Low-Value,At Risk Customers
87450,1242,1,"15,3",2,1,1,4,Low-Value,Can't Lose
87452,733,4,"284,2",3,1,1,5,Low-Value,At Risk Customers
87454,274,3,"366,75",5,1,1,7,Mid-Value,Potential Loyalists
87457,281,4,"328,79999999999995",5,1,1,7,Mid-Value,Potential Loyalists
87459,959,2,"184,79999999999998",3,1,1,5,Low-Value,At Risk Customers
87460,404,1,"11,5",4,1,1,6,Mid-Value,Potential Loyalists
87462,15,3,"160,95",5,1,1,7,Mid-Value,Potential Loyalists
87463,1192,1,"48,1",2,1,1,4,Low-Value,Can't Lose
87466,517,2,"327,95",4,1,1,6,Mid-Value,Potential Loyalists
87467,358,1,"16,45",5,1,1,7,Mid-Value,Potential Loyalists
87468,997,2,"58,699999999999996",3,1,1,5,Low-Value,At Risk Customers
87472,795,3,"63,6",3,1,1,5,Low-Value,At Risk Customers
87475,1104,3,"87,95",2,1,1,4,Low-Value,Can't Lose
87476,136,5,"898,5999999999999",5,1,2,8,High-Value,Potential Loyalists
87477,73,6,"192,04999999999998",5,1,1,7,Mid-Value,Potential Loyalists
87478,184,4,"731,7",5,1,2,8,High-Value,Potential Loyalists
87480,122,3,"318,5",5,1,1,7,Mid-Value,Potential Loyalists
87481,88,7,"611,45",5,2,1,8,High-Value,Potential Loyalists
87485,222,4,"101,8",5,1,1,7,Mid-Value,Potential Loyalists
87487,718,2,"232,09999999999997",4,1,1,6,Mid-Value,Potential Loyalists
87488,543,3,"247,79999999999998",4,1,1,6,Mid-Value,Potential Loyalists
87490,395,3,"123,3",4,1,1,6,Mid-Value,Potential Loyalists
87492,339,1,"5,75",5,1,1,7,Mid-Value,Potential Loyalists
87494,1103,2,"48,4",2,1,1,4,Low-Value,Can't Lose
87496,339,2,"87,75",5,1,1,7,Mid-Value,Potential Loyalists
87497,747,2,"133,39999999999998",3,1,1,5,Low-Value,At Risk Customers
87500,24,2,"206,89999999999998",5,1,1,7,Mid-Value,Potential Loyalists
87501,498,2,"175,45",4,1,1,6,Mid-Value,Potential Loyalists
87502,1317,1,"96,44999999999999",2,1,1,4,Low-Value,Can't Lose
87503,1419,3,"72,5",2,1,1,4,Low-Value,Can't Lose
87504,1054,1,"36,8",3,1,1,5,Low-Value,At Risk Customers
87505,1145,2,"213,25",2,1,1,4,Low-Value,Can't Lose
87506,383,3,"188,29999999999998",4,1,1,6,Mid-Value,Potential Loyalists
87507,14,12,"931,8",5,3,2,10,High-Value,Champions
87508,666,2,"16,9",4,1,1,6,Mid-Value,Potential Loyalists
87509,439,10,"670,1",4,2,2,8,High-Value,Potential Loyalists
87515,871,1,"202,8",3,1,1,5,Low-Value,At Risk Customers
87516,329,5,"254,8",5,1,1,7,Mid-Value,Potential Loyalists
87517,260,1,"278,9",5,1,1,7,Mid-Value,Potential Loyalists
87518,1091,1,"49,15",3,1,1,5,Low-Value,At Risk Customers
87520,1285,1,"86,3",2,1,1,4,Low-Value,Can't Lose
87521,116,4,"80,15",5,1,1,7,Mid-Value,Potential Loyalists
87522,591,5,"175,9",4,1,1,6,Mid-Value,Potential Loyalists
87523,816,1,"113,45",3,1,1,5,Low-Value,At Risk Customers
87524,90,4,"108,55000000000001",5,1,1,7,Mid-Value,Potential Loyalists
87526,98,6,"125,25",5,1,1,7,Mid-Value,Potential Loyalists
87527,10,4,"301,55",5,1,1,7,Mid-Value,Potential Loyalists
87529,476,2,"172,65",4,1,1,6,Mid-Value,Potential Loyalists
87530,417,3,"38,45",4,1,1,6,Mid-Value,Potential Loyalists
87531,560,6,"372,3",4,1,1,6,Mid-Value,Potential Loyalists
87532,594,1,"43,05",4,1,1,6,Mid-Value,Potential Loyalists
87535,78,12,"561,25",5,3,1,9,High-Value,Champions
87539,75,2,"40,45",5,1,1,7,Mid-Value,Potential Loyalists
87541,1408,4,"197,3",2,1,1,4,Low-Value,Can't Lose
87543,1038,2,"65,4",3,1,1,5,Low-Value,At Risk Customers
87544,200,2,"269,79999999999995",5,1,1,7,Mid-Value,Potential Loyalists
87546,1314,1,"20,6",2,1,1,4,Low-Value,Can't Lose
87547,266,2,"136,4",5,1,1,7,Mid-Value,Potential Loyalists
87549,146,3,"93,15",5,1,1,7,Mid-Value,Potential Loyalists
87552,377,2,"153,4",4,1,1,6,Mid-Value,Potential Loyalists
87553,1018,4,"177,6",3,1,1,5,Low-Value,At Risk Customers
87555,395,4,"89,85",4,1,1,6,Mid-Value,Potential Loyalists
87556,636,1,"19,8",4,1,1,6,Mid-Value,Potential Loyalists
87558,881,2,"126,69999999999999",3,1,1,5,Low-Value,At Risk Customers
87559,339,2,"19,5",5,1,1,7,Mid-Value,Potential Loyalists
87560,200,4,"327,04999999999995",5,1,1,7,Mid-Value,Potential Loyalists
87561,1534,1,"26,6",1,1,1,3,Low-Value,Lost
87562,104,4,"315,75",5,1,1,7,Mid-Value,Potential Loyalists
87563,866,3,"83,05",3,1,1,5,Low-Value,At Risk Customers
87564,620,1,"62,85",4,1,1,6,Mid-Value,Potential Loyalists
87566,83,3,"160,65",5,1,1,7,Mid-Value,Potential Loyalists
87568,456,4,"451,9",4,1,1,6,Mid-Value,Potential Loyalists
87570,1637,1,"165,6",1,1,1,3,Low-Value,Lost
87573,11,15,"1107,75",5,3,2,10,High-Value,Champions
87574,1104,3,"106,55",2,1,1,4,Low-Value,Can't Lose
87575,89,6,"141,75",5,1,1,7,Mid-Value,Potential Loyalists
87579,346,1,"7,7",5,1,1,7,Mid-Value,Potential Loyalists
87580,1514,2,"81,14999999999999",1,1,1,3,Low-Value,Lost
87582,748,2,"114,0",3,1,1,5,Low-Value,At Risk Customers
87583,46,6,"854,7",5,1,2,8,High-Value,Potential Loyalists
87585,177,5,"673,3",5,1,2,8,High-Value,Potential Loyalists
87586,956,1,"58,0",3,1,1,5,Low-Value,At Risk Customers
87588,732,5,"358,4",3,1,1,5,Low-Value,At Risk Customers
87591,711,1,"20,1",4,1,1,6,Mid-Value,Potential Loyalists
87593,71,4,"149,1",5,1,1,7,Mid-Value,Potential Loyalists
87595,425,1,"21,45",4,1,1,6,Mid-Value,Potential Loyalists
87598,1155,3,"101,25",2,1,1,4,Low-Value,Can't Lose
87600,1442,2,"29,799999999999997",2,1,1,4,Low-Value,Can't Lose
87601,544,3,"189,7",4,1,1,6,Mid-Value,Potential Loyalists
87602,386,4,"122,7",4,1,1,6,Mid-Value,Potential Loyalists
87604,814,2,"17,6",3,1,1,5,Low-Value,At Risk Customers
87605,1115,4,"408,7",2,1,1,4,Low-Value,Can't Lose
87606,330,3,"93,6",5,1,1,7,Mid-Value,Potential Loyalists
87607,607,3,"259,75",4,1,1,6,Mid-Value,Potential Loyalists
87609,210,3,"155,20000000000002",5,1,1,7,Mid-Value,Potential Loyalists
87611,1351,2,"13,149999999999999",2,1,1,4,Low-Value,Can't Lose
87613,1455,2,"128,2",2,1,1,4,Low-Value,Can't Lose
87615,216,9,"301,25",5,2,1,8,High-Value,Potential Loyalists
87617,75,6,"394,4",5,1,1,7,Mid-Value,Potential Loyalists
87618,115,4,"297,3",5,1,1,7,Mid-Value,Potential Loyalists
87623,133,2,"51,25",5,1,1,7,Mid-Value,Potential Loyalists
87625,220,2,"182,15",5,1,1,7,Mid-Value,Potential Loyalists
87626,241,1,"21,0",5,1,1,7,Mid-Value,Potential Loyalists
87630,937,1,"13,5",3,1,1,5,Low-Value,At Risk Customers
87632,804,4,"250,05",3,1,1,5,Low-Value,At Risk Customers
87637,50,5,"228,15",5,1,1,7,Mid-Value,Potential Loyalists
87640,54,7,"452,8",5,2,1,8,High-Value,Potential Loyalists
87642,271,4,"131,4",5,1,1,7,Mid-Value,Potential Loyalists
87644,972,1,"26,400000000000002",3,1,1,5,Low-Value,At Risk Customers
87645,60,1,"82,2",5,1,1,7,Mid-Value,Potential Loyalists
87647,32,1,"5,35",5,1,1,7,Mid-Value,Potential Loyalists
87649,53,10,"890,05",5,2,2,9,High-Value,Champions
87650,377,3,"42,45",4,1,1,6,Mid-Value,Potential Loyalists
87653,945,3,"44,050000000000004",3,1,1,5,Low-Value,At Risk Customers
87654,322,5,"209,0",5,1,1,7,Mid-Value,Potential Loyalists
87655,79,2,"97,30000000000001",5,1,1,7,Mid-Value,Potential Loyalists
87656,39,4,"361,65",5,1,1,7,Mid-Value,Potential Loyalists
87657,66,2,"189,3",5,1,1,7,Mid-Value,Potential Loyalists
87658,1120,1,"8,1",2,1,1,4,Low-Value,Can't Lose
87660,307,2,"140,45",5,1,1,7,Mid-Value,Potential Loyalists
87662,234,2,"93,15",5,1,1,7,Mid-Value,Potential Loyalists
87663,952,3,"210,85",3,1,1,5,Low-Value,At Risk Customers
87665,169,5,"806,75",5,1,2,8,High-Value,Potential Loyalists
87667,1022,3,"163,95",3,1,1,5,Low-Value,At Risk Customers
87674,63,2,"69,95",5,1,1,7,Mid-Value,Potential Loyalists
87675,105,1,"18,6",5,1,1,7,Mid-Value,Potential Loyalists
87677,1287,3,"154,85",2,1,1,4,Low-Value,Can't Lose
87678,28,10,"440,7",5,2,1,8,High-Value,Potential Loyalists
87680,346,1,"42,75",5,1,1,7,Mid-Value,Potential Loyalists
87681,209,3,"188,05",5,1,1,7,Mid-Value,Potential Loyalists
87682,1192,1,"11,8",2,1,1,4,Low-Value,Can't Lose
87683,1485,2,"52,150000000000006",1,1,1,3,Low-Value,Lost
87685,14,8,"461,84999999999997",5,2,1,8,High-Value,Potential Loyalists
87686,1329,3,"264,15",2,1,1,4,Low-Value,Can't Lose
87689,109,2,"118,05",5,1,1,7,Mid-Value,Potential Loyalists
87693,138,6,"580,85",5,1,1,7,Mid-Value,Potential Loyalists
87695,385,4,"128,9",4,1,1,6,Mid-Value,Potential Loyalists
87696,755,7,"375,34999999999997",3,2,1,6,Mid-Value,Potential Loyalists
87698,47,5,"163,55",5,1,1,7,Mid-Value,Potential Loyalists
87699,1303,1,"181,4",2,1,1,4,Low-Value,Can't Lose
87700,327,9,"890,8",5,2,2,9,High-Value,Champions
87701,857,1,"28,35",3,1,1,5,Low-Value,At Risk Customers
87702,10,8,"1381,95",5,2,3,10,High-Value,Champions
87703,67,8,"179,75",5,2,1,8,High-Value,Potential Loyalists
87704,121,3,"417,59999999999997",5,1,1,7,Mid-Value,Potential Loyalists
87705,785,3,"359,5",3,1,1,5,Low-Value,At Risk Customers
87707,1085,1,"117,8",3,1,1,5,Low-Value,At Risk Customers
87709,116,9,"610,0",5,2,1,8,High-Value,Potential Loyalists
87710,41,5,"153,65",5,1,1,7,Mid-Value,Potential Loyalists
87714,429,3,"136,3",4,1,1,6,Mid-Value,Potential Loyalists
87715,683,3,"242,55",4,1,1,6,Mid-Value,Potential Loyalists
87717,49,5,"235,9",5,1,1,7,Mid-Value,Potential Loyalists
87719,1415,1,"34,4",2,1,1,4,Low-Value,Can't Lose
87723,15,10,"579,55",5,2,1,8,High-Value,Potential Loyalists
87725,1329,5,"286,85",2,1,1,4,Low-Value,Can't Lose
87726,59,3,"245,5",5,1,1,7,Mid-Value,Potential Loyalists
87729,128,9,"1178,8999999999999",5,2,2,9,High-Value,Champions
87730,783,1,"14,15",3,1,1,5,Low-Value,At Risk Customers
87733,1245,1,"35,55",2,1,1,4,Low-Value,Can't Lose
87737,983,2,"38,75",3,1,1,5,Low-Value,At Risk Customers
87738,57,4,"221,74999999999997",5,1,1,7,Mid-Value,Potential Loyalists
87742,488,1,"7,0",4,1,1,6,Mid-Value,Potential Loyalists
87744,56,3,"124,3",5,1,1,7,Mid-Value,Potential Loyalists
87745,59,4,"406,35",5,1,1,7,Mid-Value,Potential Loyalists
87746,70,7,"261,5",5,2,1,8,High-Value,Potential Loyalists
87748,259,3,"173,45000000000002",5,1,1,7,Mid-Value,Potential Loyalists
87749,1472,2,"124,6",1,1,1,3,Low-Value,Lost
87750,63,5,"474,65",5,1,1,7,Mid-Value,Potential Loyalists
87751,11,6,"472,65000000000003",5,1,1,7,Mid-Value,Potential Loyalists
87754,341,4,"298,4",5,1,1,7,Mid-Value,Potential Loyalists
87755,46,2,"33,85",5,1,1,7,Mid-Value,Potential Loyalists
87756,44,6,"308,09999999999997",5,1,1,7,Mid-Value,Potential Loyalists
87757,20,10,"743,85",5,2,2,9,High-Value,Champions
87759,676,1,"33,25",4,1,1,6,Mid-Value,Potential Loyalists
87762,391,2,"200,54999999999998",4,1,1,6,Mid-Value,Potential Loyalists
87765,24,2,"153,3",5,1,1,7,Mid-Value,Potential Loyalists
87766,29,3,"221,29999999999998",5,1,1,7,Mid-Value,Potential Loyalists
87768,988,2,"100,7",3,1,1,5,Low-Value,At Risk Customers
87771,800,5,"205,35",3,1,1,5,Low-Value,At Risk Customers
87772,158,5,"337,75",5,1,1,7,Mid-Value,Potential Loyalists
87777,604,2,"191,60000000000002",4,1,1,6,Mid-Value,Potential Loyalists
87782,1231,1,"37,05",2,1,1,4,Low-Value,Can't Lose
87783,246,2,"254,5",5,1,1,7,Mid-Value,Potential Loyalists
87785,33,5,"516,4",5,1,1,7,Mid-Value,Potential Loyalists
87787,94,7,"460,59999999999997",5,2,1,8,High-Value,Potential Loyalists
87789,692,3,"101,1",4,1,1,6,Mid-Value,Potential Loyalists
87790,1567,2,"77,1",1,1,1,3,Low-Value,Lost
87791,2,6,"153,14999999999998",5,1,1,7,Mid-Value,Potential Loyalists
87793,119,9,"590,3000000000001",5,2,1,8,High-Value,Potential Loyalists
87795,1075,1,"17,1",3,1,1,5,Low-Value,At Risk Customers
87797,1049,3,"48,0",3,1,1,5,Low-Value,At Risk Customers
87798,20,5,"479,95000000000005",5,1,1,7,Mid-Value,Potential Loyalists
87800,1223,1,"95,5",2,1,1,4,Low-Value,Can't Lose
87801,62,2,"70,80000000000001",5,1,1,7,Mid-Value,Potential Loyalists
87804,17,6,"432,1",5,1,1,7,Mid-Value,Potential Loyalists
87806,138,6,"328,35",5,1,1,7,Mid-Value,Potential Loyalists
87808,1283,1,"226,4",2,1,1,4,Low-Value,Can't Lose
87809,57,3,"65,15",5,1,1,7,Mid-Value,Potential Loyalists
87810,29,4,"134,64999999999998",5,1,1,7,Mid-Value,Potential Loyalists
87811,66,2,"82,94999999999999",5,1,1,7,Mid-Value,Potential Loyalists
87813,120,5,"508,05",5,1,1,7,Mid-Value,Potential Loyalists
87814,789,3,"133,2",3,1,1,5,Low-Value,At Risk Customers
87815,466,7,"362,05",4,2,1,7,Mid-Value,Potential Loyalists
87816,1070,1,"28,35",3,1,1,5,Low-Value,At Risk Customers
87817,738,1,"125,8",3,1,1,5,Low-Value,At Risk Customers
87818,1440,1,"62,9",2,1,1,4,Low-Value,Can't Lose
87819,26,2,"44,35",5,1,1,7,Mid-Value,Potential Loyalists
87820,454,4,"115,35",4,1,1,6,Mid-Value,Potential Loyalists
87822,532,2,"43,2",4,1,1,6,Mid-Value,Potential Loyalists
87823,116,2,"74,6",5,1,1,7,Mid-Value,Potential Loyalists
87824,1070,3,"204,50000000000003",3,1,1,5,Low-Value,At Risk Customers
87825,8,1,"23,5",5,1,1,7,Mid-Value,Potential Loyalists
87826,230,2,"56,65",5,1,1,7,Mid-Value,Potential Loyalists
87828,71,1,"24,1",5,1,1,7,Mid-Value,Potential Loyalists
87829,530,5,"305,34999999999997",4,1,1,6,Mid-Value,Potential Loyalists
87830,770,2,"191,1",3,1,1,5,Low-Value,At Risk Customers
87831,122,1,"120,4",5,1,1,7,Mid-Value,Potential Loyalists
87833,644,3,"55,5",4,1,1,6,Mid-Value,Potential Loyalists
87834,402,4,"321,85",4,1,1,6,Mid-Value,Potential Loyalists
87836,41,5,"281,95",5,1,1,7,Mid-Value,Potential Loyalists
87840,1260,1,"39,1",2,1,1,4,Low-Value,Can't Lose
87843,1127,1,"69,1",2,1,1,4,Low-Value,Can't Lose
87844,1187,2,"61,7",2,1,1,4,Low-Value,Can't Lose
87845,1280,1,"100,75",2,1,1,4,Low-Value,Can't Lose
87846,134,5,"208,75",5,1,1,7,Mid-Value,Potential Loyalists
87848,197,4,"155,75",5,1,1,7,Mid-Value,Potential Loyalists
87849,174,4,"179,45000000000002",5,1,1,7,Mid-Value,Potential Loyalists
87850,126,3,"663,5",5,1,2,8,High-Value,Potential Loyalists
87851,686,1,"4,4",4,1,1,6,Mid-Value,Potential Loyalists
87853,779,3,"90,5",3,1,1,5,Low-Value,At Risk Customers
87856,874,2,"36,1",3,1,1,5,Low-Value,At Risk Customers
87857,446,3,"272,4",4,1,1,6,Mid-Value,Potential Loyalists
87860,441,2,"88,2",4,1,1,6,Mid-Value,Potential Loyalists
87861,451,2,"72,4",4,1,1,6,Mid-Value,Potential Loyalists
87862,25,9,"872,15",5,2,2,9,High-Value,Champions
87866,1276,1,"54,599999999999994",2,1,1,4,Low-Value,Can't Lose
87867,954,1,"82,85",3,1,1,5,Low-Value,At Risk Customers
87868,1201,2,"49,8",2,1,1,4,Low-Value,Can't Lose
87869,200,4,"312,75",5,1,1,7,Mid-Value,Potential Loyalists
87871,978,2,"39,3",3,1,1,5,Low-Value,At Risk Customers
87873,1528,4,"136,8",1,1,1,3,Low-Value,Lost
87874,14,5,"546,4",5,1,1,7,Mid-Value,Potential Loyalists
87876,150,1,"121,3",5,1,1,7,Mid-Value,Potential Loyalists
87881,83,8,"364,6",5,2,1,8,High-Value,Potential Loyalists
87882,1410,1,"15,9",2,1,1,4,Low-Value,Can't Lose
87884,503,6,"379,15",4,1,1,6,Mid-Value,Potential Loyalists
87885,1715,1,"32,85",1,1,1,3,Low-Value,Lost
87887,622,2,"305,0",4,1,1,6,Mid-Value,Potential Loyalists
87889,86,7,"598,1",5,2,1,8,High-Value,Potential Loyalists
87891,396,5,"121,80000000000001",4,1,1,6,Mid-Value,Potential Loyalists
87892,379,6,"895,85",4,1,2,7,Mid-Value,Potential Loyalists
87893,495,1,"145,95",4,1,1,6,Mid-Value,Potential Loyalists
87894,792,2,"81,85000000000001",3,1,1,5,Low-Value,At Risk Customers
87895,33,9,"159,6",5,2,1,8,High-Value,Potential Loyalists
87897,514,3,"116,5",4,1,1,6,Mid-Value,Potential Loyalists
87898,1192,2,"34,55",2,1,1,4,Low-Value,Can't Lose
87901,1226,3,"850,3000000000001",2,1,2,5,Low-Value,At Risk Customers
87903,1228,1,"35,4",2,1,1,4,Low-Value,Can't Lose
87904,1294,1,"84,9",2,1,1,4,Low-Value,Can't Lose
87906,749,2,"164,1",3,1,1,5,Low-Value,At Risk Customers
87908,132,4,"129,8",5,1,1,7,Mid-Value,Potential Loyalists
87910,396,1,"10,1",4,1,1,6,Mid-Value,Potential Loyalists
87911,1453,1,"20,65",2,1,1,4,Low-Value,Can't Lose
87912,230,5,"172,45",5,1,1,7,Mid-Value,Potential Loyalists
87916,526,2,"34,599999999999994",4,1,1,6,Mid-Value,Potential Loyalists
87921,680,3,"191,95000000000002",4,1,1,6,Mid-Value,Potential Loyalists
87922,913,1,"78,1",3,1,1,5,Low-Value,At Risk Customers
87923,11,7,"195,35",5,2,1,8,High-Value,Potential Loyalists
87924,166,4,"115,55",5,1,1,7,Mid-Value,Potential Loyalists
87925,841,9,"548,65",3,2,1,6,Mid-Value,Potential Loyalists
87926,441,2,"114,05000000000001",4,1,1,6,Mid-Value,Potential Loyalists
87930,254,3,"87,0",5,1,1,7,Mid-Value,Potential Loyalists
87932,60,6,"477,6",5,1,1,7,Mid-Value,Potential Loyalists
87936,895,1,"109,4",3,1,1,5,Low-Value,At Risk Customers
87937,167,9,"388,55",5,2,1,8,High-Value,Potential Loyalists
87938,1420,1,"29,3",2,1,1,4,Low-Value,Can't Lose
87940,1604,1,"22,8",1,1,1,3,Low-Value,Lost
87941,377,5,"285,0",4,1,1,6,Mid-Value,Potential Loyalists
87945,296,2,"323,8",5,1,1,7,Mid-Value,Potential Loyalists
87947,177,1,"84,3",5,1,1,7,Mid-Value,Potential Loyalists
87948,445,5,"570,8000000000001",4,1,1,6,Mid-Value,Potential Loyalists
87949,133,1,"17,1",5,1,1,7,Mid-Value,Potential Loyalists
87950,843,3,"108,25",3,1,1,5,Low-Value,At Risk Customers
87953,496,3,"238,9",4,1,1,6,Mid-Value,Potential Loyalists
87954,370,4,"159,8",4,1,1,6,Mid-Value,Potential Loyalists
87955,143,1,"42,45",5,1,1,7,Mid-Value,Potential Loyalists
87956,405,4,"144,95",4,1,1,6,Mid-Value,Potential Loyalists
87958,208,3,"176,7",5,1,1,7,Mid-Value,Potential Loyalists
87959,1328,1,"1,3",2,1,1,4,Low-Value,Can't Lose
87960,235,5,"382,15000000000003",5,1,1,7,Mid-Value,Potential Loyalists
87961,429,2,"99,85",4,1,1,6,Mid-Value,Potential Loyalists
87964,588,2,"83,3",4,1,1,6,Mid-Value,Potential Loyalists
87966,8,7,"779,35",5,2,2,9,High-Value,Champions
87967,1401,1,"7,8",2,1,1,4,Low-Value,Can't Lose
87968,259,2,"41,3",5,1,1,7,Mid-Value,Potential Loyalists
87970,1243,2,"35,8",2,1,1,4,Low-Value,Can't Lose
87974,395,6,"209,39999999999998",4,1,1,6,Mid-Value,Potential Loyalists
87975,860,2,"249,45",3,1,1,5,Low-Value,At Risk Customers
87976,35,5,"437,25000000000006",5,1,1,7,Mid-Value,Potential Loyalists
87977,146,1,"73,3",5,1,1,7,Mid-Value,Potential Loyalists
87979,520,2,"153,6",4,1,1,6,Mid-Value,Potential Loyalists
87981,38,4,"258,0",5,1,1,7,Mid-Value,Potential Loyalists
87983,54,4,"391,5",5,1,1,7,Mid-Value,Potential Loyalists
87984,381,4,"119,64999999999999",4,1,1,6,Mid-Value,Potential Loyalists
87987,1211,2,"94,6",2,1,1,4,Low-Value,Can't Lose
87988,1266,1,"5,05",2,1,1,4,Low-Value,Can't Lose
87989,748,2,"52,8",3,1,1,5,Low-Value,At Risk Customers
87990,392,8,"473,05",4,2,1,7,Mid-Value,Potential Loyalists
87992,26,5,"413,85",5,1,1,7,Mid-Value,Potential Loyalists
87995,234,7,"328,95000000000005",5,2,1,8,High-Value,Potential Loyalists
87996,55,2,"688,25",5,1,2,8,High-Value,Potential Loyalists
88003,940,3,"95,65",3,1,1,5,Low-Value,At Risk Customers
88004,1104,3,"108,25",2,1,1,4,Low-Value,Can't Lose
88007,1,5,"334,34999999999997",5,1,1,7,Mid-Value,Potential Loyalists
88008,649,1,"34,9",4,1,1,6,Mid-Value,Potential Loyalists
88010,169,9,"777,5",5,2,2,9,High-Value,Champions
88011,263,3,"295,95",5,1,1,7,Mid-Value,Potential Loyalists
88012,514,3,"132,9",4,1,1,6,Mid-Value,Potential Loyalists
88014,118,6,"513,95",5,1,1,7,Mid-Value,Potential Loyalists
88015,39,2,"60,05",5,1,1,7,Mid-Value,Potential Loyalists
88016,615,2,"145,2",4,1,1,6,Mid-Value,Potential Loyalists
88017,3,6,"628,1",5,1,1,7,Mid-Value,Potential Loyalists
88019,378,3,"133,45",4,1,1,6,Mid-Value,Potential Loyalists
88025,441,3,"18,45",4,1,1,6,Mid-Value,Potential Loyalists
88027,267,4,"399,0",5,1,1,7,Mid-Value,Potential Loyalists
88030,1316,2,"47,650000000000006",2,1,1,4,Low-Value,Can't Lose
88031,1788,1,"107,2",1,1,1,3,Low-Value,Lost
88032,12,5,"128,3",5,1,1,7,Mid-Value,Potential Loyalists
88033,15,6,"311,4",5,1,1,7,Mid-Value,Potential Loyalists
88034,892,3,"275,9",3,1,1,5,Low-Value,At Risk Customers
88035,63,3,"203,20000000000002",5,1,1,7,Mid-Value,Potential Loyalists
88037,962,3,"229,10000000000002",3,1,1,5,Low-Value,At Risk Customers
88040,1658,1,"40,4",1,1,1,3,Low-Value,Lost
88041,199,1,"13,4",5,1,1,7,Mid-Value,Potential Loyalists
88043,80,11,"716,4",5,2,2,9,High-Value,Champions
88044,413,2,"112,3",4,1,1,6,Mid-Value,Potential Loyalists
88046,1041,2,"72,3",3,1,1,5,Low-Value,At Risk Customers
88047,556,6,"590,85",4,1,1,6,Mid-Value,Potential Loyalists
88048,1431,1,"5,3",2,1,1,4,Low-Value,Can't Lose
88049,1494,1,"6,65",1,1,1,3,Low-Value,Lost
88051,500,1,"78,15",4,1,1,6,Mid-Value,Potential Loyalists
88053,672,1,"28,85",4,1,1,6,Mid-Value,Potential Loyalists
88055,476,2,"120,6",4,1,1,6,Mid-Value,Potential Loyalists
88056,335,4,"647,6500000000001",5,1,1,7,Mid-Value,Potential Loyalists
88057,1232,4,"264,9",2,1,1,4,Low-Value,Can't Lose
88059,781,2,"211,35000000000002",3,1,1,5,Low-Value,At Risk Customers
88060,11,5,"172,0",5,1,1,7,Mid-Value,Potential Loyalists
88061,688,1,"5,75",4,1,1,6,Mid-Value,Potential Loyalists
88063,844,5,"504,20000000000005",3,1,1,5,Low-Value,At Risk Customers
88064,154,3,"176,2",5,1,1,7,Mid-Value,Potential Loyalists
88065,19,4,"363,0",5,1,1,7,Mid-Value,Potential Loyalists
88066,375,4,"122,44999999999999",4,1,1,6,Mid-Value,Potential Loyalists
88067,1358,1,"15,45",2,1,1,4,Low-Value,Can't Lose
88068,415,3,"102,69999999999999",4,1,1,6,Mid-Value,Potential Loyalists
88070,1314,2,"132,1",2,1,1,4,Low-Value,Can't Lose
88072,295,2,"234,60000000000002",5,1,1,7,Mid-Value,Potential Loyalists
88073,1077,1,"36,8",3,1,1,5,Low-Value,At Risk Customers
88074,160,5,"268,3",5,1,1,7,Mid-Value,Potential Loyalists
88075,12,5,"243,89999999999998",5,1,1,7,Mid-Value,Potential Loyalists
88077,340,1,"78,0",5,1,1,7,Mid-Value,Potential Loyalists
88078,1058,2,"47,300000000000004",3,1,1,5,Low-Value,At Risk Customers
88079,21,8,"333,8",5,2,1,8,High-Value,Potential Loyalists
88080,52,3,"42,3",5,1,1,7,Mid-Value,Potential Loyalists
88081,1538,3,"162,95",1,1,1,3,Low-Value,Lost
88088,421,3,"53,85",4,1,1,6,Mid-Value,Potential Loyalists
88089,1244,1,"262,0",2,1,1,4,Low-Value,Can't Lose
88090,580,5,"358,0",4,1,1,6,Mid-Value,Potential Loyalists
88092,651,1,"15,3",4,1,1,6,Mid-Value,Potential Loyalists
88093,1570,1,"32,9",1,1,1,3,Low-Value,Lost
88094,781,2,"61,900000000000006",3,1,1,5,Low-Value,At Risk Customers
88095,1137,5,"60,25",2,1,1,4,Low-Value,Can't Lose
88098,525,2,"151,5",4,1,1,6,Mid-Value,Potential Loyalists
88100,394,7,"903,5999999999999",4,2,2,8,High-Value,Potential Loyalists
88101,1410,2,"47,35",2,1,1,4,Low-Value,Can't Lose
88102,1039,2,"20,6",3,1,1,5,Low-Value,At Risk Customers
88103,716,3,"121,29999999999998",4,1,1,6,Mid-Value,Potential Loyalists
88104,1127,1,"8,5",2,1,1,4,Low-Value,Can't Lose
88106,7,8,"392,85",5,2,1,8,High-Value,Potential Loyalists
88107,1029,2,"25,200000000000003",3,1,1,5,Low-Value,At Risk Customers
88109,1175,5,"185,15",2,1,1,4,Low-Value,Can't Lose
88113,32,9,"446,65000000000003",5,2,1,8,High-Value,Potential Loyalists
88118,213,3,"64,15",5,1,1,7,Mid-Value,Potential Loyalists
88119,1286,4,"199,60000000000002",2,1,1,4,Low-Value,Can't Lose
88124,353,8,"423,04999999999995",5,2,1,8,High-Value,Potential Loyalists
88125,260,1,"12,2",5,1,1,7,Mid-Value,Potential Loyalists
88127,260,1,"14,45",5,1,1,7,Mid-Value,Potential Loyalists
88128,723,2,"75,9",4,1,1,6,Mid-Value,Potential Loyalists
88129,390,5,"368,75",4,1,1,6,Mid-Value,Potential Loyalists
88130,300,4,"76,15",5,1,1,7,Mid-Value,Potential Loyalists
88131,612,2,"29,4",4,1,1,6,Mid-Value,Potential Loyalists
88137,179,1,"125,2",5,1,1,7,Mid-Value,Potential Loyalists
88141,418,4,"273,79999999999995",4,1,1,6,Mid-Value,Potential Loyalists
88143,1534,2,"180,0",1,1,1,3,Low-Value,Lost
88145,941,2,"37,1",3,1,1,5,Low-Value,At Risk Customers
88146,414,11,"762,1",4,2,2,8,High-Value,Potential Loyalists
88147,859,1,"139,64999999999998",3,1,1,5,Low-Value,At Risk Customers
88150,1124,3,"125,55000000000001",2,1,1,4,Low-Value,Can't Lose
88151,1014,1,"49,4",3,1,1,5,Low-Value,At Risk Customers
88154,1809,1,"55,85",1,1,1,3,Low-Value,Lost
88155,530,5,"161,35",4,1,1,6,Mid-Value,Potential Loyalists
88156,17,5,"319,75",5,1,1,7,Mid-Value,Potential Loyalists
88157,659,1,"16,55",4,1,1,6,Mid-Value,Potential Loyalists
88158,622,4,"651,5",4,1,1,6,Mid-Value,Potential Loyalists
88161,1497,5,"307,5",1,1,1,3,Low-Value,Lost
88164,782,8,"539,55",3,2,1,6,Mid-Value,Potential Loyalists
88166,1591,1,"60,6",1,1,1,3,Low-Value,Lost
88168,138,4,"273,95",5,1,1,7,Mid-Value,Potential Loyalists
88169,132,1,"112,9",5,1,1,7,Mid-Value,Potential Loyalists
88170,321,3,"50,0",5,1,1,7,Mid-Value,Potential Loyalists
88171,534,4,"85,6",4,1,1,6,Mid-Value,Potential Loyalists
88173,420,1,"3,6",4,1,1,6,Mid-Value,Potential Loyalists
88174,1340,2,"93,99999999999999",2,1,1,4,Low-Value,Can't Lose
88176,107,8,"397,4",5,2,1,8,High-Value,Potential Loyalists
88177,1464,1,"66,4",1,1,1,3,Low-Value,Lost
88179,40,3,"238,9",5,1,1,7,Mid-Value,Potential Loyalists
88182,143,5,"1138,05",5,1,2,8,High-Value,Potential Loyalists
88183,1059,1,"3,6",3,1,1,5,Low-Value,At Risk Customers
88184,159,3,"149,85",5,1,1,7,Mid-Value,Potential Loyalists
88185,1758,1,"3,95",1,1,1,3,Low-Value,Lost
88186,194,3,"97,05000000000001",5,1,1,7,Mid-Value,Potential Loyalists
88187,881,2,"539,75",3,1,1,5,Low-Value,At Risk Customers
88188,257,3,"69,15",5,1,1,7,Mid-Value,Potential Loyalists
88189,496,1,"49,0",4,1,1,6,Mid-Value,Potential Loyalists
88190,77,5,"236,5",5,1,1,7,Mid-Value,Potential Loyalists
88193,38,5,"224,7",5,1,1,7,Mid-Value,Potential Loyalists
88194,433,3,"85,55",4,1,1,6,Mid-Value,Potential Loyalists
88195,572,1,"8,7",4,1,1,6,Mid-Value,Potential Loyalists
88197,886,3,"64,75",3,1,1,5,Low-Value,At Risk Customers
88198,349,4,"266,85",5,1,1,7,Mid-Value,Potential Loyalists
88200,445,6,"311,5",4,1,1,6,Mid-Value,Potential Loyalists
88201,294,4,"233,85000000000002",5,1,1,7,Mid-Value,Potential Loyalists
88202,453,4,"220,4",4,1,1,6,Mid-Value,Potential Loyalists
88204,830,4,"114,25",3,1,1,5,Low-Value,At Risk Customers
88205,32,4,"444,1",5,1,1,7,Mid-Value,Potential Loyalists
88206,404,1,"42,45",4,1,1,6,Mid-Value,Potential Loyalists
88208,1537,1,"43,9",1,1,1,3,Low-Value,Lost
88209,963,1,"28,0",3,1,1,5,Low-Value,At Risk Customers
88213,1670,3,"378,9",1,1,1,3,Low-Value,Lost
88217,152,3,"1548,5499999999997",5,1,3,9,High-Value,Champions
88218,1484,2,"87,55",1,1,1,3,Low-Value,Lost
88220,4,2,"206,10000000000002",5,1,1,7,Mid-Value,Potential Loyalists
88222,83,6,"447,35",5,1,1,7,Mid-Value,Potential Loyalists
88223,393,3,"93,15",4,1,1,6,Mid-Value,Potential Loyalists
88225,375,6,"146,2",4,1,1,6,Mid-Value,Potential Loyalists
88226,849,3,"254,15",3,1,1,5,Low-Value,At Risk Customers
88228,1707,2,"82,25",1,1,1,3,Low-Value,Lost
88229,185,2,"38,5",5,1,1,7,Mid-Value,Potential Loyalists
88231,1265,2,"99,89999999999999",2,1,1,4,Low-Value,Can't Lose
88232,403,4,"195,0",4,1,1,6,Mid-Value,Potential Loyalists
88234,1477,1,"61,6",1,1,1,3,Low-Value,Lost
88236,142,1,"44,9",5,1,1,7,Mid-Value,Potential Loyalists
88237,434,2,"18,549999999999997",4,1,1,6,Mid-Value,Potential Loyalists
88238,1410,1,"19,5",2,1,1,4,Low-Value,Can't Lose
88240,573,4,"1083,7",4,1,2,7,Mid-Value,Potential Loyalists
88243,490,4,"311,3",4,1,1,6,Mid-Value,Potential Loyalists
88244,195,3,"45,599999999999994",5,1,1,7,Mid-Value,Potential Loyalists
88245,527,2,"479,4",4,1,1,6,Mid-Value,Potential Loyalists
88248,376,5,"394,09999999999997",4,1,1,6,Mid-Value,Potential Loyalists
88249,384,1,"24,2",4,1,1,6,Mid-Value,Potential Loyalists
88250,792,3,"71,89999999999999",3,1,1,5,Low-Value,At Risk Customers
88251,581,3,"204,39999999999998",4,1,1,6,Mid-Value,Potential Loyalists
88252,1217,1,"90,7",2,1,1,4,Low-Value,Can't Lose
88254,376,3,"257,70000000000005",4,1,1,6,Mid-Value,Potential Loyalists
88258,251,5,"125,0",5,1,1,7,Mid-Value,Potential Loyalists
88259,476,2,"168,25",4,1,1,6,Mid-Value,Potential Loyalists
88260,711,1,"17,25",4,1,1,6,Mid-Value,Potential Loyalists
88261,183,2,"102,55",5,1,1,7,Mid-Value,Potential Loyalists
88262,68,2,"68,25",5,1,1,7,Mid-Value,Potential Loyalists
88264,323,1,"43,4",5,1,1,7,Mid-Value,Potential Loyalists
88266,297,2,"130,15",5,1,1,7,Mid-Value,Potential Loyalists
88268,955,1,"6,6",3,1,1,5,Low-Value,At Risk Customers
88270,99,6,"616,7",5,1,1,7,Mid-Value,Potential Loyalists
88273,1242,1,"31,45",2,1,1,4,Low-Value,Can't Lose
88274,219,5,"693,1999999999999",5,1,2,8,High-Value,Potential Loyalists
88275,222,1,"398,0",5,1,1,7,Mid-Value,Potential Loyalists
88276,379,3,"198,65",4,1,1,6,Mid-Value,Potential Loyalists
88277,541,1,"32,3",4,1,1,6,Mid-Value,Potential Loyalists
88278,268,2,"221,35",5,1,1,7,Mid-Value,Potential Loyalists
88279,1075,1,"4,3",3,1,1,5,Low-Value,At Risk Customers
88282,431,3,"8,55",4,1,1,6,Mid-Value,Potential Loyalists
88283,490,10,"427,1",4,2,1,7,Mid-Value,Potential Loyalists
88284,284,3,"124,10000000000001",5,1,1,7,Mid-Value,Potential Loyalists
88285,864,1,"174,75",3,1,1,5,Low-Value,At Risk Customers
88286,1270,1,"133,0",2,1,1,4,Low-Value,Can't Lose
88292,1592,2,"77,0",1,1,1,3,Low-Value,Lost
88294,407,3,"74,5",4,1,1,6,Mid-Value,Potential Loyalists
88296,959,2,"152,15",3,1,1,5,Low-Value,At Risk Customers
88299,550,3,"246,35000000000002",4,1,1,6,Mid-Value,Potential Loyalists
88301,1591,1,"482,0",1,1,1,3,Low-Value,Lost
88302,18,4,"176,45000000000002",5,1,1,7,Mid-Value,Potential Loyalists
88303,1036,2,"238,75",3,1,1,5,Low-Value,At Risk Customers
88304,4,2,"348,70000000000005",5,1,1,7,Mid-Value,Potential Loyalists
88305,895,1,"84,1",3,1,1,5,Low-Value,At Risk Customers
88309,233,2,"658,15",5,1,1,7,Mid-Value,Potential Loyalists
88313,972,1,"20,9",3,1,1,5,Low-Value,At Risk Customers
88314,44,1,"14,8",5,1,1,7,Mid-Value,Potential Loyalists
88315,115,9,"200,70000000000002",5,2,1,8,High-Value,Potential Loyalists
88316,967,1,"31,0",3,1,1,5,Low-Value,At Risk Customers
88317,454,2,"37,85",4,1,1,6,Mid-Value,Potential Loyalists
88320,1065,1,"98,45",3,1,1,5,Low-Value,At Risk Customers
88321,336,10,"478,54999999999995",5,2,1,8,High-Value,Potential Loyalists
88323,327,1,"27,2",5,1,1,7,Mid-Value,Potential Loyalists
88325,323,2,"809,1",5,1,2,8,High-Value,Potential Loyalists
88326,721,3,"123,8",4,1,1,6,Mid-Value,Potential Loyalists
88327,222,3,"66,45",5,1,1,7,Mid-Value,Potential Loyalists
88328,974,1,"29,849999999999998",3,1,1,5,Low-Value,At Risk Customers
88329,196,6,"239,3",5,1,1,7,Mid-Value,Potential Loyalists
88331,746,8,"518,9499999999999",3,2,1,6,Mid-Value,Potential Loyalists
88334,1785,1,"19,1",1,1,1,3,Low-Value,Lost
88335,753,3,"74,45",3,1,1,5,Low-Value,At Risk Customers
88336,3,2,"102,35",5,1,1,7,Mid-Value,Potential Loyalists
88337,1645,1,"56,5",1,1,1,3,Low-Value,Lost
88338,700,3,"498,65",4,1,1,6,Mid-Value,Potential Loyalists
88339,459,2,"21,3",4,1,1,6,Mid-Value,Potential Loyalists
88340,390,2,"240,35",4,1,1,6,Mid-Value,Potential Loyalists
88342,158,2,"90,70000000000002",5,1,1,7,Mid-Value,Potential Loyalists
88343,218,1,"37,650000000000006",5,1,1,7,Mid-Value,Potential Loyalists
88344,1011,1,"80,9",3,1,1,5,Low-Value,At Risk Customers
88346,601,2,"38,900000000000006",4,1,1,6,Mid-Value,Potential Loyalists
88348,233,1,"14,8",5,1,1,7,Mid-Value,Potential Loyalists
88349,830,2,"58,1",3,1,1,5,Low-Value,At Risk Customers
88352,89,2,"130,29999999999998",5,1,1,7,Mid-Value,Potential Loyalists
88353,274,1,"36,4",5,1,1,7,Mid-Value,Potential Loyalists
88354,424,2,"54,15",4,1,1,6,Mid-Value,Potential Loyalists
88356,791,12,"490,79999999999995",3,3,1,7,Mid-Value,Potential Loyalists
88358,733,2,"93,2",3,1,1,5,Low-Value,At Risk Customers
88359,243,2,"44,05",5,1,1,7,Mid-Value,Potential Loyalists
88361,284,2,"148,35",5,1,1,7,Mid-Value,Potential Loyalists
88363,355,3,"56,0",5,1,1,7,Mid-Value,Potential Loyalists
88364,141,2,"177,0",5,1,1,7,Mid-Value,Potential Loyalists
88366,824,5,"223,15",3,1,1,5,Low-Value,At Risk Customers
88367,341,5,"175,65",5,1,1,7,Mid-Value,Potential Loyalists
88368,374,3,"212,2",4,1,1,6,Mid-Value,Potential Loyalists
88370,692,2,"41,2",4,1,1,6,Mid-Value,Potential Loyalists
88371,997,1,"276,2",3,1,1,5,Low-Value,At Risk Customers
88373,7,4,"377,9",5,1,1,7,Mid-Value,Potential Loyalists
88374,227,3,"53,449999999999996",5,1,1,7,Mid-Value,Potential Loyalists
88375,1279,2,"370,84999999999997",2,1,1,4,Low-Value,Can't Lose
88376,775,5,"229,2",3,1,1,5,Low-Value,At Risk Customers
88377,1116,1,"37,8",2,1,1,4,Low-Value,Can't Lose
88379,1436,1,"89,55",2,1,1,4,Low-Value,Can't Lose
88380,703,3,"77,35",4,1,1,6,Mid-Value,Potential Loyalists
88381,1337,1,"32,55",2,1,1,4,Low-Value,Can't Lose
88382,1295,1,"53,7",2,1,1,4,Low-Value,Can't Lose
88384,332,3,"144,79999999999998",5,1,1,7,Mid-Value,Potential Loyalists
88385,228,10,"872,45",5,2,2,9,High-Value,Champions
88387,223,1,"26,65",5,1,1,7,Mid-Value,Potential Loyalists
88388,862,1,"9,1",3,1,1,5,Low-Value,At Risk Customers
88389,201,4,"53,050000000000004",5,1,1,7,Mid-Value,Potential Loyalists
88392,12,8,"382,25",5,2,1,8,High-Value,Potential Loyalists
88393,8,8,"870,4",5,2,2,9,High-Value,Champions
88394,336,3,"143,5",5,1,1,7,Mid-Value,Potential Loyalists
88395,214,1,"8,35",5,1,1,7,Mid-Value,Potential Loyalists
88396,398,3,"168,85",4,1,1,6,Mid-Value,Potential Loyalists
88397,108,1,"20,0",5,1,1,7,Mid-Value,Potential Loyalists
88398,534,7,"523,6999999999999",4,2,1,7,Mid-Value,Potential Loyalists
88399,550,2,"222,0",4,1,1,6,Mid-Value,Potential Loyalists
88401,414,4,"312,65",4,1,1,6,Mid-Value,Potential Loyalists
88405,293,3,"50,9",5,1,1,7,Mid-Value,Potential Loyalists
88406,746,1,"512,9",3,1,1,5,Low-Value,At Risk Customers
88409,702,2,"281,24999999999994",4,1,1,6,Mid-Value,Potential Loyalists
88410,113,3,"99,05",5,1,1,7,Mid-Value,Potential Loyalists
88411,340,2,"130,5",5,1,1,7,Mid-Value,Potential Loyalists
88412,849,6,"263,85",3,1,1,5,Low-Value,At Risk Customers
88413,591,2,"28,549999999999997",4,1,1,6,Mid-Value,Potential Loyalists
88414,164,2,"127,05",5,1,1,7,Mid-Value,Potential Loyalists
88415,1147,3,"889,5000000000001",2,1,2,5,Low-Value,At Risk Customers
88416,839,2,"106,35",3,1,1,5,Low-Value,At Risk Customers
88418,12,5,"252,2",5,1,1,7,Mid-Value,Potential Loyalists
88420,603,1,"18,8",4,1,1,6,Mid-Value,Potential Loyalists
88421,325,3,"591,35",5,1,1,7,Mid-Value,Potential Loyalists
88422,45,6,"177,7",5,1,1,7,Mid-Value,Potential Loyalists
88423,664,1,"14,4",4,1,1,6,Mid-Value,Potential Loyalists
88424,1076,1,"34,5",3,1,1,5,Low-Value,At Risk Customers
88425,1454,2,"115,35",2,1,1,4,Low-Value,Can't Lose
88426,303,6,"394,15",5,1,1,7,Mid-Value,Potential Loyalists
88427,589,4,"165,95",4,1,1,6,Mid-Value,Potential Loyalists
88428,11,4,"404,8",5,1,1,7,Mid-Value,Potential Loyalists
88429,731,1,"217,79999999999998",3,1,1,5,Low-Value,At Risk Customers
88430,1637,1,"33,3",1,1,1,3,Low-Value,Lost
88431,207,5,"146,45000000000002",5,1,1,7,Mid-Value,Potential Loyalists
88432,695,1,"16,75",4,1,1,6,Mid-Value,Potential Loyalists
88433,637,2,"43,4",4,1,1,6,Mid-Value,Potential Loyalists
88437,389,1,"82,2",4,1,1,6,Mid-Value,Potential Loyalists
88440,852,1,"48,25",3,1,1,5,Low-Value,At Risk Customers
88443,1072,1,"24,7",3,1,1,5,Low-Value,At Risk Customers
88445,124,1,"384,7",5,1,1,7,Mid-Value,Potential Loyalists
88447,740,3,"245,8",3,1,1,5,Low-Value,At Risk Customers
88448,787,5,"252,35",3,1,1,5,Low-Value,At Risk Customers
88449,200,1,"15,2",5,1,1,7,Mid-Value,Potential Loyalists
88451,29,3,"81,75",5,1,1,7,Mid-Value,Potential Loyalists
88452,700,1,"20,45",4,1,1,6,Mid-Value,Potential Loyalists
88454,733,4,"468,69999999999993",3,1,1,5,Low-Value,At Risk Customers
88456,949,2,"64,7",3,1,1,5,Low-Value,At Risk Customers
88458,1163,15,"625,8",2,3,1,6,Mid-Value,Potential Loyalists
88459,833,1,"41,65",3,1,1,5,Low-Value,At Risk Customers
88460,162,5,"190,45000000000002",5,1,1,7,Mid-Value,Potential Loyalists
88461,1185,2,"125,0",2,1,1,4,Low-Value,Can't Lose
88464,1342,1,"11,95",2,1,1,4,Low-Value,Can't Lose
88465,388,4,"202,0",4,1,1,6,Mid-Value,Potential Loyalists
88467,25,4,"160,85",5,1,1,7,Mid-Value,Potential Loyalists
88468,137,3,"200,0",5,1,1,7,Mid-Value,Potential Loyalists
88469,46,3,"130,15",5,1,1,7,Mid-Value,Potential Loyalists
88472,869,3,"150,5",3,1,1,5,Low-Value,At Risk Customers
88474,378,1,"66,1",4,1,1,6,Mid-Value,Potential Loyalists
88477,231,4,"241,95",5,1,1,7,Mid-Value,Potential Loyalists
88478,681,4,"224,15",4,1,1,6,Mid-Value,Potential Loyalists
88479,384,3,"278,7",4,1,1,6,Mid-Value,Potential Loyalists
88480,1,1,"393,2",5,1,1,7,Mid-Value,Potential Loyalists
88481,165,1,"27,450000000000003",5,1,1,7,Mid-Value,Potential Loyalists
88482,232,1,"13,4",5,1,1,7,Mid-Value,Potential Loyalists
88484,836,4,"66,7",3,1,1,5,Low-Value,At Risk Customers
88486,2,3,"347,24999999999994",5,1,1,7,Mid-Value,Potential Loyalists
88488,1123,1,"26,0",2,1,1,4,Low-Value,Can't Lose
88490,117,4,"142,65",5,1,1,7,Mid-Value,Potential Loyalists
88491,818,1,"14,1",3,1,1,5,Low-Value,At Risk Customers
88492,9,2,"76,6",5,1,1,7,Mid-Value,Potential Loyalists
88494,53,6,"568,05",5,1,1,7,Mid-Value,Potential Loyalists
88495,50,1,"20,0",5,1,1,7,Mid-Value,Potential Loyalists
88496,159,1,"85,15",5,1,1,7,Mid-Value,Potential Loyalists
88498,682,1,"16,799999999999997",4,1,1,6,Mid-Value,Potential Loyalists
88499,172,8,"653,25",5,2,1,8,High-Value,Potential Loyalists
88500,228,8,"420,0",5,2,1,8,High-Value,Potential Loyalists
88503,1246,1,"58,050000000000004",2,1,1,4,Low-Value,Can't Lose
88504,151,2,"94,35",5,1,1,7,Mid-Value,Potential Loyalists
88505,707,2,"86,1",4,1,1,6,Mid-Value,Potential Loyalists
88506,660,3,"92,25",4,1,1,6,Mid-Value,Potential Loyalists
88508,737,1,"103,64999999999999",3,1,1,5,Low-Value,At Risk Customers
88510,1198,1,"83,4",2,1,1,4,Low-Value,Can't Lose
88511,79,3,"94,35",5,1,1,7,Mid-Value,Potential Loyalists
88513,68,5,"258,5",5,1,1,7,Mid-Value,Potential Loyalists
88514,348,4,"247,70000000000002",5,1,1,7,Mid-Value,Potential Loyalists
88518,152,4,"430,4",5,1,1,7,Mid-Value,Potential Loyalists
88519,754,2,"31,9",3,1,1,5,Low-Value,At Risk Customers
88521,410,2,"29,75",4,1,1,6,Mid-Value,Potential Loyalists
88525,470,4,"293,1",4,1,1,6,Mid-Value,Potential Loyalists
88529,140,3,"230,35000000000002",5,1,1,7,Mid-Value,Potential Loyalists
88530,426,2,"186,95",4,1,1,6,Mid-Value,Potential Loyalists
88531,715,1,"7,95",4,1,1,6,Mid-Value,Potential Loyalists
88534,1048,1,"34,8",3,1,1,5,Low-Value,At Risk Customers
88535,296,1,"33,05",5,1,1,7,Mid-Value,Potential Loyalists
88538,69,2,"112,44999999999999",5,1,1,7,Mid-Value,Potential Loyalists
88541,172,3,"839,6999999999999",5,1,2,8,High-Value,Potential Loyalists
88543,1198,2,"76,39999999999999",2,1,1,4,Low-Value,Can't Lose
88544,77,8,"440,6",5,2,1,8,High-Value,Potential Loyalists
88545,32,2,"77,6",5,1,1,7,Mid-Value,Potential Loyalists
88546,1131,1,"135,0",2,1,1,4,Low-Value,Can't Lose
88548,105,13,"781,25",5,3,2,10,High-Value,Champions
88549,100,8,"535,05",5,2,1,8,High-Value,Potential Loyalists
88550,45,5,"186,5",5,1,1,7,Mid-Value,Potential Loyalists
88551,273,4,"68,69999999999999",5,1,1,7,Mid-Value,Potential Loyalists
88553,745,2,"35,2",3,1,1,5,Low-Value,At Risk Customers
88556,188,4,"218,89999999999998",5,1,1,7,Mid-Value,Potential Loyalists
88557,587,1,"7,65",4,1,1,6,Mid-Value,Potential Loyalists
88558,237,7,"272,90000000000003",5,2,1,8,High-Value,Potential Loyalists
88559,1050,4,"494,35",3,1,1,5,Low-Value,At Risk Customers
88560,692,2,"37,2",4,1,1,6,Mid-Value,Potential Loyalists
88562,1515,1,"13,15",1,1,1,3,Low-Value,Lost
88563,4,10,"476,45000000000005",5,2,1,8,High-Value,Potential Loyalists
88564,793,4,"329,9",3,1,1,5,Low-Value,At Risk Customers
88565,1362,4,"209,2",2,1,1,4,Low-Value,Can't Lose
88567,760,1,"42,3",3,1,1,5,Low-Value,At Risk Customers
88569,575,4,"268,05",4,1,1,6,Mid-Value,Potential Loyalists
88574,518,7,"637,35",4,2,1,7,Mid-Value,Potential Loyalists
88575,159,3,"167,9",5,1,1,7,Mid-Value,Potential Loyalists
88576,880,1,"5,5",3,1,1,5,Low-Value,At Risk Customers
88577,566,3,"479,65",4,1,1,6,Mid-Value,Potential Loyalists
88583,103,3,"381,4",5,1,1,7,Mid-Value,Potential Loyalists
88584,420,1,"15,6",4,1,1,6,Mid-Value,Potential Loyalists
88585,80,3,"395,54999999999995",5,1,1,7,Mid-Value,Potential Loyalists
88586,1515,1,"13,45",1,1,1,3,Low-Value,Lost
88587,1703,2,"49,0",1,1,1,3,Low-Value,Lost
88589,443,4,"63,85",4,1,1,6,Mid-Value,Potential Loyalists
88590,1562,3,"146,55",1,1,1,3,Low-Value,Lost
88594,66,5,"396,5",5,1,1,7,Mid-Value,Potential Loyalists
88595,340,6,"197,9",5,1,1,7,Mid-Value,Potential Loyalists
88596,151,3,"90,4",5,1,1,7,Mid-Value,Potential Loyalists
88597,780,2,"338,34999999999997",3,1,1,5,Low-Value,At Risk Customers
88599,235,3,"71,15",5,1,1,7,Mid-Value,Potential Loyalists
88600,36,3,"153,4",5,1,1,7,Mid-Value,Potential Loyalists
88602,32,7,"1238,35",5,2,2,9,High-Value,Champions
88606,544,2,"55,4",4,1,1,6,Mid-Value,Potential Loyalists
88608,180,3,"88,30000000000001",5,1,1,7,Mid-Value,Potential Loyalists
88609,140,4,"66,25",5,1,1,7,Mid-Value,Potential Loyalists
88611,24,2,"202,64999999999998",5,1,1,7,Mid-Value,Potential Loyalists
88615,1257,1,"96,8",2,1,1,4,Low-Value,Can't Lose
88616,403,1,"19,75",4,1,1,6,Mid-Value,Potential Loyalists
88617,163,1,"47,75",5,1,1,7,Mid-Value,Potential Loyalists
88620,14,7,"271,9",5,2,1,8,High-Value,Potential Loyalists
88621,243,8,"665,8000000000001",5,2,2,9,High-Value,Champions
88622,202,8,"695,9499999999999",5,2,2,9,High-Value,Champions
88623,882,3,"202,7",3,1,1,5,Low-Value,At Risk Customers
88624,252,3,"97,44999999999999",5,1,1,7,Mid-Value,Potential Loyalists
88626,358,4,"107,95",5,1,1,7,Mid-Value,Potential Loyalists
88627,115,5,"156,85",5,1,1,7,Mid-Value,Potential Loyalists
88628,774,4,"249,85000000000002",3,1,1,5,Low-Value,At Risk Customers
88630,339,3,"258,15",5,1,1,7,Mid-Value,Potential Loyalists
88633,311,4,"209,9",5,1,1,7,Mid-Value,Potential Loyalists
88635,814,3,"91,4",3,1,1,5,Low-Value,At Risk Customers
88636,428,1,"2,65",4,1,1,6,Mid-Value,Potential Loyalists
88637,245,6,"378,5",5,1,1,7,Mid-Value,Potential Loyalists
88639,528,2,"138,15",4,1,1,6,Mid-Value,Potential Loyalists
88642,781,5,"481,2",3,1,1,5,Low-Value,At Risk Customers
88644,650,1,"58,9",4,1,1,6,Mid-Value,Potential Loyalists
88645,840,2,"434,55",3,1,1,5,Low-Value,At Risk Customers
88647,1486,3,"420,45",1,1,1,3,Low-Value,Lost
88648,1735,1,"19,15",1,1,1,3,Low-Value,Lost
88649,1251,1,"34,5",2,1,1,4,Low-Value,Can't Lose
88651,20,2,"87,30000000000001",5,1,1,7,Mid-Value,Potential Loyalists
88653,992,4,"402,65",3,1,1,5,Low-Value,At Risk Customers
88654,1592,1,"243,0",1,1,1,3,Low-Value,Lost
88657,352,4,"113,39999999999999",5,1,1,7,Mid-Value,Potential Loyalists
88661,622,5,"241,35000000000002",4,1,1,6,Mid-Value,Potential Loyalists
88663,497,3,"184,8",4,1,1,6,Mid-Value,Potential Loyalists
88665,542,2,"98,7",4,1,1,6,Mid-Value,Potential Loyalists
88667,77,2,"41,35",5,1,1,7,Mid-Value,Potential Loyalists
88668,245,1,"110,65",5,1,1,7,Mid-Value,Potential Loyalists
88669,254,2,"42,900000000000006",5,1,1,7,Mid-Value,Potential Loyalists
88674,377,5,"128,3",4,1,1,6,Mid-Value,Potential Loyalists
88675,1522,1,"22,4",1,1,1,3,Low-Value,Lost
88679,635,1,"58,6",4,1,1,6,Mid-Value,Potential Loyalists
88681,390,12,"694,4",4,3,2,9,High-Value,Champions
88683,53,5,"226,29999999999998",5,1,1,7,Mid-Value,Potential Loyalists
88684,528,1,"21,4",4,1,1,6,Mid-Value,Potential Loyalists
88685,654,9,"615,75",4,2,1,7,Mid-Value,Potential Loyalists
88686,62,7,"1181,3",5,2,2,9,High-Value,Champions
88687,127,2,"143,04999999999998",5,1,1,7,Mid-Value,Potential Loyalists
88688,1006,1,"41,0",3,1,1,5,Low-Value,At Risk Customers
88689,169,3,"201,35",5,1,1,7,Mid-Value,Potential Loyalists
88690,752,3,"209,1",3,1,1,5,Low-Value,At Risk Customers
88691,451,3,"139,1",4,1,1,6,Mid-Value,Potential Loyalists
88692,53,4,"225,05",5,1,1,7,Mid-Value,Potential Loyalists
88693,655,2,"50,2",4,1,1,6,Mid-Value,Potential Loyalists
88694,312,1,"78,5",5,1,1,7,Mid-Value,Potential Loyalists
88695,160,1,"56,7",5,1,1,7,Mid-Value,Potential Loyalists
88696,986,1,"42,6",3,1,1,5,Low-Value,At Risk Customers
88698,653,8,"558,8",4,2,1,7,Mid-Value,Potential Loyalists
88707,69,1,"41,65",5,1,1,7,Mid-Value,Potential Loyalists
88708,210,3,"225,85000000000002",5,1,1,7,Mid-Value,Potential Loyalists
88709,66,8,"431,3",5,2,1,8,High-Value,Potential Loyalists
88713,703,1,"110,2",4,1,1,6,Mid-Value,Potential Loyalists
88714,14,7,"160,35",5,2,1,8,High-Value,Potential Loyalists
88715,96,7,"451,5",5,2,1,8,High-Value,Potential Loyalists
88718,591,1,"49,4",4,1,1,6,Mid-Value,Potential Loyalists
88722,379,2,"43,800000000000004",4,1,1,6,Mid-Value,Potential Loyalists
88724,523,2,"94,85",4,1,1,6,Mid-Value,Potential Loyalists
88725,1243,3,"162,7",2,1,1,4,Low-Value,Can't Lose
88729,2,6,"323,85",5,1,1,7,Mid-Value,Potential Loyalists
88730,238,4,"155,25",5,1,1,7,Mid-Value,Potential Loyalists
88731,166,4,"304,5",5,1,1,7,Mid-Value,Potential Loyalists
88732,1778,1,"20,85",1,1,1,3,Low-Value,Lost
88733,511,11,"500,25",4,2,1,7,Mid-Value,Potential Loyalists
88734,78,8,"646,3",5,2,1,8,High-Value,Potential Loyalists
88735,692,1,"20,3",4,1,1,6,Mid-Value,Potential Loyalists
88736,476,1,"73,4",4,1,1,6,Mid-Value,Potential Loyalists
88742,129,8,"692,5",5,2,2,9,High-Value,Champions
88745,17,4,"63,65",5,1,1,7,Mid-Value,Potential Loyalists
88746,30,6,"252,95",5,1,1,7,Mid-Value,Potential Loyalists
88751,746,3,"344,95",3,1,1,5,Low-Value,At Risk Customers
88752,1234,4,"412,2",2,1,1,4,Low-Value,Can't Lose
88753,1324,1,"9,95",2,1,1,4,Low-Value,Can't Lose
88754,241,2,"73,0",5,1,1,7,Mid-Value,Potential Loyalists
88757,33,10,"609,35",5,2,1,8,High-Value,Potential Loyalists
88758,527,4,"168,89999999999998",4,1,1,6,Mid-Value,Potential Loyalists
88759,108,3,"18,75",5,1,1,7,Mid-Value,Potential Loyalists
88761,1418,1,"29,05",2,1,1,4,Low-Value,Can't Lose
88762,18,12,"521,05",5,3,1,9,High-Value,Champions
88763,850,1,"6,35",3,1,1,5,Low-Value,At Risk Customers
88764,164,5,"208,05",5,1,1,7,Mid-Value,Potential Loyalists
88766,306,3,"67,4",5,1,1,7,Mid-Value,Potential Loyalists
88767,1105,2,"305,59999999999997",2,1,1,4,Low-Value,Can't Lose
88768,453,2,"323,0",4,1,1,6,Mid-Value,Potential Loyalists
88770,1612,1,"101,3",1,1,1,3,Low-Value,Lost
88771,262,2,"60,25",5,1,1,7,Mid-Value,Potential Loyalists
88773,57,8,"435,95",5,2,1,8,High-Value,Potential Loyalists
88774,769,10,"270,2",3,2,1,6,Mid-Value,Potential Loyalists
88777,847,3,"121,55",3,1,1,5,Low-Value,At Risk Customers
88779,785,3,"93,55",3,1,1,5,Low-Value,At Risk Customers
88780,144,1,"41,3",5,1,1,7,Mid-Value,Potential Loyalists
88783,175,2,"357,45000000000005",5,1,1,7,Mid-Value,Potential Loyalists
88784,501,2,"224,9",4,1,1,6,Mid-Value,Potential Loyalists
88785,57,2,"48,25",5,1,1,7,Mid-Value,Potential Loyalists
88786,542,1,"16,8",4,1,1,6,Mid-Value,Potential Loyalists
88787,365,3,"250,60000000000002",5,1,1,7,Mid-Value,Potential Loyalists
88789,990,2,"65,1",3,1,1,5,Low-Value,At Risk Customers
88790,734,5,"587,9",3,1,1,5,Low-Value,At Risk Customers
88792,107,3,"198,0",5,1,1,7,Mid-Value,Potential Loyalists
88793,183,10,"224,39999999999998",5,2,1,8,High-Value,Potential Loyalists
88794,274,6,"164,0",5,1,1,7,Mid-Value,Potential Loyalists
88797,755,5,"175,2",3,1,1,5,Low-Value,At Risk Customers
88798,939,1,"84,6",3,1,1,5,Low-Value,At Risk Customers
88802,752,7,"471,45",3,2,1,6,Mid-Value,Potential Loyalists
88804,32,5,"251,4",5,1,1,7,Mid-Value,Potential Loyalists
88805,1068,3,"145,3",3,1,1,5,Low-Value,At Risk Customers
88806,20,9,"1052,75",5,2,2,9,High-Value,Champions
88809,65,4,"66,6",5,1,1,7,Mid-Value,Potential Loyalists
88812,19,3,"343,8",5,1,1,7,Mid-Value,Potential Loyalists
88814,191,9,"585,55",5,2,1,8,High-Value,Potential Loyalists
88815,266,2,"56,2",5,1,1,7,Mid-Value,Potential Loyalists
88816,15,2,"104,30000000000001",5,1,1,7,Mid-Value,Potential Loyalists
88818,970,1,"127,0",3,1,1,5,Low-Value,At Risk Customers
88819,124,5,"375,35",5,1,1,7,Mid-Value,Potential Loyalists
88823,1331,1,"12,95",2,1,1,4,Low-Value,Can't Lose
88824,959,2,"55,8",3,1,1,5,Low-Value,At Risk Customers
88828,261,3,"159,9",5,1,1,7,Mid-Value,Potential Loyalists
88829,1194,1,"103,8",2,1,1,4,Low-Value,Can't Lose
88830,455,2,"23,1",4,1,1,6,Mid-Value,Potential Loyalists
88832,977,2,"57,2",3,1,1,5,Low-Value,At Risk Customers
88834,1114,2,"81,75",2,1,1,4,Low-Value,Can't Lose
88837,340,4,"179,95",5,1,1,7,Mid-Value,Potential Loyalists
88840,343,9,"363,25",5,2,1,8,High-Value,Potential Loyalists
88841,17,6,"193,8",5,1,1,7,Mid-Value,Potential Loyalists
88842,501,4,"143,15",4,1,1,6,Mid-Value,Potential Loyalists
88843,197,4,"206,04999999999998",5,1,1,7,Mid-Value,Potential Loyalists
88844,1117,3,"512,75",2,1,1,4,Low-Value,Can't Lose
88845,461,4,"375,5",4,1,1,6,Mid-Value,Potential Loyalists
88846,925,3,"560,0",3,1,1,5,Low-Value,At Risk Customers
88847,979,2,"284,0",3,1,1,5,Low-Value,At Risk Customers
88848,23,2,"53,0",5,1,1,7,Mid-Value,Potential Loyalists
88850,231,2,"62,7",5,1,1,7,Mid-Value,Potential Loyalists
88853,985,1,"66,7",3,1,1,5,Low-Value,At Risk Customers
88854,533,3,"150,2",4,1,1,6,Mid-Value,Potential Loyalists
88855,1156,1,"33,8",2,1,1,4,Low-Value,Can't Lose
88859,82,6,"139,4",5,1,1,7,Mid-Value,Potential Loyalists
88860,8,2,"141,1",5,1,1,7,Mid-Value,Potential Loyalists
88862,69,7,"463,9",5,2,1,8,High-Value,Potential Loyalists
88863,488,3,"28,9",4,1,1,6,Mid-Value,Potential Loyalists
88865,487,2,"232,5",4,1,1,6,Mid-Value,Potential Loyalists
88866,489,1,"58,6",4,1,1,6,Mid-Value,Potential Loyalists
88867,1414,2,"837,4",2,1,2,5,Low-Value,At Risk Customers
88869,1528,2,"69,25",1,1,1,3,Low-Value,Lost
88870,1139,1,"23,25",2,1,1,4,Low-Value,Can't Lose
88874,928,1,"70,3",3,1,1,5,Low-Value,At Risk Customers
88876,633,2,"150,85",4,1,1,6,Mid-Value,Potential Loyalists
88877,66,7,"273,85",5,2,1,8,High-Value,Potential Loyalists
88880,94,8,"526,25",5,2,1,8,High-Value,Potential Loyalists
88885,60,5,"296,4",5,1,1,7,Mid-Value,Potential Loyalists
88886,103,5,"274,35",5,1,1,7,Mid-Value,Potential Loyalists
88887,998,1,"11,55",3,1,1,5,Low-Value,At Risk Customers
88888,1598,1,"23,4",1,1,1,3,Low-Value,Lost
88889,1174,4,"310,95000000000005",2,1,1,4,Low-Value,Can't Lose
88892,397,7,"164,5",4,2,1,7,Mid-Value,Potential Loyalists
88894,270,8,"926,05",5,2,2,9,High-Value,Champions
88895,48,5,"360,2",5,1,1,7,Mid-Value,Potential Loyalists
88896,1419,2,"47,75",2,1,1,4,Low-Value,Can't Lose
88900,52,4,"174,5",5,1,1,7,Mid-Value,Potential Loyalists
88904,1602,2,"53,6",1,1,1,3,Low-Value,Lost
88905,525,2,"149,85",4,1,1,6,Mid-Value,Potential Loyalists
88906,112,8,"192,15",5,2,1,8,High-Value,Potential Loyalists
88907,25,8,"428,45",5,2,1,8,High-Value,Potential Loyalists
88909,1160,3,"103,85",2,1,1,4,Low-Value,Can't Lose
88911,1265,1,"60,7",2,1,1,4,Low-Value,Can't Lose
88912,383,1,"12,9",4,1,1,6,Mid-Value,Potential Loyalists
88913,1672,1,"57,5",1,1,1,3,Low-Value,Lost
88914,290,1,"13,0",5,1,1,7,Mid-Value,Potential Loyalists
88915,1708,1,"8,55",1,1,1,3,Low-Value,Lost
88917,1118,4,"430,95000000000005",2,1,1,4,Low-Value,Can't Lose
88920,139,2,"269,5",5,1,1,7,Mid-Value,Potential Loyalists
88921,649,4,"280,1",4,1,1,6,Mid-Value,Potential Loyalists
88925,8,10,"1006,7",5,2,2,9,High-Value,Champions
88927,929,2,"185,85000000000002",3,1,1,5,Low-Value,At Risk Customers
88928,142,5,"136,2",5,1,1,7,Mid-Value,Potential Loyalists
88930,711,1,"28,35",4,1,1,6,Mid-Value,Potential Loyalists
88931,1623,1,"87,4",1,1,1,3,Low-Value,Lost
88933,582,5,"357,79999999999995",4,1,1,6,Mid-Value,Potential Loyalists
88936,1110,2,"56,6",2,1,1,4,Low-Value,Can't Lose
88937,53,3,"114,15",5,1,1,7,Mid-Value,Potential Loyalists
88942,33,5,"388,65000000000003",5,1,1,7,Mid-Value,Potential Loyalists
88943,11,2,"71,25",5,1,1,7,Mid-Value,Potential Loyalists
88945,802,2,"379,90000000000003",3,1,1,5,Low-Value,At Risk Customers
88946,277,4,"172,65",5,1,1,7,Mid-Value,Potential Loyalists
88949,170,3,"159,9",5,1,1,7,Mid-Value,Potential Loyalists
88950,622,1,"30,55",4,1,1,6,Mid-Value,Potential Loyalists
88951,140,2,"100,75",5,1,1,7,Mid-Value,Potential Loyalists
88952,355,3,"165,0",5,1,1,7,Mid-Value,Potential Loyalists
88953,222,2,"52,95",5,1,1,7,Mid-Value,Potential Loyalists
88954,143,3,"68,30000000000001",5,1,1,7,Mid-Value,Potential Loyalists
88955,671,2,"54,8",4,1,1,6,Mid-Value,Potential Loyalists
88956,187,3,"184,45",5,1,1,7,Mid-Value,Potential Loyalists
88958,62,4,"280,25",5,1,1,7,Mid-Value,Potential Loyalists
88959,593,2,"469,4",4,1,1,6,Mid-Value,Potential Loyalists
88960,801,4,"158,95",3,1,1,5,Low-Value,At Risk Customers
88961,388,1,"5,8",4,1,1,6,Mid-Value,Potential Loyalists
88964,567,6,"367,6",4,1,1,6,Mid-Value,Potential Loyalists
88966,880,7,"581,85",3,2,1,6,Mid-Value,Potential Loyalists
88967,1280,1,"12,1",2,1,1,4,Low-Value,Can't Lose
88968,35,1,"247,15",5,1,1,7,Mid-Value,Potential Loyalists
88969,562,2,"58,05",4,1,1,6,Mid-Value,Potential Loyalists
88970,626,4,"144,75",4,1,1,6,Mid-Value,Potential Loyalists
88971,962,1,"45,5",3,1,1,5,Low-Value,At Risk Customers
88973,20,1,"199,0",5,1,1,7,Mid-Value,Potential Loyalists
88974,1035,1,"111,9",3,1,1,5,Low-Value,At Risk Customers
88975,722,5,"309,0",4,1,1,6,Mid-Value,Potential Loyalists
88976,69,2,"54,699999999999996",5,1,1,7,Mid-Value,Potential Loyalists
88983,1259,2,"38,75",2,1,1,4,Low-Value,Can't Lose
88984,396,11,"594,9499999999999",4,2,1,7,Mid-Value,Potential Loyalists
88985,1003,2,"70,8",3,1,1,5,Low-Value,At Risk Customers
88986,853,4,"189,5",3,1,1,5,Low-Value,At Risk Customers
88989,643,1,"20,0",4,1,1,6,Mid-Value,Potential Loyalists
88990,1287,2,"34,8",2,1,1,4,Low-Value,Can't Lose
88993,99,4,"147,89999999999998",5,1,1,7,Mid-Value,Potential Loyalists
88996,432,3,"211,85000000000002",4,1,1,6,Mid-Value,Potential Loyalists
89001,1138,4,"127,5",2,1,1,4,Low-Value,Can't Lose
89003,613,1,"10,5",4,1,1,6,Mid-Value,Potential Loyalists
89004,242,3,"150,9",5,1,1,7,Mid-Value,Potential Loyalists
89005,799,1,"205,9",3,1,1,5,Low-Value,At Risk Customers
89006,101,8,"422,75",5,2,1,8,High-Value,Potential Loyalists
89008,13,11,"696,05",5,2,2,9,High-Value,Champions
89009,66,3,"234,45",5,1,1,7,Mid-Value,Potential Loyalists
89011,1296,2,"191,35",2,1,1,4,Low-Value,Can't Lose
89012,1337,2,"117,39999999999999",2,1,1,4,Low-Value,Can't Lose
89013,194,5,"1453,35",5,1,3,9,High-Value,Champions
89014,623,4,"225,39999999999998",4,1,1,6,Mid-Value,Potential Loyalists
89015,394,3,"78,9",4,1,1,6,Mid-Value,Potential Loyalists
89016,827,5,"180,9",3,1,1,5,Low-Value,At Risk Customers
89017,362,5,"211,85",5,1,1,7,Mid-Value,Potential Loyalists
89019,14,1,"45,3",5,1,1,7,Mid-Value,Potential Loyalists
89020,1685,1,"46,8",1,1,1,3,Low-Value,Lost
89021,200,1,"36,8",5,1,1,7,Mid-Value,Potential Loyalists
89022,30,6,"183,10000000000002",5,1,1,7,Mid-Value,Potential Loyalists
89024,8,6,"222,9",5,1,1,7,Mid-Value,Potential Loyalists
89025,1109,2,"106,55",2,1,1,4,Low-Value,Can't Lose
89028,62,6,"210,85000000000002",5,1,1,7,Mid-Value,Potential Loyalists
89030,17,3,"94,54999999999998",5,1,1,7,Mid-Value,Potential Loyalists
89031,166,8,"397,15000000000003",5,2,1,8,High-Value,Potential Loyalists
89032,1277,3,"233,20000000000002",2,1,1,4,Low-Value,Can't Lose
89033,336,4,"330,5",5,1,1,7,Mid-Value,Potential Loyalists
89034,972,1,"89,65",3,1,1,5,Low-Value,At Risk Customers
89035,5,4,"88,0",5,1,1,7,Mid-Value,Potential Loyalists
89037,4,6,"606,5",5,1,1,7,Mid-Value,Potential Loyalists
89038,1432,1,"21,2",2,1,1,4,Low-Value,Can't Lose
89040,5,2,"267,9",5,1,1,7,Mid-Value,Potential Loyalists
89041,553,2,"190,39999999999998",4,1,1,6,Mid-Value,Potential Loyalists
89042,88,4,"163,35",5,1,1,7,Mid-Value,Potential Loyalists
89046,1063,2,"249,05",3,1,1,5,Low-Value,At Risk Customers
89049,1813,1,"34,1",1,1,1,3,Low-Value,Lost
89051,910,2,"51,5",3,1,1,5,Low-Value,At Risk Customers
89053,1425,2,"65,80000000000001",2,1,1,4,Low-Value,Can't Lose
89054,29,7,"913,85",5,2,2,9,High-Value,Champions
89055,28,1,"11,5",5,1,1,7,Mid-Value,Potential Loyalists
89057,64,2,"26,25",5,1,1,7,Mid-Value,Potential Loyalists
89060,133,2,"117,9",5,1,1,7,Mid-Value,Potential Loyalists
89061,137,4,"295,90000000000003",5,1,1,7,Mid-Value,Potential Loyalists
89062,38,5,"1086,65",5,1,2,8,High-Value,Potential Loyalists
89063,1446,1,"24,5",2,1,1,4,Low-Value,Can't Lose
89064,253,1,"23,75",5,1,1,7,Mid-Value,Potential Loyalists
89065,1288,1,"69,0",2,1,1,4,Low-Value,Can't Lose
89068,909,1,"14,549999999999999",3,1,1,5,Low-Value,At Risk Customers
89071,1264,2,"191,3",2,1,1,4,Low-Value,Can't Lose
89073,1588,1,"51,0",1,1,1,3,Low-Value,Lost
89074,184,5,"433,1",5,1,1,7,Mid-Value,Potential Loyalists
89077,533,2,"164,4",4,1,1,6,Mid-Value,Potential Loyalists
89081,1667,3,"101,45",1,1,1,3,Low-Value,Lost
89084,1102,1,"40,0",2,1,1,4,Low-Value,Can't Lose
89086,501,10,"646,4",4,2,1,7,Mid-Value,Potential Loyalists
89087,191,4,"212,04999999999998",5,1,1,7,Mid-Value,Potential Loyalists
89089,673,1,"54,7",4,1,1,6,Mid-Value,Potential Loyalists
89090,1417,1,"23,25",2,1,1,4,Low-Value,Can't Lose
89093,82,4,"169,1",5,1,1,7,Mid-Value,Potential Loyalists
89094,1803,1,"12,6",1,1,1,3,Low-Value,Lost
89095,502,2,"65,25",4,1,1,6,Mid-Value,Potential Loyalists
89096,636,3,"219,05",4,1,1,6,Mid-Value,Potential Loyalists
89097,1539,1,"30,25",1,1,1,3,Low-Value,Lost
89100,27,3,"191,35",5,1,1,7,Mid-Value,Potential Loyalists
89101,538,5,"607,4",4,1,1,6,Mid-Value,Potential Loyalists
89102,1002,2,"69,55",3,1,1,5,Low-Value,At Risk Customers
89103,64,4,"220,7",5,1,1,7,Mid-Value,Potential Loyalists
89109,311,7,"818,3",5,2,2,9,High-Value,Champions
89110,109,2,"148,0",5,1,1,7,Mid-Value,Potential Loyalists
89111,678,6,"395,40000000000003",4,1,1,6,Mid-Value,Potential Loyalists
89112,1111,1,"191,39999999999998",2,1,1,4,Low-Value,Can't Lose
89117,81,7,"465,05",5,2,1,8,High-Value,Potential Loyalists
89118,158,1,"70,0",5,1,1,7,Mid-Value,Potential Loyalists
89119,1665,1,"236,25",1,1,1,3,Low-Value,Lost
89122,233,2,"58,5",5,1,1,7,Mid-Value,Potential Loyalists
89126,1112,1,"7,2",2,1,1,4,Low-Value,Can't Lose
89128,12,2,"11,1",5,1,1,7,Mid-Value,Potential Loyalists
89129,157,1,"118,8",5,1,1,7,Mid-Value,Potential Loyalists
89130,987,4,"146,6",3,1,1,5,Low-Value,At Risk Customers
89132,741,1,"27,2",3,1,1,5,Low-Value,At Risk Customers
89134,434,2,"253,6",4,1,1,6,Mid-Value,Potential Loyalists
89136,90,7,"539,35",5,2,1,8,High-Value,Potential Loyalists
89137,62,9,"783,45",5,2,2,9,High-Value,Champions
89142,187,6,"517,9",5,1,1,7,Mid-Value,Potential Loyalists
89143,98,2,"67,1",5,1,1,7,Mid-Value,Potential Loyalists
89145,96,1,"72,6",5,1,1,7,Mid-Value,Potential Loyalists
89146,98,5,"459,90000000000003",5,1,1,7,Mid-Value,Potential Loyalists
89147,1063,3,"104,75",3,1,1,5,Low-Value,At Risk Customers
89148,648,3,"320,7",4,1,1,6,Mid-Value,Potential Loyalists
89153,620,3,"234,29999999999998",4,1,1,6,Mid-Value,Potential Loyalists
89154,167,5,"144,15",5,1,1,7,Mid-Value,Potential Loyalists
89156,1382,2,"87,8",2,1,1,4,Low-Value,Can't Lose
89157,62,2,"102,9",5,1,1,7,Mid-Value,Potential Loyalists
89158,1490,1,"8,7",1,1,1,3,Low-Value,Lost
89160,42,7,"248,0",5,2,1,8,High-Value,Potential Loyalists
89162,749,5,"164,2",3,1,1,5,Low-Value,At Risk Customers
89164,149,4,"162,1",5,1,1,7,Mid-Value,Potential Loyalists
89166,946,6,"280,4",3,1,1,5,Low-Value,At Risk Customers
89168,1774,1,"7,8",1,1,1,3,Low-Value,Lost
89169,1497,3,"228,9",1,1,1,3,Low-Value,Lost
89170,373,1,"39,8",4,1,1,6,Mid-Value,Potential Loyalists
89171,523,3,"168,5",4,1,1,6,Mid-Value,Potential Loyalists
89174,1064,1,"52,3",3,1,1,5,Low-Value,At Risk Customers
89175,782,3,"131,75",3,1,1,5,Low-Value,At Risk Customers
89176,537,1,"74,55",4,1,1,6,Mid-Value,Potential Loyalists
89177,142,11,"687,8",5,2,2,9,High-Value,Champions
89178,458,2,"13,549999999999999",4,1,1,6,Mid-Value,Potential Loyalists
89179,487,1,"107,85000000000001",4,1,1,6,Mid-Value,Potential Loyalists
89181,147,2,"118,3",5,1,1,7,Mid-Value,Potential Loyalists
89183,400,3,"89,35",4,1,1,6,Mid-Value,Potential Loyalists
89185,697,6,"177,0",4,1,1,6,Mid-Value,Potential Loyalists
89186,778,5,"1249,0",3,1,2,6,Mid-Value,Potential Loyalists
89187,379,1,"71,75",4,1,1,6,Mid-Value,Potential Loyalists
89190,804,4,"235,7",3,1,1,5,Low-Value,At Risk Customers
89191,70,5,"791,3999999999999",5,1,2,8,High-Value,Potential Loyalists
89192,193,2,"1025,55",5,1,2,8,High-Value,Potential Loyalists
89193,1805,1,"36,75",1,1,1,3,Low-Value,Lost
89196,5,5,"737,8499999999999",5,1,2,8,High-Value,Potential Loyalists
89197,1071,2,"37,65",3,1,1,5,Low-Value,At Risk Customers
89198,937,3,"355,65",3,1,1,5,Low-Value,At Risk Customers
89199,115,1,"18,45",5,1,1,7,Mid-Value,Potential Loyalists
89201,235,4,"110,75",5,1,1,7,Mid-Value,Potential Loyalists
89202,412,2,"67,5",4,1,1,6,Mid-Value,Potential Loyalists
89205,122,7,"213,04999999999998",5,2,1,8,High-Value,Potential Loyalists
89206,1074,3,"117,9",3,1,1,5,Low-Value,At Risk Customers
89207,35,6,"695,8",5,1,2,8,High-Value,Potential Loyalists
89208,485,3,"541,65",4,1,1,6,Mid-Value,Potential Loyalists
89209,1614,3,"288,29999999999995",1,1,1,3,Low-Value,Lost
89210,200,3,"93,15",5,1,1,7,Mid-Value,Potential Loyalists
89212,49,4,"152,6",5,1,1,7,Mid-Value,Potential Loyalists
89213,98,4,"179,45000000000002",5,1,1,7,Mid-Value,Potential Loyalists
89214,710,2,"57,65",4,1,1,6,Mid-Value,Potential Loyalists
89219,941,1,"226,9",3,1,1,5,Low-Value,At Risk Customers
89220,157,4,"165,45000000000002",5,1,1,7,Mid-Value,Potential Loyalists
89221,1278,1,"169,6",2,1,1,4,Low-Value,Can't Lose
89223,529,10,"468,15",4,2,1,7,Mid-Value,Potential Loyalists
89224,583,4,"104,3",4,1,1,6,Mid-Value,Potential Loyalists
89228,1264,2,"88,7",2,1,1,4,Low-Value,Can't Lose
89230,857,2,"86,3",3,1,1,5,Low-Value,At Risk Customers
89231,963,3,"134,35",3,1,1,5,Low-Value,At Risk Customers
89232,798,2,"118,0",3,1,1,5,Low-Value,At Risk Customers
89233,399,1,"20,95",4,1,1,6,Mid-Value,Potential Loyalists
89235,249,1,"59,4",5,1,1,7,Mid-Value,Potential Loyalists
89237,1019,2,"257,35",3,1,1,5,Low-Value,At Risk Customers
89238,48,7,"387,95",5,2,1,8,High-Value,Potential Loyalists
89240,913,2,"173,0",3,1,1,5,Low-Value,At Risk Customers
89241,472,4,"182,8",4,1,1,6,Mid-Value,Potential Loyalists
89242,761,7,"222,75",3,2,1,6,Mid-Value,Potential Loyalists
89243,1330,1,"142,64999999999998",2,1,1,4,Low-Value,Can't Lose
89244,366,4,"44,7",4,1,1,6,Mid-Value,Potential Loyalists
89248,597,1,"7,8",4,1,1,6,Mid-Value,Potential Loyalists
89249,795,2,"111,19999999999999",3,1,1,5,Low-Value,At Risk Customers
89252,538,3,"88,25",4,1,1,6,Mid-Value,Potential Loyalists
89253,126,7,"389,95",5,2,1,8,High-Value,Potential Loyalists
89256,852,1,"96,14999999999999",3,1,1,5,Low-Value,At Risk Customers
89257,64,2,"59,099999999999994",5,1,1,7,Mid-Value,Potential Loyalists
89258,46,4,"178,5",5,1,1,7,Mid-Value,Potential Loyalists
89259,832,2,"96,9",3,1,1,5,Low-Value,At Risk Customers
89260,419,2,"24,35",4,1,1,6,Mid-Value,Potential Loyalists
89263,155,1,"34,5",5,1,1,7,Mid-Value,Potential Loyalists
89264,1669,1,"16,2",1,1,1,3,Low-Value,Lost
89265,515,2,"144,59999999999997",4,1,1,6,Mid-Value,Potential Loyalists
89266,735,8,"415,0",3,2,1,6,Mid-Value,Potential Loyalists
89271,622,1,"90,4",4,1,1,6,Mid-Value,Potential Loyalists
89272,1178,1,"39,7",2,1,1,4,Low-Value,Can't Lose
89273,228,2,"87,1",5,1,1,7,Mid-Value,Potential Loyalists
89275,655,4,"542,9",4,1,1,6,Mid-Value,Potential Loyalists
89276,34,4,"282,95",5,1,1,7,Mid-Value,Potential Loyalists
89278,226,3,"214,75",5,1,1,7,Mid-Value,Potential Loyalists
89279,0,1,"28,7",5,1,1,7,Mid-Value,Potential Loyalists
89280,1293,2,"133,7",2,1,1,4,Low-Value,Can't Lose
89281,1297,1,"64,1",2,1,1,4,Low-Value,Can't Lose
89284,1653,1,"42,2",1,1,1,3,Low-Value,Lost
89288,13,4,"112,6",5,1,1,7,Mid-Value,Potential Loyalists
89289,1370,1,"6,6",2,1,1,4,Low-Value,Can't Lose
89290,396,2,"73,45",4,1,1,6,Mid-Value,Potential Loyalists
89291,1470,1,"251,7",1,1,1,3,Low-Value,Lost
89292,566,2,"92,0",4,1,1,6,Mid-Value,Potential Loyalists
89294,143,11,"859,4000000000001",5,2,2,9,High-Value,Champions
89295,494,1,"28,5",4,1,1,6,Mid-Value,Potential Loyalists
89296,22,3,"630,5",5,1,1,7,Mid-Value,Potential Loyalists
89297,106,6,"194,35000000000002",5,1,1,7,Mid-Value,Potential Loyalists
89299,854,3,"52,95",3,1,1,5,Low-Value,At Risk Customers
89300,568,1,"20,2",4,1,1,6,Mid-Value,Potential Loyalists
89301,1669,4,"73,05",1,1,1,3,Low-Value,Lost
89302,65,4,"297,2",5,1,1,7,Mid-Value,Potential Loyalists
89303,322,2,"165,79999999999998",5,1,1,7,Mid-Value,Potential Loyalists
89307,764,1,"54,9",3,1,1,5,Low-Value,At Risk Customers
89308,211,1,"5,5",5,1,1,7,Mid-Value,Potential Loyalists
89310,1709,1,"33,0",1,1,1,3,Low-Value,Lost
89311,381,4,"301,05",4,1,1,6,Mid-Value,Potential Loyalists
89314,885,1,"27,1",3,1,1,5,Low-Value,At Risk Customers
89315,17,12,"638,95",5,3,1,9,High-Value,Champions
89316,1616,1,"209,8",1,1,1,3,Low-Value,Lost
89317,52,8,"351,2",5,2,1,8,High-Value,Potential Loyalists
89318,983,1,"33,6",3,1,1,5,Low-Value,At Risk Customers
89320,1170,2,"84,05",2,1,1,4,Low-Value,Can't Lose
89322,94,4,"157,54999999999998",5,1,1,7,Mid-Value,Potential Loyalists
89324,567,4,"155,35000000000002",4,1,1,6,Mid-Value,Potential Loyalists
89326,1415,1,"400,5",2,1,1,4,Low-Value,Can't Lose
89328,104,3,"64,3",5,1,1,7,Mid-Value,Potential Loyalists
89331,132,3,"298,25",5,1,1,7,Mid-Value,Potential Loyalists
89333,128,4,"329,79999999999995",5,1,1,7,Mid-Value,Potential Loyalists
89336,852,5,"492,4",3,1,1,5,Low-Value,At Risk Customers
89338,10,4,"76,6",5,1,1,7,Mid-Value,Potential Loyalists
89341,182,1,"104,5",5,1,1,7,Mid-Value,Potential Loyalists
89342,124,5,"195,35",5,1,1,7,Mid-Value,Potential Loyalists
89345,43,2,"44,099999999999994",5,1,1,7,Mid-Value,Potential Loyalists
89346,426,3,"321,95000000000005",4,1,1,6,Mid-Value,Potential Loyalists
89347,349,9,"658,65",5,2,1,8,High-Value,Potential Loyalists
89348,59,2,"79,55",5,1,1,7,Mid-Value,Potential Loyalists
89349,29,2,"171,0",5,1,1,7,Mid-Value,Potential Loyalists
89350,752,3,"265,2",3,1,1,5,Low-Value,At Risk Customers
89351,692,3,"239,95000000000002",4,1,1,6,Mid-Value,Potential Loyalists
89356,639,4,"169,10000000000002",4,1,1,6,Mid-Value,Potential Loyalists
89357,376,2,"32,5",4,1,1,6,Mid-Value,Potential Loyalists
89359,414,2,"35,8",4,1,1,6,Mid-Value,Potential Loyalists
89362,750,3,"174,8",3,1,1,5,Low-Value,At Risk Customers
89363,836,2,"132,1",3,1,1,5,Low-Value,At Risk Customers
89365,358,12,"585,1",5,3,1,9,High-Value,Champions
89367,1071,1,"24,2",3,1,1,5,Low-Value,At Risk Customers
89368,1524,1,"30,2",1,1,1,3,Low-Value,Lost
89370,183,1,"22,9",5,1,1,7,Mid-Value,Potential Loyalists
89371,94,1,"19,45",5,1,1,7,Mid-Value,Potential Loyalists
89372,1563,1,"49,45",1,1,1,3,Low-Value,Lost
89377,171,4,"345,55000000000007",5,1,1,7,Mid-Value,Potential Loyalists
89378,386,6,"478,20000000000005",4,1,1,6,Mid-Value,Potential Loyalists
89379,479,1,"4,55",4,1,1,6,Mid-Value,Potential Loyalists
89380,219,2,"63,699999999999996",5,1,1,7,Mid-Value,Potential Loyalists
89381,1259,1,"28,6",2,1,1,4,Low-Value,Can't Lose
89382,829,8,"341,15",3,2,1,6,Mid-Value,Potential Loyalists
89385,190,5,"233,8",5,1,1,7,Mid-Value,Potential Loyalists
89387,1459,1,"13,3",2,1,1,4,Low-Value,Can't Lose
89391,596,2,"57,45",4,1,1,6,Mid-Value,Potential Loyalists
89392,19,14,"1294,8",5,3,2,10,High-Value,Champions
89393,220,2,"92,64999999999999",5,1,1,7,Mid-Value,Potential Loyalists
89394,731,1,"312,1",3,1,1,5,Low-Value,At Risk Customers
89398,610,3,"173,8",4,1,1,6,Mid-Value,Potential Loyalists
89399,338,6,"296,7",5,1,1,7,Mid-Value,Potential Loyalists
89400,962,1,"25,9",3,1,1,5,Low-Value,At Risk Customers
89401,46,4,"942,7",5,1,2,8,High-Value,Potential Loyalists
89403,1809,1,"58,4",1,1,1,3,Low-Value,Lost
89404,260,5,"343,5",5,1,1,7,Mid-Value,Potential Loyalists
89405,597,4,"83,05",4,1,1,6,Mid-Value,Potential Loyalists
89406,695,4,"70,9",4,1,1,6,Mid-Value,Potential Loyalists
89407,158,2,"160,7",5,1,1,7,Mid-Value,Potential Loyalists
89411,269,4,"331,65",5,1,1,7,Mid-Value,Potential Loyalists
89413,36,13,"658,05",5,3,1,9,High-Value,Champions
89414,808,7,"259,09999999999997",3,2,1,6,Mid-Value,Potential Loyalists
89416,91,3,"265,0",5,1,1,7,Mid-Value,Potential Loyalists
89418,1646,1,"281,1",1,1,1,3,Low-Value,Lost
89420,7,2,"34,599999999999994",5,1,1,7,Mid-Value,Potential Loyalists
89422,127,5,"80,4",5,1,1,7,Mid-Value,Potential Loyalists
89423,413,1,"20,2",4,1,1,6,Mid-Value,Potential Loyalists
89424,1204,1,"17,4",2,1,1,4,Low-Value,Can't Lose
89425,192,2,"34,0",5,1,1,7,Mid-Value,Potential Loyalists
89426,87,6,"440,8",5,1,1,7,Mid-Value,Potential Loyalists
89427,1441,1,"24,2",2,1,1,4,Low-Value,Can't Lose
89429,740,3,"279,40000000000003",3,1,1,5,Low-Value,At Risk Customers
89434,943,2,"70,7",3,1,1,5,Low-Value,At Risk Customers
89436,977,1,"21,5",3,1,1,5,Low-Value,At Risk Customers
89437,860,6,"479,45",3,1,1,5,Low-Value,At Risk Customers
89438,18,6,"361,25",5,1,1,7,Mid-Value,Potential Loyalists
89440,374,4,"273,4",4,1,1,6,Mid-Value,Potential Loyalists
89441,758,1,"14,4",3,1,1,5,Low-Value,At Risk Customers
89444,997,2,"935,35",3,1,2,6,Mid-Value,Potential Loyalists
89447,376,1,"483,5",4,1,1,6,Mid-Value,Potential Loyalists
89448,228,2,"166,45000000000002",5,1,1,7,Mid-Value,Potential Loyalists
89449,1154,1,"153,0",2,1,1,4,Low-Value,Can't Lose
89450,539,1,"206,75",4,1,1,6,Mid-Value,Potential Loyalists
89451,449,3,"252,55",4,1,1,6,Mid-Value,Potential Loyalists
89453,1488,1,"215,75",1,1,1,3,Low-Value,Lost
89456,385,2,"162,65",4,1,1,6,Mid-Value,Potential Loyalists
89457,327,1,"55,5",5,1,1,7,Mid-Value,Potential Loyalists
89459,508,2,"245,74999999999997",4,1,1,6,Mid-Value,Potential Loyalists
89461,146,2,"105,6",5,1,1,7,Mid-Value,Potential Loyalists
89463,32,3,"102,39999999999999",5,1,1,7,Mid-Value,Potential Loyalists
89466,151,6,"255,39999999999998",5,1,1,7,Mid-Value,Potential Loyalists
89468,453,1,"38,6",4,1,1,6,Mid-Value,Potential Loyalists
89469,541,1,"1,6",4,1,1,6,Mid-Value,Potential Loyalists
89470,1217,2,"131,2",2,1,1,4,Low-Value,Can't Lose
89471,1,5,"273,25",5,1,1,7,Mid-Value,Potential Loyalists
89472,62,4,"78,95",5,1,1,7,Mid-Value,Potential Loyalists
89474,32,8,"301,1",5,2,1,8,High-Value,Potential Loyalists
89475,989,1,"70,1",3,1,1,5,Low-Value,At Risk Customers
89476,827,2,"43,099999999999994",3,1,1,5,Low-Value,At Risk Customers
89477,422,6,"517,3",4,1,1,6,Mid-Value,Potential Loyalists
89478,639,6,"180,05",4,1,1,6,Mid-Value,Potential Loyalists
89482,1258,1,"76,2",2,1,1,4,Low-Value,Can't Lose
89483,720,1,"17,15",4,1,1,6,Mid-Value,Potential Loyalists
89485,812,1,"87,15",3,1,1,5,Low-Value,At Risk Customers
89487,28,2,"48,85",5,1,1,7,Mid-Value,Potential Loyalists
89489,33,10,"694,5",5,2,2,9,High-Value,Champions
89491,812,6,"306,1",3,1,1,5,Low-Value,At Risk Customers
89492,977,3,"150,4",3,1,1,5,Low-Value,At Risk Customers
89493,296,4,"151,55",5,1,1,7,Mid-Value,Potential Loyalists
89494,247,12,"649,55",5,3,1,9,High-Value,Champions
89495,70,6,"153,35",5,1,1,7,Mid-Value,Potential Loyalists
89497,445,9,"472,90000000000003",4,2,1,7,Mid-Value,Potential Loyalists
89499,413,6,"357,75",4,1,1,6,Mid-Value,Potential Loyalists
89500,1079,1,"37,9",3,1,1,5,Low-Value,At Risk Customers
89501,558,1,"7,0",4,1,1,6,Mid-Value,Potential Loyalists
89503,1228,2,"144,3",2,1,1,4,Low-Value,Can't Lose
89504,977,2,"212,55",3,1,1,5,Low-Value,At Risk Customers
89509,1005,3,"787,15",3,1,2,6,Mid-Value,Potential Loyalists
89512,766,4,"92,35",3,1,1,5,Low-Value,At Risk Customers
89515,946,1,"81,3",3,1,1,5,Low-Value,At Risk Customers
89516,993,1,"30,5",3,1,1,5,Low-Value,At Risk Customers
89518,87,2,"207,75000000000003",5,1,1,7,Mid-Value,Potential Loyalists
89521,296,3,"236,55",5,1,1,7,Mid-Value,Potential Loyalists
89523,450,4,"418,5",4,1,1,6,Mid-Value,Potential Loyalists
89527,532,8,"725,25",4,2,2,8,High-Value,Potential Loyalists
89528,213,4,"144,55",5,1,1,7,Mid-Value,Potential Loyalists
89530,557,1,"57,05",4,1,1,6,Mid-Value,Potential Loyalists
89532,1291,3,"485,65",2,1,1,4,Low-Value,Can't Lose
89538,11,2,"68,5",5,1,1,7,Mid-Value,Potential Loyalists
89542,769,4,"162,7",3,1,1,5,Low-Value,At Risk Customers
89544,809,1,"1,35",3,1,1,5,Low-Value,At Risk Customers
89545,163,8,"436,0",5,2,1,8,High-Value,Potential Loyalists
89547,755,3,"102,75",3,1,1,5,Low-Value,At Risk Customers
89551,240,4,"211,55",5,1,1,7,Mid-Value,Potential Loyalists
89553,31,3,"258,5",5,1,1,7,Mid-Value,Potential Loyalists
89554,172,2,"121,85",5,1,1,7,Mid-Value,Potential Loyalists
89555,876,1,"83,7",3,1,1,5,Low-Value,At Risk Customers
89558,778,2,"107,4",3,1,1,5,Low-Value,At Risk Customers
89559,1649,1,"268,79999999999995",1,1,1,3,Low-Value,Lost
89560,626,1,"80,9",4,1,1,6,Mid-Value,Potential Loyalists
89561,891,1,"18,8",3,1,1,5,Low-Value,At Risk Customers
89563,1146,1,"13,15",2,1,1,4,Low-Value,Can't Lose
89565,2,2,"193,0",5,1,1,7,Mid-Value,Potential Loyalists
89566,1133,1,"49,6",2,1,1,4,Low-Value,Can't Lose
89568,122,2,"76,3",5,1,1,7,Mid-Value,Potential Loyalists
89573,1278,1,"81,30000000000001",2,1,1,4,Low-Value,Can't Lose
89577,115,3,"108,7",5,1,1,7,Mid-Value,Potential Loyalists
89579,484,6,"591,8000000000001",4,1,1,6,Mid-Value,Potential Loyalists
89581,71,3,"38,05",5,1,1,7,Mid-Value,Potential Loyalists
89582,249,3,"223,55",5,1,1,7,Mid-Value,Potential Loyalists
89583,11,5,"884,65",5,1,2,8,High-Value,Potential Loyalists
89584,41,2,"146,85",5,1,1,7,Mid-Value,Potential Loyalists
89586,964,1,"8,0",3,1,1,5,Low-Value,At Risk Customers
89587,302,5,"365,9",5,1,1,7,Mid-Value,Potential Loyalists
89591,342,3,"3187,2",5,1,5,11,High-Value,Champions
89592,1563,2,"180,55",1,1,1,3,Low-Value,Lost
89594,155,1,"65,1",5,1,1,7,Mid-Value,Potential Loyalists
89595,67,1,"20,0",5,1,1,7,Mid-Value,Potential Loyalists
89598,1004,2,"231,1",3,1,1,5,Low-Value,At Risk Customers
89599,15,1,"109,1",5,1,1,7,Mid-Value,Potential Loyalists
89600,90,3,"265,04999999999995",5,1,1,7,Mid-Value,Potential Loyalists
89601,1245,1,"87,2",2,1,1,4,Low-Value,Can't Lose
89602,984,1,"169,7",3,1,1,5,Low-Value,At Risk Customers
89603,648,4,"422,75",4,1,1,6,Mid-Value,Potential Loyalists
89604,1171,2,"91,85",2,1,1,4,Low-Value,Can't Lose
89606,739,2,"53,8",3,1,1,5,Low-Value,At Risk Customers
89608,1758,1,"16,8",1,1,1,3,Low-Value,Lost
89609,657,1,"7,25",4,1,1,6,Mid-Value,Potential Loyalists
89613,675,1,"28,8",4,1,1,6,Mid-Value,Potential Loyalists
89614,432,2,"215,1",4,1,1,6,Mid-Value,Potential Loyalists
89615,78,6,"344,7",5,1,1,7,Mid-Value,Potential Loyalists
89616,949,1,"45,35",3,1,1,5,Low-Value,At Risk Customers
89617,1499,1,"13,3",1,1,1,3,Low-Value,Lost
89619,15,6,"519,6",5,1,1,7,Mid-Value,Potential Loyalists
89620,374,4,"500,54999999999995",4,1,1,6,Mid-Value,Potential Loyalists
89621,131,6,"400,35",5,1,1,7,Mid-Value,Potential Loyalists
89625,151,4,"221,4",5,1,1,7,Mid-Value,Potential Loyalists
89627,241,5,"156,35",5,1,1,7,Mid-Value,Potential Loyalists
89628,401,5,"223,65",4,1,1,6,Mid-Value,Potential Loyalists
89630,1377,1,"6,15",2,1,1,4,Low-Value,Can't Lose
89632,432,1,"253,2",4,1,1,6,Mid-Value,Potential Loyalists
89633,271,8,"314,05",5,2,1,8,High-Value,Potential Loyalists
89634,495,1,"12,9",4,1,1,6,Mid-Value,Potential Loyalists
89635,570,1,"40,6",4,1,1,6,Mid-Value,Potential Loyalists
89636,738,3,"43,85",3,1,1,5,Low-Value,At Risk Customers
89638,501,6,"481,84999999999997",4,1,1,6,Mid-Value,Potential Loyalists
89640,1019,1,"8,35",3,1,1,5,Low-Value,At Risk Customers
89643,1132,2,"546,25",2,1,1,4,Low-Value,Can't Lose
89644,735,2,"86,25",3,1,1,5,Low-Value,At Risk Customers
89645,183,1,"50,25",5,1,1,7,Mid-Value,Potential Loyalists
89647,520,2,"42,15",4,1,1,6,Mid-Value,Potential Loyalists
89648,65,4,"149,4",5,1,1,7,Mid-Value,Potential Loyalists
89649,332,6,"381,5",5,1,1,7,Mid-Value,Potential Loyalists
89650,1671,1,"15,0",1,1,1,3,Low-Value,Lost
89651,1082,1,"22,45",3,1,1,5,Low-Value,At Risk Customers
89654,388,5,"115,7",4,1,1,6,Mid-Value,Potential Loyalists
89655,361,3,"45,0",5,1,1,7,Mid-Value,Potential Loyalists
89658,776,2,"113,8",3,1,1,5,Low-Value,At Risk Customers
89659,69,3,"257,7",5,1,1,7,Mid-Value,Potential Loyalists
89661,109,5,"248,55",5,1,1,7,Mid-Value,Potential Loyalists
89663,1273,1,"88,0",2,1,1,4,Low-Value,Can't Lose
89667,261,1,"86,1",5,1,1,7,Mid-Value,Potential Loyalists
89668,960,1,"25,8",3,1,1,5,Low-Value,At Risk Customers
89672,13,3,"116,95",5,1,1,7,Mid-Value,Potential Loyalists
89673,439,1,"6,1",4,1,1,6,Mid-Value,Potential Loyalists
89674,777,2,"45,8",3,1,1,5,Low-Value,At Risk Customers
89675,17,3,"158,2",5,1,1,7,Mid-Value,Potential Loyalists
89676,32,5,"481,09999999999997",5,1,1,7,Mid-Value,Potential Loyalists
89678,259,4,"324,6",5,1,1,7,Mid-Value,Potential Loyalists
89681,164,3,"58,35",5,1,1,7,Mid-Value,Potential Loyalists
89682,1249,1,"24,2",2,1,1,4,Low-Value,Can't Lose
89684,1614,1,"484,9",1,1,1,3,Low-Value,Lost
89685,26,12,"1048,6",5,3,2,10,High-Value,Champions
89687,805,1,"23,75",3,1,1,5,Low-Value,At Risk Customers
89689,192,6,"336,35",5,1,1,7,Mid-Value,Potential Loyalists
89691,307,2,"221,55",5,1,1,7,Mid-Value,Potential Loyalists
89693,855,3,"254,14999999999998",3,1,1,5,Low-Value,At Risk Customers
89694,759,2,"45,3",3,1,1,5,Low-Value,At Risk Customers
89697,40,2,"257,75",5,1,1,7,Mid-Value,Potential Loyalists
89700,207,2,"276,7",5,1,1,7,Mid-Value,Potential Loyalists
89701,115,1,"62,7",5,1,1,7,Mid-Value,Potential Loyalists
89702,63,4,"174,85",5,1,1,7,Mid-Value,Potential Loyalists
89703,426,2,"118,55000000000001",4,1,1,6,Mid-Value,Potential Loyalists
89704,28,4,"111,55",5,1,1,7,Mid-Value,Potential Loyalists
89706,1677,2,"144,29999999999998",1,1,1,3,Low-Value,Lost
89710,1139,4,"166,3",2,1,1,4,Low-Value,Can't Lose
89711,542,7,"627,7",4,2,1,7,Mid-Value,Potential Loyalists
89713,1572,3,"101,3",1,1,1,3,Low-Value,Lost
89714,698,4,"312,25",4,1,1,6,Mid-Value,Potential Loyalists
89716,1375,1,"19,0",2,1,1,4,Low-Value,Can't Lose
89717,912,2,"54,7",3,1,1,5,Low-Value,At Risk Customers
89718,153,4,"201,5",5,1,1,7,Mid-Value,Potential Loyalists
89720,1250,5,"233,0",2,1,1,4,Low-Value,Can't Lose
89722,572,3,"108,0",4,1,1,6,Mid-Value,Potential Loyalists
89724,155,1,"42,45",5,1,1,7,Mid-Value,Potential Loyalists
89728,667,2,"53,699999999999996",4,1,1,6,Mid-Value,Potential Loyalists
89729,16,3,"160,1",5,1,1,7,Mid-Value,Potential Loyalists
89730,887,3,"233,6",3,1,1,5,Low-Value,At Risk Customers
89732,623,4,"67,25",4,1,1,6,Mid-Value,Potential Loyalists
89733,141,3,"80,10000000000001",5,1,1,7,Mid-Value,Potential Loyalists
89734,680,3,"233,2",4,1,1,6,Mid-Value,Potential Loyalists
89735,335,6,"161,65",5,1,1,7,Mid-Value,Potential Loyalists
89736,55,3,"103,25",5,1,1,7,Mid-Value,Potential Loyalists
89738,141,2,"34,75",5,1,1,7,Mid-Value,Potential Loyalists
89739,575,2,"86,30000000000001",4,1,1,6,Mid-Value,Potential Loyalists
89746,495,3,"664,4",4,1,2,7,Mid-Value,Potential Loyalists
89747,999,1,"13,9",3,1,1,5,Low-Value,At Risk Customers
89748,1737,3,"93,19999999999999",1,1,1,3,Low-Value,Lost
89749,620,3,"150,0",4,1,1,6,Mid-Value,Potential Loyalists
89750,155,4,"269,65",5,1,1,7,Mid-Value,Potential Loyalists
89751,411,7,"665,05",4,2,2,8,High-Value,Potential Loyalists
89752,703,8,"450,45",4,2,1,7,Mid-Value,Potential Loyalists
89754,171,4,"489,65",5,1,1,7,Mid-Value,Potential Loyalists
89757,819,1,"42,3",3,1,1,5,Low-Value,At Risk Customers
89760,20,4,"456,25",5,1,1,7,Mid-Value,Potential Loyalists
89761,356,4,"88,7",5,1,1,7,Mid-Value,Potential Loyalists
89762,1156,2,"21,0",2,1,1,4,Low-Value,Can't Lose
89765,598,3,"340,65000000000003",4,1,1,6,Mid-Value,Potential Loyalists
89766,272,2,"133,1",5,1,1,7,Mid-Value,Potential Loyalists
89767,1806,1,"8,75",1,1,1,3,Low-Value,Lost
89768,350,5,"358,0",5,1,1,7,Mid-Value,Potential Loyalists
89769,696,2,"133,14999999999998",4,1,1,6,Mid-Value,Potential Loyalists
89770,703,1,"6,8",4,1,1,6,Mid-Value,Potential Loyalists
89772,784,3,"93,1",3,1,1,5,Low-Value,At Risk Customers
89773,317,1,"14,2",5,1,1,7,Mid-Value,Potential Loyalists
89775,1055,1,"20,05",3,1,1,5,Low-Value,At Risk Customers
89776,121,10,"776,25",5,2,2,9,High-Value,Champions
89779,911,3,"179,75",3,1,1,5,Low-Value,At Risk Customers
89781,1455,1,"49,0",2,1,1,4,Low-Value,Can't Lose
89783,848,3,"505,0",3,1,1,5,Low-Value,At Risk Customers
89784,1368,1,"109,1",2,1,1,4,Low-Value,Can't Lose
89785,1165,1,"6,0",2,1,1,4,Low-Value,Can't Lose
89786,1248,2,"344,29999999999995",2,1,1,4,Low-Value,Can't Lose
89787,328,3,"105,89999999999999",5,1,1,7,Mid-Value,Potential Loyalists
89788,1176,1,"19,25",2,1,1,4,Low-Value,Can't Lose
89789,741,6,"457,85",3,1,1,5,Low-Value,At Risk Customers
89790,504,3,"406,5",4,1,1,6,Mid-Value,Potential Loyalists
89791,826,6,"223,85",3,1,1,5,Low-Value,At Risk Customers
89792,599,2,"60,05",4,1,1,6,Mid-Value,Potential Loyalists
89793,1456,1,"32,8",2,1,1,4,Low-Value,Can't Lose
89794,985,1,"25,45",3,1,1,5,Low-Value,At Risk Customers
89795,82,8,"521,4",5,2,1,8,High-Value,Potential Loyalists
89796,1106,3,"137,1",2,1,1,4,Low-Value,Can't Lose
89797,146,3,"90,9",5,1,1,7,Mid-Value,Potential Loyalists
89798,436,2,"110,5",4,1,1,6,Mid-Value,Potential Loyalists
89800,174,1,"124,5",5,1,1,7,Mid-Value,Potential Loyalists
89801,883,4,"149,65",3,1,1,5,Low-Value,At Risk Customers
89802,1562,2,"60,45",1,1,1,3,Low-Value,Lost
89803,757,4,"237,6",3,1,1,5,Low-Value,At Risk Customers
89805,19,2,"40,2",5,1,1,7,Mid-Value,Potential Loyalists
89806,394,1,"53,3",4,1,1,6,Mid-Value,Potential Loyalists
89808,1258,2,"114,2",2,1,1,4,Low-Value,Can't Lose
89810,67,3,"127,25",5,1,1,7,Mid-Value,Potential Loyalists
89812,174,5,"261,0",5,1,1,7,Mid-Value,Potential Loyalists
89813,1496,4,"192,85",1,1,1,3,Low-Value,Lost
89814,1497,4,"205,14999999999998",1,1,1,3,Low-Value,Lost
89815,19,12,"765,5",5,3,2,10,High-Value,Champions
89816,1792,1,"204,6",1,1,1,3,Low-Value,Lost
89817,683,1,"23,1",4,1,1,6,Mid-Value,Potential Loyalists
89818,265,7,"202,5",5,2,1,8,High-Value,Potential Loyalists
89821,426,3,"77,25",4,1,1,6,Mid-Value,Potential Loyalists
89823,142,3,"107,95",5,1,1,7,Mid-Value,Potential Loyalists
89824,903,2,"37,0",3,1,1,5,Low-Value,At Risk Customers
89825,62,1,"111,0",5,1,1,7,Mid-Value,Potential Loyalists
89826,175,3,"112,5",5,1,1,7,Mid-Value,Potential Loyalists
89827,622,6,"549,3",4,1,1,6,Mid-Value,Potential Loyalists
89828,731,2,"1124,55",3,1,2,6,Mid-Value,Potential Loyalists
89829,1379,2,"125,35",2,1,1,4,Low-Value,Can't Lose
89831,931,1,"12,0",3,1,1,5,Low-Value,At Risk Customers
89832,706,5,"137,15",4,1,1,6,Mid-Value,Potential Loyalists
89833,446,5,"287,1",4,1,1,6,Mid-Value,Potential Loyalists
89835,405,5,"181,25",4,1,1,6,Mid-Value,Potential Loyalists
89836,1491,2,"21,75",1,1,1,3,Low-Value,Lost
89837,20,7,"397,15",5,2,1,8,High-Value,Potential Loyalists
89838,93,2,"89,5",5,1,1,7,Mid-Value,Potential Loyalists
89839,420,4,"345,5",4,1,1,6,Mid-Value,Potential Loyalists
89840,206,4,"197,0",5,1,1,7,Mid-Value,Potential Loyalists
89842,1482,3,"136,3",1,1,1,3,Low-Value,Lost
89845,53,2,"167,8",5,1,1,7,Mid-Value,Potential Loyalists
89848,448,5,"337,45",4,1,1,6,Mid-Value,Potential Loyalists
89850,58,1,"29,2",5,1,1,7,Mid-Value,Potential Loyalists
89851,976,1,"12,4",3,1,1,5,Low-Value,At Risk Customers
89853,221,5,"203,85",5,1,1,7,Mid-Value,Potential Loyalists
89854,392,3,"401,84999999999997",4,1,1,6,Mid-Value,Potential Loyalists
89858,656,2,"15,850000000000001",4,1,1,6,Mid-Value,Potential Loyalists
89859,1159,7,"495,85",2,2,1,5,Low-Value,At Risk Customers
89861,1261,1,"69,6",2,1,1,4,Low-Value,Can't Lose
89866,525,1,"38,7",4,1,1,6,Mid-Value,Potential Loyalists
89868,317,5,"205,1",5,1,1,7,Mid-Value,Potential Loyalists
89869,1176,1,"19,45",2,1,1,4,Low-Value,Can't Lose
89872,881,5,"366,8",3,1,1,5,Low-Value,At Risk Customers
89873,34,10,"662,25",5,2,1,8,High-Value,Potential Loyalists
89874,393,3,"284,70000000000005",4,1,1,6,Mid-Value,Potential Loyalists
89875,1197,5,"412,29999999999995",2,1,1,4,Low-Value,Can't Lose
89876,219,3,"176,8",5,1,1,7,Mid-Value,Potential Loyalists
89877,892,1,"213,75",3,1,1,5,Low-Value,At Risk Customers
89878,35,1,"53,0",5,1,1,7,Mid-Value,Potential Loyalists
89879,19,4,"555,25",5,1,1,7,Mid-Value,Potential Loyalists
89880,393,1,"63,599999999999994",4,1,1,6,Mid-Value,Potential Loyalists
89881,372,1,"60,5",4,1,1,6,Mid-Value,Potential Loyalists
89882,807,4,"138,95000000000002",3,1,1,5,Low-Value,At Risk Customers
89883,399,5,"329,9",4,1,1,6,Mid-Value,Potential Loyalists
89884,1075,1,"54,95",3,1,1,5,Low-Value,At Risk Customers
89885,411,3,"116,60000000000001",4,1,1,6,Mid-Value,Potential Loyalists
89891,410,2,"50,8",4,1,1,6,Mid-Value,Potential Loyalists
89892,175,4,"135,05",5,1,1,7,Mid-Value,Potential Loyalists
89893,206,5,"305,15",5,1,1,7,Mid-Value,Potential Loyalists
89896,45,3,"199,95",5,1,1,7,Mid-Value,Potential Loyalists
89898,1113,1,"93,3",2,1,1,4,Low-Value,Can't Lose
89899,1602,1,"16,55",1,1,1,3,Low-Value,Lost
89901,914,1,"18,3",3,1,1,5,Low-Value,At Risk Customers
89902,431,5,"342,55",4,1,1,6,Mid-Value,Potential Loyalists
89906,155,5,"1046,75",5,1,2,8,High-Value,Potential Loyalists
89907,1515,2,"21,400000000000002",1,1,1,3,Low-Value,Lost
89909,34,4,"157,6",5,1,1,7,Mid-Value,Potential Loyalists
89910,1659,1,"24,2",1,1,1,3,Low-Value,Lost
89911,456,4,"124,55",4,1,1,6,Mid-Value,Potential Loyalists
89913,328,3,"345,35",5,1,1,7,Mid-Value,Potential Loyalists
89917,485,9,"884,9999999999999",4,2,2,8,High-Value,Potential Loyalists
89918,657,1,"84,8",4,1,1,6,Mid-Value,Potential Loyalists
89919,476,6,"131,35",4,1,1,6,Mid-Value,Potential Loyalists
89921,20,6,"166,5",5,1,1,7,Mid-Value,Potential Loyalists
89922,191,1,"24,5",5,1,1,7,Mid-Value,Potential Loyalists
89923,281,2,"22,4",5,1,1,7,Mid-Value,Potential Loyalists
89925,752,3,"731,75",3,1,2,6,Mid-Value,Potential Loyalists
89927,1341,2,"89,85",2,1,1,4,Low-Value,Can't Lose
89930,853,3,"103,35000000000001",3,1,1,5,Low-Value,At Risk Customers
89932,145,7,"703,45",5,2,2,9,High-Value,Champions
89933,138,4,"251,2",5,1,1,7,Mid-Value,Potential Loyalists
89934,335,2,"78,35",5,1,1,7,Mid-Value,Potential Loyalists
89935,120,5,"235,85",5,1,1,7,Mid-Value,Potential Loyalists
89936,1125,2,"175,9",2,1,1,4,Low-Value,Can't Lose
89937,140,4,"72,0",5,1,1,7,Mid-Value,Potential Loyalists
89938,1538,1,"17,95",1,1,1,3,Low-Value,Lost
89939,375,4,"176,2",4,1,1,6,Mid-Value,Potential Loyalists
89940,35,6,"304,45",5,1,1,7,Mid-Value,Potential Loyalists
89941,398,4,"140,2",4,1,1,6,Mid-Value,Potential Loyalists
89945,847,5,"301,90000000000003",3,1,1,5,Low-Value,At Risk Customers
89946,884,1,"64,35",3,1,1,5,Low-Value,At Risk Customers
89947,873,6,"272,09999999999997",3,1,1,5,Low-Value,At Risk Customers
89949,69,2,"70,85",5,1,1,7,Mid-Value,Potential Loyalists
89950,600,5,"167,9",4,1,1,6,Mid-Value,Potential Loyalists
89952,9,3,"163,3",5,1,1,7,Mid-Value,Potential Loyalists
89953,9,2,"85,8",5,1,1,7,Mid-Value,Potential Loyalists
89954,48,8,"386,3",5,2,1,8,High-Value,Potential Loyalists
89955,21,5,"365,05",5,1,1,7,Mid-Value,Potential Loyalists
89958,512,4,"289,55",4,1,1,6,Mid-Value,Potential Loyalists
89960,912,3,"276,4",3,1,1,5,Low-Value,At Risk Customers
89967,1545,1,"14,35",1,1,1,3,Low-Value,Lost
89972,259,2,"28,65",5,1,1,7,Mid-Value,Potential Loyalists
89975,713,3,"217,25",4,1,1,6,Mid-Value,Potential Loyalists
89976,493,10,"1060,95",4,2,2,8,High-Value,Potential Loyalists
89977,3,6,"346,1",5,1,1,7,Mid-Value,Potential Loyalists
89979,162,3,"130,8",5,1,1,7,Mid-Value,Potential Loyalists
89983,587,2,"39,4",4,1,1,6,Mid-Value,Potential Loyalists
89988,8,13,"882,1999999999999",5,3,2,10,High-Value,Champions
89991,89,2,"31,75",5,1,1,7,Mid-Value,Potential Loyalists
89995,220,4,"95,95",5,1,1,7,Mid-Value,Potential Loyalists
89996,369,1,"78,4",4,1,1,6,Mid-Value,Potential Loyalists
89997,1238,1,"84,9",2,1,1,4,Low-Value,Can't Lose
89999,966,2,"98,4",3,1,1,5,Low-Value,At Risk Customers
90000,8,1,"1236,25",5,1,2,8,High-Value,Potential Loyalists
90001,281,2,"23,35",5,1,1,7,Mid-Value,Potential Loyalists
90008,1007,4,"393,7",3,1,1,5,Low-Value,At Risk Customers
90009,340,1,"29,55",5,1,1,7,Mid-Value,Potential Loyalists
90013,517,3,"133,0",4,1,1,6,Mid-Value,Potential Loyalists
90014,268,1,"19,2",5,1,1,7,Mid-Value,Potential Loyalists
90015,1049,3,"107,75",3,1,1,5,Low-Value,At Risk Customers
90019,748,2,"59,35",3,1,1,5,Low-Value,At Risk Customers
90020,855,3,"248,15",3,1,1,5,Low-Value,At Risk Customers
90022,66,8,"410,6",5,2,1,8,High-Value,Potential Loyalists
90023,168,3,"101,8",5,1,1,7,Mid-Value,Potential Loyalists
90025,89,3,"41,3",5,1,1,7,Mid-Value,Potential Loyalists
90027,168,2,"41,3",5,1,1,7,Mid-Value,Potential Loyalists
90031,195,2,"418,90000000000003",5,1,1,7,Mid-Value,Potential Loyalists
90032,26,11,"699,0",5,2,2,9,High-Value,Champions
90038,89,8,"483,15",5,2,1,8,High-Value,Potential Loyalists
90039,93,7,"430,9",5,2,1,8,High-Value,Potential Loyalists
90040,805,4,"677,4",3,1,2,6,Mid-Value,Potential Loyalists
90041,369,4,"272,09999999999997",4,1,1,6,Mid-Value,Potential Loyalists
90042,13,1,"122,0",5,1,1,7,Mid-Value,Potential Loyalists
90044,1674,1,"75,9",1,1,1,3,Low-Value,Lost
90045,313,8,"803,7",5,2,2,9,High-Value,Champions
90046,27,1,"38,6",5,1,1,7,Mid-Value,Potential Loyalists
90047,505,4,"329,9",4,1,1,6,Mid-Value,Potential Loyalists
90048,444,3,"649,35",4,1,1,6,Mid-Value,Potential Loyalists
90049,33,7,"344,05",5,2,1,8,High-Value,Potential Loyalists
90050,110,3,"182,85",5,1,1,7,Mid-Value,Potential Loyalists
90051,723,5,"207,1",4,1,1,6,Mid-Value,Potential Loyalists
90055,783,1,"40,1",3,1,1,5,Low-Value,At Risk Customers
90056,110,2,"98,94999999999999",5,1,1,7,Mid-Value,Potential Loyalists
90057,199,1,"183,4",5,1,1,7,Mid-Value,Potential Loyalists
90060,1384,3,"65,0",2,1,1,4,Low-Value,Can't Lose
90061,445,5,"137,05",4,1,1,6,Mid-Value,Potential Loyalists
90066,699,1,"21,55",4,1,1,6,Mid-Value,Potential Loyalists
90067,535,1,"53,4",4,1,1,6,Mid-Value,Potential Loyalists
90068,285,2,"68,5",5,1,1,7,Mid-Value,Potential Loyalists
90069,58,5,"442,2",5,1,1,7,Mid-Value,Potential Loyalists
90071,329,2,"212,15",5,1,1,7,Mid-Value,Potential Loyalists
90072,157,6,"682,05",5,1,2,8,High-Value,Potential Loyalists
90075,12,2,"147,7",5,1,1,7,Mid-Value,Potential Loyalists
90077,681,3,"301,15",4,1,1,6,Mid-Value,Potential Loyalists
90079,258,5,"400,5",5,1,1,7,Mid-Value,Potential Loyalists
90080,622,1,"31,1",4,1,1,6,Mid-Value,Potential Loyalists
90081,282,3,"121,94999999999999",5,1,1,7,Mid-Value,Potential Loyalists
90082,230,2,"393,90000000000003",5,1,1,7,Mid-Value,Potential Loyalists
90083,952,3,"751,1",3,1,2,6,Mid-Value,Potential Loyalists
90084,37,7,"365,4",5,2,1,8,High-Value,Potential Loyalists
90085,1448,1,"5,35",2,1,1,4,Low-Value,Can't Lose
90087,44,6,"461,75",5,1,1,7,Mid-Value,Potential Loyalists
90088,670,3,"102,9",4,1,1,6,Mid-Value,Potential Loyalists
90090,494,1,"107,6",4,1,1,6,Mid-Value,Potential Loyalists
90092,370,6,"174,2",4,1,1,6,Mid-Value,Potential Loyalists
90093,910,4,"169,15",3,1,1,5,Low-Value,At Risk Customers
90094,253,1,"57,599999999999994",5,1,1,7,Mid-Value,Potential Loyalists
90098,776,3,"249,09999999999997",3,1,1,5,Low-Value,At Risk Customers
90101,284,9,"496,65",5,2,1,8,High-Value,Potential Loyalists
90102,217,1,"53,5",5,1,1,7,Mid-Value,Potential Loyalists
90103,14,14,"651,85",5,3,1,9,High-Value,Champions
90105,658,3,"129,45",4,1,1,6,Mid-Value,Potential Loyalists
90107,73,3,"156,75",5,1,1,7,Mid-Value,Potential Loyalists
90109,95,3,"104,1",5,1,1,7,Mid-Value,Potential Loyalists
90111,311,2,"96,5",5,1,1,7,Mid-Value,Potential Loyalists
90112,15,1,"37,8",5,1,1,7,Mid-Value,Potential Loyalists
90114,809,6,"315,55",3,1,1,5,Low-Value,At Risk Customers
90115,1076,1,"186,89999999999998",3,1,1,5,Low-Value,At Risk Customers
90118,861,1,"264,0",3,1,1,5,Low-Value,At Risk Customers
90119,187,3,"230,04999999999998",5,1,1,7,Mid-Value,Potential Loyalists
90123,8,2,"28,75",5,1,1,7,Mid-Value,Potential Loyalists
90126,201,7,"424,6",5,2,1,8,High-Value,Potential Loyalists
90127,124,4,"1008,3",5,1,2,8,High-Value,Potential Loyalists
90128,1353,2,"189,65",2,1,1,4,Low-Value,Can't Lose
90129,1544,1,"50,4",1,1,1,3,Low-Value,Lost
90130,403,5,"378,79999999999995",4,1,1,6,Mid-Value,Potential Loyalists
90132,1279,3,"252,79999999999998",2,1,1,4,Low-Value,Can't Lose
90133,493,7,"516,6",4,2,1,7,Mid-Value,Potential Loyalists
90135,35,10,"374,65",5,2,1,8,High-Value,Potential Loyalists
90142,622,5,"448,9",4,1,1,6,Mid-Value,Potential Loyalists
90143,581,3,"273,8",4,1,1,6,Mid-Value,Potential Loyalists
90144,913,2,"48,75",3,1,1,5,Low-Value,At Risk Customers
90147,4,2,"168,14999999999998",5,1,1,7,Mid-Value,Potential Loyalists
90148,876,2,"221,14999999999998",3,1,1,5,Low-Value,At Risk Customers
90150,199,2,"51,75",5,1,1,7,Mid-Value,Potential Loyalists
90151,802,5,"134,0",3,1,1,5,Low-Value,At Risk Customers
90156,1420,1,"17,8",2,1,1,4,Low-Value,Can't Lose
90157,1300,1,"13,8",2,1,1,4,Low-Value,Can't Lose
90158,380,20,"1029,3",4,4,2,10,High-Value,Champions
90159,1448,1,"600,0",2,1,1,4,Low-Value,Can't Lose
90160,228,3,"189,0",5,1,1,7,Mid-Value,Potential Loyalists
90161,204,3,"357,7",5,1,1,7,Mid-Value,Potential Loyalists
90162,701,3,"87,7",4,1,1,6,Mid-Value,Potential Loyalists
90165,1218,3,"136,64999999999998",2,1,1,4,Low-Value,Can't Lose
90166,388,2,"48,099999999999994",4,1,1,6,Mid-Value,Potential Loyalists
90167,920,2,"304,1",3,1,1,5,Low-Value,At Risk Customers
90169,8,5,"557,2",5,1,1,7,Mid-Value,Potential Loyalists
90172,214,5,"221,2",5,1,1,7,Mid-Value,Potential Loyalists
90174,1501,2,"30,150000000000002",1,1,1,3,Low-Value,Lost
90175,67,3,"124,8",5,1,1,7,Mid-Value,Potential Loyalists
90176,1490,1,"126,8",1,1,1,3,Low-Value,Lost
90177,587,4,"354,65",4,1,1,6,Mid-Value,Potential Loyalists
90179,263,3,"91,94999999999999",5,1,1,7,Mid-Value,Potential Loyalists
90180,1040,2,"67,6",3,1,1,5,Low-Value,At Risk Customers
90182,193,2,"30,15",5,1,1,7,Mid-Value,Potential Loyalists
90183,55,8,"452,2",5,2,1,8,High-Value,Potential Loyalists
90184,988,4,"652,9",3,1,1,5,Low-Value,At Risk Customers
90185,20,11,"744,15",5,2,2,9,High-Value,Champions
90186,1069,5,"184,05",3,1,1,5,Low-Value,At Risk Customers
90187,25,1,"20,4",5,1,1,7,Mid-Value,Potential Loyalists
90189,43,5,"323,0",5,1,1,7,Mid-Value,Potential Loyalists
90190,1473,2,"109,5",1,1,1,3,Low-Value,Lost
90193,1424,3,"56,9",2,1,1,4,Low-Value,Can't Lose
90198,215,4,"238,35",5,1,1,7,Mid-Value,Potential Loyalists
90199,1446,1,"58,3",2,1,1,4,Low-Value,Can't Lose
90200,194,3,"103,1",5,1,1,7,Mid-Value,Potential Loyalists
90201,125,5,"283,35",5,1,1,7,Mid-Value,Potential Loyalists
90204,86,3,"254,9",5,1,1,7,Mid-Value,Potential Loyalists
90205,991,2,"56,900000000000006",3,1,1,5,Low-Value,At Risk Customers
90206,1244,2,"192,39999999999998",2,1,1,4,Low-Value,Can't Lose
90211,1536,1,"29,05",1,1,1,3,Low-Value,Lost
90212,53,7,"554,3499999999999",5,2,1,8,High-Value,Potential Loyalists
90213,103,4,"225,14999999999998",5,1,1,7,Mid-Value,Potential Loyalists
90218,1172,1,"30,7",2,1,1,4,Low-Value,Can't Lose
90219,1617,1,"225,75",1,1,1,3,Low-Value,Lost
90220,88,2,"106,45",5,1,1,7,Mid-Value,Potential Loyalists
90222,670,10,"360,55",4,2,1,7,Mid-Value,Potential Loyalists
90223,1207,1,"84,9",2,1,1,4,Low-Value,Can't Lose
90224,204,4,"169,5",5,1,1,7,Mid-Value,Potential Loyalists
90225,325,4,"117,05000000000001",5,1,1,7,Mid-Value,Potential Loyalists
90226,187,7,"849,0500000000001",5,2,2,9,High-Value,Champions
90227,292,8,"235,15",5,2,1,8,High-Value,Potential Loyalists
90228,14,3,"499,15",5,1,1,7,Mid-Value,Potential Loyalists
90229,61,4,"104,4",5,1,1,7,Mid-Value,Potential Loyalists
90230,32,2,"10,05",5,1,1,7,Mid-Value,Potential Loyalists
90231,833,3,"126,05",3,1,1,5,Low-Value,At Risk Customers
90234,542,4,"190,1",4,1,1,6,Mid-Value,Potential Loyalists
90238,1658,1,"270,8",1,1,1,3,Low-Value,Lost
90240,580,4,"163,35000000000002",4,1,1,6,Mid-Value,Potential Loyalists
90241,368,3,"390,65",4,1,1,6,Mid-Value,Potential Loyalists
90242,219,4,"279,0",5,1,1,7,Mid-Value,Potential Loyalists
90243,1132,2,"98,55",2,1,1,4,Low-Value,Can't Lose
90245,101,2,"67,0",5,1,1,7,Mid-Value,Potential Loyalists
90246,146,4,"630,0",5,1,1,7,Mid-Value,Potential Loyalists
90247,1320,1,"12,5",2,1,1,4,Low-Value,Can't Lose
90248,1220,1,"2,7",2,1,1,4,Low-Value,Can't Lose
90255,719,2,"44,05",4,1,1,6,Mid-Value,Potential Loyalists
90256,934,1,"239,6",3,1,1,5,Low-Value,At Risk Customers
90257,104,5,"213,7",5,1,1,7,Mid-Value,Potential Loyalists
90258,165,3,"460,15000000000003",5,1,1,7,Mid-Value,Potential Loyalists
90260,204,5,"185,95",5,1,1,7,Mid-Value,Potential Loyalists
90263,415,2,"456,2",4,1,1,6,Mid-Value,Potential Loyalists
90266,1315,1,"55,9",2,1,1,4,Low-Value,Can't Lose
90267,924,2,"159,0",3,1,1,5,Low-Value,At Risk Customers
90268,604,1,"14,4",4,1,1,6,Mid-Value,Potential Loyalists
90271,130,4,"637,4000000000001",5,1,1,7,Mid-Value,Potential Loyalists
90272,488,4,"106,85",4,1,1,6,Mid-Value,Potential Loyalists
90278,133,6,"364,09999999999997",5,1,1,7,Mid-Value,Potential Loyalists
90279,1173,1,"5,9",2,1,1,4,Low-Value,Can't Lose
90283,403,8,"958,15",4,2,2,8,High-Value,Potential Loyalists
90284,1477,1,"116,0",1,1,1,3,Low-Value,Lost
90285,677,8,"474,9",4,2,1,7,Mid-Value,Potential Loyalists
90286,567,2,"141,6",4,1,1,6,Mid-Value,Potential Loyalists
90287,618,2,"44,15",4,1,1,6,Mid-Value,Potential Loyalists
90291,931,1,"79,6",3,1,1,5,Low-Value,At Risk Customers
90293,229,3,"33,6",5,1,1,7,Mid-Value,Potential Loyalists
90294,988,2,"66,1",3,1,1,5,Low-Value,At Risk Customers
90295,132,6,"272,8",5,1,1,7,Mid-Value,Potential Loyalists
90297,141,5,"115,4",5,1,1,7,Mid-Value,Potential Loyalists
90298,132,6,"170,3",5,1,1,7,Mid-Value,Potential Loyalists
90301,1791,1,"10,15",1,1,1,3,Low-Value,Lost
90304,54,1,"39,05",5,1,1,7,Mid-Value,Potential Loyalists
90305,1039,3,"98,4",3,1,1,5,Low-Value,At Risk Customers
90306,164,4,"118,45",5,1,1,7,Mid-Value,Potential Loyalists
90307,682,3,"208,45",4,1,1,6,Mid-Value,Potential Loyalists
90308,111,9,"665,6999999999999",5,2,2,9,High-Value,Champions
90312,36,7,"338,3",5,2,1,8,High-Value,Potential Loyalists
90313,242,9,"211,7",5,2,1,8,High-Value,Potential Loyalists
90314,115,4,"297,3",5,1,1,7,Mid-Value,Potential Loyalists
90317,1431,3,"49,7",2,1,1,4,Low-Value,Can't Lose
90319,138,5,"410,55",5,1,1,7,Mid-Value,Potential Loyalists
90320,915,3,"197,45",3,1,1,5,Low-Value,At Risk Customers
90321,104,8,"474,35",5,2,1,8,High-Value,Potential Loyalists
90323,499,4,"388,29999999999995",4,1,1,6,Mid-Value,Potential Loyalists
90324,374,8,"609,25",4,2,1,7,Mid-Value,Potential Loyalists
90326,248,3,"55,0",5,1,1,7,Mid-Value,Potential Loyalists
90328,243,4,"211,7",5,1,1,7,Mid-Value,Potential Loyalists
90330,570,2,"50,050000000000004",4,1,1,6,Mid-Value,Potential Loyalists
90332,68,1,"20,05",5,1,1,7,Mid-Value,Potential Loyalists
90333,463,4,"120,10000000000001",4,1,1,6,Mid-Value,Potential Loyalists
90334,308,3,"145,0",5,1,1,7,Mid-Value,Potential Loyalists
90337,175,3,"41,75",5,1,1,7,Mid-Value,Potential Loyalists
90338,748,3,"96,8",3,1,1,5,Low-Value,At Risk Customers
90339,1347,1,"40,7",2,1,1,4,Low-Value,Can't Lose
90340,560,2,"129,1",4,1,1,6,Mid-Value,Potential Loyalists
90341,1061,1,"2,6",3,1,1,5,Low-Value,At Risk Customers
90342,86,5,"194,45",5,1,1,7,Mid-Value,Potential Loyalists
90345,391,1,"2,3",4,1,1,6,Mid-Value,Potential Loyalists
90346,387,5,"180,6",4,1,1,6,Mid-Value,Potential Loyalists
90348,1225,1,"130,35000000000002",2,1,1,4,Low-Value,Can't Lose
90349,471,3,"235,55",4,1,1,6,Mid-Value,Potential Loyalists
90355,204,5,"477,8",5,1,1,7,Mid-Value,Potential Loyalists
90358,1541,1,"77,55000000000001",1,1,1,3,Low-Value,Lost
90359,54,6,"251,85",5,1,1,7,Mid-Value,Potential Loyalists
90360,73,3,"87,15",5,1,1,7,Mid-Value,Potential Loyalists
90364,671,6,"397,55",4,1,1,6,Mid-Value,Potential Loyalists
90365,1056,2,"61,15",3,1,1,5,Low-Value,At Risk Customers
90368,52,5,"299,7",5,1,1,7,Mid-Value,Potential Loyalists
90369,147,6,"353,5",5,1,1,7,Mid-Value,Potential Loyalists
90371,622,4,"261,54999999999995",4,1,1,6,Mid-Value,Potential Loyalists
90372,859,4,"247,6",3,1,1,5,Low-Value,At Risk Customers
90373,899,2,"118,5",3,1,1,5,Low-Value,At Risk Customers
90374,266,3,"55,25",5,1,1,7,Mid-Value,Potential Loyalists
90375,151,7,"402,25",5,2,1,8,High-Value,Potential Loyalists
90377,1324,2,"102,14999999999999",2,1,1,4,Low-Value,Can't Lose
90378,430,4,"559,35",4,1,1,6,Mid-Value,Potential Loyalists
90380,145,2,"140,95",5,1,1,7,Mid-Value,Potential Loyalists
90381,545,1,"86,1",4,1,1,6,Mid-Value,Potential Loyalists
90382,508,3,"301,65",4,1,1,6,Mid-Value,Potential Loyalists
90384,779,7,"680,45",3,2,2,7,Mid-Value,Potential Loyalists
90385,108,13,"533,9",5,3,1,9,High-Value,Champions
90386,764,3,"466,0",3,1,1,5,Low-Value,At Risk Customers
90388,1574,1,"46,65",1,1,1,3,Low-Value,Lost
90389,55,1,"125,15",5,1,1,7,Mid-Value,Potential Loyalists
90392,1474,2,"94,75000000000001",1,1,1,3,Low-Value,Lost
90395,148,5,"450,45",5,1,1,7,Mid-Value,Potential Loyalists
90396,684,1,"26,55",4,1,1,6,Mid-Value,Potential Loyalists
90397,12,4,"174,6",5,1,1,7,Mid-Value,Potential Loyalists
90399,356,2,"83,5",5,1,1,7,Mid-Value,Potential Loyalists
90400,1036,2,"54,75",3,1,1,5,Low-Value,At Risk Customers
90402,623,5,"543,75",4,1,1,6,Mid-Value,Potential Loyalists
90404,155,2,"134,95",5,1,1,7,Mid-Value,Potential Loyalists
90405,123,7,"460,70000000000005",5,2,1,8,High-Value,Potential Loyalists
90406,461,3,"190,25",4,1,1,6,Mid-Value,Potential Loyalists
90408,775,2,"25,15",3,1,1,5,Low-Value,At Risk Customers
90409,84,4,"156,45",5,1,1,7,Mid-Value,Potential Loyalists
90410,124,5,"221,10000000000002",5,1,1,7,Mid-Value,Potential Loyalists
90411,34,10,"447,4",5,2,1,8,High-Value,Potential Loyalists
90412,214,10,"1013,3",5,2,2,9,High-Value,Champions
90416,1654,2,"39,400000000000006",1,1,1,3,Low-Value,Lost
90421,253,2,"61,349999999999994",5,1,1,7,Mid-Value,Potential Loyalists
90422,471,6,"231,75",4,1,1,6,Mid-Value,Potential Loyalists
90423,32,6,"338,2",5,1,1,7,Mid-Value,Potential Loyalists
90425,231,13,"576,45",5,3,1,9,High-Value,Champions
90427,296,6,"206,20000000000002",5,1,1,7,Mid-Value,Potential Loyalists
90428,1717,2,"59,550000000000004",1,1,1,3,Low-Value,Lost
90431,182,3,"120,6",5,1,1,7,Mid-Value,Potential Loyalists
90432,1653,1,"87,35",1,1,1,3,Low-Value,Lost
90433,1099,1,"31,2",2,1,1,4,Low-Value,Can't Lose
90434,200,4,"253,05",5,1,1,7,Mid-Value,Potential Loyalists
90435,47,9,"398,3",5,2,1,8,High-Value,Potential Loyalists
90436,30,7,"327,54999999999995",5,2,1,8,High-Value,Potential Loyalists
90438,1418,1,"12,5",2,1,1,4,Low-Value,Can't Lose
90439,123,3,"128,9",5,1,1,7,Mid-Value,Potential Loyalists
90440,1572,1,"51,5",1,1,1,3,Low-Value,Lost
90441,45,5,"87,3",5,1,1,7,Mid-Value,Potential Loyalists
90442,202,1,"14,4",5,1,1,7,Mid-Value,Potential Loyalists
90443,622,1,"17,75",4,1,1,6,Mid-Value,Potential Loyalists
90446,508,6,"478,8",4,1,1,6,Mid-Value,Potential Loyalists
90450,1168,1,"17,5",2,1,1,4,Low-Value,Can't Lose
90452,36,5,"274,3",5,1,1,7,Mid-Value,Potential Loyalists
90453,42,2,"50,8",5,1,1,7,Mid-Value,Potential Loyalists
90454,218,1,"42,9",5,1,1,7,Mid-Value,Potential Loyalists
90456,1132,1,"6,65",2,1,1,4,Low-Value,Can't Lose
90458,731,1,"110,95",3,1,1,5,Low-Value,At Risk Customers
90461,384,6,"239,05",4,1,1,6,Mid-Value,Potential Loyalists
90463,21,3,"81,95",5,1,1,7,Mid-Value,Potential Loyalists
90466,30,6,"266,25",5,1,1,7,Mid-Value,Potential Loyalists
90468,1733,1,"11,8",1,1,1,3,Low-Value,Lost
90469,995,1,"113,25",3,1,1,5,Low-Value,At Risk Customers
90470,526,2,"15,65",4,1,1,6,Mid-Value,Potential Loyalists
90472,90,7,"152,35",5,2,1,8,High-Value,Potential Loyalists
90475,198,2,"213,9",5,1,1,7,Mid-Value,Potential Loyalists
90476,862,1,"56,699999999999996",3,1,1,5,Low-Value,At Risk Customers
90478,437,3,"436,0",4,1,1,6,Mid-Value,Potential Loyalists
90479,1743,1,"43,45",1,1,1,3,Low-Value,Lost
90481,106,6,"199,95",5,1,1,7,Mid-Value,Potential Loyalists
90482,390,2,"180,55",4,1,1,6,Mid-Value,Potential Loyalists
90484,575,5,"343,85",4,1,1,6,Mid-Value,Potential Loyalists
90487,383,11,"483,65",4,2,1,7,Mid-Value,Potential Loyalists
90489,1037,3,"368,1",3,1,1,5,Low-Value,At Risk Customers
90490,1222,1,"18,8",2,1,1,4,Low-Value,Can't Lose
90491,1021,1,"4,75",3,1,1,5,Low-Value,At Risk Customers
90492,402,3,"167,5",4,1,1,6,Mid-Value,Potential Loyalists
90493,1751,1,"17,8",1,1,1,3,Low-Value,Lost
90494,1630,2,"308,6",1,1,1,3,Low-Value,Lost
90499,464,2,"107,5",4,1,1,6,Mid-Value,Potential Loyalists
90500,743,2,"109,25",3,1,1,5,Low-Value,At Risk Customers
90501,349,6,"391,34999999999997",5,1,1,7,Mid-Value,Potential Loyalists
90502,123,2,"117,15",5,1,1,7,Mid-Value,Potential Loyalists
90504,417,4,"96,4",4,1,1,6,Mid-Value,Potential Loyalists
90505,348,6,"90,85",5,1,1,7,Mid-Value,Potential Loyalists
90507,16,5,"83,3",5,1,1,7,Mid-Value,Potential Loyalists
90508,760,4,"273,85",3,1,1,5,Low-Value,At Risk Customers
90510,948,1,"81,3",3,1,1,5,Low-Value,At Risk Customers
90511,921,2,"54,6",3,1,1,5,Low-Value,At Risk Customers
90516,637,3,"164,85",4,1,1,6,Mid-Value,Potential Loyalists
90517,88,9,"698,5",5,2,2,9,High-Value,Champions
90518,1146,1,"36,95",2,1,1,4,Low-Value,Can't Lose
90519,108,3,"125,35",5,1,1,7,Mid-Value,Potential Loyalists
90520,165,1,"24,8",5,1,1,7,Mid-Value,Potential Loyalists
90525,1397,1,"58,9",2,1,1,4,Low-Value,Can't Lose
90527,1522,1,"86,65",1,1,1,3,Low-Value,Lost
90528,1471,2,"96,2",1,1,1,3,Low-Value,Lost
90529,154,6,"613,1",5,1,1,7,Mid-Value,Potential Loyalists
90530,544,1,"39,0",4,1,1,6,Mid-Value,Potential Loyalists
90531,317,3,"81,7",5,1,1,7,Mid-Value,Potential Loyalists
90532,11,5,"173,55",5,1,1,7,Mid-Value,Potential Loyalists
90533,494,2,"162,2",4,1,1,6,Mid-Value,Potential Loyalists
90535,956,3,"50,15",3,1,1,5,Low-Value,At Risk Customers
90536,1058,1,"7,5",3,1,1,5,Low-Value,At Risk Customers
90537,10,6,"132,25",5,1,1,7,Mid-Value,Potential Loyalists
90538,336,3,"146,85",5,1,1,7,Mid-Value,Potential Loyalists
90539,102,2,"72,75",5,1,1,7,Mid-Value,Potential Loyalists
90541,1,12,"520,1999999999999",5,3,1,9,High-Value,Champions
90544,676,1,"73,85",4,1,1,6,Mid-Value,Potential Loyalists
90545,17,7,"214,4",5,2,1,8,High-Value,Potential Loyalists
90549,834,1,"40,7",3,1,1,5,Low-Value,At Risk Customers
90551,1723,2,"21,8",1,1,1,3,Low-Value,Lost
90552,1568,2,"63,25",1,1,1,3,Low-Value,Lost
90553,507,4,"875,2",4,1,2,7,Mid-Value,Potential Loyalists
90557,563,3,"155,35",4,1,1,6,Mid-Value,Potential Loyalists
90559,356,3,"94,4",5,1,1,7,Mid-Value,Potential Loyalists
90561,804,3,"643,8000000000001",3,1,1,5,Low-Value,At Risk Customers
90562,423,10,"521,7",4,2,1,7,Mid-Value,Potential Loyalists
90563,444,12,"1424,25",4,3,3,10,High-Value,Champions
90564,873,1,"20,25",3,1,1,5,Low-Value,At Risk Customers
90566,798,4,"114,44999999999999",3,1,1,5,Low-Value,At Risk Customers
90568,1244,2,"133,75",2,1,1,4,Low-Value,Can't Lose
90571,387,3,"82,35",4,1,1,6,Mid-Value,Potential Loyalists
90572,454,3,"154,25",4,1,1,6,Mid-Value,Potential Loyalists
90573,407,5,"141,9",4,1,1,6,Mid-Value,Potential Loyalists
90574,1279,2,"88,20000000000002",2,1,1,4,Low-Value,Can't Lose
90575,569,1,"9,2",4,1,1,6,Mid-Value,Potential Loyalists
90577,1524,3,"80,65",1,1,1,3,Low-Value,Lost
90578,564,1,"103,1",4,1,1,6,Mid-Value,Potential Loyalists
90579,491,3,"440,35",4,1,1,6,Mid-Value,Potential Loyalists
90580,1319,3,"206,4",2,1,1,4,Low-Value,Can't Lose
90581,1602,2,"42,7",1,1,1,3,Low-Value,Lost
90583,1030,1,"13,0",3,1,1,5,Low-Value,At Risk Customers
90584,498,3,"158,15000000000003",4,1,1,6,Mid-Value,Potential Loyalists
90586,47,6,"162,29999999999998",5,1,1,7,Mid-Value,Potential Loyalists
90587,640,4,"53,0",4,1,1,6,Mid-Value,Potential Loyalists
90588,1321,1,"90,4",2,1,1,4,Low-Value,Can't Lose
90591,1173,3,"158,9",2,1,1,4,Low-Value,Can't Lose
90593,343,2,"154,2",5,1,1,7,Mid-Value,Potential Loyalists
90596,1100,4,"244,59999999999997",2,1,1,4,Low-Value,Can't Lose
90598,887,5,"204,0",3,1,1,5,Low-Value,At Risk Customers
90599,372,7,"385,65",4,2,1,7,Mid-Value,Potential Loyalists
90600,259,1,"38,8",5,1,1,7,Mid-Value,Potential Loyalists
90601,183,5,"206,1",5,1,1,7,Mid-Value,Potential Loyalists
90602,580,1,"14,4",4,1,1,6,Mid-Value,Potential Loyalists
90603,1117,1,"41,9",2,1,1,4,Low-Value,Can't Lose
90604,59,1,"14,5",5,1,1,7,Mid-Value,Potential Loyalists
90605,853,2,"133,9",3,1,1,5,Low-Value,At Risk Customers
90610,365,6,"347,8",5,1,1,7,Mid-Value,Potential Loyalists
90611,645,2,"71,05",4,1,1,6,Mid-Value,Potential Loyalists
90612,133,5,"208,89999999999998",5,1,1,7,Mid-Value,Potential Loyalists
90613,389,3,"420,65000000000003",4,1,1,6,Mid-Value,Potential Loyalists
90614,1152,1,"20,95",2,1,1,4,Low-Value,Can't Lose
90615,136,7,"644,1",5,2,1,8,High-Value,Potential Loyalists
90617,1351,1,"28,55",2,1,1,4,Low-Value,Can't Lose
90618,860,1,"11,5",3,1,1,5,Low-Value,At Risk Customers
90619,168,2,"338,05",5,1,1,7,Mid-Value,Potential Loyalists
90625,7,6,"253,5",5,1,1,7,Mid-Value,Potential Loyalists
90627,413,5,"290,35",4,1,1,6,Mid-Value,Potential Loyalists
90628,620,2,"78,65",4,1,1,6,Mid-Value,Potential Loyalists
90630,610,1,"20,1",4,1,1,6,Mid-Value,Potential Loyalists
90632,1695,1,"62,35",1,1,1,3,Low-Value,Lost
90633,935,2,"68,85",3,1,1,5,Low-Value,At Risk Customers
90635,330,1,"34,4",5,1,1,7,Mid-Value,Potential Loyalists
90637,19,10,"538,1",5,2,1,8,High-Value,Potential Loyalists
90638,132,12,"582,05",5,3,1,9,High-Value,Champions
90639,22,10,"567,8000000000001",5,2,1,8,High-Value,Potential Loyalists
90640,57,2,"95,8",5,1,1,7,Mid-Value,Potential Loyalists
90641,715,5,"324,65",4,1,1,6,Mid-Value,Potential Loyalists
90643,71,6,"195,75",5,1,1,7,Mid-Value,Potential Loyalists
90644,17,2,"423,2",5,1,1,7,Mid-Value,Potential Loyalists
90645,1397,1,"12,7",2,1,1,4,Low-Value,Can't Lose
90647,752,4,"159,04999999999998",3,1,1,5,Low-Value,At Risk Customers
90648,346,3,"307,7",5,1,1,7,Mid-Value,Potential Loyalists
90651,672,4,"203,85000000000002",4,1,1,6,Mid-Value,Potential Loyalists
90652,56,2,"40,949999999999996",5,1,1,7,Mid-Value,Potential Loyalists
90653,731,3,"124,85",3,1,1,5,Low-Value,At Risk Customers
90655,1676,1,"16,799999999999997",1,1,1,3,Low-Value,Lost
90657,845,2,"152,95",3,1,1,5,Low-Value,At Risk Customers
90658,957,2,"328,2",3,1,1,5,Low-Value,At Risk Customers
90659,899,3,"213,7",3,1,1,5,Low-Value,At Risk Customers
90662,111,6,"165,3",5,1,1,7,Mid-Value,Potential Loyalists
90663,21,6,"392,65",5,1,1,7,Mid-Value,Potential Loyalists
90666,273,4,"92,9",5,1,1,7,Mid-Value,Potential Loyalists
90670,568,1,"88,5",4,1,1,6,Mid-Value,Potential Loyalists
90671,621,4,"219,25",4,1,1,6,Mid-Value,Potential Loyalists
90672,438,2,"22,95",4,1,1,6,Mid-Value,Potential Loyalists
90673,83,3,"339,79999999999995",5,1,1,7,Mid-Value,Potential Loyalists
90674,328,2,"82,35",5,1,1,7,Mid-Value,Potential Loyalists
90675,529,2,"159,4",4,1,1,6,Mid-Value,Potential Loyalists
90677,53,1,"120,3",5,1,1,7,Mid-Value,Potential Loyalists
90679,13,11,"581,8",5,2,1,8,High-Value,Potential Loyalists
90682,705,3,"53,95",4,1,1,6,Mid-Value,Potential Loyalists
90683,23,3,"204,10000000000002",5,1,1,7,Mid-Value,Potential Loyalists
90685,1498,3,"221,5",1,1,1,3,Low-Value,Lost
90686,917,2,"28,4",3,1,1,5,Low-Value,At Risk Customers
90687,941,2,"69,15",3,1,1,5,Low-Value,At Risk Customers
90688,299,3,"120,15",5,1,1,7,Mid-Value,Potential Loyalists
90689,131,4,"248,05",5,1,1,7,Mid-Value,Potential Loyalists
90691,1039,3,"118,4",3,1,1,5,Low-Value,At Risk Customers
90693,928,2,"147,85",3,1,1,5,Low-Value,At Risk Customers
90694,538,5,"211,9",4,1,1,6,Mid-Value,Potential Loyalists
90697,539,1,"67,2",4,1,1,6,Mid-Value,Potential Loyalists
90698,977,3,"13,4",3,1,1,5,Low-Value,At Risk Customers
90699,407,3,"128,35",4,1,1,6,Mid-Value,Potential Loyalists
90700,447,1,"43,55",4,1,1,6,Mid-Value,Potential Loyalists
90701,1516,1,"13,55",1,1,1,3,Low-Value,Lost
90702,869,2,"93,95",3,1,1,5,Low-Value,At Risk Customers
90703,1730,1,"136,9",1,1,1,3,Low-Value,Lost
90704,621,1,"79,0",4,1,1,6,Mid-Value,Potential Loyalists
90706,714,5,"311,59999999999997",4,1,1,6,Mid-Value,Potential Loyalists
90707,718,1,"39,3",4,1,1,6,Mid-Value,Potential Loyalists
90709,388,6,"283,6",4,1,1,6,Mid-Value,Potential Loyalists
90710,77,4,"107,8",5,1,1,7,Mid-Value,Potential Loyalists
90715,302,1,"36,7",5,1,1,7,Mid-Value,Potential Loyalists
90716,1697,1,"15,0",1,1,1,3,Low-Value,Lost
90717,11,2,"127,0",5,1,1,7,Mid-Value,Potential Loyalists
90718,1050,2,"77,95",3,1,1,5,Low-Value,At Risk Customers
90719,409,1,"35,7",4,1,1,6,Mid-Value,Potential Loyalists
90720,64,2,"24,35",5,1,1,7,Mid-Value,Potential Loyalists
90721,569,3,"314,55",4,1,1,6,Mid-Value,Potential Loyalists
90722,1525,2,"18,2",1,1,1,3,Low-Value,Lost
90723,143,2,"277,8",5,1,1,7,Mid-Value,Potential Loyalists
90726,154,4,"149,1",5,1,1,7,Mid-Value,Potential Loyalists
90727,673,4,"116,35000000000001",4,1,1,6,Mid-Value,Potential Loyalists
90728,204,3,"344,84999999999997",5,1,1,7,Mid-Value,Potential Loyalists
90729,1183,1,"10,75",2,1,1,4,Low-Value,Can't Lose
90734,408,2,"13,3",4,1,1,6,Mid-Value,Potential Loyalists
90736,433,4,"212,2",4,1,1,6,Mid-Value,Potential Loyalists
90737,1525,2,"9,55",1,1,1,3,Low-Value,Lost
90738,1191,3,"180,4",2,1,1,4,Low-Value,Can't Lose
90739,1727,1,"23,05",1,1,1,3,Low-Value,Lost
90740,368,4,"376,35",4,1,1,6,Mid-Value,Potential Loyalists
90741,1181,2,"354,7",2,1,1,4,Low-Value,Can't Lose
90742,365,4,"221,8",5,1,1,7,Mid-Value,Potential Loyalists
90744,480,2,"74,7",4,1,1,6,Mid-Value,Potential Loyalists
90746,712,1,"1,75",4,1,1,6,Mid-Value,Potential Loyalists
90749,311,9,"418,8",5,2,1,8,High-Value,Potential Loyalists
90753,173,5,"296,55",5,1,1,7,Mid-Value,Potential Loyalists
90755,627,1,"42,15",4,1,1,6,Mid-Value,Potential Loyalists
90757,365,3,"100,25",5,1,1,7,Mid-Value,Potential Loyalists
90758,184,1,"361,4",5,1,1,7,Mid-Value,Potential Loyalists
90759,48,8,"249,45000000000002",5,2,1,8,High-Value,Potential Loyalists
90760,321,6,"175,55",5,1,1,7,Mid-Value,Potential Loyalists
90763,66,6,"153,45",5,1,1,7,Mid-Value,Potential Loyalists
90770,196,5,"171,2",5,1,1,7,Mid-Value,Potential Loyalists
90772,624,3,"75,0",4,1,1,6,Mid-Value,Potential Loyalists
90773,196,6,"129,8",5,1,1,7,Mid-Value,Potential Loyalists
90774,116,4,"215,1",5,1,1,7,Mid-Value,Potential Loyalists
90775,786,6,"257,7",3,1,1,5,Low-Value,At Risk Customers
90777,540,1,"270,0",4,1,1,6,Mid-Value,Potential Loyalists
90779,77,4,"233,89999999999998",5,1,1,7,Mid-Value,Potential Loyalists
90782,631,8,"932,4499999999999",4,2,2,8,High-Value,Potential Loyalists
90783,1249,1,"983,2",2,1,2,5,Low-Value,At Risk Customers
90784,177,4,"146,25",5,1,1,7,Mid-Value,Potential Loyalists
90785,64,7,"368,45000000000005",5,2,1,8,High-Value,Potential Loyalists
90786,244,1,"249,8",5,1,1,7,Mid-Value,Potential Loyalists
90789,852,1,"96,9",3,1,1,5,Low-Value,At Risk Customers
90792,339,4,"164,8",5,1,1,7,Mid-Value,Potential Loyalists
90795,122,5,"964,75",5,1,2,8,High-Value,Potential Loyalists
90796,116,2,"59,7",5,1,1,7,Mid-Value,Potential Loyalists
90797,730,1,"13,0",4,1,1,6,Mid-Value,Potential Loyalists
90798,209,2,"117,5",5,1,1,7,Mid-Value,Potential Loyalists
90799,126,12,"611,0",5,3,1,9,High-Value,Champions
90800,1594,1,"35,2",1,1,1,3,Low-Value,Lost
90802,278,2,"39,599999999999994",5,1,1,7,Mid-Value,Potential Loyalists
90803,34,4,"37,65",5,1,1,7,Mid-Value,Potential Loyalists
90805,90,1,"44,3",5,1,1,7,Mid-Value,Potential Loyalists
90807,524,4,"414,7",4,1,1,6,Mid-Value,Potential Loyalists
90808,916,2,"97,25",3,1,1,5,Low-Value,At Risk Customers
90811,448,8,"255,05",4,2,1,7,Mid-Value,Potential Loyalists
90813,98,13,"1290,5",5,3,2,10,High-Value,Champions
90814,465,3,"104,44999999999999",4,1,1,6,Mid-Value,Potential Loyalists
90815,192,2,"418,9",5,1,1,7,Mid-Value,Potential Loyalists
90817,574,1,"103,7",4,1,1,6,Mid-Value,Potential Loyalists
90818,972,6,"107,14999999999999",3,1,1,5,Low-Value,At Risk Customers
90820,687,1,"12,95",4,1,1,6,Mid-Value,Potential Loyalists
90821,59,4,"104,9",5,1,1,7,Mid-Value,Potential Loyalists
90824,515,7,"905,3",4,2,2,8,High-Value,Potential Loyalists
90826,459,6,"619,9",4,1,1,6,Mid-Value,Potential Loyalists
90830,27,9,"416,0",5,2,1,8,High-Value,Potential Loyalists
90833,425,5,"295,95",4,1,1,6,Mid-Value,Potential Loyalists
90834,115,13,"787,5",5,3,2,10,High-Value,Champions
90839,510,3,"122,0",4,1,1,6,Mid-Value,Potential Loyalists
90841,1650,2,"1028,0",1,1,2,4,Low-Value,Can't Lose
90844,1322,2,"287,04999999999995",2,1,1,4,Low-Value,Can't Lose
90845,5,5,"282,6",5,1,1,7,Mid-Value,Potential Loyalists
90846,1254,1,"108,4",2,1,1,4,Low-Value,Can't Lose
90848,171,4,"387,35",5,1,1,7,Mid-Value,Potential Loyalists
90851,717,3,"215,2",4,1,1,6,Mid-Value,Potential Loyalists
90852,1658,1,"165,2",1,1,1,3,Low-Value,Lost
90856,71,5,"234,45",5,1,1,7,Mid-Value,Potential Loyalists
90858,1535,3,"185,45000000000002",1,1,1,3,Low-Value,Lost
90860,496,8,"739,7",4,2,2,8,High-Value,Potential Loyalists
90861,892,2,"141,8",3,1,1,5,Low-Value,At Risk Customers
90864,134,2,"126,5",5,1,1,7,Mid-Value,Potential Loyalists
90865,362,1,"52,2",5,1,1,7,Mid-Value,Potential Loyalists
90868,19,1,"1,6",5,1,1,7,Mid-Value,Potential Loyalists
90869,35,6,"167,85",5,1,1,7,Mid-Value,Potential Loyalists
90870,204,3,"208,2",5,1,1,7,Mid-Value,Potential Loyalists
90872,84,5,"174,8",5,1,1,7,Mid-Value,Potential Loyalists
90873,377,3,"141,05",4,1,1,6,Mid-Value,Potential Loyalists
90874,1687,1,"212,0",1,1,1,3,Low-Value,Lost
90876,88,1,"79,9",5,1,1,7,Mid-Value,Potential Loyalists
90878,15,11,"848,15",5,2,2,9,High-Value,Champions
90880,381,4,"706,4",4,1,2,7,Mid-Value,Potential Loyalists
90881,115,4,"201,64999999999998",5,1,1,7,Mid-Value,Potential Loyalists
90882,551,3,"111,85",4,1,1,6,Mid-Value,Potential Loyalists
90883,196,3,"212,85",5,1,1,7,Mid-Value,Potential Loyalists
90885,68,3,"293,75",5,1,1,7,Mid-Value,Potential Loyalists
90887,1347,4,"237,65",2,1,1,4,Low-Value,Can't Lose
90888,1772,1,"22,8",1,1,1,3,Low-Value,Lost
90890,199,2,"112,5",5,1,1,7,Mid-Value,Potential Loyalists
90893,251,2,"72,75",5,1,1,7,Mid-Value,Potential Loyalists
90894,1306,1,"90,4",2,1,1,4,Low-Value,Can't Lose
90896,83,4,"1070,25",5,1,2,8,High-Value,Potential Loyalists
90898,758,2,"37,5",3,1,1,5,Low-Value,At Risk Customers
90899,1354,1,"52,4",2,1,1,4,Low-Value,Can't Lose
90900,243,7,"481,5",5,2,1,8,High-Value,Potential Loyalists
90901,883,3,"162,25",3,1,1,5,Low-Value,At Risk Customers
90902,883,3,"142,05",3,1,1,5,Low-Value,At Risk Customers
90904,47,3,"83,85",5,1,1,7,Mid-Value,Potential Loyalists
90905,1089,1,"9,15",3,1,1,5,Low-Value,At Risk Customers
90906,1089,1,"9,15",3,1,1,5,Low-Value,At Risk Customers
90907,1025,2,"253,55",3,1,1,5,Low-Value,At Risk Customers
90909,22,9,"550,1",5,2,1,8,High-Value,Potential Loyalists
90910,566,2,"86,14999999999999",4,1,1,6,Mid-Value,Potential Loyalists
90912,1057,1,"40,2",3,1,1,5,Low-Value,At Risk Customers
90913,44,5,"181,4",5,1,1,7,Mid-Value,Potential Loyalists
90915,307,1,"38,8",5,1,1,7,Mid-Value,Potential Loyalists
90916,123,2,"30,049999999999997",5,1,1,7,Mid-Value,Potential Loyalists
90918,376,4,"200,8",4,1,1,6,Mid-Value,Potential Loyalists
90919,153,4,"256,1",5,1,1,7,Mid-Value,Potential Loyalists
90920,13,9,"487,75",5,2,1,8,High-Value,Potential Loyalists
90921,139,6,"144,6",5,1,1,7,Mid-Value,Potential Loyalists
90925,2,5,"471,6",5,1,1,7,Mid-Value,Potential Loyalists
90926,1466,2,"220,75",1,1,1,3,Low-Value,Lost
90927,847,2,"100,60000000000001",3,1,1,5,Low-Value,At Risk Customers
90928,910,2,"279,34999999999997",3,1,1,5,Low-Value,At Risk Customers
90929,188,8,"328,5",5,2,1,8,High-Value,Potential Loyalists
90930,1771,1,"33,9",1,1,1,3,Low-Value,Lost
90932,1008,2,"193,5",3,1,1,5,Low-Value,At Risk Customers
90933,11,2,"73,6",5,1,1,7,Mid-Value,Potential Loyalists
90938,592,1,"5,5",4,1,1,6,Mid-Value,Potential Loyalists
90939,770,1,"20,45",3,1,1,5,Low-Value,At Risk Customers
90941,67,15,"466,5",5,3,1,9,High-Value,Champions
90943,11,6,"598,7",5,1,1,7,Mid-Value,Potential Loyalists
90944,4,6,"231,70000000000002",5,1,1,7,Mid-Value,Potential Loyalists
90945,155,5,"83,5",5,1,1,7,Mid-Value,Potential Loyalists
90948,12,3,"297,65",5,1,1,7,Mid-Value,Potential Loyalists
90955,92,3,"124,95",5,1,1,7,Mid-Value,Potential Loyalists
90959,408,3,"47,7",4,1,1,6,Mid-Value,Potential Loyalists
90961,616,1,"40,5",4,1,1,6,Mid-Value,Potential Loyalists
90962,484,9,"257,55",4,2,1,7,Mid-Value,Potential Loyalists
90963,166,3,"272,85",5,1,1,7,Mid-Value,Potential Loyalists
90965,1309,3,"158,5",2,1,1,4,Low-Value,Can't Lose
90966,931,2,"65,25",3,1,1,5,Low-Value,At Risk Customers
90968,31,3,"26,2",5,1,1,7,Mid-Value,Potential Loyalists
90972,1692,1,"15,6",1,1,1,3,Low-Value,Lost
90973,243,5,"180,29999999999998",5,1,1,7,Mid-Value,Potential Loyalists
90975,40,4,"147,15",5,1,1,7,Mid-Value,Potential Loyalists
90978,1261,1,"17,5",2,1,1,4,Low-Value,Can't Lose
90980,105,1,"15,9",5,1,1,7,Mid-Value,Potential Loyalists
90981,830,1,"38,05",3,1,1,5,Low-Value,At Risk Customers
90982,132,8,"240,35",5,2,1,8,High-Value,Potential Loyalists
90983,876,2,"274,0",3,1,1,5,Low-Value,At Risk Customers
90984,268,1,"71,25",5,1,1,7,Mid-Value,Potential Loyalists
90987,798,2,"36,3",3,1,1,5,Low-Value,At Risk Customers
90988,323,5,"444,5",5,1,1,7,Mid-Value,Potential Loyalists
90991,243,1,"12,15",5,1,1,7,Mid-Value,Potential Loyalists
90992,989,4,"152,75",3,1,1,5,Low-Value,At Risk Customers
90993,763,5,"161,14999999999998",3,1,1,5,Low-Value,At Risk Customers
90995,390,3,"162,95",4,1,1,6,Mid-Value,Potential Loyalists
90998,15,15,"1237,3",5,3,2,10,High-Value,Champions
91001,612,4,"394,85",4,1,1,6,Mid-Value,Potential Loyalists
91003,1403,1,"20,1",2,1,1,4,Low-Value,Can't Lose
91005,739,6,"558,7",3,1,1,5,Low-Value,At Risk Customers
91008,18,7,"751,8499999999999",5,2,2,9,High-Value,Champions
91010,35,4,"56,39999999999999",5,1,1,7,Mid-Value,Potential Loyalists
91012,416,6,"441,55",4,1,1,6,Mid-Value,Potential Loyalists
91013,28,3,"654,5",5,1,1,7,Mid-Value,Potential Loyalists
91014,11,5,"464,25",5,1,1,7,Mid-Value,Potential Loyalists
91015,236,1,"85,05000000000001",5,1,1,7,Mid-Value,Potential Loyalists
91016,14,11,"1607,7",5,2,3,10,High-Value,Champions
91018,384,1,"46,0",4,1,1,6,Mid-Value,Potential Loyalists
91019,70,4,"126,35",5,1,1,7,Mid-Value,Potential Loyalists
91020,454,3,"189,4",4,1,1,6,Mid-Value,Potential Loyalists
91021,554,3,"124,9",4,1,1,6,Mid-Value,Potential Loyalists
91023,173,7,"250,1",5,2,1,8,High-Value,Potential Loyalists
91024,435,3,"201,55",4,1,1,6,Mid-Value,Potential Loyalists
91028,9,3,"282,85",5,1,1,7,Mid-Value,Potential Loyalists
91029,1519,2,"71,45",1,1,1,3,Low-Value,Lost
91030,266,3,"448,9",5,1,1,7,Mid-Value,Potential Loyalists
91031,1641,1,"479,2",1,1,1,3,Low-Value,Lost
91032,1301,1,"15,0",2,1,1,4,Low-Value,Can't Lose
91033,163,4,"207,85",5,1,1,7,Mid-Value,Potential Loyalists
91034,89,6,"953,95",5,1,2,8,High-Value,Potential Loyalists
91035,1515,2,"199,05",1,1,1,3,Low-Value,Lost
91036,24,3,"276,05",5,1,1,7,Mid-Value,Potential Loyalists
91037,790,3,"340,4",3,1,1,5,Low-Value,At Risk Customers
91039,1,3,"170,0",5,1,1,7,Mid-Value,Potential Loyalists
91042,31,4,"559,9",5,1,1,7,Mid-Value,Potential Loyalists
91045,409,2,"24,65",4,1,1,6,Mid-Value,Potential Loyalists
91046,12,7,"497,2",5,2,1,8,High-Value,Potential Loyalists
91047,329,2,"105,85",5,1,1,7,Mid-Value,Potential Loyalists
91049,146,11,"358,26",5,2,1,8,High-Value,Potential Loyalists
91051,363,5,"761,15",5,1,2,8,High-Value,Potential Loyalists
91052,462,1,"29,9",4,1,1,6,Mid-Value,Potential Loyalists
91054,260,4,"82,4",5,1,1,7,Mid-Value,Potential Loyalists
91055,1428,1,"5,4",2,1,1,4,Low-Value,Can't Lose
91056,52,5,"868,9",5,1,2,8,High-Value,Potential Loyalists
91057,707,1,"34,65",4,1,1,6,Mid-Value,Potential Loyalists
91058,916,1,"38,5",3,1,1,5,Low-Value,At Risk Customers
91059,883,3,"340,15",3,1,1,5,Low-Value,At Risk Customers
91062,1074,1,"23,45",3,1,1,5,Low-Value,At Risk Customers
91063,243,8,"490,05",5,2,1,8,High-Value,Potential Loyalists
91065,853,2,"100,6",3,1,1,5,Low-Value,At Risk Customers
91067,748,5,"594,8",3,1,1,5,Low-Value,At Risk Customers
91068,570,6,"641,0500000000001",4,1,1,6,Mid-Value,Potential Loyalists
91069,101,5,"104,85",5,1,1,7,Mid-Value,Potential Loyalists
91070,338,3,"104,95",5,1,1,7,Mid-Value,Potential Loyalists
91071,421,2,"144,95",4,1,1,6,Mid-Value,Potential Loyalists
91072,645,3,"65,0",4,1,1,6,Mid-Value,Potential Loyalists
91075,1814,1,"23,4",1,1,1,3,Low-Value,Lost
91076,1298,1,"103,6",2,1,1,4,Low-Value,Can't Lose
91077,400,2,"47,0",4,1,1,6,Mid-Value,Potential Loyalists
91078,1473,7,"1204,3",1,2,2,5,Low-Value,At Risk Customers
91080,381,3,"73,44999999999999",4,1,1,6,Mid-Value,Potential Loyalists
91083,654,3,"259,4",4,1,1,6,Mid-Value,Potential Loyalists
91084,412,3,"131,8",4,1,1,6,Mid-Value,Potential Loyalists
91085,575,4,"250,70000000000002",4,1,1,6,Mid-Value,Potential Loyalists
91088,1735,1,"255,9",1,1,1,3,Low-Value,Lost
91089,30,9,"863,65",5,2,2,9,High-Value,Champions
91090,369,2,"382,20000000000005",4,1,1,6,Mid-Value,Potential Loyalists
91092,1475,1,"136,0",1,1,1,3,Low-Value,Lost
91093,222,5,"200,4",5,1,1,7,Mid-Value,Potential Loyalists
91094,82,7,"367,85",5,2,1,8,High-Value,Potential Loyalists
91095,1008,2,"87,3",3,1,1,5,Low-Value,At Risk Customers
91096,445,2,"38,4",4,1,1,6,Mid-Value,Potential Loyalists
91097,293,2,"125,14999999999999",5,1,1,7,Mid-Value,Potential Loyalists
91098,1728,1,"47,7",1,1,1,3,Low-Value,Lost
91100,23,5,"221,6",5,1,1,7,Mid-Value,Potential Loyalists
91101,1266,2,"100,05000000000001",2,1,1,4,Low-Value,Can't Lose
91102,16,1,"71,2",5,1,1,7,Mid-Value,Potential Loyalists
91104,36,1,"18,55",5,1,1,7,Mid-Value,Potential Loyalists
91106,1097,3,"123,85000000000001",2,1,1,4,Low-Value,Can't Lose
91107,742,4,"206,29999999999998",3,1,1,5,Low-Value,At Risk Customers
91108,1165,1,"22,1",2,1,1,4,Low-Value,Can't Lose
91110,337,6,"311,5",5,1,1,7,Mid-Value,Potential Loyalists
91113,1271,2,"169,95",2,1,1,4,Low-Value,Can't Lose
91114,617,3,"307,95",4,1,1,6,Mid-Value,Potential Loyalists
91115,637,2,"121,9",4,1,1,6,Mid-Value,Potential Loyalists
91116,358,5,"229,15",5,1,1,7,Mid-Value,Potential Loyalists
91118,267,7,"377,55",5,2,1,8,High-Value,Potential Loyalists
91119,1093,1,"9,75",3,1,1,5,Low-Value,At Risk Customers
91120,539,8,"624,0",4,2,1,7,Mid-Value,Potential Loyalists
91122,206,6,"363,3",5,1,1,7,Mid-Value,Potential Loyalists
91123,34,2,"38,5",5,1,1,7,Mid-Value,Potential Loyalists
91125,79,1,"9,55",5,1,1,7,Mid-Value,Potential Loyalists
91126,545,4,"147,39999999999998",4,1,1,6,Mid-Value,Potential Loyalists
91127,300,8,"451,4",5,2,1,8,High-Value,Potential Loyalists
91128,870,4,"596,7",3,1,1,5,Low-Value,At Risk Customers
91132,323,3,"115,95",5,1,1,7,Mid-Value,Potential Loyalists
91134,698,5,"108,2",4,1,1,6,Mid-Value,Potential Loyalists
91138,264,3,"382,0",5,1,1,7,Mid-Value,Potential Loyalists
91139,1599,1,"22,8",1,1,1,3,Low-Value,Lost
91141,298,5,"76,85",5,1,1,7,Mid-Value,Potential Loyalists
91143,759,6,"588,0999999999999",3,1,1,5,Low-Value,At Risk Customers
91145,795,3,"89,65",3,1,1,5,Low-Value,At Risk Customers
91146,20,4,"213,05",5,1,1,7,Mid-Value,Potential Loyalists
91147,631,3,"88,39999999999999",4,1,1,6,Mid-Value,Potential Loyalists
91148,456,5,"206,25",4,1,1,6,Mid-Value,Potential Loyalists
91149,120,1,"58,6",5,1,1,7,Mid-Value,Potential Loyalists
91150,788,2,"84,3",3,1,1,5,Low-Value,At Risk Customers
91151,27,1,"502,20000000000005",5,1,1,7,Mid-Value,Potential Loyalists
91152,143,1,"143,6",5,1,1,7,Mid-Value,Potential Loyalists
91153,14,1,"64,1",5,1,1,7,Mid-Value,Potential Loyalists
91154,426,9,"171,15",4,2,1,7,Mid-Value,Potential Loyalists
91155,1160,2,"97,3",2,1,1,4,Low-Value,Can't Lose
91156,355,3,"175,5",5,1,1,7,Mid-Value,Potential Loyalists
91159,516,2,"57,2",4,1,1,6,Mid-Value,Potential Loyalists
91160,463,2,"295,7",4,1,1,6,Mid-Value,Potential Loyalists
91161,70,5,"240,95",5,1,1,7,Mid-Value,Potential Loyalists
91162,1176,3,"51,2",2,1,1,4,Low-Value,Can't Lose
91163,11,5,"113,94999999999999",5,1,1,7,Mid-Value,Potential Loyalists
91165,1527,2,"71,0",1,1,1,3,Low-Value,Lost
91166,32,2,"148,10000000000002",5,1,1,7,Mid-Value,Potential Loyalists
91167,1166,7,"382,0",2,2,1,5,Low-Value,At Risk Customers
91168,167,3,"125,35",5,1,1,7,Mid-Value,Potential Loyalists
91169,44,3,"63,0",5,1,1,7,Mid-Value,Potential Loyalists
91172,924,3,"435,45000000000005",3,1,1,5,Low-Value,At Risk Customers
91173,599,3,"106,6",4,1,1,6,Mid-Value,Potential Loyalists
91174,507,2,"228,3",4,1,1,6,Mid-Value,Potential Loyalists
91176,94,6,"371,8",5,1,1,7,Mid-Value,Potential Loyalists
91177,101,3,"34,85",5,1,1,7,Mid-Value,Potential Loyalists
91178,268,26,"1540,55",5,5,3,13,High-Value,Champions
91179,130,1,"50,25",5,1,1,7,Mid-Value,Potential Loyalists
91180,302,1,"15,9",5,1,1,7,Mid-Value,Potential Loyalists
91181,498,6,"410,8",4,1,1,6,Mid-Value,Potential Loyalists
91182,1114,1,"11,5",2,1,1,4,Low-Value,Can't Lose
91183,15,3,"134,1",5,1,1,7,Mid-Value,Potential Loyalists
91184,467,3,"302,6",4,1,1,6,Mid-Value,Potential Loyalists
91186,74,8,"252,79999999999998",5,2,1,8,High-Value,Potential Loyalists
91187,838,1,"51,65",3,1,1,5,Low-Value,At Risk Customers
91190,656,7,"316,75",4,2,1,7,Mid-Value,Potential Loyalists
91192,521,4,"110,85",4,1,1,6,Mid-Value,Potential Loyalists
91193,206,4,"266,85",5,1,1,7,Mid-Value,Potential Loyalists
91195,22,2,"254,85",5,1,1,7,Mid-Value,Potential Loyalists
91199,541,2,"56,2",4,1,1,6,Mid-Value,Potential Loyalists
91200,1683,1,"29,05",1,1,1,3,Low-Value,Lost
91201,48,5,"341,65000000000003",5,1,1,7,Mid-Value,Potential Loyalists
91204,61,3,"96,9",5,1,1,7,Mid-Value,Potential Loyalists
91206,198,2,"119,65",5,1,1,7,Mid-Value,Potential Loyalists
91207,13,6,"735,8499999999999",5,1,2,8,High-Value,Potential Loyalists
91208,488,2,"762,25",4,1,2,7,Mid-Value,Potential Loyalists
91209,164,2,"287,0",5,1,1,7,Mid-Value,Potential Loyalists
91210,1148,2,"41,099999999999994",2,1,1,4,Low-Value,Can't Lose
91211,575,3,"87,95",4,1,1,6,Mid-Value,Potential Loyalists
91213,262,3,"172,6",5,1,1,7,Mid-Value,Potential Loyalists
91214,274,6,"189,85",5,1,1,7,Mid-Value,Potential Loyalists
91215,566,3,"151,89999999999998",4,1,1,6,Mid-Value,Potential Loyalists
91217,1352,1,"16,15",2,1,1,4,Low-Value,Can't Lose
91219,1134,2,"76,15",2,1,1,4,Low-Value,Can't Lose
91220,1670,1,"193,8",1,1,1,3,Low-Value,Lost
91221,1527,2,"91,1",1,1,1,3,Low-Value,Lost
91222,21,9,"794,1",5,2,2,9,High-Value,Champions
91225,857,2,"212,0",3,1,1,5,Low-Value,At Risk Customers
91227,457,2,"75,35",4,1,1,6,Mid-Value,Potential Loyalists
91228,617,4,"79,5",4,1,1,6,Mid-Value,Potential Loyalists
91229,594,3,"142,6",4,1,1,6,Mid-Value,Potential Loyalists
91231,860,6,"336,45",3,1,1,5,Low-Value,At Risk Customers
91234,954,2,"125,35000000000001",3,1,1,5,Low-Value,At Risk Customers
91237,188,2,"99,1",5,1,1,7,Mid-Value,Potential Loyalists
91238,1355,2,"70,35000000000001",2,1,1,4,Low-Value,Can't Lose
91239,752,1,"22,5",3,1,1,5,Low-Value,At Risk Customers
91241,1678,1,"21,45",1,1,1,3,Low-Value,Lost
91242,81,1,"108,6",5,1,1,7,Mid-Value,Potential Loyalists
91244,215,6,"385,6",5,1,1,7,Mid-Value,Potential Loyalists
91245,10,11,"482,9",5,2,1,8,High-Value,Potential Loyalists
91246,1744,1,"13,15",1,1,1,3,Low-Value,Lost
91247,1678,1,"149,8",1,1,1,3,Low-Value,Lost
91248,12,19,"1587,8999999999999",5,4,3,12,High-Value,Champions
91253,431,3,"81,85",4,1,1,6,Mid-Value,Potential Loyalists
91256,1529,1,"28,35",1,1,1,3,Low-Value,Lost
91258,1059,1,"41,4",3,1,1,5,Low-Value,At Risk Customers
91261,5,7,"399,70000000000005",5,2,1,8,High-Value,Potential Loyalists
91265,573,3,"385,95",4,1,1,6,Mid-Value,Potential Loyalists
91266,1121,5,"538,4",2,1,1,4,Low-Value,Can't Lose
91267,1385,1,"36,65",2,1,1,4,Low-Value,Can't Lose
91268,1023,2,"151,6",3,1,1,5,Low-Value,At Risk Customers
91269,382,3,"389,5",4,1,1,6,Mid-Value,Potential Loyalists
91270,1441,1,"25,2",2,1,1,4,Low-Value,Can't Lose
91273,1336,2,"200,75",2,1,1,4,Low-Value,Can't Lose
91276,403,4,"133,7",4,1,1,6,Mid-Value,Potential Loyalists
91277,1673,1,"9,45",1,1,1,3,Low-Value,Lost
91278,510,3,"173,3",4,1,1,6,Mid-Value,Potential Loyalists
91279,743,1,"59,6",3,1,1,5,Low-Value,At Risk Customers
91280,145,7,"799,05",5,2,2,9,High-Value,Champions
91281,1002,1,"14,15",3,1,1,5,Low-Value,At Risk Customers
91284,305,3,"202,45000000000002",5,1,1,7,Mid-Value,Potential Loyalists
91285,72,5,"189,14999999999998",5,1,1,7,Mid-Value,Potential Loyalists
91287,19,2,"261,7",5,1,1,7,Mid-Value,Potential Loyalists
91288,894,3,"253,4",3,1,1,5,Low-Value,At Risk Customers
91289,429,3,"450,75",4,1,1,6,Mid-Value,Potential Loyalists
91290,1131,1,"105,7",2,1,1,4,Low-Value,Can't Lose
91291,70,6,"363,3",5,1,1,7,Mid-Value,Potential Loyalists
91292,120,3,"214,54999999999998",5,1,1,7,Mid-Value,Potential Loyalists
91294,11,6,"756,5",5,1,2,8,High-Value,Potential Loyalists
91297,965,3,"106,15",3,1,1,5,Low-Value,At Risk Customers
91298,193,1,"21,75",5,1,1,7,Mid-Value,Potential Loyalists
91300,328,2,"96,1",5,1,1,7,Mid-Value,Potential Loyalists
91302,102,1,"100,65",5,1,1,7,Mid-Value,Potential Loyalists
91305,137,9,"627,75",5,2,1,8,High-Value,Potential Loyalists
91309,29,2,"94,75",5,1,1,7,Mid-Value,Potential Loyalists
91312,1104,1,"75,7",2,1,1,4,Low-Value,Can't Lose
91313,52,4,"284,8",5,1,1,7,Mid-Value,Potential Loyalists
91315,532,3,"127,15",4,1,1,6,Mid-Value,Potential Loyalists
91316,1344,2,"117,19999999999999",2,1,1,4,Low-Value,Can't Lose
91317,320,4,"195,39999999999998",5,1,1,7,Mid-Value,Potential Loyalists
91318,10,2,"237,7",5,1,1,7,Mid-Value,Potential Loyalists
91319,124,2,"186,65",5,1,1,7,Mid-Value,Potential Loyalists
91321,1117,1,"12,7",2,1,1,4,Low-Value,Can't Lose
91323,877,2,"89,69999999999999",3,1,1,5,Low-Value,At Risk Customers
91325,1461,1,"30,8",1,1,1,3,Low-Value,Lost
91326,789,10,"534,05",3,2,1,6,Mid-Value,Potential Loyalists
91327,103,2,"102,7",5,1,1,7,Mid-Value,Potential Loyalists
91328,708,2,"40,4",4,1,1,6,Mid-Value,Potential Loyalists
91329,1423,1,"117,4",2,1,1,4,Low-Value,Can't Lose
91331,144,3,"304,75",5,1,1,7,Mid-Value,Potential Loyalists
91334,170,3,"152,65",5,1,1,7,Mid-Value,Potential Loyalists
91335,368,6,"397,55",4,1,1,6,Mid-Value,Potential Loyalists
91337,820,10,"597,2",3,2,1,6,Mid-Value,Potential Loyalists
91338,647,2,"42,45",4,1,1,6,Mid-Value,Potential Loyalists
91339,1422,1,"154,55",2,1,1,4,Low-Value,Can't Lose
91340,316,2,"88,3",5,1,1,7,Mid-Value,Potential Loyalists
91341,55,8,"371,84999999999997",5,2,1,8,High-Value,Potential Loyalists
91342,8,1,"19,35",5,1,1,7,Mid-Value,Potential Loyalists
91343,1706,1,"20,4",1,1,1,3,Low-Value,Lost
91344,1113,2,"97,3",2,1,1,4,Low-Value,Can't Lose
91345,219,4,"240,7",5,1,1,7,Mid-Value,Potential Loyalists
91346,208,1,"54,1",5,1,1,7,Mid-Value,Potential Loyalists
91347,231,3,"205,60000000000002",5,1,1,7,Mid-Value,Potential Loyalists
91351,183,5,"95,95",5,1,1,7,Mid-Value,Potential Loyalists
91353,142,3,"435,55",5,1,1,7,Mid-Value,Potential Loyalists
91354,418,1,"12,5",4,1,1,6,Mid-Value,Potential Loyalists
91355,600,1,"8,55",4,1,1,6,Mid-Value,Potential Loyalists
91356,1234,5,"290,05",2,1,1,4,Low-Value,Can't Lose
91357,149,1,"46,9",5,1,1,7,Mid-Value,Potential Loyalists
91362,1373,2,"98,35",2,1,1,4,Low-Value,Can't Lose
91364,95,3,"130,9",5,1,1,7,Mid-Value,Potential Loyalists
91365,929,3,"71,94999999999999",3,1,1,5,Low-Value,At Risk Customers
91366,268,2,"97,19999999999999",5,1,1,7,Mid-Value,Potential Loyalists
91369,1210,2,"16,299999999999997",2,1,1,4,Low-Value,Can't Lose
91373,477,5,"185,6",4,1,1,6,Mid-Value,Potential Loyalists
91374,753,3,"167,3",3,1,1,5,Low-Value,At Risk Customers
91375,428,5,"896,65",4,1,2,7,Mid-Value,Potential Loyalists
91376,164,3,"152,15",5,1,1,7,Mid-Value,Potential Loyalists
91377,23,7,"204,25",5,2,1,8,High-Value,Potential Loyalists
91379,852,1,"23,5",3,1,1,5,Low-Value,At Risk Customers
91382,769,2,"90,7",3,1,1,5,Low-Value,At Risk Customers
91384,190,5,"259,75",5,1,1,7,Mid-Value,Potential Loyalists
91385,802,1,"63,2",3,1,1,5,Low-Value,At Risk Customers
91387,869,2,"30,0",3,1,1,5,Low-Value,At Risk Customers
91389,627,1,"168,05",4,1,1,6,Mid-Value,Potential Loyalists
91390,421,3,"826,65",4,1,2,7,Mid-Value,Potential Loyalists
91392,52,10,"942,3",5,2,2,9,High-Value,Champions
91393,12,7,"398,2",5,2,1,8,High-Value,Potential Loyalists
91394,828,6,"310,45",3,1,1,5,Low-Value,At Risk Customers
91395,707,4,"103,95",4,1,1,6,Mid-Value,Potential Loyalists
91396,955,1,"70,0",3,1,1,5,Low-Value,At Risk Customers
91397,790,1,"175,2",3,1,1,5,Low-Value,At Risk Customers
91399,1199,2,"44,85",2,1,1,4,Low-Value,Can't Lose
91401,393,5,"449,2",4,1,1,6,Mid-Value,Potential Loyalists
91402,988,1,"61,0",3,1,1,5,Low-Value,At Risk Customers
91403,964,2,"277,90000000000003",3,1,1,5,Low-Value,At Risk Customers
91404,150,1,"10,2",5,1,1,7,Mid-Value,Potential Loyalists
91408,1410,2,"267,2",2,1,1,4,Low-Value,Can't Lose
91409,590,2,"56,45",4,1,1,6,Mid-Value,Potential Loyalists
91411,247,3,"45,8",5,1,1,7,Mid-Value,Potential Loyalists
91412,732,2,"307,0",3,1,1,5,Low-Value,At Risk Customers
91413,157,13,"1002,45",5,3,2,10,High-Value,Champions
91415,566,3,"295,45",4,1,1,6,Mid-Value,Potential Loyalists
91417,443,1,"56,35",4,1,1,6,Mid-Value,Potential Loyalists
91420,2,1,"12,25",5,1,1,7,Mid-Value,Potential Loyalists
91425,78,3,"131,8",5,1,1,7,Mid-Value,Potential Loyalists
91426,608,4,"227,7",4,1,1,6,Mid-Value,Potential Loyalists
91427,159,3,"193,25000000000003",5,1,1,7,Mid-Value,Potential Loyalists
91432,1143,9,"937,75",2,2,2,6,Mid-Value,Potential Loyalists
91433,166,9,"514,15",5,2,1,8,High-Value,Potential Loyalists
91435,1327,4,"257,55",2,1,1,4,Low-Value,Can't Lose
91436,129,11,"706,2",5,2,2,9,High-Value,Champions
91438,101,4,"707,1",5,1,2,8,High-Value,Potential Loyalists
91439,835,7,"390,7",3,2,1,6,Mid-Value,Potential Loyalists
91440,1616,1,"27,9",1,1,1,3,Low-Value,Lost
91441,795,3,"274,6",3,1,1,5,Low-Value,At Risk Customers
91442,1337,1,"7,0",2,1,1,4,Low-Value,Can't Lose
91443,3,10,"698,2",5,2,2,9,High-Value,Champions
91444,1662,1,"8,25",1,1,1,3,Low-Value,Lost
91445,376,3,"88,8",4,1,1,6,Mid-Value,Potential Loyalists
91446,14,4,"282,8",5,1,1,7,Mid-Value,Potential Loyalists
91447,426,3,"102,4",4,1,1,6,Mid-Value,Potential Loyalists
91448,1295,1,"9,35",2,1,1,4,Low-Value,Can't Lose
91449,633,1,"45,5",4,1,1,6,Mid-Value,Potential Loyalists
91450,400,2,"10,95",4,1,1,6,Mid-Value,Potential Loyalists
91451,26,10,"289,2",5,2,1,8,High-Value,Potential Loyalists
91452,750,1,"494,5",3,1,1,5,Low-Value,At Risk Customers
91453,10,2,"92,3",5,1,1,7,Mid-Value,Potential Loyalists
91455,742,5,"335,3",3,1,1,5,Low-Value,At Risk Customers
91457,343,4,"591,95",5,1,1,7,Mid-Value,Potential Loyalists
91458,180,3,"249,85000000000002",5,1,1,7,Mid-Value,Potential Loyalists
91463,67,1,"8,4",5,1,1,7,Mid-Value,Potential Loyalists
91465,894,2,"83,25",3,1,1,5,Low-Value,At Risk Customers
91470,398,2,"344,85",4,1,1,6,Mid-Value,Potential Loyalists
91471,26,17,"888,7",5,4,2,11,High-Value,Champions
91472,194,5,"285,6",5,1,1,7,Mid-Value,Potential Loyalists
91473,147,2,"100,4",5,1,1,7,Mid-Value,Potential Loyalists
91474,1313,1,"54,8",2,1,1,4,Low-Value,Can't Lose
91476,1179,2,"190,70000000000002",2,1,1,4,Low-Value,Can't Lose
91477,432,2,"63,9",4,1,1,6,Mid-Value,Potential Loyalists
91480,105,2,"42,5",5,1,1,7,Mid-Value,Potential Loyalists
91481,1606,1,"16,25",1,1,1,3,Low-Value,Lost
91482,731,1,"33,5",3,1,1,5,Low-Value,At Risk Customers
91483,1370,1,"39,25",2,1,1,4,Low-Value,Can't Lose
91488,678,1,"84,3",4,1,1,6,Mid-Value,Potential Loyalists
91489,757,1,"189,6",3,1,1,5,Low-Value,At Risk Customers
91490,160,4,"563,55",5,1,1,7,Mid-Value,Potential Loyalists
91492,918,1,"109,6",3,1,1,5,Low-Value,At Risk Customers
91496,773,1,"10,15",3,1,1,5,Low-Value,At Risk Customers
91498,888,3,"275,25",3,1,1,5,Low-Value,At Risk Customers
91499,51,4,"66,5",5,1,1,7,Mid-Value,Potential Loyalists
91500,1613,3,"551,9",1,1,1,3,Low-Value,Lost
91502,998,5,"264,6",3,1,1,5,Low-Value,At Risk Customers
91504,152,12,"734,9",5,3,2,10,High-Value,Champions
91505,406,4,"177,85",4,1,1,6,Mid-Value,Potential Loyalists
91506,1111,1,"12,3",2,1,1,4,Low-Value,Can't Lose
91508,15,4,"165,70000000000002",5,1,1,7,Mid-Value,Potential Loyalists
91509,368,4,"107,25",4,1,1,6,Mid-Value,Potential Loyalists
91510,1158,1,"30,35",2,1,1,4,Low-Value,Can't Lose
91511,30,6,"258,05",5,1,1,7,Mid-Value,Potential Loyalists
91512,941,1,"67,8",3,1,1,5,Low-Value,At Risk Customers
91513,183,1,"73,4",5,1,1,7,Mid-Value,Potential Loyalists
91514,353,1,"8,9",5,1,1,7,Mid-Value,Potential Loyalists
91516,983,1,"29,6",3,1,1,5,Low-Value,At Risk Customers
91518,1270,2,"135,5",2,1,1,4,Low-Value,Can't Lose
91519,842,2,"41,85",3,1,1,5,Low-Value,At Risk Customers
91521,234,3,"922,5",5,1,2,8,High-Value,Potential Loyalists
91522,157,3,"260,05",5,1,1,7,Mid-Value,Potential Loyalists
91523,144,2,"188,0",5,1,1,7,Mid-Value,Potential Loyalists
91524,829,4,"228,5",3,1,1,5,Low-Value,At Risk Customers
91527,492,3,"221,1",4,1,1,6,Mid-Value,Potential Loyalists
91529,503,1,"6,6",4,1,1,6,Mid-Value,Potential Loyalists
91530,377,1,"73,4",4,1,1,6,Mid-Value,Potential Loyalists
91531,1,8,"564,3000000000001",5,2,1,8,High-Value,Potential Loyalists
91532,189,1,"101,69999999999999",5,1,1,7,Mid-Value,Potential Loyalists
91533,107,2,"21,3",5,1,1,7,Mid-Value,Potential Loyalists
91535,500,1,"161,8",4,1,1,6,Mid-Value,Potential Loyalists
91536,826,1,"38,4",3,1,1,5,Low-Value,At Risk Customers
91539,46,2,"45,95",5,1,1,7,Mid-Value,Potential Loyalists
91541,490,5,"345,09999999999997",4,1,1,6,Mid-Value,Potential Loyalists
91543,1606,1,"74,1",1,1,1,3,Low-Value,Lost
91544,518,1,"67,65",4,1,1,6,Mid-Value,Potential Loyalists
91545,84,2,"42,0",5,1,1,7,Mid-Value,Potential Loyalists
91550,717,2,"65,35",4,1,1,6,Mid-Value,Potential Loyalists
91551,205,11,"710,45",5,2,2,9,High-Value,Champions
91553,137,7,"236,15",5,2,1,8,High-Value,Potential Loyalists
91554,908,2,"573,55",3,1,1,5,Low-Value,At Risk Customers
91555,742,1,"41,3",3,1,1,5,Low-Value,At Risk Customers
91556,1302,3,"362,35",2,1,1,4,Low-Value,Can't Lose
91558,172,1,"78,0",5,1,1,7,Mid-Value,Potential Loyalists
91561,934,3,"123,0",3,1,1,5,Low-Value,At Risk Customers
91562,1796,1,"62,85",1,1,1,3,Low-Value,Lost
91563,315,1,"11,3",5,1,1,7,Mid-Value,Potential Loyalists
91564,784,3,"440,95",3,1,1,5,Low-Value,At Risk Customers
91565,258,9,"502,6",5,2,1,8,High-Value,Potential Loyalists
91566,1082,4,"334,15000000000003",3,1,1,5,Low-Value,At Risk Customers
91567,8,10,"386,55",5,2,1,8,High-Value,Potential Loyalists
91570,453,5,"520,25",4,1,1,6,Mid-Value,Potential Loyalists
91571,1340,1,"157,64999999999998",2,1,1,4,Low-Value,Can't Lose
91573,111,4,"1129,8500000000001",5,1,2,8,High-Value,Potential Loyalists
91574,969,2,"172,6",3,1,1,5,Low-Value,At Risk Customers
91575,400,1,"9,95",4,1,1,6,Mid-Value,Potential Loyalists
91576,628,5,"1149,1",4,1,2,7,Mid-Value,Potential Loyalists
91577,326,4,"423,05",5,1,1,7,Mid-Value,Potential Loyalists
91581,74,7,"727,45",5,2,2,9,High-Value,Champions
91583,581,5,"220,7",4,1,1,6,Mid-Value,Potential Loyalists
91584,1498,1,"78,5",1,1,1,3,Low-Value,Lost
91587,223,4,"382,35",5,1,1,7,Mid-Value,Potential Loyalists
91590,223,3,"61,35",5,1,1,7,Mid-Value,Potential Loyalists
91591,1749,1,"78,4",1,1,1,3,Low-Value,Lost
91593,6,4,"303,35",5,1,1,7,Mid-Value,Potential Loyalists
91595,832,3,"109,35",3,1,1,5,Low-Value,At Risk Customers
91598,730,3,"131,6",4,1,1,6,Mid-Value,Potential Loyalists
91601,1453,1,"225,7",2,1,1,4,Low-Value,Can't Lose
91604,103,3,"123,4",5,1,1,7,Mid-Value,Potential Loyalists
91609,23,4,"128,7",5,1,1,7,Mid-Value,Potential Loyalists
91611,308,1,"50,5",5,1,1,7,Mid-Value,Potential Loyalists
91612,217,2,"50,150000000000006",5,1,1,7,Mid-Value,Potential Loyalists
91613,14,1,"58,4",5,1,1,7,Mid-Value,Potential Loyalists
91614,427,3,"326,5",4,1,1,6,Mid-Value,Potential Loyalists
91615,249,11,"628,35",5,2,1,8,High-Value,Potential Loyalists
91617,609,1,"7,4",4,1,1,6,Mid-Value,Potential Loyalists
91619,62,6,"354,15",5,1,1,7,Mid-Value,Potential Loyalists
91620,404,1,"22,1",4,1,1,6,Mid-Value,Potential Loyalists
91621,1135,2,"56,349999999999994",2,1,1,4,Low-Value,Can't Lose
91622,1488,1,"37,0",1,1,1,3,Low-Value,Lost
91623,203,1,"38,8",5,1,1,7,Mid-Value,Potential Loyalists
91624,513,2,"109,2",4,1,1,6,Mid-Value,Potential Loyalists
91625,593,2,"118,4",4,1,1,6,Mid-Value,Potential Loyalists
91626,195,5,"258,6",5,1,1,7,Mid-Value,Potential Loyalists
91627,854,1,"256,5",3,1,1,5,Low-Value,At Risk Customers
91629,543,3,"630,6500000000001",4,1,1,6,Mid-Value,Potential Loyalists
91630,916,3,"174,75",3,1,1,5,Low-Value,At Risk Customers
91631,1596,1,"152,55",1,1,1,3,Low-Value,Lost
91632,1060,1,"31,95",3,1,1,5,Low-Value,At Risk Customers
91634,616,1,"51,0",4,1,1,6,Mid-Value,Potential Loyalists
91636,178,2,"30,25",5,1,1,7,Mid-Value,Potential Loyalists
91637,151,5,"256,15",5,1,1,7,Mid-Value,Potential Loyalists
91641,303,4,"100,5",5,1,1,7,Mid-Value,Potential Loyalists
91643,446,3,"62,900000000000006",4,1,1,6,Mid-Value,Potential Loyalists
91645,1567,1,"47,05",1,1,1,3,Low-Value,Lost
91646,1140,2,"141,45",2,1,1,4,Low-Value,Can't Lose
91648,425,3,"69,7",4,1,1,6,Mid-Value,Potential Loyalists
91649,732,1,"349,6",3,1,1,5,Low-Value,At Risk Customers
91650,225,8,"669,75",5,2,2,9,High-Value,Champions
91651,1024,2,"118,69999999999999",3,1,1,5,Low-Value,At Risk Customers
91653,151,4,"86,19999999999999",5,1,1,7,Mid-Value,Potential Loyalists
91656,484,2,"61,2",4,1,1,6,Mid-Value,Potential Loyalists
91657,1324,1,"32,25",2,1,1,4,Low-Value,Can't Lose
91658,561,2,"379,6",4,1,1,6,Mid-Value,Potential Loyalists
91659,883,3,"103,25",3,1,1,5,Low-Value,At Risk Customers
91660,40,6,"305,2",5,1,1,7,Mid-Value,Potential Loyalists
91661,1504,2,"23,45",1,1,1,3,Low-Value,Lost
91663,125,5,"321,0",5,1,1,7,Mid-Value,Potential Loyalists
91664,691,2,"44,7",4,1,1,6,Mid-Value,Potential Loyalists
91667,918,1,"104,0",3,1,1,5,Low-Value,At Risk Customers
91669,8,7,"246,85",5,2,1,8,High-Value,Potential Loyalists
91670,811,4,"338,9",3,1,1,5,Low-Value,At Risk Customers
91671,404,3,"168,9",4,1,1,6,Mid-Value,Potential Loyalists
91672,75,1,"72,75",5,1,1,7,Mid-Value,Potential Loyalists
91673,947,3,"269,15",3,1,1,5,Low-Value,At Risk Customers
91674,145,3,"88,05",5,1,1,7,Mid-Value,Potential Loyalists
91675,491,4,"645,9",4,1,1,6,Mid-Value,Potential Loyalists
91678,161,5,"460,05",5,1,1,7,Mid-Value,Potential Loyalists
91679,397,4,"276,5",4,1,1,6,Mid-Value,Potential Loyalists
91681,22,10,"687,5",5,2,2,9,High-Value,Champions
91682,4,3,"139,7",5,1,1,7,Mid-Value,Potential Loyalists
91683,454,4,"274,2",4,1,1,6,Mid-Value,Potential Loyalists
91687,1546,1,"45,35",1,1,1,3,Low-Value,Lost
91688,767,4,"132,25",3,1,1,5,Low-Value,At Risk Customers
91689,623,3,"140,8",4,1,1,6,Mid-Value,Potential Loyalists
91690,1179,4,"238,95",2,1,1,4,Low-Value,Can't Lose
91693,21,6,"266,25",5,1,1,7,Mid-Value,Potential Loyalists
91698,477,4,"353,05",4,1,1,6,Mid-Value,Potential Loyalists
91701,731,4,"267,8",3,1,1,5,Low-Value,At Risk Customers
91702,389,1,"66,75",4,1,1,6,Mid-Value,Potential Loyalists
91704,1464,3,"250,9",1,1,1,3,Low-Value,Lost
91706,560,2,"113,1",4,1,1,6,Mid-Value,Potential Loyalists
91707,410,3,"54,9",4,1,1,6,Mid-Value,Potential Loyalists
91709,869,3,"460,29999999999995",3,1,1,5,Low-Value,At Risk Customers
91710,180,1,"39,9",5,1,1,7,Mid-Value,Potential Loyalists
91711,59,4,"83,5",5,1,1,7,Mid-Value,Potential Loyalists
91718,1473,1,"17,6",1,1,1,3,Low-Value,Lost
91719,1165,1,"12,1",2,1,1,4,Low-Value,Can't Lose
91720,16,4,"72,45",5,1,1,7,Mid-Value,Potential Loyalists
91721,302,1,"13,8",5,1,1,7,Mid-Value,Potential Loyalists
91722,11,3,"187,15",5,1,1,7,Mid-Value,Potential Loyalists
91723,862,1,"94,5",3,1,1,5,Low-Value,At Risk Customers
91724,199,4,"155,3",5,1,1,7,Mid-Value,Potential Loyalists
91725,202,3,"536,4499999999999",5,1,1,7,Mid-Value,Potential Loyalists
91726,531,1,"73,4",4,1,1,6,Mid-Value,Potential Loyalists
91727,150,7,"198,10000000000002",5,2,1,8,High-Value,Potential Loyalists
91728,463,5,"306,20000000000005",4,1,1,6,Mid-Value,Potential Loyalists
91730,440,7,"557,35",4,2,1,7,Mid-Value,Potential Loyalists
91731,13,5,"191,3",5,1,1,7,Mid-Value,Potential Loyalists
91733,36,14,"809,45",5,3,2,10,High-Value,Champions
91734,47,6,"251,70000000000002",5,1,1,7,Mid-Value,Potential Loyalists
91735,395,3,"101,3",4,1,1,6,Mid-Value,Potential Loyalists
91736,916,1,"33,2",3,1,1,5,Low-Value,At Risk Customers
91737,565,2,"107,8",4,1,1,6,Mid-Value,Potential Loyalists
91738,106,9,"464,0",5,2,1,8,High-Value,Potential Loyalists
91739,565,4,"584,6",4,1,1,6,Mid-Value,Potential Loyalists
91740,421,6,"256,85",4,1,1,6,Mid-Value,Potential Loyalists
91741,150,4,"476,15000000000003",5,1,1,7,Mid-Value,Potential Loyalists
91745,608,3,"62,900000000000006",4,1,1,6,Mid-Value,Potential Loyalists
91748,388,3,"185,7",4,1,1,6,Mid-Value,Potential Loyalists
91749,769,1,"2,75",3,1,1,5,Low-Value,At Risk Customers
91750,991,4,"144,6",3,1,1,5,Low-Value,At Risk Customers
91751,9,4,"68,4",5,1,1,7,Mid-Value,Potential Loyalists
91752,1574,2,"117,9",1,1,1,3,Low-Value,Lost
91753,18,5,"301,85",5,1,1,7,Mid-Value,Potential Loyalists
91754,940,3,"87,85000000000001",3,1,1,5,Low-Value,At Risk Customers
91756,141,6,"414,55",5,1,1,7,Mid-Value,Potential Loyalists
91759,337,3,"163,29999999999998",5,1,1,7,Mid-Value,Potential Loyalists
91762,817,5,"172,3",3,1,1,5,Low-Value,At Risk Customers
91765,215,2,"24,299999999999997",5,1,1,7,Mid-Value,Potential Loyalists
91768,502,3,"143,65",4,1,1,6,Mid-Value,Potential Loyalists
91769,1386,3,"375,6",2,1,1,4,Low-Value,Can't Lose
91771,220,5,"226,95",5,1,1,7,Mid-Value,Potential Loyalists
91773,227,1,"38,05",5,1,1,7,Mid-Value,Potential Loyalists
91774,184,3,"102,95",5,1,1,7,Mid-Value,Potential Loyalists
91775,1535,1,"57,35",1,1,1,3,Low-Value,Lost
91776,692,2,"50,8",4,1,1,6,Mid-Value,Potential Loyalists
91777,357,6,"584,5",5,1,1,7,Mid-Value,Potential Loyalists
91778,697,1,"41,4",4,1,1,6,Mid-Value,Potential Loyalists
91781,1227,1,"143,25",2,1,1,4,Low-Value,Can't Lose
91783,266,7,"322,8",5,2,1,8,High-Value,Potential Loyalists
91784,86,2,"48,25",5,1,1,7,Mid-Value,Potential Loyalists
91785,41,4,"178,45",5,1,1,7,Mid-Value,Potential Loyalists
91786,630,4,"228,25",4,1,1,6,Mid-Value,Potential Loyalists
91788,797,2,"55,1",3,1,1,5,Low-Value,At Risk Customers
91790,929,1,"60,0",3,1,1,5,Low-Value,At Risk Customers
91791,202,6,"166,35",5,1,1,7,Mid-Value,Potential Loyalists
91796,766,4,"199,2",3,1,1,5,Low-Value,At Risk Customers
91797,760,2,"36,35",3,1,1,5,Low-Value,At Risk Customers
91798,415,1,"132,7",4,1,1,6,Mid-Value,Potential Loyalists
91799,573,4,"551,0999999999999",4,1,1,6,Mid-Value,Potential Loyalists
91800,136,2,"185,1",5,1,1,7,Mid-Value,Potential Loyalists
91802,1101,3,"127,45",2,1,1,4,Low-Value,Can't Lose
91806,733,4,"507,45",3,1,1,5,Low-Value,At Risk Customers
91807,822,1,"36,05",3,1,1,5,Low-Value,At Risk Customers
91809,996,1,"1,2",3,1,1,5,Low-Value,At Risk Customers
91812,922,1,"69,8",3,1,1,5,Low-Value,At Risk Customers
91813,139,5,"392,54999999999995",5,1,1,7,Mid-Value,Potential Loyalists
91814,60,6,"163,45",5,1,1,7,Mid-Value,Potential Loyalists
91815,525,1,"33,5",4,1,1,6,Mid-Value,Potential Loyalists
91816,171,1,"71,9",5,1,1,7,Mid-Value,Potential Loyalists
91817,1811,1,"149,1",1,1,1,3,Low-Value,Lost
91821,147,4,"185,20000000000002",5,1,1,7,Mid-Value,Potential Loyalists
91823,2,5,"329,8",5,1,1,7,Mid-Value,Potential Loyalists
91827,20,2,"141,9",5,1,1,7,Mid-Value,Potential Loyalists
91828,397,4,"90,65",4,1,1,6,Mid-Value,Potential Loyalists
91829,174,1,"69,6",5,1,1,7,Mid-Value,Potential Loyalists
91830,983,1,"39,45",3,1,1,5,Low-Value,At Risk Customers
91831,362,3,"145,45",5,1,1,7,Mid-Value,Potential Loyalists
91833,950,2,"149,4",3,1,1,5,Low-Value,At Risk Customers
91834,1511,2,"48,699999999999996",1,1,1,3,Low-Value,Lost
91836,545,6,"175,55",4,1,1,6,Mid-Value,Potential Loyalists
91838,291,1,"42,15",5,1,1,7,Mid-Value,Potential Loyalists
91840,489,3,"241,2",4,1,1,6,Mid-Value,Potential Loyalists
91842,146,5,"290,0",5,1,1,7,Mid-Value,Potential Loyalists
91843,222,4,"295,8",5,1,1,7,Mid-Value,Potential Loyalists
91844,12,3,"163,0",5,1,1,7,Mid-Value,Potential Loyalists
91846,494,5,"405,84999999999997",4,1,1,6,Mid-Value,Potential Loyalists
91848,309,5,"307,7",5,1,1,7,Mid-Value,Potential Loyalists
91851,406,2,"114,39999999999999",4,1,1,6,Mid-Value,Potential Loyalists
91853,992,1,"16,35",3,1,1,5,Low-Value,At Risk Customers
91854,192,4,"413,25",5,1,1,7,Mid-Value,Potential Loyalists
91855,668,3,"82,05",4,1,1,6,Mid-Value,Potential Loyalists
91858,930,1,"349,79999999999995",3,1,1,5,Low-Value,At Risk Customers
91859,1503,1,"13,8",1,1,1,3,Low-Value,Lost
91861,974,7,"657,15",3,2,1,6,Mid-Value,Potential Loyalists
91862,521,2,"139,1",4,1,1,6,Mid-Value,Potential Loyalists
91863,251,4,"212,60000000000002",5,1,1,7,Mid-Value,Potential Loyalists
91865,487,4,"324,5",4,1,1,6,Mid-Value,Potential Loyalists
91866,234,7,"316,15",5,2,1,8,High-Value,Potential Loyalists
91867,17,2,"216,90000000000003",5,1,1,7,Mid-Value,Potential Loyalists
91868,335,3,"130,5",5,1,1,7,Mid-Value,Potential Loyalists
91869,232,2,"82,65",5,1,1,7,Mid-Value,Potential Loyalists
91870,197,3,"117,29999999999998",5,1,1,7,Mid-Value,Potential Loyalists
91873,312,6,"371,44999999999993",5,1,1,7,Mid-Value,Potential Loyalists
91874,105,4,"136,45",5,1,1,7,Mid-Value,Potential Loyalists
91877,696,1,"42,6",4,1,1,6,Mid-Value,Potential Loyalists
91881,1062,2,"372,40000000000003",3,1,1,5,Low-Value,At Risk Customers
91885,8,4,"127,14999999999999",5,1,1,7,Mid-Value,Potential Loyalists
91886,178,2,"54,3",5,1,1,7,Mid-Value,Potential Loyalists
91887,335,6,"353,0",5,1,1,7,Mid-Value,Potential Loyalists
91888,1448,1,"122,0",2,1,1,4,Low-Value,Can't Lose
91889,780,2,"39,55",3,1,1,5,Low-Value,At Risk Customers
91890,262,5,"139,8",5,1,1,7,Mid-Value,Potential Loyalists
91891,18,2,"96,55",5,1,1,7,Mid-Value,Potential Loyalists
91893,1556,4,"80,75",1,1,1,3,Low-Value,Lost
91894,986,1,"17,5",3,1,1,5,Low-Value,At Risk Customers
91895,249,7,"665,75",5,2,2,9,High-Value,Champions
91898,375,5,"486,34999999999997",4,1,1,6,Mid-Value,Potential Loyalists
91900,1674,1,"37,5",1,1,1,3,Low-Value,Lost
91902,133,1,"71,1",5,1,1,7,Mid-Value,Potential Loyalists
91903,36,12,"1093,35",5,3,2,10,High-Value,Champions
91905,756,3,"67,75",3,1,1,5,Low-Value,At Risk Customers
91906,1279,1,"134,7",2,1,1,4,Low-Value,Can't Lose
91907,104,5,"530,55",5,1,1,7,Mid-Value,Potential Loyalists
91909,42,4,"166,7",5,1,1,7,Mid-Value,Potential Loyalists
91910,1170,1,"12,25",2,1,1,4,Low-Value,Can't Lose
91911,1133,2,"43,9",2,1,1,4,Low-Value,Can't Lose
91912,265,1,"55,95",5,1,1,7,Mid-Value,Potential Loyalists
91913,566,1,"95,9",4,1,1,6,Mid-Value,Potential Loyalists
91914,761,1,"19,25",3,1,1,5,Low-Value,At Risk Customers
91915,143,11,"928,9",5,2,2,9,High-Value,Champions
91916,274,4,"239,2",5,1,1,7,Mid-Value,Potential Loyalists
91918,1617,1,"7,2",1,1,1,3,Low-Value,Lost
91919,208,2,"104,65",5,1,1,7,Mid-Value,Potential Loyalists
91920,839,2,"105,25",3,1,1,5,Low-Value,At Risk Customers
91921,93,2,"145,45",5,1,1,7,Mid-Value,Potential Loyalists
91922,673,5,"247,45",4,1,1,6,Mid-Value,Potential Loyalists
91923,145,9,"342,65000000000003",5,2,1,8,High-Value,Potential Loyalists
91924,958,1,"46,349999999999994",3,1,1,5,Low-Value,At Risk Customers
91925,530,2,"28,8",4,1,1,6,Mid-Value,Potential Loyalists
91928,22,1,"30,8",5,1,1,7,Mid-Value,Potential Loyalists
91929,1048,1,"10,8",3,1,1,5,Low-Value,At Risk Customers
91931,25,6,"596,8",5,1,1,7,Mid-Value,Potential Loyalists
91932,411,3,"192,89999999999998",4,1,1,6,Mid-Value,Potential Loyalists
91935,3,12,"510,6",5,3,1,9,High-Value,Champions
91936,1444,1,"20,6",2,1,1,4,Low-Value,Can't Lose
91940,214,1,"180,60000000000002",5,1,1,7,Mid-Value,Potential Loyalists
91941,866,2,"60,9",3,1,1,5,Low-Value,At Risk Customers
91944,324,3,"56,0",5,1,1,7,Mid-Value,Potential Loyalists
91947,531,1,"49,650000000000006",4,1,1,6,Mid-Value,Potential Loyalists
91948,367,2,"25,7",4,1,1,6,Mid-Value,Potential Loyalists
91949,1760,1,"5,7",1,1,1,3,Low-Value,Lost
91950,1674,1,"26,0",1,1,1,3,Low-Value,Lost
91952,699,1,"53,3",4,1,1,6,Mid-Value,Potential Loyalists
91953,528,2,"134,9",4,1,1,6,Mid-Value,Potential Loyalists
91954,137,2,"375,80000000000007",5,1,1,7,Mid-Value,Potential Loyalists
91956,1054,1,"78,5",3,1,1,5,Low-Value,At Risk Customers
91957,1356,1,"7,85",2,1,1,4,Low-Value,Can't Lose
91959,1194,1,"44,0",2,1,1,4,Low-Value,Can't Lose
91960,1734,1,"22,75",1,1,1,3,Low-Value,Lost
91961,188,7,"208,1",5,2,1,8,High-Value,Potential Loyalists
91965,570,4,"469,05",4,1,1,6,Mid-Value,Potential Loyalists
91968,8,5,"370,75",5,1,1,7,Mid-Value,Potential Loyalists
91969,45,3,"131,2",5,1,1,7,Mid-Value,Potential Loyalists
91972,329,1,"44,4",5,1,1,7,Mid-Value,Potential Loyalists
91973,984,1,"6,35",3,1,1,5,Low-Value,At Risk Customers
91974,1555,2,"250,89999999999998",1,1,1,3,Low-Value,Lost
91975,1099,3,"225,65",2,1,1,4,Low-Value,Can't Lose
91976,421,8,"293,55",4,2,1,7,Mid-Value,Potential Loyalists
91977,121,3,"253,14999999999998",5,1,1,7,Mid-Value,Potential Loyalists
91978,1330,2,"97,75",2,1,1,4,Low-Value,Can't Lose
91979,40,12,"757,4",5,3,2,10,High-Value,Champions
91980,137,4,"184,35",5,1,1,7,Mid-Value,Potential Loyalists
91981,722,3,"158,89999999999998",4,1,1,6,Mid-Value,Potential Loyalists
91982,492,1,"113,9",4,1,1,6,Mid-Value,Potential Loyalists
91983,143,1,"222,0",5,1,1,7,Mid-Value,Potential Loyalists
91986,251,2,"154,25",5,1,1,7,Mid-Value,Potential Loyalists
91987,70,4,"436,49999999999994",5,1,1,7,Mid-Value,Potential Loyalists
91988,1392,1,"35,95",2,1,1,4,Low-Value,Can't Lose
91991,488,5,"315,25",4,1,1,6,Mid-Value,Potential Loyalists
91992,22,1,"103,7",5,1,1,7,Mid-Value,Potential Loyalists
91994,811,2,"26,599999999999998",3,1,1,5,Low-Value,At Risk Customers
91996,685,2,"25,1",4,1,1,6,Mid-Value,Potential Loyalists
91998,354,2,"37,85",5,1,1,7,Mid-Value,Potential Loyalists
91999,319,5,"207,9",5,1,1,7,Mid-Value,Potential Loyalists
92000,26,3,"241,39999999999998",5,1,1,7,Mid-Value,Potential Loyalists
92001,277,7,"558,4",5,2,1,8,High-Value,Potential Loyalists
92004,1107,2,"177,3",2,1,1,4,Low-Value,Can't Lose
92006,267,1,"14,05",5,1,1,7,Mid-Value,Potential Loyalists
92012,369,6,"502,0",4,1,1,6,Mid-Value,Potential Loyalists
92013,1714,1,"9,8",1,1,1,3,Low-Value,Lost
92018,283,4,"286,75",5,1,1,7,Mid-Value,Potential Loyalists
92019,169,4,"375,40000000000003",5,1,1,7,Mid-Value,Potential Loyalists
92020,29,8,"391,4",5,2,1,8,High-Value,Potential Loyalists
92021,63,4,"145,5",5,1,1,7,Mid-Value,Potential Loyalists
92022,885,2,"419,45",3,1,1,5,Low-Value,At Risk Customers
92024,48,9,"824,5",5,2,2,9,High-Value,Champions
92025,787,9,"517,05",3,2,1,6,Mid-Value,Potential Loyalists
92026,1352,1,"109,1",2,1,1,4,Low-Value,Can't Lose
92027,839,5,"102,15",3,1,1,5,Low-Value,At Risk Customers
92028,247,4,"283,29999999999995",5,1,1,7,Mid-Value,Potential Loyalists
92029,85,4,"146,75",5,1,1,7,Mid-Value,Potential Loyalists
92030,4,4,"268,1",5,1,1,7,Mid-Value,Potential Loyalists
92031,863,2,"366,55",3,1,1,5,Low-Value,At Risk Customers
92032,595,8,"418,15000000000003",4,2,1,7,Mid-Value,Potential Loyalists
92034,18,3,"95,6",5,1,1,7,Mid-Value,Potential Loyalists
92035,182,5,"1154,7",5,1,2,8,High-Value,Potential Loyalists
92036,723,1,"10,05",4,1,1,6,Mid-Value,Potential Loyalists
92037,749,2,"278,85",3,1,1,5,Low-Value,At Risk Customers
92039,434,9,"388,4",4,2,1,7,Mid-Value,Potential Loyalists
92042,558,2,"46,7",4,1,1,6,Mid-Value,Potential Loyalists
92047,1127,1,"134,7",2,1,1,4,Low-Value,Can't Lose
92048,1652,3,"226,45",1,1,1,3,Low-Value,Lost
92049,83,7,"1281,8999999999999",5,2,2,9,High-Value,Champions
92050,428,6,"104,55",4,1,1,6,Mid-Value,Potential Loyalists
92051,12,6,"367,1",5,1,1,7,Mid-Value,Potential Loyalists
92053,737,1,"8,9",3,1,1,5,Low-Value,At Risk Customers
92055,506,6,"381,0",4,1,1,6,Mid-Value,Potential Loyalists
92056,350,2,"69,4",5,1,1,7,Mid-Value,Potential Loyalists
92057,181,4,"176,65",5,1,1,7,Mid-Value,Potential Loyalists
92059,652,1,"22,55",4,1,1,6,Mid-Value,Potential Loyalists
92060,666,7,"334,85",4,2,1,7,Mid-Value,Potential Loyalists
92061,1111,1,"31,9",2,1,1,4,Low-Value,Can't Lose
92062,8,22,"2352,25",5,5,4,14,High-Value,Champions
92064,28,2,"275,95",5,1,1,7,Mid-Value,Potential Loyalists
92066,52,5,"59,2",5,1,1,7,Mid-Value,Potential Loyalists
92067,441,1,"12,55",4,1,1,6,Mid-Value,Potential Loyalists
92068,361,3,"123,39999999999999",5,1,1,7,Mid-Value,Potential Loyalists
92070,267,3,"53,6",5,1,1,7,Mid-Value,Potential Loyalists
92071,622,8,"367,9",4,2,1,7,Mid-Value,Potential Loyalists
92072,418,1,"68,6",4,1,1,6,Mid-Value,Potential Loyalists
92073,14,10,"482,75",5,2,1,8,High-Value,Potential Loyalists
92074,561,1,"37,8",4,1,1,6,Mid-Value,Potential Loyalists
92075,1299,1,"75,6",2,1,1,4,Low-Value,Can't Lose
92079,250,3,"104,35",5,1,1,7,Mid-Value,Potential Loyalists
92081,156,2,"24,25",5,1,1,7,Mid-Value,Potential Loyalists
92086,1458,2,"14,65",2,1,1,4,Low-Value,Can't Lose
92087,1718,1,"24,95",1,1,1,3,Low-Value,Lost
92089,945,1,"18,2",3,1,1,5,Low-Value,At Risk Customers
92090,174,2,"30,0",5,1,1,7,Mid-Value,Potential Loyalists
92091,1590,1,"16,6",1,1,1,3,Low-Value,Lost
92092,135,4,"178,1",5,1,1,7,Mid-Value,Potential Loyalists
92093,365,4,"309,65",5,1,1,7,Mid-Value,Potential Loyalists
92095,677,3,"150,35",4,1,1,6,Mid-Value,Potential Loyalists
92096,1468,1,"287,25",1,1,1,3,Low-Value,Lost
92097,107,2,"47,0",5,1,1,7,Mid-Value,Potential Loyalists
92098,176,4,"82,75",5,1,1,7,Mid-Value,Potential Loyalists
92099,388,2,"78,2",4,1,1,6,Mid-Value,Potential Loyalists
92100,475,1,"122,8",4,1,1,6,Mid-Value,Potential Loyalists
92102,839,2,"329,9",3,1,1,5,Low-Value,At Risk Customers
92103,1252,4,"830,7",2,1,2,5,Low-Value,At Risk Customers
92104,1464,3,"193,85000000000002",1,1,1,3,Low-Value,Lost
92105,552,4,"103,2",4,1,1,6,Mid-Value,Potential Loyalists
92106,54,3,"263,6",5,1,1,7,Mid-Value,Potential Loyalists
92108,363,4,"267,6",5,1,1,7,Mid-Value,Potential Loyalists
92109,963,3,"95,6",3,1,1,5,Low-Value,At Risk Customers
92110,900,1,"161,55",3,1,1,5,Low-Value,At Risk Customers
92111,1236,1,"28,4",2,1,1,4,Low-Value,Can't Lose
92112,23,6,"400,25",5,1,1,7,Mid-Value,Potential Loyalists
92113,533,5,"261,2",4,1,1,6,Mid-Value,Potential Loyalists
92114,844,6,"425,3",3,1,1,5,Low-Value,At Risk Customers
92116,448,3,"46,3",4,1,1,6,Mid-Value,Potential Loyalists
92118,708,4,"78,0",4,1,1,6,Mid-Value,Potential Loyalists
92119,594,3,"96,05",4,1,1,6,Mid-Value,Potential Loyalists
92120,0,5,"208,4",5,1,1,7,Mid-Value,Potential Loyalists
92121,21,2,"396,0",5,1,1,7,Mid-Value,Potential Loyalists
92122,28,2,"38,95",5,1,1,7,Mid-Value,Potential Loyalists
92124,428,3,"208,35",4,1,1,6,Mid-Value,Potential Loyalists
92125,92,6,"993,5999999999999",5,1,2,8,High-Value,Potential Loyalists
92126,40,8,"585,3",5,2,1,8,High-Value,Potential Loyalists
92127,734,1,"15,8",3,1,1,5,Low-Value,At Risk Customers
92130,41,2,"63,65",5,1,1,7,Mid-Value,Potential Loyalists
92133,30,10,"534,4499999999999",5,2,1,8,High-Value,Potential Loyalists
92134,465,6,"184,25",4,1,1,6,Mid-Value,Potential Loyalists
92135,24,4,"222,5",5,1,1,7,Mid-Value,Potential Loyalists
92136,379,8,"481,54999999999995",4,2,1,7,Mid-Value,Potential Loyalists
92137,1429,2,"148,05",2,1,1,4,Low-Value,Can't Lose
92139,500,4,"281,85",4,1,1,6,Mid-Value,Potential Loyalists
92140,349,4,"483,4",5,1,1,7,Mid-Value,Potential Loyalists
92141,638,1,"6,85",4,1,1,6,Mid-Value,Potential Loyalists
92142,476,2,"211,20000000000002",4,1,1,6,Mid-Value,Potential Loyalists
92143,818,2,"39,05",3,1,1,5,Low-Value,At Risk Customers
92146,22,9,"363,4",5,2,1,8,High-Value,Potential Loyalists
92149,255,1,"7,7",5,1,1,7,Mid-Value,Potential Loyalists
92151,632,1,"12,35",4,1,1,6,Mid-Value,Potential Loyalists
92152,711,2,"178,54999999999998",4,1,1,6,Mid-Value,Potential Loyalists
92154,1400,2,"47,849999999999994",2,1,1,4,Low-Value,Can't Lose
92155,239,1,"30,25",5,1,1,7,Mid-Value,Potential Loyalists
92156,218,5,"246,15",5,1,1,7,Mid-Value,Potential Loyalists
92157,842,1,"21,2",3,1,1,5,Low-Value,At Risk Customers
92158,1181,4,"562,65",2,1,1,4,Low-Value,Can't Lose
92159,138,7,"534,35",5,2,1,8,High-Value,Potential Loyalists
92160,91,8,"450,35",5,2,1,8,High-Value,Potential Loyalists
92161,1350,2,"20,2",2,1,1,4,Low-Value,Can't Lose
92165,1513,1,"31,75",1,1,1,3,Low-Value,Lost
92166,1679,1,"187,2",1,1,1,3,Low-Value,Lost
92167,807,7,"169,55",3,2,1,6,Mid-Value,Potential Loyalists
92170,30,7,"460,75",5,2,1,8,High-Value,Potential Loyalists
92171,8,2,"167,8",5,1,1,7,Mid-Value,Potential Loyalists
92173,148,1,"235,5",5,1,1,7,Mid-Value,Potential Loyalists
92174,237,3,"74,4",5,1,1,7,Mid-Value,Potential Loyalists
92176,508,5,"221,05",4,1,1,6,Mid-Value,Potential Loyalists
92177,5,2,"190,5",5,1,1,7,Mid-Value,Potential Loyalists
92178,755,2,"154,6",3,1,1,5,Low-Value,At Risk Customers
92180,398,3,"78,55",4,1,1,6,Mid-Value,Potential Loyalists
92181,1292,2,"67,75",2,1,1,4,Low-Value,Can't Lose
92183,70,4,"148,8",5,1,1,7,Mid-Value,Potential Loyalists
92185,1075,2,"24,55",3,1,1,5,Low-Value,At Risk Customers
92186,96,1,"15,8",5,1,1,7,Mid-Value,Potential Loyalists
92187,1479,1,"52,0",1,1,1,3,Low-Value,Lost
92189,1618,1,"69,2",1,1,1,3,Low-Value,Lost
92190,585,1,"61,0",4,1,1,6,Mid-Value,Potential Loyalists
92191,559,2,"105,95000000000002",4,1,1,6,Mid-Value,Potential Loyalists
92194,1106,2,"66,2",2,1,1,4,Low-Value,Can't Lose
92195,358,3,"146,9",5,1,1,7,Mid-Value,Potential Loyalists
92196,797,7,"993,4499999999999",3,2,2,7,Mid-Value,Potential Loyalists
92198,45,2,"248,74999999999997",5,1,1,7,Mid-Value,Potential Loyalists
92199,381,2,"132,4",4,1,1,6,Mid-Value,Potential Loyalists
92200,200,4,"98,9",5,1,1,7,Mid-Value,Potential Loyalists
92201,987,2,"34,800000000000004",3,1,1,5,Low-Value,At Risk Customers
92202,444,3,"90,05",4,1,1,6,Mid-Value,Potential Loyalists
92203,979,12,"538,6",3,3,1,7,Mid-Value,Potential Loyalists
92204,887,2,"61,0",3,1,1,5,Low-Value,At Risk Customers
92205,37,2,"147,35",5,1,1,7,Mid-Value,Potential Loyalists
92207,1108,2,"107,05",2,1,1,4,Low-Value,Can't Lose
92208,52,2,"32,25",5,1,1,7,Mid-Value,Potential Loyalists
92211,781,4,"34,8",3,1,1,5,Low-Value,At Risk Customers
92213,151,6,"721,55",5,1,2,8,High-Value,Potential Loyalists
92214,495,4,"373,20000000000005",4,1,1,6,Mid-Value,Potential Loyalists
92218,1,9,"822,8000000000001",5,2,2,9,High-Value,Champions
92219,31,8,"287,0",5,2,1,8,High-Value,Potential Loyalists
92222,545,1,"495,4",4,1,1,6,Mid-Value,Potential Loyalists
92224,672,2,"59,5",4,1,1,6,Mid-Value,Potential Loyalists
92225,945,3,"697,15",3,1,2,6,Mid-Value,Potential Loyalists
92226,831,4,"171,45000000000002",3,1,1,5,Low-Value,At Risk Customers
92227,1706,1,"30,9",1,1,1,3,Low-Value,Lost
92228,1124,5,"425,95",2,1,1,4,Low-Value,Can't Lose
92229,1032,2,"54,45",3,1,1,5,Low-Value,At Risk Customers
92231,609,1,"133,64999999999998",4,1,1,6,Mid-Value,Potential Loyalists
92232,1376,2,"34,400000000000006",2,1,1,4,Low-Value,Can't Lose
92233,970,1,"91,05000000000001",3,1,1,5,Low-Value,At Risk Customers
92234,1061,2,"80,75",3,1,1,5,Low-Value,At Risk Customers
92235,895,6,"545,3000000000001",3,1,1,5,Low-Value,At Risk Customers
92237,61,3,"46,1",5,1,1,7,Mid-Value,Potential Loyalists
92238,473,6,"248,60000000000002",4,1,1,6,Mid-Value,Potential Loyalists
92240,910,4,"170,65",3,1,1,5,Low-Value,At Risk Customers
92241,105,6,"248,15",5,1,1,7,Mid-Value,Potential Loyalists
92242,30,3,"255,39999999999998",5,1,1,7,Mid-Value,Potential Loyalists
92244,528,1,"237,0",4,1,1,6,Mid-Value,Potential Loyalists
92245,1414,1,"14,8",2,1,1,4,Low-Value,Can't Lose
92246,69,1,"3,5",5,1,1,7,Mid-Value,Potential Loyalists
92248,1240,1,"13,75",2,1,1,4,Low-Value,Can't Lose
92249,375,5,"255,7",4,1,1,6,Mid-Value,Potential Loyalists
92251,270,3,"105,5",5,1,1,7,Mid-Value,Potential Loyalists
92252,380,5,"240,85",4,1,1,6,Mid-Value,Potential Loyalists
92253,60,1,"17,85",5,1,1,7,Mid-Value,Potential Loyalists
92257,81,7,"386,0",5,2,1,8,High-Value,Potential Loyalists
92259,1282,4,"86,64999999999999",2,1,1,4,Low-Value,Can't Lose
92260,1114,2,"36,5",2,1,1,4,Low-Value,Can't Lose
92263,509,1,"117,2",4,1,1,6,Mid-Value,Potential Loyalists
92265,637,1,"7,3",4,1,1,6,Mid-Value,Potential Loyalists
92266,273,2,"315,69999999999993",5,1,1,7,Mid-Value,Potential Loyalists
92267,399,2,"52,2",4,1,1,6,Mid-Value,Potential Loyalists
92268,555,2,"53,45",4,1,1,6,Mid-Value,Potential Loyalists
92269,244,1,"8,850000000000001",5,1,1,7,Mid-Value,Potential Loyalists
92273,118,7,"311,7",5,2,1,8,High-Value,Potential Loyalists
92275,93,4,"117,25",5,1,1,7,Mid-Value,Potential Loyalists
92276,781,1,"72,6",3,1,1,5,Low-Value,At Risk Customers
92277,10,1,"36,9",5,1,1,7,Mid-Value,Potential Loyalists
92278,240,4,"273,0",5,1,1,7,Mid-Value,Potential Loyalists
92279,1167,2,"44,599999999999994",2,1,1,4,Low-Value,Can't Lose
92281,1236,1,"19,0",2,1,1,4,Low-Value,Can't Lose
92283,626,2,"8,65",4,1,1,6,Mid-Value,Potential Loyalists
92285,1432,1,"10,2",2,1,1,4,Low-Value,Can't Lose
92287,1726,2,"38,9",1,1,1,3,Low-Value,Lost
92289,730,2,"58,4",4,1,1,6,Mid-Value,Potential Loyalists
92291,18,4,"144,55",5,1,1,7,Mid-Value,Potential Loyalists
92293,133,2,"227,45",5,1,1,7,Mid-Value,Potential Loyalists
92294,63,5,"129,35",5,1,1,7,Mid-Value,Potential Loyalists
92297,66,9,"656,0500000000001",5,2,1,8,High-Value,Potential Loyalists
92299,818,1,"20,05",3,1,1,5,Low-Value,At Risk Customers
92301,84,3,"303,8",5,1,1,7,Mid-Value,Potential Loyalists
92303,1435,2,"107,69999999999999",2,1,1,4,Low-Value,Can't Lose
92305,1762,2,"46,55",1,1,1,3,Low-Value,Lost
92308,391,2,"67,7",4,1,1,6,Mid-Value,Potential Loyalists
92311,20,11,"404,4",5,2,1,8,High-Value,Potential Loyalists
92313,676,1,"22,8",4,1,1,6,Mid-Value,Potential Loyalists
92315,260,3,"449,25",5,1,1,7,Mid-Value,Potential Loyalists
92316,994,3,"493,55",3,1,1,5,Low-Value,At Risk Customers
92318,1774,1,"28,25",1,1,1,3,Low-Value,Lost
92320,778,2,"62,25",3,1,1,5,Low-Value,At Risk Customers
92321,487,1,"131,10000000000002",4,1,1,6,Mid-Value,Potential Loyalists
92322,41,4,"586,75",5,1,1,7,Mid-Value,Potential Loyalists
92323,886,3,"452,55",3,1,1,5,Low-Value,At Risk Customers
92325,1296,1,"87,9",2,1,1,4,Low-Value,Can't Lose
92326,1103,2,"400,9",2,1,1,4,Low-Value,Can't Lose
92328,21,1,"184,1",5,1,1,7,Mid-Value,Potential Loyalists
92329,1492,1,"104,5",1,1,1,3,Low-Value,Lost
92330,397,4,"116,0",4,1,1,6,Mid-Value,Potential Loyalists
92335,1117,1,"207,89999999999998",2,1,1,4,Low-Value,Can't Lose
92338,244,3,"144,75",5,1,1,7,Mid-Value,Potential Loyalists
92343,618,3,"52,60000000000001",4,1,1,6,Mid-Value,Potential Loyalists
92344,568,3,"257,3",4,1,1,6,Mid-Value,Potential Loyalists
92345,253,3,"114,0",5,1,1,7,Mid-Value,Potential Loyalists
92347,226,2,"178,95",5,1,1,7,Mid-Value,Potential Loyalists
92351,221,5,"239,9",5,1,1,7,Mid-Value,Potential Loyalists
92357,211,3,"721,5000000000001",5,1,2,8,High-Value,Potential Loyalists
92360,749,3,"147,45",3,1,1,5,Low-Value,At Risk Customers
92362,202,5,"269,4",5,1,1,7,Mid-Value,Potential Loyalists
92363,626,2,"56,95",4,1,1,6,Mid-Value,Potential Loyalists
92364,908,3,"102,8",3,1,1,5,Low-Value,At Risk Customers
92366,111,5,"157,9",5,1,1,7,Mid-Value,Potential Loyalists
92368,1520,1,"303,1",1,1,1,3,Low-Value,Lost
92371,538,7,"823,25",4,2,2,8,High-Value,Potential Loyalists
92372,910,2,"137,15",3,1,1,5,Low-Value,At Risk Customers
92377,1487,1,"45,9",1,1,1,3,Low-Value,Lost
92378,333,4,"566,4",5,1,1,7,Mid-Value,Potential Loyalists
92379,1179,2,"43,25",2,1,1,4,Low-Value,Can't Lose
92380,716,5,"207,65",4,1,1,6,Mid-Value,Potential Loyalists
92381,249,2,"115,30000000000001",5,1,1,7,Mid-Value,Potential Loyalists
92382,7,7,"430,65000000000003",5,2,1,8,High-Value,Potential Loyalists
92383,774,4,"715,05",3,1,2,6,Mid-Value,Potential Loyalists
92387,1064,1,"1,8",3,1,1,5,Low-Value,At Risk Customers
92389,62,7,"162,75",5,2,1,8,High-Value,Potential Loyalists
92390,83,3,"244,85000000000002",5,1,1,7,Mid-Value,Potential Loyalists
92391,1439,1,"19,9",2,1,1,4,Low-Value,Can't Lose
92393,883,3,"155,35000000000002",3,1,1,5,Low-Value,At Risk Customers
92395,440,4,"526,25",4,1,1,6,Mid-Value,Potential Loyalists
92398,738,2,"144,85000000000002",3,1,1,5,Low-Value,At Risk Customers
92399,245,5,"449,75",5,1,1,7,Mid-Value,Potential Loyalists
92400,241,5,"313,20000000000005",5,1,1,7,Mid-Value,Potential Loyalists
92404,1096,1,"18,15",2,1,1,4,Low-Value,Can't Lose
92405,215,2,"91,45",5,1,1,7,Mid-Value,Potential Loyalists
92406,88,5,"299,4",5,1,1,7,Mid-Value,Potential Loyalists
92407,229,4,"116,95",5,1,1,7,Mid-Value,Potential Loyalists
92409,291,6,"587,0500000000001",5,1,1,7,Mid-Value,Potential Loyalists
92410,1545,2,"33,95",1,1,1,3,Low-Value,Lost
92411,73,5,"882,6999999999999",5,1,2,8,High-Value,Potential Loyalists
92414,166,2,"86,60000000000001",5,1,1,7,Mid-Value,Potential Loyalists
92415,469,2,"58,0",4,1,1,6,Mid-Value,Potential Loyalists
92419,160,10,"359,45",5,2,1,8,High-Value,Potential Loyalists
92420,50,6,"350,35",5,1,1,7,Mid-Value,Potential Loyalists
92421,42,13,"419,7",5,3,1,9,High-Value,Champions
92422,121,1,"143,6",5,1,1,7,Mid-Value,Potential Loyalists
92425,486,6,"266,84999999999997",4,1,1,6,Mid-Value,Potential Loyalists
92426,271,1,"6,35",5,1,1,7,Mid-Value,Potential Loyalists
92427,929,3,"158,65",3,1,1,5,Low-Value,At Risk Customers
92429,375,5,"375,05",4,1,1,6,Mid-Value,Potential Loyalists
92434,1306,1,"98,69999999999999",2,1,1,4,Low-Value,Can't Lose
92435,47,4,"333,35",5,1,1,7,Mid-Value,Potential Loyalists
92437,158,3,"163,85",5,1,1,7,Mid-Value,Potential Loyalists
92440,735,4,"88,45",3,1,1,5,Low-Value,At Risk Customers
92444,168,8,"425,45",5,2,1,8,High-Value,Potential Loyalists
92446,396,5,"146,7",4,1,1,6,Mid-Value,Potential Loyalists
92448,329,3,"64,4",5,1,1,7,Mid-Value,Potential Loyalists
92449,1299,2,"107,05",2,1,1,4,Low-Value,Can't Lose
92450,417,2,"39,2",4,1,1,6,Mid-Value,Potential Loyalists
92451,952,1,"39,0",3,1,1,5,Low-Value,At Risk Customers
92454,515,2,"38,8",4,1,1,6,Mid-Value,Potential Loyalists
92458,340,5,"168,3",5,1,1,7,Mid-Value,Potential Loyalists
92461,7,5,"238,64999999999998",5,1,1,7,Mid-Value,Potential Loyalists
92464,1723,1,"153,6",1,1,1,3,Low-Value,Lost
92465,130,2,"66,9",5,1,1,7,Mid-Value,Potential Loyalists
92467,0,2,"72,3",5,1,1,7,Mid-Value,Potential Loyalists
92468,880,4,"215,0",3,1,1,5,Low-Value,At Risk Customers
92469,1295,4,"93,5",2,1,1,4,Low-Value,Can't Lose
92471,427,3,"160,75",4,1,1,6,Mid-Value,Potential Loyalists
92475,611,3,"234,20000000000002",4,1,1,6,Mid-Value,Potential Loyalists
92476,106,9,"600,5500000000001",5,2,1,8,High-Value,Potential Loyalists
92477,308,4,"288,35",5,1,1,7,Mid-Value,Potential Loyalists
92478,13,2,"39,400000000000006",5,1,1,7,Mid-Value,Potential Loyalists
92480,517,2,"195,95000000000002",4,1,1,6,Mid-Value,Potential Loyalists
92483,985,1,"1,5",3,1,1,5,Low-Value,At Risk Customers
92487,85,11,"864,1",5,2,2,9,High-Value,Champions
92488,628,1,"46,9",4,1,1,6,Mid-Value,Potential Loyalists
92489,42,5,"180,45",5,1,1,7,Mid-Value,Potential Loyalists
92490,188,2,"31,85",5,1,1,7,Mid-Value,Potential Loyalists
92491,1707,1,"10,6",1,1,1,3,Low-Value,Lost
92494,1069,3,"147,85",3,1,1,5,Low-Value,At Risk Customers
92496,1239,1,"11,2",2,1,1,4,Low-Value,Can't Lose
92499,287,1,"12,1",5,1,1,7,Mid-Value,Potential Loyalists
92500,47,2,"87,9",5,1,1,7,Mid-Value,Potential Loyalists
92503,47,1,"31,8",5,1,1,7,Mid-Value,Potential Loyalists
92504,1116,1,"226,9",2,1,1,4,Low-Value,Can't Lose
92509,819,2,"83,9",3,1,1,5,Low-Value,At Risk Customers
92513,1537,1,"3,95",1,1,1,3,Low-Value,Lost
92514,59,5,"224,5",5,1,1,7,Mid-Value,Potential Loyalists
92515,90,1,"60,05",5,1,1,7,Mid-Value,Potential Loyalists
92516,449,5,"115,05",4,1,1,6,Mid-Value,Potential Loyalists
92517,743,6,"375,45",3,1,1,5,Low-Value,At Risk Customers
92520,596,4,"253,3",4,1,1,6,Mid-Value,Potential Loyalists
92523,1428,1,"16,15",2,1,1,4,Low-Value,Can't Lose
92526,1287,2,"59,1",2,1,1,4,Low-Value,Can't Lose
92529,439,2,"158,1",4,1,1,6,Mid-Value,Potential Loyalists
92530,735,3,"150,45",3,1,1,5,Low-Value,At Risk Customers
92531,52,3,"268,35",5,1,1,7,Mid-Value,Potential Loyalists
92532,1225,1,"42,3",2,1,1,4,Low-Value,Can't Lose
92533,385,4,"169,3",4,1,1,6,Mid-Value,Potential Loyalists
92534,110,4,"181,6",5,1,1,7,Mid-Value,Potential Loyalists
92536,950,3,"335,05",3,1,1,5,Low-Value,At Risk Customers
92538,608,5,"341,90000000000003",4,1,1,6,Mid-Value,Potential Loyalists
92539,1622,1,"228,0",1,1,1,3,Low-Value,Lost
92541,991,1,"25,0",3,1,1,5,Low-Value,At Risk Customers
92546,47,7,"610,7",5,2,1,8,High-Value,Potential Loyalists
92547,134,12,"455,75",5,3,1,9,High-Value,Champions
92550,15,3,"106,35",5,1,1,7,Mid-Value,Potential Loyalists
92551,1687,1,"212,70000000000002",1,1,1,3,Low-Value,Lost
92552,30,5,"222,7",5,1,1,7,Mid-Value,Potential Loyalists
92559,1530,1,"118,9",1,1,1,3,Low-Value,Lost
92560,471,1,"155,7",4,1,1,6,Mid-Value,Potential Loyalists
92561,269,1,"23,9",5,1,1,7,Mid-Value,Potential Loyalists
92562,437,5,"236,2",4,1,1,6,Mid-Value,Potential Loyalists
92564,424,3,"231,14999999999998",4,1,1,6,Mid-Value,Potential Loyalists
92565,1771,1,"39,0",1,1,1,3,Low-Value,Lost
92566,193,1,"150,0",5,1,1,7,Mid-Value,Potential Loyalists
92569,735,3,"647,5",3,1,1,5,Low-Value,At Risk Customers
92571,189,8,"277,2",5,2,1,8,High-Value,Potential Loyalists
92572,378,2,"588,5",4,1,1,6,Mid-Value,Potential Loyalists
92573,47,5,"241,54999999999998",5,1,1,7,Mid-Value,Potential Loyalists
92574,160,1,"39,8",5,1,1,7,Mid-Value,Potential Loyalists
92578,601,2,"183,1",4,1,1,6,Mid-Value,Potential Loyalists
92580,591,2,"13,9",4,1,1,6,Mid-Value,Potential Loyalists
92583,922,1,"53,5",3,1,1,5,Low-Value,At Risk Customers
92584,1,4,"77,94999999999999",5,1,1,7,Mid-Value,Potential Loyalists
92587,376,3,"173,4",4,1,1,6,Mid-Value,Potential Loyalists
92589,1292,1,"21,2",2,1,1,4,Low-Value,Can't Lose
92590,294,10,"487,75",5,2,1,8,High-Value,Potential Loyalists
92592,1319,1,"66,75",2,1,1,4,Low-Value,Can't Lose
92593,858,3,"95,85",3,1,1,5,Low-Value,At Risk Customers
92594,336,2,"139,35",5,1,1,7,Mid-Value,Potential Loyalists
92596,454,1,"17,8",4,1,1,6,Mid-Value,Potential Loyalists
92597,537,5,"199,05",4,1,1,6,Mid-Value,Potential Loyalists
92600,1144,2,"142,5",2,1,1,4,Low-Value,Can't Lose
92601,1179,4,"304,55",2,1,1,4,Low-Value,Can't Lose
92602,743,3,"193,35000000000002",3,1,1,5,Low-Value,At Risk Customers
92605,753,3,"189,59999999999997",3,1,1,5,Low-Value,At Risk Customers
92607,147,2,"295,70000000000005",5,1,1,7,Mid-Value,Potential Loyalists
92609,1609,1,"71,05",1,1,1,3,Low-Value,Lost
92610,141,1,"39,3",5,1,1,7,Mid-Value,Potential Loyalists
92612,1021,1,"5,7",3,1,1,5,Low-Value,At Risk Customers
92613,894,1,"346,6",3,1,1,5,Low-Value,At Risk Customers
92614,501,3,"152,04999999999998",4,1,1,6,Mid-Value,Potential Loyalists
92615,320,1,"25,799999999999997",5,1,1,7,Mid-Value,Potential Loyalists
92617,11,9,"793,9000000000001",5,2,2,9,High-Value,Champions
92620,82,7,"186,25",5,2,1,8,High-Value,Potential Loyalists
92621,899,3,"34,95",3,1,1,5,Low-Value,At Risk Customers
92622,396,2,"54,7",4,1,1,6,Mid-Value,Potential Loyalists
92623,19,6,"381,55",5,1,1,7,Mid-Value,Potential Loyalists
92624,1583,1,"38,6",1,1,1,3,Low-Value,Lost
92626,614,1,"89,2",4,1,1,6,Mid-Value,Potential Loyalists
92627,27,6,"649,1500000000001",5,1,1,7,Mid-Value,Potential Loyalists
92630,1220,2,"43,95",2,1,1,4,Low-Value,Can't Lose
92631,440,1,"8,25",4,1,1,6,Mid-Value,Potential Loyalists
92632,1021,3,"155,3",3,1,1,5,Low-Value,At Risk Customers
92633,12,3,"289,8",5,1,1,7,Mid-Value,Potential Loyalists
92634,595,8,"419,05",4,2,1,7,Mid-Value,Potential Loyalists
92635,440,3,"111,8",4,1,1,6,Mid-Value,Potential Loyalists
92638,255,2,"105,4",5,1,1,7,Mid-Value,Potential Loyalists
92640,143,2,"136,35",5,1,1,7,Mid-Value,Potential Loyalists
92641,34,6,"457,40000000000003",5,1,1,7,Mid-Value,Potential Loyalists
92643,1027,2,"62,5",3,1,1,5,Low-Value,At Risk Customers
92645,278,3,"103,4",5,1,1,7,Mid-Value,Potential Loyalists
92646,749,3,"511,15000000000003",3,1,1,5,Low-Value,At Risk Customers
92647,436,8,"440,6",4,2,1,7,Mid-Value,Potential Loyalists
92649,508,4,"557,5",4,1,1,6,Mid-Value,Potential Loyalists
92652,49,2,"55,65",5,1,1,7,Mid-Value,Potential Loyalists
92653,158,2,"132,95",5,1,1,7,Mid-Value,Potential Loyalists
92654,599,4,"397,90000000000003",4,1,1,6,Mid-Value,Potential Loyalists
92655,1127,3,"171,35",2,1,1,4,Low-Value,Can't Lose
92656,157,4,"541,3",5,1,1,7,Mid-Value,Potential Loyalists
92657,34,1,"33,7",5,1,1,7,Mid-Value,Potential Loyalists
92658,750,4,"302,2",3,1,1,5,Low-Value,At Risk Customers
92659,313,2,"95,7",5,1,1,7,Mid-Value,Potential Loyalists
92660,765,2,"56,25",3,1,1,5,Low-Value,At Risk Customers
92662,1594,1,"31,0",1,1,1,3,Low-Value,Lost
92664,237,2,"262,95",5,1,1,7,Mid-Value,Potential Loyalists
92665,971,1,"9,5",3,1,1,5,Low-Value,At Risk Customers
92666,1796,1,"252,8",1,1,1,3,Low-Value,Lost
92669,391,2,"292,65",4,1,1,6,Mid-Value,Potential Loyalists
92670,508,1,"37,8",4,1,1,6,Mid-Value,Potential Loyalists
92671,833,1,"17,8",3,1,1,5,Low-Value,At Risk Customers
92673,132,3,"93,75",5,1,1,7,Mid-Value,Potential Loyalists
92674,553,1,"114,30000000000001",4,1,1,6,Mid-Value,Potential Loyalists
92675,48,2,"270,15000000000003",5,1,1,7,Mid-Value,Potential Loyalists
92678,1503,1,"15,0",1,1,1,3,Low-Value,Lost
92679,302,3,"85,95",5,1,1,7,Mid-Value,Potential Loyalists
92680,829,2,"111,30000000000001",3,1,1,5,Low-Value,At Risk Customers
92681,4,2,"120,9",5,1,1,7,Mid-Value,Potential Loyalists
92682,508,2,"196,7",4,1,1,6,Mid-Value,Potential Loyalists
92684,444,4,"148,15",4,1,1,6,Mid-Value,Potential Loyalists
92685,788,1,"202,8",3,1,1,5,Low-Value,At Risk Customers
92686,743,5,"141,7",3,1,1,5,Low-Value,At Risk Customers
92688,839,2,"36,099999999999994",3,1,1,5,Low-Value,At Risk Customers
92689,792,1,"16,15",3,1,1,5,Low-Value,At Risk Customers
92690,1394,2,"13,65",2,1,1,4,Low-Value,Can't Lose
92692,321,6,"982,85",5,1,2,8,High-Value,Potential Loyalists
92693,419,2,"71,15",4,1,1,6,Mid-Value,Potential Loyalists
92694,277,1,"49,650000000000006",5,1,1,7,Mid-Value,Potential Loyalists
92695,1129,2,"103,75",2,1,1,4,Low-Value,Can't Lose
92697,1511,1,"15,0",1,1,1,3,Low-Value,Lost
92700,120,7,"399,79999999999995",5,2,1,8,High-Value,Potential Loyalists
92704,1222,2,"132,45",2,1,1,4,Low-Value,Can't Lose
92708,249,3,"283,7",5,1,1,7,Mid-Value,Potential Loyalists
92710,1561,1,"55,9",1,1,1,3,Low-Value,Lost
92711,772,3,"150,35",3,1,1,5,Low-Value,At Risk Customers
92712,215,4,"139,2",5,1,1,7,Mid-Value,Potential Loyalists
92714,84,1,"9,2",5,1,1,7,Mid-Value,Potential Loyalists
92715,872,4,"201,5",3,1,1,5,Low-Value,At Risk Customers
92716,885,3,"68,25",3,1,1,5,Low-Value,At Risk Customers
92717,47,5,"324,7",5,1,1,7,Mid-Value,Potential Loyalists
92719,1634,1,"232,1",1,1,1,3,Low-Value,Lost
92720,52,9,"406,65",5,2,1,8,High-Value,Potential Loyalists
92721,45,3,"371,0",5,1,1,7,Mid-Value,Potential Loyalists
92722,12,3,"245,7",5,1,1,7,Mid-Value,Potential Loyalists
92723,900,4,"61,25",3,1,1,5,Low-Value,At Risk Customers
92725,147,2,"181,7",5,1,1,7,Mid-Value,Potential Loyalists
92726,151,3,"273,6",5,1,1,7,Mid-Value,Potential Loyalists
92731,528,7,"312,15000000000003",4,2,1,7,Mid-Value,Potential Loyalists
92733,490,2,"22,75",4,1,1,6,Mid-Value,Potential Loyalists
92734,160,9,"594,55",5,2,1,8,High-Value,Potential Loyalists
92736,1030,1,"29,5",3,1,1,5,Low-Value,At Risk Customers
92737,1018,2,"51,3",3,1,1,5,Low-Value,At Risk Customers
92738,66,4,"232,05",5,1,1,7,Mid-Value,Potential Loyalists
92739,49,1,"32,2",5,1,1,7,Mid-Value,Potential Loyalists
92741,1755,1,"157,0",1,1,1,3,Low-Value,Lost
92743,718,1,"51,9",4,1,1,6,Mid-Value,Potential Loyalists
92748,135,5,"268,05",5,1,1,7,Mid-Value,Potential Loyalists
92749,734,7,"290,3",3,2,1,6,Mid-Value,Potential Loyalists
92750,606,3,"364,45",4,1,1,6,Mid-Value,Potential Loyalists
92752,778,6,"446,8999999999999",3,1,1,5,Low-Value,At Risk Customers
92753,1362,1,"92,69999999999999",2,1,1,4,Low-Value,Can't Lose
92754,528,3,"193,9",4,1,1,6,Mid-Value,Potential Loyalists
92757,372,1,"100,4",4,1,1,6,Mid-Value,Potential Loyalists
92761,28,3,"325,70000000000005",5,1,1,7,Mid-Value,Potential Loyalists
92763,1585,1,"24,2",1,1,1,3,Low-Value,Lost
92766,711,1,"13,4",4,1,1,6,Mid-Value,Potential Loyalists
92767,43,2,"95,94999999999999",5,1,1,7,Mid-Value,Potential Loyalists
92772,718,1,"28,5",4,1,1,6,Mid-Value,Potential Loyalists
92774,59,11,"722,75",5,2,2,9,High-Value,Champions
92775,9,2,"314,15",5,1,1,7,Mid-Value,Potential Loyalists
92776,48,3,"119,7",5,1,1,7,Mid-Value,Potential Loyalists
92778,691,2,"349,04999999999995",4,1,1,6,Mid-Value,Potential Loyalists
92780,1194,4,"390,25000000000006",2,1,1,4,Low-Value,Can't Lose
92781,896,1,"31,0",3,1,1,5,Low-Value,At Risk Customers
92782,304,4,"216,45",5,1,1,7,Mid-Value,Potential Loyalists
92784,457,1,"6,65",4,1,1,6,Mid-Value,Potential Loyalists
92789,214,3,"134,85",5,1,1,7,Mid-Value,Potential Loyalists
92792,67,4,"160,6",5,1,1,7,Mid-Value,Potential Loyalists
92795,1174,1,"65,6",2,1,1,4,Low-Value,Can't Lose
92797,1341,2,"61,75",2,1,1,4,Low-Value,Can't Lose
92798,503,3,"277,5",4,1,1,6,Mid-Value,Potential Loyalists
92802,968,3,"106,1",3,1,1,5,Low-Value,At Risk Customers
92804,861,1,"71,55",3,1,1,5,Low-Value,At Risk Customers
92805,402,2,"56,25",4,1,1,6,Mid-Value,Potential Loyalists
92806,204,4,"666,8499999999999",5,1,2,8,High-Value,Potential Loyalists
92807,289,3,"355,25",5,1,1,7,Mid-Value,Potential Loyalists
92808,11,2,"40,15",5,1,1,7,Mid-Value,Potential Loyalists
92809,20,3,"292,95",5,1,1,7,Mid-Value,Potential Loyalists
92811,656,4,"119,95",4,1,1,6,Mid-Value,Potential Loyalists
92815,399,5,"585,5",4,1,1,6,Mid-Value,Potential Loyalists
92816,945,2,"28,85",3,1,1,5,Low-Value,At Risk Customers
92817,743,5,"296,0",3,1,1,5,Low-Value,At Risk Customers
92818,407,4,"288,45",4,1,1,6,Mid-Value,Potential Loyalists
92823,1533,2,"95,5",1,1,1,3,Low-Value,Lost
92824,552,2,"575,0",4,1,1,6,Mid-Value,Potential Loyalists
92825,34,4,"269,9",5,1,1,7,Mid-Value,Potential Loyalists
92827,526,3,"164,65",4,1,1,6,Mid-Value,Potential Loyalists
92830,649,2,"84,05000000000001",4,1,1,6,Mid-Value,Potential Loyalists
92833,319,2,"23,5",5,1,1,7,Mid-Value,Potential Loyalists
92834,89,1,"199,0",5,1,1,7,Mid-Value,Potential Loyalists
92835,1266,3,"97,15",2,1,1,4,Low-Value,Can't Lose
92836,12,5,"106,0",5,1,1,7,Mid-Value,Potential Loyalists
92837,91,3,"188,25",5,1,1,7,Mid-Value,Potential Loyalists
92840,1784,1,"13,9",1,1,1,3,Low-Value,Lost
92841,12,5,"84,0",5,1,1,7,Mid-Value,Potential Loyalists
92842,20,3,"250,7",5,1,1,7,Mid-Value,Potential Loyalists
92843,1658,1,"30,6",1,1,1,3,Low-Value,Lost
92844,1671,1,"80,5",1,1,1,3,Low-Value,Lost
92846,325,1,"20,3",5,1,1,7,Mid-Value,Potential Loyalists
92847,414,4,"91,5",4,1,1,6,Mid-Value,Potential Loyalists
92850,91,3,"83,0",5,1,1,7,Mid-Value,Potential Loyalists
92851,59,1,"25,5",5,1,1,7,Mid-Value,Potential Loyalists
92853,224,5,"247,60000000000002",5,1,1,7,Mid-Value,Potential Loyalists
92858,1159,3,"117,5",2,1,1,4,Low-Value,Can't Lose
92859,1312,1,"66,5",2,1,1,4,Low-Value,Can't Lose
92862,1152,2,"119,55",2,1,1,4,Low-Value,Can't Lose
92863,446,6,"232,15",4,1,1,6,Mid-Value,Potential Loyalists
92865,865,2,"264,45",3,1,1,5,Low-Value,At Risk Customers
92866,0,2,"43,55",5,1,1,7,Mid-Value,Potential Loyalists
92868,83,3,"51,0",5,1,1,7,Mid-Value,Potential Loyalists
92869,903,1,"122,3",3,1,1,5,Low-Value,At Risk Customers
92871,663,3,"32,75",4,1,1,6,Mid-Value,Potential Loyalists
92872,695,3,"30,550000000000004",4,1,1,6,Mid-Value,Potential Loyalists
92874,1277,1,"42,4",2,1,1,4,Low-Value,Can't Lose
92876,637,5,"134,4",4,1,1,6,Mid-Value,Potential Loyalists
92877,381,2,"298,20000000000005",4,1,1,6,Mid-Value,Potential Loyalists
92878,108,4,"237,05",5,1,1,7,Mid-Value,Potential Loyalists
92879,732,6,"203,9",3,1,1,5,Low-Value,At Risk Customers
92881,1470,1,"88,80000000000001",1,1,1,3,Low-Value,Lost
92882,507,2,"111,75",4,1,1,6,Mid-Value,Potential Loyalists
92884,516,9,"311,95",4,2,1,7,Mid-Value,Potential Loyalists
92887,991,2,"196,5",3,1,1,5,Low-Value,At Risk Customers
92888,38,10,"661,75",5,2,1,8,High-Value,Potential Loyalists
92889,20,7,"450,15",5,2,1,8,High-Value,Potential Loyalists
92890,190,6,"251,45",5,1,1,7,Mid-Value,Potential Loyalists
92891,370,6,"413,75",4,1,1,6,Mid-Value,Potential Loyalists
92892,16,2,"79,5",5,1,1,7,Mid-Value,Potential Loyalists
92893,132,3,"180,29999999999998",5,1,1,7,Mid-Value,Potential Loyalists
92894,0,5,"321,35",5,1,1,7,Mid-Value,Potential Loyalists
92896,188,3,"249,5",5,1,1,7,Mid-Value,Potential Loyalists
92898,76,2,"11,2",5,1,1,7,Mid-Value,Potential Loyalists
92900,338,5,"509,75",5,1,1,7,Mid-Value,Potential Loyalists
92901,1547,6,"298,95",1,1,1,3,Low-Value,Lost
92905,1045,3,"459,9",3,1,1,5,Low-Value,At Risk Customers
92907,36,12,"743,95",5,3,2,10,High-Value,Champions
92909,168,2,"112,85000000000001",5,1,1,7,Mid-Value,Potential Loyalists
92910,1116,5,"338,2",2,1,1,4,Low-Value,Can't Lose
92913,1120,1,"43,05",2,1,1,4,Low-Value,Can't Lose
92914,627,1,"1,75",4,1,1,6,Mid-Value,Potential Loyalists
92918,615,1,"14,05",4,1,1,6,Mid-Value,Potential Loyalists
92919,609,2,"34,6",4,1,1,6,Mid-Value,Potential Loyalists
92920,411,3,"114,4",4,1,1,6,Mid-Value,Potential Loyalists
92922,1508,2,"95,35000000000001",1,1,1,3,Low-Value,Lost
92923,816,3,"92,5",3,1,1,5,Low-Value,At Risk Customers
92925,655,2,"32,7",4,1,1,6,Mid-Value,Potential Loyalists
92929,392,2,"35,0",4,1,1,6,Mid-Value,Potential Loyalists
92930,442,5,"346,65000000000003",4,1,1,6,Mid-Value,Potential Loyalists
92931,1649,2,"21,1",1,1,1,3,Low-Value,Lost
92932,517,1,"3,75",4,1,1,6,Mid-Value,Potential Loyalists
92933,7,5,"150,5",5,1,1,7,Mid-Value,Potential Loyalists
92934,11,3,"149,45",5,1,1,7,Mid-Value,Potential Loyalists
92936,762,2,"40,8",3,1,1,5,Low-Value,At Risk Customers
92938,12,7,"364,4",5,2,1,8,High-Value,Potential Loyalists
92939,1123,2,"64,65",2,1,1,4,Low-Value,Can't Lose
92940,976,2,"38,75",3,1,1,5,Low-Value,At Risk Customers
92942,701,3,"78,05",4,1,1,6,Mid-Value,Potential Loyalists
92944,332,3,"108,55",5,1,1,7,Mid-Value,Potential Loyalists
92946,307,3,"201,7",5,1,1,7,Mid-Value,Potential Loyalists
92947,579,4,"225,85",4,1,1,6,Mid-Value,Potential Loyalists
92948,250,4,"167,25",5,1,1,7,Mid-Value,Potential Loyalists
92950,1060,2,"93,55",3,1,1,5,Low-Value,At Risk Customers
92952,415,5,"147,85",4,1,1,6,Mid-Value,Potential Loyalists
92954,1480,1,"40,0",1,1,1,3,Low-Value,Lost
92956,186,7,"460,65",5,2,1,8,High-Value,Potential Loyalists
92957,678,1,"9,5",4,1,1,6,Mid-Value,Potential Loyalists
92961,1052,1,"51,9",3,1,1,5,Low-Value,At Risk Customers
92963,229,4,"64,5",5,1,1,7,Mid-Value,Potential Loyalists
92965,1028,2,"279,3",3,1,1,5,Low-Value,At Risk Customers
92966,850,3,"84,35",3,1,1,5,Low-Value,At Risk Customers
92967,60,5,"248,00000000000003",5,1,1,7,Mid-Value,Potential Loyalists
92969,28,12,"571,15",5,3,1,9,High-Value,Champions
92970,299,3,"54,650000000000006",5,1,1,7,Mid-Value,Potential Loyalists
92971,28,5,"521,45",5,1,1,7,Mid-Value,Potential Loyalists
92972,107,3,"297,8",5,1,1,7,Mid-Value,Potential Loyalists
92973,1687,1,"32,25",1,1,1,3,Low-Value,Lost
92974,908,2,"110,1",3,1,1,5,Low-Value,At Risk Customers
92975,780,2,"56,400000000000006",3,1,1,5,Low-Value,At Risk Customers
92976,33,6,"244,15",5,1,1,7,Mid-Value,Potential Loyalists
92978,1216,3,"109,1",2,1,1,4,Low-Value,Can't Lose
92983,46,8,"131,95",5,2,1,8,High-Value,Potential Loyalists
92985,10,6,"699,45",5,1,2,8,High-Value,Potential Loyalists
92987,822,3,"361,25",3,1,1,5,Low-Value,At Risk Customers
92989,659,2,"32,900000000000006",4,1,1,6,Mid-Value,Potential Loyalists
92990,314,6,"451,55",5,1,1,7,Mid-Value,Potential Loyalists
92991,12,12,"565,95",5,3,1,9,High-Value,Champions
92992,669,1,"42,75",4,1,1,6,Mid-Value,Potential Loyalists
92993,1104,4,"1005,1",2,1,2,5,Low-Value,At Risk Customers
92994,988,1,"91,05000000000001",3,1,1,5,Low-Value,At Risk Customers
92996,291,4,"513,5",5,1,1,7,Mid-Value,Potential Loyalists
92997,475,2,"307,95000000000005",4,1,1,6,Mid-Value,Potential Loyalists
92998,623,3,"233,8",4,1,1,6,Mid-Value,Potential Loyalists
92999,125,6,"266,25",5,1,1,7,Mid-Value,Potential Loyalists
93000,152,2,"68,9",5,1,1,7,Mid-Value,Potential Loyalists
93002,180,7,"468,9",5,2,1,8,High-Value,Potential Loyalists
93004,778,2,"55,45",3,1,1,5,Low-Value,At Risk Customers
93005,72,3,"54,650000000000006",5,1,1,7,Mid-Value,Potential Loyalists
93006,896,2,"191,89999999999998",3,1,1,5,Low-Value,At Risk Customers
93007,629,2,"23,049999999999997",4,1,1,6,Mid-Value,Potential Loyalists
93009,407,3,"126,1",4,1,1,6,Mid-Value,Potential Loyalists
93010,135,9,"604,8",5,2,1,8,High-Value,Potential Loyalists
93014,42,3,"385,34999999999997",5,1,1,7,Mid-Value,Potential Loyalists
93015,1607,1,"112,7",1,1,1,3,Low-Value,Lost
93017,446,4,"248,0",4,1,1,6,Mid-Value,Potential Loyalists
93019,54,1,"54,55",5,1,1,7,Mid-Value,Potential Loyalists
93020,17,9,"790,8",5,2,2,9,High-Value,Champions
93022,106,6,"250,04999999999998",5,1,1,7,Mid-Value,Potential Loyalists
93024,405,4,"107,8",4,1,1,6,Mid-Value,Potential Loyalists
93025,1552,1,"3,6",1,1,1,3,Low-Value,Lost
93026,922,6,"448,8",3,1,1,5,Low-Value,At Risk Customers
93030,595,2,"184,0",4,1,1,6,Mid-Value,Potential Loyalists
93031,153,2,"359,65000000000003",5,1,1,7,Mid-Value,Potential Loyalists
93033,871,5,"256,25",3,1,1,5,Low-Value,At Risk Customers
93034,247,1,"19,25",5,1,1,7,Mid-Value,Potential Loyalists
93035,439,4,"70,45",4,1,1,6,Mid-Value,Potential Loyalists
93038,1485,1,"33,1",1,1,1,3,Low-Value,Lost
93039,37,12,"565,55",5,3,1,9,High-Value,Champions
93040,203,1,"110,5",5,1,1,7,Mid-Value,Potential Loyalists
93041,133,3,"89,9",5,1,1,7,Mid-Value,Potential Loyalists
93042,229,6,"611,35",5,1,1,7,Mid-Value,Potential Loyalists
93043,130,3,"130,6",5,1,1,7,Mid-Value,Potential Loyalists
93046,767,2,"256,45",3,1,1,5,Low-Value,At Risk Customers
93048,673,2,"106,75",4,1,1,6,Mid-Value,Potential Loyalists
93049,353,1,"56,7",5,1,1,7,Mid-Value,Potential Loyalists
93050,47,4,"108,85",5,1,1,7,Mid-Value,Potential Loyalists
93052,459,1,"18,3",4,1,1,6,Mid-Value,Potential Loyalists
93053,798,1,"127,65",3,1,1,5,Low-Value,At Risk Customers
93056,1180,2,"149,6",2,1,1,4,Low-Value,Can't Lose
93063,143,1,"12,0",5,1,1,7,Mid-Value,Potential Loyalists
93064,173,5,"179,65",5,1,1,7,Mid-Value,Potential Loyalists
93066,1523,1,"27,45",1,1,1,3,Low-Value,Lost
93069,889,2,"89,45",3,1,1,5,Low-Value,At Risk Customers
93070,1736,1,"53,85",1,1,1,3,Low-Value,Lost
93074,987,1,"25,650000000000002",3,1,1,5,Low-Value,At Risk Customers
93077,20,6,"415,75",5,1,1,7,Mid-Value,Potential Loyalists
93078,85,1,"90,45",5,1,1,7,Mid-Value,Potential Loyalists
93080,947,1,"145,2",3,1,1,5,Low-Value,At Risk Customers
93081,120,4,"174,0",5,1,1,7,Mid-Value,Potential Loyalists
93082,179,1,"127,4",5,1,1,7,Mid-Value,Potential Loyalists
93084,257,3,"192,7",5,1,1,7,Mid-Value,Potential Loyalists
93086,619,1,"15,2",4,1,1,6,Mid-Value,Potential Loyalists
93088,63,4,"704,5",5,1,2,8,High-Value,Potential Loyalists
93092,177,3,"118,9",5,1,1,7,Mid-Value,Potential Loyalists
93093,1693,2,"175,2",1,1,1,3,Low-Value,Lost
93094,396,2,"77,69999999999999",4,1,1,6,Mid-Value,Potential Loyalists
93095,78,5,"359,2",5,1,1,7,Mid-Value,Potential Loyalists
93097,197,2,"110,8",5,1,1,7,Mid-Value,Potential Loyalists
93103,14,5,"210,05",5,1,1,7,Mid-Value,Potential Loyalists
93104,654,4,"388,65",4,1,1,6,Mid-Value,Potential Loyalists
93105,1258,1,"43,2",2,1,1,4,Low-Value,Can't Lose
93107,139,4,"135,8",5,1,1,7,Mid-Value,Potential Loyalists
93108,178,3,"105,95",5,1,1,7,Mid-Value,Potential Loyalists
93109,1615,1,"32,2",1,1,1,3,Low-Value,Lost
93110,1244,1,"71,9",2,1,1,4,Low-Value,Can't Lose
93111,258,17,"931,3",5,4,2,11,High-Value,Champions
93112,619,2,"20,05",4,1,1,6,Mid-Value,Potential Loyalists
93114,7,1,"8,05",5,1,1,7,Mid-Value,Potential Loyalists
93115,1259,1,"102,6",2,1,1,4,Low-Value,Can't Lose
93116,1,10,"734,15",5,2,2,9,High-Value,Champions
93119,192,1,"9,2",5,1,1,7,Mid-Value,Potential Loyalists
93121,1382,1,"11,6",2,1,1,4,Low-Value,Can't Lose
93122,632,3,"128,65",4,1,1,6,Mid-Value,Potential Loyalists
93123,157,1,"23,45",5,1,1,7,Mid-Value,Potential Loyalists
93124,556,8,"310,35",4,2,1,7,Mid-Value,Potential Loyalists
93125,335,1,"13,25",5,1,1,7,Mid-Value,Potential Loyalists
93126,671,4,"568,75",4,1,1,6,Mid-Value,Potential Loyalists
93128,61,7,"223,95",5,2,1,8,High-Value,Potential Loyalists
93129,741,5,"338,0",3,1,1,5,Low-Value,At Risk Customers
93131,520,2,"198,65",4,1,1,6,Mid-Value,Potential Loyalists
93132,288,5,"326,29999999999995",5,1,1,7,Mid-Value,Potential Loyalists
93133,4,6,"454,04999999999995",5,1,1,7,Mid-Value,Potential Loyalists
93136,1284,3,"103,4",2,1,1,4,Low-Value,Can't Lose
93137,24,3,"59,099999999999994",5,1,1,7,Mid-Value,Potential Loyalists
93138,697,1,"82,0",4,1,1,6,Mid-Value,Potential Loyalists
93139,1450,1,"13,35",2,1,1,4,Low-Value,Can't Lose
93140,766,4,"209,55",3,1,1,5,Low-Value,At Risk Customers
93141,136,3,"142,95",5,1,1,7,Mid-Value,Potential Loyalists
93142,489,4,"241,4",4,1,1,6,Mid-Value,Potential Loyalists
93144,52,4,"300,35",5,1,1,7,Mid-Value,Potential Loyalists
93145,19,4,"313,75",5,1,1,7,Mid-Value,Potential Loyalists
93146,190,2,"132,4",5,1,1,7,Mid-Value,Potential Loyalists
93147,166,4,"300,75",5,1,1,7,Mid-Value,Potential Loyalists
93150,451,4,"476,4",4,1,1,6,Mid-Value,Potential Loyalists
93151,467,6,"312,05",4,1,1,6,Mid-Value,Potential Loyalists
93153,630,2,"94,30000000000001",4,1,1,6,Mid-Value,Potential Loyalists
93154,794,1,"130,55",3,1,1,5,Low-Value,At Risk Customers
93155,974,4,"33,95",3,1,1,5,Low-Value,At Risk Customers
93156,128,11,"563,6",5,2,1,8,High-Value,Potential Loyalists
93158,1147,1,"47,4",2,1,1,4,Low-Value,Can't Lose
93159,1331,2,"40,7",2,1,1,4,Low-Value,Can't Lose
93160,439,6,"429,5",4,1,1,6,Mid-Value,Potential Loyalists
93161,1666,1,"26,6",1,1,1,3,Low-Value,Lost
93162,63,1,"6,55",5,1,1,7,Mid-Value,Potential Loyalists
93163,175,6,"486,0",5,1,1,7,Mid-Value,Potential Loyalists
93166,322,5,"188,65",5,1,1,7,Mid-Value,Potential Loyalists
93167,12,9,"399,75",5,2,1,8,High-Value,Potential Loyalists
93169,7,4,"154,8",5,1,1,7,Mid-Value,Potential Loyalists
93170,3,8,"579,75",5,2,1,8,High-Value,Potential Loyalists
93172,127,4,"315,6",5,1,1,7,Mid-Value,Potential Loyalists
93173,212,4,"617,4",5,1,1,7,Mid-Value,Potential Loyalists
93175,43,8,"496,25",5,2,1,8,High-Value,Potential Loyalists
93176,1488,1,"55,9",1,1,1,3,Low-Value,Lost
93177,674,1,"27,55",4,1,1,6,Mid-Value,Potential Loyalists
93179,362,4,"177,45",5,1,1,7,Mid-Value,Potential Loyalists
93180,241,7,"381,40000000000003",5,2,1,8,High-Value,Potential Loyalists
93181,152,5,"331,6",5,1,1,7,Mid-Value,Potential Loyalists
93183,192,2,"65,15",5,1,1,7,Mid-Value,Potential Loyalists
93187,832,10,"490,0",3,2,1,6,Mid-Value,Potential Loyalists
93188,1168,1,"40,0",2,1,1,4,Low-Value,Can't Lose
93190,58,1,"52,4",5,1,1,7,Mid-Value,Potential Loyalists
93192,942,1,"32,9",3,1,1,5,Low-Value,At Risk Customers
93193,154,5,"247,95",5,1,1,7,Mid-Value,Potential Loyalists
93195,419,1,"3,6",4,1,1,6,Mid-Value,Potential Loyalists
93196,1099,2,"361,2",2,1,1,4,Low-Value,Can't Lose
93198,1782,1,"7,5",1,1,1,3,Low-Value,Lost
93199,512,1,"14,8",4,1,1,6,Mid-Value,Potential Loyalists
93203,98,1,"13,4",5,1,1,7,Mid-Value,Potential Loyalists
93204,1262,1,"254,0",2,1,1,4,Low-Value,Can't Lose
93206,898,2,"304,2",3,1,1,5,Low-Value,At Risk Customers
93207,251,6,"196,55",5,1,1,7,Mid-Value,Potential Loyalists
93208,21,1,"63,6",5,1,1,7,Mid-Value,Potential Loyalists
93209,338,5,"547,95",5,1,1,7,Mid-Value,Potential Loyalists
93210,552,2,"282,05",4,1,1,6,Mid-Value,Potential Loyalists
93211,412,2,"15,0",4,1,1,6,Mid-Value,Potential Loyalists
93212,59,3,"82,05",5,1,1,7,Mid-Value,Potential Loyalists
93213,618,2,"91,75",4,1,1,6,Mid-Value,Potential Loyalists
93214,135,2,"336,9",5,1,1,7,Mid-Value,Potential Loyalists
93216,804,1,"34,9",3,1,1,5,Low-Value,At Risk Customers
93217,1135,2,"398,5",2,1,1,4,Low-Value,Can't Lose
93218,66,7,"166,25",5,2,1,8,High-Value,Potential Loyalists
93219,689,2,"39,550000000000004",4,1,1,6,Mid-Value,Potential Loyalists
93221,402,3,"93,25",4,1,1,6,Mid-Value,Potential Loyalists
93222,662,4,"161,45",4,1,1,6,Mid-Value,Potential Loyalists
93223,745,11,"1086,0",3,2,2,7,Mid-Value,Potential Loyalists
93228,89,4,"144,8",5,1,1,7,Mid-Value,Potential Loyalists
93230,115,4,"163,8",5,1,1,7,Mid-Value,Potential Loyalists
93231,353,3,"311,85",5,1,1,7,Mid-Value,Potential Loyalists
93233,1471,8,"396,0",1,2,1,4,Low-Value,Can't Lose
93234,472,2,"63,599999999999994",4,1,1,6,Mid-Value,Potential Loyalists
93235,131,8,"338,35",5,2,1,8,High-Value,Potential Loyalists
93237,49,1,"149,9",5,1,1,7,Mid-Value,Potential Loyalists
93238,444,7,"278,75",4,2,1,7,Mid-Value,Potential Loyalists
93239,0,6,"624,85",5,1,1,7,Mid-Value,Potential Loyalists
93242,1476,2,"67,75",1,1,1,3,Low-Value,Lost
93245,230,2,"45,449999999999996",5,1,1,7,Mid-Value,Potential Loyalists
93246,449,5,"167,7",4,1,1,6,Mid-Value,Potential Loyalists
93248,1732,2,"97,9",1,1,1,3,Low-Value,Lost
93250,410,7,"312,3",4,2,1,7,Mid-Value,Potential Loyalists
93251,265,2,"59,2",5,1,1,7,Mid-Value,Potential Loyalists
93252,974,1,"157,64999999999998",3,1,1,5,Low-Value,At Risk Customers
93253,612,5,"277,20000000000005",4,1,1,6,Mid-Value,Potential Loyalists
93254,1065,2,"94,24999999999999",3,1,1,5,Low-Value,At Risk Customers
93255,101,11,"859,4",5,2,2,9,High-Value,Champions
93256,42,7,"337,84999999999997",5,2,1,8,High-Value,Potential Loyalists
93257,1564,1,"19,9",1,1,1,3,Low-Value,Lost
93258,331,3,"156,0",5,1,1,7,Mid-Value,Potential Loyalists
93259,382,2,"82,4",4,1,1,6,Mid-Value,Potential Loyalists
93261,57,4,"58,75",5,1,1,7,Mid-Value,Potential Loyalists
93262,38,10,"847,3",5,2,2,9,High-Value,Champions
93264,900,7,"376,85",3,2,1,6,Mid-Value,Potential Loyalists
93267,481,2,"49,6",4,1,1,6,Mid-Value,Potential Loyalists
93268,42,4,"271,65",5,1,1,7,Mid-Value,Potential Loyalists
93270,18,6,"744,8",5,1,2,8,High-Value,Potential Loyalists
93273,21,14,"626,4",5,3,1,9,High-Value,Champions
93276,1138,3,"137,95000000000002",2,1,1,4,Low-Value,Can't Lose
93279,571,4,"253,35000000000002",4,1,1,6,Mid-Value,Potential Loyalists
93280,142,4,"205,7",5,1,1,7,Mid-Value,Potential Loyalists
93281,1107,1,"59,6",2,1,1,4,Low-Value,Can't Lose
93282,456,1,"13,4",4,1,1,6,Mid-Value,Potential Loyalists
93283,45,3,"217,15",5,1,1,7,Mid-Value,Potential Loyalists
93285,1027,1,"16,3",3,1,1,5,Low-Value,At Risk Customers
93288,62,6,"221,35",5,1,1,7,Mid-Value,Potential Loyalists
93292,1161,2,"141,55",2,1,1,4,Low-Value,Can't Lose
93293,236,5,"1151,75",5,1,2,8,High-Value,Potential Loyalists
93295,190,2,"94,0",5,1,1,7,Mid-Value,Potential Loyalists
93298,1525,1,"68,15",1,1,1,3,Low-Value,Lost
93299,140,7,"235,8",5,2,1,8,High-Value,Potential Loyalists
93300,319,3,"108,1",5,1,1,7,Mid-Value,Potential Loyalists
93302,98,2,"13,7",5,1,1,7,Mid-Value,Potential Loyalists
93303,528,2,"460,90000000000003",4,1,1,6,Mid-Value,Potential Loyalists
93304,101,8,"328,65",5,2,1,8,High-Value,Potential Loyalists
93309,43,5,"417,05",5,1,1,7,Mid-Value,Potential Loyalists
93312,1473,1,"8,0",1,1,1,3,Low-Value,Lost
93315,753,3,"101,7",3,1,1,5,Low-Value,At Risk Customers
93316,372,1,"22,3",4,1,1,6,Mid-Value,Potential Loyalists
93317,0,5,"421,35",5,1,1,7,Mid-Value,Potential Loyalists
93318,40,12,"708,65",5,3,2,10,High-Value,Champions
93319,706,1,"118,5",4,1,1,6,Mid-Value,Potential Loyalists
93321,305,3,"146,35",5,1,1,7,Mid-Value,Potential Loyalists
93322,1155,1,"14,85",2,1,1,4,Low-Value,Can't Lose
93323,302,5,"190,95",5,1,1,7,Mid-Value,Potential Loyalists
93324,798,2,"38,5",3,1,1,5,Low-Value,At Risk Customers
93329,750,2,"113,5",3,1,1,5,Low-Value,At Risk Customers
93330,26,9,"625,05",5,2,1,8,High-Value,Potential Loyalists
93331,9,6,"413,40000000000003",5,1,1,7,Mid-Value,Potential Loyalists
93333,469,5,"156,3",4,1,1,6,Mid-Value,Potential Loyalists
93334,1129,5,"236,05",2,1,1,4,Low-Value,Can't Lose
93335,469,6,"584,6999999999999",4,1,1,6,Mid-Value,Potential Loyalists
93337,316,3,"113,4",5,1,1,7,Mid-Value,Potential Loyalists
93338,302,7,"591,25",5,2,1,8,High-Value,Potential Loyalists
93339,1287,2,"84,1",2,1,1,4,Low-Value,Can't Lose
93341,211,5,"118,1",5,1,1,7,Mid-Value,Potential Loyalists
93343,359,2,"150,45",5,1,1,7,Mid-Value,Potential Loyalists
93344,926,2,"56,949999999999996",3,1,1,5,Low-Value,At Risk Customers
93346,667,4,"251,65",4,1,1,6,Mid-Value,Potential Loyalists
93350,2,1,"10,0",5,1,1,7,Mid-Value,Potential Loyalists
93351,1453,3,"104,8",2,1,1,4,Low-Value,Can't Lose
93354,1376,1,"51,45",2,1,1,4,Low-Value,Can't Lose
93357,3,7,"218,0",5,2,1,8,High-Value,Potential Loyalists
93358,127,10,"598,7",5,2,1,8,High-Value,Potential Loyalists
93359,343,2,"137,65",5,1,1,7,Mid-Value,Potential Loyalists
93361,267,2,"63,55",5,1,1,7,Mid-Value,Potential Loyalists
93363,1514,1,"62,25",1,1,1,3,Low-Value,Lost
93364,157,3,"370,9",5,1,1,7,Mid-Value,Potential Loyalists
93369,878,3,"82,4",3,1,1,5,Low-Value,At Risk Customers
93370,127,7,"213,35",5,2,1,8,High-Value,Potential Loyalists
93371,250,5,"496,4",5,1,1,7,Mid-Value,Potential Loyalists
93373,81,7,"1105,1",5,2,2,9,High-Value,Champions
93378,690,6,"316,2",4,1,1,6,Mid-Value,Potential Loyalists
93380,786,2,"52,599999999999994",3,1,1,5,Low-Value,At Risk Customers
93381,755,3,"353,0",3,1,1,5,Low-Value,At Risk Customers
93382,573,4,"135,20000000000002",4,1,1,6,Mid-Value,Potential Loyalists
93387,180,7,"518,0",5,2,1,8,High-Value,Potential Loyalists
93389,83,7,"819,25",5,2,2,9,High-Value,Champions
93390,347,3,"158,89999999999998",5,1,1,7,Mid-Value,Potential Loyalists
93392,1507,2,"120,65",1,1,1,3,Low-Value,Lost
93394,424,4,"200,75",4,1,1,6,Mid-Value,Potential Loyalists
93395,559,8,"642,85",4,2,1,7,Mid-Value,Potential Loyalists
93397,248,1,"10,9",5,1,1,7,Mid-Value,Potential Loyalists
93398,11,7,"258,7",5,2,1,8,High-Value,Potential Loyalists
93400,987,1,"21,65",3,1,1,5,Low-Value,At Risk Customers
93402,24,14,"1182,05",5,3,2,10,High-Value,Champions
93405,245,3,"91,85",5,1,1,7,Mid-Value,Potential Loyalists
93407,731,2,"55,5",3,1,1,5,Low-Value,At Risk Customers
93408,271,13,"1073,7",5,3,2,10,High-Value,Champions
93409,8,3,"234,35",5,1,1,7,Mid-Value,Potential Loyalists
93410,813,1,"18,45",3,1,1,5,Low-Value,At Risk Customers
93414,220,3,"107,44999999999999",5,1,1,7,Mid-Value,Potential Loyalists
93416,1313,1,"23,3",2,1,1,4,Low-Value,Can't Lose
93417,753,1,"48,4",3,1,1,5,Low-Value,At Risk Customers
93419,504,3,"167,70000000000002",4,1,1,6,Mid-Value,Potential Loyalists
93422,28,3,"217,4",5,1,1,7,Mid-Value,Potential Loyalists
93424,381,7,"386,55",4,2,1,7,Mid-Value,Potential Loyalists
93430,561,1,"63,2",4,1,1,6,Mid-Value,Potential Loyalists
93431,183,1,"61,9",5,1,1,7,Mid-Value,Potential Loyalists
93432,918,8,"781,85",3,2,2,7,Mid-Value,Potential Loyalists
93434,767,3,"114,9",3,1,1,5,Low-Value,At Risk Customers
93435,195,2,"70,85",5,1,1,7,Mid-Value,Potential Loyalists
93436,2,9,"1401,55",5,2,3,10,High-Value,Champions
93439,1176,1,"18,2",2,1,1,4,Low-Value,Can't Lose
93442,731,2,"110,14999999999999",3,1,1,5,Low-Value,At Risk Customers
93447,1200,2,"44,25",2,1,1,4,Low-Value,Can't Lose
93449,330,2,"80,15",5,1,1,7,Mid-Value,Potential Loyalists
93450,1431,1,"14,3",2,1,1,4,Low-Value,Can't Lose
93451,1120,1,"21,3",2,1,1,4,Low-Value,Can't Lose
93452,633,2,"18,75",4,1,1,6,Mid-Value,Potential Loyalists
93453,9,9,"226,45",5,2,1,8,High-Value,Potential Loyalists
93454,5,3,"127,65",5,1,1,7,Mid-Value,Potential Loyalists
93455,730,4,"107,75",4,1,1,6,Mid-Value,Potential Loyalists
93458,15,3,"397,0",5,1,1,7,Mid-Value,Potential Loyalists
93459,1506,1,"109,9",1,1,1,3,Low-Value,Lost
93460,685,1,"24,2",4,1,1,6,Mid-Value,Potential Loyalists
93463,419,1,"4,85",4,1,1,6,Mid-Value,Potential Loyalists
93464,195,5,"205,9",5,1,1,7,Mid-Value,Potential Loyalists
93465,48,3,"162,4",5,1,1,7,Mid-Value,Potential Loyalists
93467,431,4,"74,3",4,1,1,6,Mid-Value,Potential Loyalists
93468,458,2,"421,75",4,1,1,6,Mid-Value,Potential Loyalists
93473,1252,1,"5,8",2,1,1,4,Low-Value,Can't Lose
93474,27,3,"169,20000000000002",5,1,1,7,Mid-Value,Potential Loyalists
93475,1430,1,"225,5",2,1,1,4,Low-Value,Can't Lose
93476,218,2,"202,60000000000002",5,1,1,7,Mid-Value,Potential Loyalists
93477,357,1,"216,29999999999998",5,1,1,7,Mid-Value,Potential Loyalists
93478,783,7,"166,65",3,2,1,6,Mid-Value,Potential Loyalists
93479,501,2,"119,3",4,1,1,6,Mid-Value,Potential Loyalists
93480,399,2,"251,75",4,1,1,6,Mid-Value,Potential Loyalists
93486,138,8,"827,7",5,2,2,9,High-Value,Champions
93487,239,6,"619,5",5,1,1,7,Mid-Value,Potential Loyalists
93490,1240,3,"137,10000000000002",2,1,1,4,Low-Value,Can't Lose
93491,85,1,"18,55",5,1,1,7,Mid-Value,Potential Loyalists
93493,1394,1,"20,7",2,1,1,4,Low-Value,Can't Lose
93495,81,1,"10,2",5,1,1,7,Mid-Value,Potential Loyalists
93496,1330,2,"64,2",2,1,1,4,Low-Value,Can't Lose
93497,407,1,"57,4",4,1,1,6,Mid-Value,Potential Loyalists
93499,255,2,"49,7",5,1,1,7,Mid-Value,Potential Loyalists
93501,84,3,"174,6",5,1,1,7,Mid-Value,Potential Loyalists
93502,301,4,"344,4",5,1,1,7,Mid-Value,Potential Loyalists
93503,62,3,"46,05",5,1,1,7,Mid-Value,Potential Loyalists
93506,657,2,"523,35",4,1,1,6,Mid-Value,Potential Loyalists
93507,770,4,"195,54999999999998",3,1,1,5,Low-Value,At Risk Customers
93508,500,1,"84,3",4,1,1,6,Mid-Value,Potential Loyalists
93509,487,3,"248,5",4,1,1,6,Mid-Value,Potential Loyalists
93510,867,1,"14,8",3,1,1,5,Low-Value,At Risk Customers
93511,591,2,"103,8",4,1,1,6,Mid-Value,Potential Loyalists
93513,580,2,"51,25",4,1,1,6,Mid-Value,Potential Loyalists
93514,174,6,"322,5",5,1,1,7,Mid-Value,Potential Loyalists
93515,350,1,"41,3",5,1,1,7,Mid-Value,Potential Loyalists
93516,253,2,"27,6",5,1,1,7,Mid-Value,Potential Loyalists
93517,745,4,"298,05",3,1,1,5,Low-Value,At Risk Customers
93520,1160,1,"76,35",2,1,1,4,Low-Value,Can't Lose
93522,46,8,"550,95",5,2,1,8,High-Value,Potential Loyalists
93523,807,3,"168,65",3,1,1,5,Low-Value,At Risk Customers
93524,30,8,"778,35",5,2,2,9,High-Value,Champions
93526,137,4,"460,04999999999995",5,1,1,7,Mid-Value,Potential Loyalists
93528,155,4,"179,85",5,1,1,7,Mid-Value,Potential Loyalists
93529,145,3,"112,15",5,1,1,7,Mid-Value,Potential Loyalists
93532,705,2,"509,05",4,1,1,6,Mid-Value,Potential Loyalists
93534,1765,1,"21,15",1,1,1,3,Low-Value,Lost
93536,957,5,"418,79999999999995",3,1,1,5,Low-Value,At Risk Customers
93537,93,7,"330,95",5,2,1,8,High-Value,Potential Loyalists
93538,363,2,"49,55",5,1,1,7,Mid-Value,Potential Loyalists
93539,483,6,"240,75000000000003",4,1,1,6,Mid-Value,Potential Loyalists
93540,77,7,"570,45",5,2,1,8,High-Value,Potential Loyalists
93541,408,4,"139,8",4,1,1,6,Mid-Value,Potential Loyalists
93542,550,1,"10,6",4,1,1,6,Mid-Value,Potential Loyalists
93546,349,1,"187,6",5,1,1,7,Mid-Value,Potential Loyalists
93547,929,1,"24,5",3,1,1,5,Low-Value,At Risk Customers
93548,194,4,"371,85",5,1,1,7,Mid-Value,Potential Loyalists
93550,550,5,"373,34999999999997",4,1,1,6,Mid-Value,Potential Loyalists
93552,1613,1,"248,0",1,1,1,3,Low-Value,Lost
93553,248,2,"102,95",5,1,1,7,Mid-Value,Potential Loyalists
93558,270,3,"440,5",5,1,1,7,Mid-Value,Potential Loyalists
93559,548,2,"187,2",4,1,1,6,Mid-Value,Potential Loyalists
93562,125,1,"9,15",5,1,1,7,Mid-Value,Potential Loyalists
93566,656,10,"415,4",4,2,1,7,Mid-Value,Potential Loyalists
93568,313,2,"295,45",5,1,1,7,Mid-Value,Potential Loyalists
93569,91,9,"480,75",5,2,1,8,High-Value,Potential Loyalists
93571,339,5,"150,4",5,1,1,7,Mid-Value,Potential Loyalists
93574,980,5,"389,5",3,1,1,5,Low-Value,At Risk Customers
93577,1469,1,"45,9",1,1,1,3,Low-Value,Lost
93578,12,4,"158,4",5,1,1,7,Mid-Value,Potential Loyalists
93579,67,5,"527,6",5,1,1,7,Mid-Value,Potential Loyalists
93580,38,6,"281,2",5,1,1,7,Mid-Value,Potential Loyalists
93583,432,4,"209,6",4,1,1,6,Mid-Value,Potential Loyalists
93586,39,8,"303,45",5,2,1,8,High-Value,Potential Loyalists
93587,36,15,"640,95",5,3,1,9,High-Value,Champions
93590,822,1,"37,9",3,1,1,5,Low-Value,At Risk Customers
93592,797,4,"232,55",3,1,1,5,Low-Value,At Risk Customers
93593,70,5,"780,85",5,1,2,8,High-Value,Potential Loyalists
93594,65,4,"96,39999999999999",5,1,1,7,Mid-Value,Potential Loyalists
93595,1467,1,"17,5",1,1,1,3,Low-Value,Lost
93597,80,1,"43,2",5,1,1,7,Mid-Value,Potential Loyalists
93598,233,3,"375,9",5,1,1,7,Mid-Value,Potential Loyalists
93600,17,4,"594,4",5,1,1,7,Mid-Value,Potential Loyalists
93602,1111,2,"61,2",2,1,1,4,Low-Value,Can't Lose
93603,21,4,"102,2",5,1,1,7,Mid-Value,Potential Loyalists
93605,676,1,"29,05",4,1,1,6,Mid-Value,Potential Loyalists
93606,964,1,"52,8",3,1,1,5,Low-Value,At Risk Customers
93608,1151,1,"40,45",2,1,1,4,Low-Value,Can't Lose
93609,349,2,"92,65",5,1,1,7,Mid-Value,Potential Loyalists
93611,423,2,"121,55000000000001",4,1,1,6,Mid-Value,Potential Loyalists
93613,1769,1,"32,15",1,1,1,3,Low-Value,Lost
93615,1002,4,"159,95",3,1,1,5,Low-Value,At Risk Customers
93617,950,1,"51,3",3,1,1,5,Low-Value,At Risk Customers
93619,51,3,"120,0",5,1,1,7,Mid-Value,Potential Loyalists
93621,751,1,"38,4",3,1,1,5,Low-Value,At Risk Customers
93622,1,8,"320,40000000000003",5,2,1,8,High-Value,Potential Loyalists
93623,10,4,"133,85",5,1,1,7,Mid-Value,Potential Loyalists
93624,171,2,"83,9",5,1,1,7,Mid-Value,Potential Loyalists
93626,367,2,"56,1",4,1,1,6,Mid-Value,Potential Loyalists
93627,528,2,"124,19999999999999",4,1,1,6,Mid-Value,Potential Loyalists
93628,257,3,"786,8",5,1,2,8,High-Value,Potential Loyalists
93629,263,1,"97,95",5,1,1,7,Mid-Value,Potential Loyalists
93630,61,9,"351,3",5,2,1,8,High-Value,Potential Loyalists
93632,594,3,"113,7",4,1,1,6,Mid-Value,Potential Loyalists
93636,521,1,"16,1",4,1,1,6,Mid-Value,Potential Loyalists
93638,1162,6,"202,8",2,1,1,4,Low-Value,Can't Lose
93639,1812,1,"16,3",1,1,1,3,Low-Value,Lost
93640,473,1,"199,0",4,1,1,6,Mid-Value,Potential Loyalists
93641,79,7,"852,3000000000001",5,2,2,9,High-Value,Champions
93642,649,1,"8,9",4,1,1,6,Mid-Value,Potential Loyalists
93643,56,7,"763,5",5,2,2,9,High-Value,Champions
93649,164,2,"113,45",5,1,1,7,Mid-Value,Potential Loyalists
93651,1110,4,"239,00000000000003",2,1,1,4,Low-Value,Can't Lose
93652,330,2,"19,5",5,1,1,7,Mid-Value,Potential Loyalists
93653,382,5,"176,75",4,1,1,6,Mid-Value,Potential Loyalists
93654,377,3,"313,65",4,1,1,6,Mid-Value,Potential Loyalists
93659,1483,1,"220,79999999999998",1,1,1,3,Low-Value,Lost
93660,344,2,"172,7",5,1,1,7,Mid-Value,Potential Loyalists
93661,375,4,"154,55",4,1,1,6,Mid-Value,Potential Loyalists
93662,77,5,"522,5",5,1,1,7,Mid-Value,Potential Loyalists
93663,12,2,"175,0",5,1,1,7,Mid-Value,Potential Loyalists
93664,502,1,"139,95",4,1,1,6,Mid-Value,Potential Loyalists
93665,693,1,"8,5",4,1,1,6,Mid-Value,Potential Loyalists
93667,138,4,"131,05",5,1,1,7,Mid-Value,Potential Loyalists
93669,13,6,"395,15",5,1,1,7,Mid-Value,Potential Loyalists
93671,383,8,"564,45",4,2,1,7,Mid-Value,Potential Loyalists
93673,1292,1,"81,3",2,1,1,4,Low-Value,Can't Lose
93675,1261,2,"117,75",2,1,1,4,Low-Value,Can't Lose
93676,1195,1,"38,9",2,1,1,4,Low-Value,Can't Lose
93677,372,2,"162,0",4,1,1,6,Mid-Value,Potential Loyalists
93679,691,2,"72,25",4,1,1,6,Mid-Value,Potential Loyalists
93681,160,7,"754,0999999999999",5,2,2,9,High-Value,Champions
93682,1511,2,"32,35",1,1,1,3,Low-Value,Lost
93683,918,1,"84,0",3,1,1,5,Low-Value,At Risk Customers
93684,74,3,"58,8",5,1,1,7,Mid-Value,Potential Loyalists
93688,725,3,"639,0999999999999",4,1,1,6,Mid-Value,Potential Loyalists
93690,139,4,"301,55",5,1,1,7,Mid-Value,Potential Loyalists
93691,522,2,"59,5",4,1,1,6,Mid-Value,Potential Loyalists
93693,242,2,"315,3",5,1,1,7,Mid-Value,Potential Loyalists
93694,385,4,"213,70000000000002",4,1,1,6,Mid-Value,Potential Loyalists
93697,740,4,"222,7",3,1,1,5,Low-Value,At Risk Customers
93698,163,1,"552,9",5,1,1,7,Mid-Value,Potential Loyalists
93700,860,1,"48,1",3,1,1,5,Low-Value,At Risk Customers
93701,845,3,"193,7",3,1,1,5,Low-Value,At Risk Customers
93702,257,1,"24,2",5,1,1,7,Mid-Value,Potential Loyalists
93703,258,4,"837,3499999999999",5,1,2,8,High-Value,Potential Loyalists
93705,4,4,"229,55",5,1,1,7,Mid-Value,Potential Loyalists
93706,218,2,"416,7",5,1,1,7,Mid-Value,Potential Loyalists
93708,681,4,"341,0",4,1,1,6,Mid-Value,Potential Loyalists
93709,1652,1,"8,55",1,1,1,3,Low-Value,Lost
93710,10,2,"114,1",5,1,1,7,Mid-Value,Potential Loyalists
93711,928,3,"294,79999999999995",3,1,1,5,Low-Value,At Risk Customers
93712,372,2,"72,5",4,1,1,6,Mid-Value,Potential Loyalists
93714,303,3,"53,0",5,1,1,7,Mid-Value,Potential Loyalists
93715,299,6,"347,0",5,1,1,7,Mid-Value,Potential Loyalists
93716,426,4,"262,3",4,1,1,6,Mid-Value,Potential Loyalists
93717,303,3,"187,55",5,1,1,7,Mid-Value,Potential Loyalists
93718,211,5,"349,1",5,1,1,7,Mid-Value,Potential Loyalists
93720,223,6,"646,45",5,1,1,7,Mid-Value,Potential Loyalists
93723,157,6,"378,95000000000005",5,1,1,7,Mid-Value,Potential Loyalists
93725,43,2,"131,29999999999998",5,1,1,7,Mid-Value,Potential Loyalists
93726,247,4,"116,15",5,1,1,7,Mid-Value,Potential Loyalists
93729,1441,1,"10,0",2,1,1,4,Low-Value,Can't Lose
93730,971,1,"13,5",3,1,1,5,Low-Value,At Risk Customers
93733,597,2,"126,60000000000001",4,1,1,6,Mid-Value,Potential Loyalists
93734,8,8,"850,25",5,2,2,9,High-Value,Champions
93735,477,2,"85,5",4,1,1,6,Mid-Value,Potential Loyalists
93736,1055,1,"238,95",3,1,1,5,Low-Value,At Risk Customers
93738,592,1,"8,1",4,1,1,6,Mid-Value,Potential Loyalists
93739,277,4,"534,65",5,1,1,7,Mid-Value,Potential Loyalists
93740,136,9,"618,95",5,2,1,8,High-Value,Potential Loyalists
93741,561,3,"57,95",4,1,1,6,Mid-Value,Potential Loyalists
93742,392,2,"196,89999999999998",4,1,1,6,Mid-Value,Potential Loyalists
93746,872,1,"175,8",3,1,1,5,Low-Value,At Risk Customers
93749,1606,1,"15,4",1,1,1,3,Low-Value,Lost
93750,1221,6,"841,1",2,1,2,5,Low-Value,At Risk Customers
93751,1660,2,"110,6",1,1,1,3,Low-Value,Lost
93752,841,2,"114,85000000000001",3,1,1,5,Low-Value,At Risk Customers
93753,1395,2,"26,35",2,1,1,4,Low-Value,Can't Lose
93755,708,2,"101,0",4,1,1,6,Mid-Value,Potential Loyalists
93757,146,2,"140,7",5,1,1,7,Mid-Value,Potential Loyalists
93759,714,2,"32,25",4,1,1,6,Mid-Value,Potential Loyalists
93760,755,3,"258,05",3,1,1,5,Low-Value,At Risk Customers
93761,691,2,"22,75",4,1,1,6,Mid-Value,Potential Loyalists
93762,1126,3,"111,95",2,1,1,4,Low-Value,Can't Lose
93763,994,1,"39,9",3,1,1,5,Low-Value,At Risk Customers
93765,47,2,"57,25",5,1,1,7,Mid-Value,Potential Loyalists
93767,1447,1,"10,85",2,1,1,4,Low-Value,Can't Lose
93768,166,10,"1194,8",5,2,2,9,High-Value,Champions
93770,49,6,"429,35",5,1,1,7,Mid-Value,Potential Loyalists
93773,22,4,"393,55",5,1,1,7,Mid-Value,Potential Loyalists
93774,153,17,"736,4",5,4,2,11,High-Value,Champions
93775,72,5,"264,75",5,1,1,7,Mid-Value,Potential Loyalists
93777,660,6,"324,34999999999997",4,1,1,6,Mid-Value,Potential Loyalists
93779,1,4,"332,0",5,1,1,7,Mid-Value,Potential Loyalists
93783,387,5,"588,55",4,1,1,6,Mid-Value,Potential Loyalists
93786,1596,1,"8,0",1,1,1,3,Low-Value,Lost
93788,651,5,"396,25",4,1,1,6,Mid-Value,Potential Loyalists
93789,1648,2,"10,8",1,1,1,3,Low-Value,Lost
93795,115,3,"236,85000000000002",5,1,1,7,Mid-Value,Potential Loyalists
93797,12,10,"453,15000000000003",5,2,1,8,High-Value,Potential Loyalists
93798,22,7,"527,6",5,2,1,8,High-Value,Potential Loyalists
93799,741,3,"265,95",3,1,1,5,Low-Value,At Risk Customers
93800,1648,1,"13,35",1,1,1,3,Low-Value,Lost
93801,86,3,"88,4",5,1,1,7,Mid-Value,Potential Loyalists
93803,22,6,"128,3",5,1,1,7,Mid-Value,Potential Loyalists
93807,262,1,"3,0",5,1,1,7,Mid-Value,Potential Loyalists
93808,1688,1,"43,9",1,1,1,3,Low-Value,Lost
93809,791,4,"214,25",3,1,1,5,Low-Value,At Risk Customers
93810,1639,1,"151,8",1,1,1,3,Low-Value,Lost
93811,42,5,"448,55",5,1,1,7,Mid-Value,Potential Loyalists
93813,21,6,"245,50000000000003",5,1,1,7,Mid-Value,Potential Loyalists
93814,14,1,"389,25",5,1,1,7,Mid-Value,Potential Loyalists
93816,519,1,"71,55",4,1,1,6,Mid-Value,Potential Loyalists
93817,502,1,"60,7",4,1,1,6,Mid-Value,Potential Loyalists
93819,23,2,"62,150000000000006",5,1,1,7,Mid-Value,Potential Loyalists
93821,74,1,"191,3",5,1,1,7,Mid-Value,Potential Loyalists
93822,270,2,"83,55",5,1,1,7,Mid-Value,Potential Loyalists
93825,228,9,"608,75",5,2,1,8,High-Value,Potential Loyalists
93826,49,4,"426,7",5,1,1,7,Mid-Value,Potential Loyalists
93827,762,1,"15,25",3,1,1,5,Low-Value,At Risk Customers
93828,561,2,"161,3",4,1,1,6,Mid-Value,Potential Loyalists
93829,34,3,"161,5",5,1,1,7,Mid-Value,Potential Loyalists
93830,874,1,"158,55",3,1,1,5,Low-Value,At Risk Customers
93831,934,1,"47,2",3,1,1,5,Low-Value,At Risk Customers
93832,27,9,"514,25",5,2,1,8,High-Value,Potential Loyalists
93833,441,3,"165,20000000000002",4,1,1,6,Mid-Value,Potential Loyalists
93834,773,5,"436,4",3,1,1,5,Low-Value,At Risk Customers
93835,1599,2,"89,7",1,1,1,3,Low-Value,Lost
93837,419,1,"85,35",4,1,1,6,Mid-Value,Potential Loyalists
93838,853,1,"56,0",3,1,1,5,Low-Value,At Risk Customers
93839,916,3,"75,3",3,1,1,5,Low-Value,At Risk Customers
93841,1025,1,"48,45",3,1,1,5,Low-Value,At Risk Customers
93843,108,6,"177,29999999999998",5,1,1,7,Mid-Value,Potential Loyalists
93844,402,2,"74,3",4,1,1,6,Mid-Value,Potential Loyalists
93847,70,7,"187,75",5,2,1,8,High-Value,Potential Loyalists
93850,894,1,"32,400000000000006",3,1,1,5,Low-Value,At Risk Customers
93852,65,6,"265,59999999999997",5,1,1,7,Mid-Value,Potential Loyalists
93853,1106,1,"381,5",2,1,1,4,Low-Value,Can't Lose
93854,97,3,"179,3",5,1,1,7,Mid-Value,Potential Loyalists
93855,366,1,"15,2",4,1,1,6,Mid-Value,Potential Loyalists
93859,747,1,"48,4",3,1,1,5,Low-Value,At Risk Customers
93862,381,5,"289,15",4,1,1,6,Mid-Value,Potential Loyalists
93863,11,5,"887,05",5,1,2,8,High-Value,Potential Loyalists
93864,88,3,"345,4",5,1,1,7,Mid-Value,Potential Loyalists
93865,833,2,"20,1",3,1,1,5,Low-Value,At Risk Customers
93866,1226,2,"110,0",2,1,1,4,Low-Value,Can't Lose
93867,557,2,"176,05",4,1,1,6,Mid-Value,Potential Loyalists
93868,108,2,"354,49999999999994",5,1,1,7,Mid-Value,Potential Loyalists
93871,11,2,"189,64999999999998",5,1,1,7,Mid-Value,Potential Loyalists
93873,1129,1,"6,15",2,1,1,4,Low-Value,Can't Lose
93874,379,2,"80,0",4,1,1,6,Mid-Value,Potential Loyalists
93875,416,5,"508,15",4,1,1,6,Mid-Value,Potential Loyalists
93876,624,3,"89,45",4,1,1,6,Mid-Value,Potential Loyalists
93877,831,2,"57,5",3,1,1,5,Low-Value,At Risk Customers
93878,552,3,"198,2",4,1,1,6,Mid-Value,Potential Loyalists
93879,109,1,"1,5",5,1,1,7,Mid-Value,Potential Loyalists
93880,102,3,"206,60000000000002",5,1,1,7,Mid-Value,Potential Loyalists
93881,1233,1,"8,4",2,1,1,4,Low-Value,Can't Lose
93882,466,3,"37,550000000000004",4,1,1,6,Mid-Value,Potential Loyalists
93883,50,1,"13,2",5,1,1,7,Mid-Value,Potential Loyalists
93886,284,6,"560,25",5,1,1,7,Mid-Value,Potential Loyalists
93887,1670,1,"65,75",1,1,1,3,Low-Value,Lost
93888,42,3,"464,25000000000006",5,1,1,7,Mid-Value,Potential Loyalists
93890,600,1,"52,7",4,1,1,6,Mid-Value,Potential Loyalists
93892,104,1,"28,7",5,1,1,7,Mid-Value,Potential Loyalists
93893,541,2,"79,55",4,1,1,6,Mid-Value,Potential Loyalists
93894,1421,1,"100,1",2,1,1,4,Low-Value,Can't Lose
93896,824,3,"143,55",3,1,1,5,Low-Value,At Risk Customers
93902,555,1,"233,7",4,1,1,6,Mid-Value,Potential Loyalists
93903,1257,1,"8,0",2,1,1,4,Low-Value,Can't Lose
93904,26,7,"341,65",5,2,1,8,High-Value,Potential Loyalists
93905,1571,6,"191,25",1,1,1,3,Low-Value,Lost
93908,1445,1,"244,20000000000002",2,1,1,4,Low-Value,Can't Lose
93909,573,4,"94,4",4,1,1,6,Mid-Value,Potential Loyalists
93910,1770,2,"103,64999999999999",1,1,1,3,Low-Value,Lost
93914,903,2,"293,85",3,1,1,5,Low-Value,At Risk Customers
93916,365,4,"181,45",5,1,1,7,Mid-Value,Potential Loyalists
93917,783,5,"204,75",3,1,1,5,Low-Value,At Risk Customers
93918,1545,6,"362,55",1,1,1,3,Low-Value,Lost
93919,308,4,"302,45",5,1,1,7,Mid-Value,Potential Loyalists
93920,416,2,"31,8",4,1,1,6,Mid-Value,Potential Loyalists
93922,1084,1,"34,1",3,1,1,5,Low-Value,At Risk Customers
93923,460,7,"472,05",4,2,1,7,Mid-Value,Potential Loyalists
93924,866,1,"17,15",3,1,1,5,Low-Value,At Risk Customers
93925,182,2,"40,400000000000006",5,1,1,7,Mid-Value,Potential Loyalists
93928,1529,1,"42,75",1,1,1,3,Low-Value,Lost
93929,125,1,"90,0",5,1,1,7,Mid-Value,Potential Loyalists
93930,108,2,"25,55",5,1,1,7,Mid-Value,Potential Loyalists
93932,942,1,"51,3",3,1,1,5,Low-Value,At Risk Customers
93933,15,1,"33,0",5,1,1,7,Mid-Value,Potential Loyalists
93934,1131,1,"16,3",2,1,1,4,Low-Value,Can't Lose
93935,133,2,"64,25",5,1,1,7,Mid-Value,Potential Loyalists
93936,83,1,"44,6",5,1,1,7,Mid-Value,Potential Loyalists
93938,11,11,"573,2",5,2,1,8,High-Value,Potential Loyalists
93939,746,2,"164,2",3,1,1,5,Low-Value,At Risk Customers
93940,1729,1,"49,6",1,1,1,3,Low-Value,Lost
93941,224,2,"185,60000000000002",5,1,1,7,Mid-Value,Potential Loyalists
93942,269,5,"189,5",5,1,1,7,Mid-Value,Potential Loyalists
93945,9,4,"100,8",5,1,1,7,Mid-Value,Potential Loyalists
93946,328,6,"381,8",5,1,1,7,Mid-Value,Potential Loyalists
93949,217,1,"316,1",5,1,1,7,Mid-Value,Potential Loyalists
93952,124,9,"588,5999999999999",5,2,1,8,High-Value,Potential Loyalists
93955,366,6,"804,3000000000001",4,1,2,7,Mid-Value,Potential Loyalists
93957,1,7,"705,6",5,2,2,9,High-Value,Champions
93958,792,5,"344,5",3,1,1,5,Low-Value,At Risk Customers
93960,1342,2,"116,45",2,1,1,4,Low-Value,Can't Lose
93961,615,1,"14,75",4,1,1,6,Mid-Value,Potential Loyalists
93962,327,3,"176,24999999999997",5,1,1,7,Mid-Value,Potential Loyalists
93964,1112,4,"422,65",2,1,1,4,Low-Value,Can't Lose
93965,269,3,"148,25",5,1,1,7,Mid-Value,Potential Loyalists
93966,1074,1,"89,55",3,1,1,5,Low-Value,At Risk Customers
93967,1066,2,"268,7",3,1,1,5,Low-Value,At Risk Customers
93968,440,7,"271,55",4,2,1,7,Mid-Value,Potential Loyalists
93969,137,1,"124,8",5,1,1,7,Mid-Value,Potential Loyalists
93970,262,3,"48,9",5,1,1,7,Mid-Value,Potential Loyalists
93971,618,1,"34,9",4,1,1,6,Mid-Value,Potential Loyalists
93973,448,2,"94,95",4,1,1,6,Mid-Value,Potential Loyalists
93974,1327,3,"639,3",2,1,1,4,Low-Value,Can't Lose
93976,1182,2,"60,2",2,1,1,4,Low-Value,Can't Lose
93978,412,5,"283,8",4,1,1,6,Mid-Value,Potential Loyalists
93979,654,1,"90,7",4,1,1,6,Mid-Value,Potential Loyalists
93980,304,5,"720,9499999999999",5,1,2,8,High-Value,Potential Loyalists
93983,260,1,"26,65",5,1,1,7,Mid-Value,Potential Loyalists
93984,760,1,"109,4",3,1,1,5,Low-Value,At Risk Customers
93986,25,3,"489,29999999999995",5,1,1,7,Mid-Value,Potential Loyalists
93988,500,2,"238,5",4,1,1,6,Mid-Value,Potential Loyalists
93989,533,1,"46,9",4,1,1,6,Mid-Value,Potential Loyalists
93990,1097,2,"216,35000000000002",2,1,1,4,Low-Value,Can't Lose
93991,331,6,"241,9",5,1,1,7,Mid-Value,Potential Loyalists
93997,1630,2,"66,9",1,1,1,3,Low-Value,Lost
93998,322,1,"49,8",5,1,1,7,Mid-Value,Potential Loyalists
93999,237,2,"133,6",5,1,1,7,Mid-Value,Potential Loyalists
94000,252,1,"133,8",5,1,1,7,Mid-Value,Potential Loyalists
94001,793,2,"14,75",3,1,1,5,Low-Value,At Risk Customers
94004,153,5,"185,1",5,1,1,7,Mid-Value,Potential Loyalists
94005,1559,2,"92,1",1,1,1,3,Low-Value,Lost
94006,353,1,"113,65",5,1,1,7,Mid-Value,Potential Loyalists
94007,596,7,"371,95",4,2,1,7,Mid-Value,Potential Loyalists
94008,219,2,"456,8",5,1,1,7,Mid-Value,Potential Loyalists
94010,122,5,"190,04999999999998",5,1,1,7,Mid-Value,Potential Loyalists
94011,1229,2,"47,1",2,1,1,4,Low-Value,Can't Lose
94017,498,1,"45,75",4,1,1,6,Mid-Value,Potential Loyalists
94019,16,10,"233,45",5,2,1,8,High-Value,Potential Loyalists
94020,102,5,"142,85",5,1,1,7,Mid-Value,Potential Loyalists
94022,180,4,"346,45",5,1,1,7,Mid-Value,Potential Loyalists
94025,451,1,"11,95",4,1,1,6,Mid-Value,Potential Loyalists
94026,45,2,"68,7",5,1,1,7,Mid-Value,Potential Loyalists
94028,1,4,"167,95",5,1,1,7,Mid-Value,Potential Loyalists
94034,216,3,"94,1",5,1,1,7,Mid-Value,Potential Loyalists
94037,127,2,"70,15",5,1,1,7,Mid-Value,Potential Loyalists
94038,630,1,"32,65",4,1,1,6,Mid-Value,Potential Loyalists
94039,205,2,"102,5",5,1,1,7,Mid-Value,Potential Loyalists
94042,1418,1,"49,199999999999996",2,1,1,4,Low-Value,Can't Lose
94043,326,4,"93,05000000000001",5,1,1,7,Mid-Value,Potential Loyalists
94044,1325,4,"86,14999999999999",2,1,1,4,Low-Value,Can't Lose
94045,218,2,"34,4",5,1,1,7,Mid-Value,Potential Loyalists
94046,40,1,"12,1",5,1,1,7,Mid-Value,Potential Loyalists
94047,753,1,"18,5",3,1,1,5,Low-Value,At Risk Customers
94048,1160,1,"4,15",2,1,1,4,Low-Value,Can't Lose
94049,111,4,"157,7",5,1,1,7,Mid-Value,Potential Loyalists
94050,143,2,"70,8",5,1,1,7,Mid-Value,Potential Loyalists
94051,19,6,"193,85000000000002",5,1,1,7,Mid-Value,Potential Loyalists
94052,950,1,"51,75",3,1,1,5,Low-Value,At Risk Customers
94054,360,2,"61,150000000000006",5,1,1,7,Mid-Value,Potential Loyalists
94055,54,5,"351,1",5,1,1,7,Mid-Value,Potential Loyalists
94056,67,12,"716,4",5,3,2,10,High-Value,Champions
94059,282,5,"203,15",5,1,1,7,Mid-Value,Potential Loyalists
94060,1712,1,"7,55",1,1,1,3,Low-Value,Lost
94062,67,1,"14,0",5,1,1,7,Mid-Value,Potential Loyalists
94064,142,2,"65,0",5,1,1,7,Mid-Value,Potential Loyalists
94065,10,4,"211,8",5,1,1,7,Mid-Value,Potential Loyalists
94067,700,2,"104,6",4,1,1,6,Mid-Value,Potential Loyalists
94068,75,2,"84,05",5,1,1,7,Mid-Value,Potential Loyalists
94069,3,4,"168,15",5,1,1,7,Mid-Value,Potential Loyalists
94070,127,3,"103,25",5,1,1,7,Mid-Value,Potential Loyalists
94074,35,9,"468,5",5,2,1,8,High-Value,Potential Loyalists
94075,960,3,"184,45",3,1,1,5,Low-Value,At Risk Customers
94076,687,1,"72,9",4,1,1,6,Mid-Value,Potential Loyalists
94078,40,9,"364,8",5,2,1,8,High-Value,Potential Loyalists
94079,54,3,"47,2",5,1,1,7,Mid-Value,Potential Loyalists
94080,640,3,"134,65",4,1,1,6,Mid-Value,Potential Loyalists
94081,644,7,"220,85000000000002",4,2,1,7,Mid-Value,Potential Loyalists
94082,279,5,"271,55",5,1,1,7,Mid-Value,Potential Loyalists
94086,1512,2,"19,3",1,1,1,3,Low-Value,Lost
94089,974,1,"40,1",3,1,1,5,Low-Value,At Risk Customers
94091,247,6,"479,95000000000005",5,1,1,7,Mid-Value,Potential Loyalists
94094,81,3,"160,35",5,1,1,7,Mid-Value,Potential Loyalists
94098,814,4,"103,4",3,1,1,5,Low-Value,At Risk Customers
94099,1106,4,"415,85",2,1,1,4,Low-Value,Can't Lose
94100,49,2,"165,60000000000002",5,1,1,7,Mid-Value,Potential Loyalists
94101,503,3,"182,64999999999998",4,1,1,6,Mid-Value,Potential Loyalists
94105,21,8,"602,95",5,2,1,8,High-Value,Potential Loyalists
94106,963,1,"15,6",3,1,1,5,Low-Value,At Risk Customers
94107,1364,1,"50,0",2,1,1,4,Low-Value,Can't Lose
94108,498,1,"33,5",4,1,1,6,Mid-Value,Potential Loyalists
94110,188,2,"8,4",5,1,1,7,Mid-Value,Potential Loyalists
94111,750,7,"364,25",3,2,1,6,Mid-Value,Potential Loyalists
94113,1153,2,"131,6",2,1,1,4,Low-Value,Can't Lose
94114,222,2,"109,9",5,1,1,7,Mid-Value,Potential Loyalists
94115,279,4,"273,59999999999997",5,1,1,7,Mid-Value,Potential Loyalists
94116,938,1,"55,3",3,1,1,5,Low-Value,At Risk Customers
94117,274,3,"165,1",5,1,1,7,Mid-Value,Potential Loyalists
94118,1647,1,"39,6",1,1,1,3,Low-Value,Lost
94120,722,5,"284,65",4,1,1,6,Mid-Value,Potential Loyalists
94121,377,3,"193,5",4,1,1,6,Mid-Value,Potential Loyalists
94122,609,3,"86,9",4,1,1,6,Mid-Value,Potential Loyalists
94123,122,3,"154,39999999999998",5,1,1,7,Mid-Value,Potential Loyalists
94124,26,3,"311,05",5,1,1,7,Mid-Value,Potential Loyalists
94125,796,6,"233,05",3,1,1,5,Low-Value,At Risk Customers
94128,119,3,"96,55",5,1,1,7,Mid-Value,Potential Loyalists
94131,739,3,"57,3",3,1,1,5,Low-Value,At Risk Customers
94133,1302,2,"167,64999999999998",2,1,1,4,Low-Value,Can't Lose
94136,642,1,"60,65",4,1,1,6,Mid-Value,Potential Loyalists
94138,1057,1,"11,9",3,1,1,5,Low-Value,At Risk Customers
94140,69,2,"108,95",5,1,1,7,Mid-Value,Potential Loyalists
94142,36,5,"524,65",5,1,1,7,Mid-Value,Potential Loyalists
94143,1084,1,"89,6",3,1,1,5,Low-Value,At Risk Customers
94144,69,7,"201,5",5,2,1,8,High-Value,Potential Loyalists
94145,38,3,"249,25000000000003",5,1,1,7,Mid-Value,Potential Loyalists
94147,722,2,"50,6",4,1,1,6,Mid-Value,Potential Loyalists
94148,1,2,"181,85",5,1,1,7,Mid-Value,Potential Loyalists
94149,1135,1,"19,9",2,1,1,4,Low-Value,Can't Lose
94150,446,1,"0,9",4,1,1,6,Mid-Value,Potential Loyalists
94154,27,4,"237,45000000000002",5,1,1,7,Mid-Value,Potential Loyalists
94155,441,2,"54,55",4,1,1,6,Mid-Value,Potential Loyalists
94158,633,1,"8,15",4,1,1,6,Mid-Value,Potential Loyalists
94159,1693,1,"115,19999999999999",1,1,1,3,Low-Value,Lost
94161,35,5,"133,8",5,1,1,7,Mid-Value,Potential Loyalists
94162,107,5,"237,35000000000002",5,1,1,7,Mid-Value,Potential Loyalists
94163,993,1,"12,4",3,1,1,5,Low-Value,At Risk Customers
94165,45,4,"305,3",5,1,1,7,Mid-Value,Potential Loyalists
94168,214,1,"33,7",5,1,1,7,Mid-Value,Potential Loyalists
94169,903,2,"102,6",3,1,1,5,Low-Value,At Risk Customers
94171,962,3,"73,25",3,1,1,5,Low-Value,At Risk Customers
94172,609,2,"159,29999999999998",4,1,1,6,Mid-Value,Potential Loyalists
94175,651,5,"79,0",4,1,1,6,Mid-Value,Potential Loyalists
94177,276,4,"374,5",5,1,1,7,Mid-Value,Potential Loyalists
94179,1115,3,"101,9",2,1,1,4,Low-Value,Can't Lose
94180,203,4,"114,3",5,1,1,7,Mid-Value,Potential Loyalists
94181,915,4,"86,15",3,1,1,5,Low-Value,At Risk Customers
94183,96,6,"184,05",5,1,1,7,Mid-Value,Potential Loyalists
94186,27,7,"185,7",5,2,1,8,High-Value,Potential Loyalists
94187,57,4,"176,75",5,1,1,7,Mid-Value,Potential Loyalists
94188,45,9,"381,1",5,2,1,8,High-Value,Potential Loyalists
94189,137,3,"152,7",5,1,1,7,Mid-Value,Potential Loyalists
94190,9,3,"256,4",5,1,1,7,Mid-Value,Potential Loyalists
94191,44,2,"85,30000000000001",5,1,1,7,Mid-Value,Potential Loyalists
94194,18,9,"701,25",5,2,2,9,High-Value,Champions
94196,11,11,"665,3",5,2,2,9,High-Value,Champions
94197,215,3,"107,8",5,1,1,7,Mid-Value,Potential Loyalists
94199,1379,1,"14,0",2,1,1,4,Low-Value,Can't Lose
94200,1817,1,"35,9",1,1,1,3,Low-Value,Lost
94201,1345,2,"116,55",2,1,1,4,Low-Value,Can't Lose
94202,560,3,"198,5",4,1,1,6,Mid-Value,Potential Loyalists
94203,424,2,"49,5",4,1,1,6,Mid-Value,Potential Loyalists
94204,155,2,"81,05000000000001",5,1,1,7,Mid-Value,Potential Loyalists
94206,34,2,"228,20000000000002",5,1,1,7,Mid-Value,Potential Loyalists
94212,182,4,"203,3",5,1,1,7,Mid-Value,Potential Loyalists
94215,818,2,"62,1",3,1,1,5,Low-Value,At Risk Customers
94216,1035,7,"245,25",3,2,1,6,Mid-Value,Potential Loyalists
94218,142,1,"113,4",5,1,1,7,Mid-Value,Potential Loyalists
94219,685,3,"289,2",4,1,1,6,Mid-Value,Potential Loyalists
94221,493,4,"383,3",4,1,1,6,Mid-Value,Potential Loyalists
94222,2,9,"552,0",5,2,1,8,High-Value,Potential Loyalists
94223,561,8,"585,3",4,2,1,7,Mid-Value,Potential Loyalists
94224,766,2,"69,94999999999999",3,1,1,5,Low-Value,At Risk Customers
94225,858,3,"29,35",3,1,1,5,Low-Value,At Risk Customers
94226,137,3,"167,70000000000002",5,1,1,7,Mid-Value,Potential Loyalists
94227,276,4,"134,8",5,1,1,7,Mid-Value,Potential Loyalists
94229,1083,1,"125,85",3,1,1,5,Low-Value,At Risk Customers
94230,97,3,"229,05",5,1,1,7,Mid-Value,Potential Loyalists
94232,38,4,"367,45",5,1,1,7,Mid-Value,Potential Loyalists
94233,188,4,"239,25",5,1,1,7,Mid-Value,Potential Loyalists
94234,684,5,"299,5",4,1,1,6,Mid-Value,Potential Loyalists
94235,724,1,"6,5",4,1,1,6,Mid-Value,Potential Loyalists
94236,79,6,"242,95",5,1,1,7,Mid-Value,Potential Loyalists
94238,274,3,"154,55",5,1,1,7,Mid-Value,Potential Loyalists
94239,399,3,"261,6",4,1,1,6,Mid-Value,Potential Loyalists
94240,172,3,"147,25",5,1,1,7,Mid-Value,Potential Loyalists
94241,39,4,"725,0",5,1,2,8,High-Value,Potential Loyalists
94242,324,7,"320,95",5,2,1,8,High-Value,Potential Loyalists
94243,999,2,"76,5",3,1,1,5,Low-Value,At Risk Customers
94244,132,6,"320,25",5,1,1,7,Mid-Value,Potential Loyalists
94246,624,2,"195,70000000000002",4,1,1,6,Mid-Value,Potential Loyalists
94247,918,3,"183,20000000000002",3,1,1,5,Low-Value,At Risk Customers
94250,948,1,"12,0",3,1,1,5,Low-Value,At Risk Customers
94252,139,9,"404,85",5,2,1,8,High-Value,Potential Loyalists
94253,1223,2,"329,4",2,1,1,4,Low-Value,Can't Lose
